"استان","شهرستان","بخش","شماره_صندوق","احمدی_نژاد","رضایی","کروبی","موسوی","صحیح","باطله","کل_آرا"
"آذربایجان_شرقی","آذرشهر","حومه",1,522,7,3,232,764,11,775
"آذربایجان_شرقی","آذرشهر","حومه",2,867,28,9,677,1581,28,1609
"آذربایجان_شرقی","آذرشهر","حومه",3,1351,20,10,772,2153,30,2183
"آذربایجان_شرقی","آذرشهر","حومه",4,629,9,4,651,1293,9,1302
"آذربایجان_شرقی","آذرشهر","حومه",5,838,10,3,424,1275,15,1290
"آذربایجان_شرقی","آذرشهر","حومه",6,386,12,1,310,709,4,713
"آذربایجان_شرقی","آذرشهر","حومه",7,735,15,1,344,1095,10,1105
"آذربایجان_شرقی","آذرشهر","حومه",8,813,5,0,269,1087,12,1099
"آذربایجان_شرقی","آذرشهر","حومه",9,820,16,2,514,1352,19,1371
"آذربایجان_شرقی","آذرشهر","حومه",10,841,2,3,380,1226,20,1246
"آذربایجان_شرقی","آذرشهر","حومه",11,888,4,0,356,1248,8,1256
"آذربایجان_شرقی","آذرشهر","حومه",12,592,11,1,309,913,9,922
"آذربایجان_شرقی","آذرشهر","حومه",13,553,10,4,342,909,10,919
"آذربایجان_شرقی","آذرشهر","حومه",14,604,9,2,352,967,10,977
"آذربایجان_شرقی","آذرشهر","حومه",15,759,10,1,536,1306,16,1322
"آذربایجان_شرقی","آذرشهر","حومه",16,238,5,1,195,439,14,453
"آذربایجان_شرقی","آذرشهر","حومه",17,227,5,1,203,436,8,444
"آذربایجان_شرقی","آذرشهر","حومه",18,185,0,2,74,261,0,261
"آذربایجان_شرقی","آذرشهر","حومه",19,411,2,2,138,553,5,558
"آذربایجان_شرقی","آذرشهر","حومه",20,613,2,2,438,1055,8,1063
"آذربایجان_شرقی","آذرشهر","حومه",21,688,5,2,269,964,9,973
"آذربایجان_شرقی","آذرشهر","حومه",22,353,9,1,318,681,6,687
"آذربایجان_شرقی","آذرشهر","حومه",23,396,1,0,216,613,1,614
"آذربایجان_شرقی","آذرشهر","حومه",24,134,1,0,51,186,2,188
"آذربایجان_شرقی","آذرشهر","حومه",25,425,5,0,109,539,11,550
"آذربایجان_شرقی","آذرشهر","حومه",26,519,1,2,54,576,2,578
"آذربایجان_شرقی","آذرشهر","حومه",27,462,2,1,161,626,10,636
"آذربایجان_شرقی","آذرشهر","حومه",28,498,0,0,99,597,2,599
"آذربایجان_شرقی","آذرشهر","حومه",29,223,4,0,70,297,3,300
"آذربایجان_شرقی","آذرشهر","حومه",30,450,6,0,44,500,0,500
"آذربایجان_شرقی","آذرشهر","حومه",31,360,2,0,13,375,6,381
"آذربایجان_شرقی","آذرشهر","حومه",32,230,6,0,37,273,5,278
"آذربایجان_شرقی","آذرشهر","حومه",33,472,0,1,13,486,2,488
"آذربایجان_شرقی","آذرشهر","حومه",34,440,4,3,345,792,13,805
"آذربایجان_شرقی","آذرشهر","حومه",35,424,1,1,184,610,8,618
"آذربایجان_شرقی","آذرشهر","حومه",36,393,0,0,60,453,2,455
"آذربایجان_شرقی","آذرشهر","حومه",37,266,1,2,61,330,4,334
"آذربایجان_شرقی","آذرشهر","حومه",38,509,2,0,17,528,3,531
"آذربایجان_شرقی","آذرشهر","حومه",39,414,4,3,65,486,14,500
"آذربایجان_شرقی","آذرشهر","حومه",40,880,13,2,174,1069,4,1073
"آذربایجان_شرقی","آذرشهر","حومه",41,873,3,0,90,966,4,970
"آذربایجان_شرقی","آذرشهر","حومه",42,194,0,0,35,229,0,229
"آذربایجان_شرقی","آذرشهر","حومه",43,314,3,0,119,436,4,440
"آذربایجان_شرقی","آذرشهر","حومه",44,348,1,1,153,503,8,511
"آذربایجان_شرقی","آذرشهر","حومه",45,371,0,0,97,468,2,470
"آذربایجان_شرقی","آذرشهر","حومه",46,343,4,1,92,440,8,448
"آذربایجان_شرقی","آذرشهر","حومه",47,449,3,0,60,512,8,520
"آذربایجان_شرقی","آذرشهر","حومه",48,407,2,1,100,510,2,512
"آذربایجان_شرقی","آذرشهر","حومه",49,291,2,4,8,305,2,307
"آذربایجان_شرقی","آذرشهر","گوگان",1,375,1,1,290,667,11,678
"آذربایجان_شرقی","آذرشهر","گوگان",2,330,5,0,272,607,8,615
"آذربایجان_شرقی","آذرشهر","گوگان",3,897,10,3,776,1686,27,1713
"آذربایجان_شرقی","آذرشهر","گوگان",4,467,8,0,241,716,12,728
"آذربایجان_شرقی","آذرشهر","گوگان",5,573,8,1,334,916,4,920
"آذربایجان_شرقی","آذرشهر","گوگان",6,609,7,2,432,1050,7,1057
"آذربایجان_شرقی","آذرشهر","گوگان",7,156,4,2,283,445,3,448
"آذربایجان_شرقی","آذرشهر","گوگان",8,266,13,3,128,410,7,417
"آذربایجان_شرقی","آذرشهر","گوگان",9,724,8,6,381,1119,14,1133
"آذربایجان_شرقی","آذرشهر","گوگان",10,605,3,4,176,788,3,791
"آذربایجان_شرقی","آذرشهر","گوگان",11,552,14,5,206,777,3,780
"آذربایجان_شرقی","آذرشهر","گوگان",12,649,2,2,101,754,3,757
"آذربایجان_شرقی","آذرشهر","گوگان",13,469,2,0,85,556,1,557
"آذربایجان_شرقی","آذرشهر","گوگان",14,291,2,1,94,388,6,394
"آذربایجان_شرقی","آذرشهر","گوگان",15,132,0,0,41,173,1,174
"آذربایجان_شرقی","آذرشهر","گوگان",16,332,5,1,179,517,4,521
"آذربایجان_شرقی","آذرشهر","گوگان",17,330,0,0,93,423,2,425
"آذربایجان_شرقی","آذرشهر","گوگان",18,488,1,1,215,705,6,711
"آذربایجان_شرقی","آذرشهر","گوگان",19,604,3,3,137,747,11,758
"آذربایجان_شرقی","آذرشهر","ممقان",1,366,2,0,337,705,12,717
"آذربایجان_شرقی","آذرشهر","ممقان",2,549,16,0,309,874,3,877
"آذربایجان_شرقی","آذرشهر","ممقان",3,586,11,1,670,1268,12,1280
"آذربایجان_شرقی","آذرشهر","ممقان",4,266,7,2,256,531,12,543
"آذربایجان_شرقی","آذرشهر","ممقان",5,125,2,1,184,312,1,313
"آذربایجان_شرقی","آذرشهر","ممقان",6,161,5,0,130,296,4,300
"آذربایجان_شرقی","آذرشهر","ممقان",7,268,7,0,253,528,3,531
"آذربایجان_شرقی","آذرشهر","ممقان",8,101,3,4,135,243,2,245
"آذربایجان_شرقی","آذرشهر","ممقان",9,179,0,0,127,306,1,307
"آذربایجان_شرقی","آذرشهر","ممقان",10,619,35,18,726,1398,31,1429
"آذربایجان_شرقی","آذرشهر","ممقان",11,136,2,0,91,229,1,230
"آذربایجان_شرقی","اسکو","مرکزی",1,153,2,0,165,320,4,324
"آذربایجان_شرقی","اسکو","مرکزی",2,194,8,0,159,361,2,363
"آذربایجان_شرقی","اسکو","مرکزی",3,263,3,1,215,482,4,486
"آذربایجان_شرقی","اسکو","مرکزی",4,238,1,0,119,358,2,360
"آذربایجان_شرقی","اسکو","مرکزی",5,455,13,2,406,876,11,887
"آذربایجان_شرقی","اسکو","مرکزی",6,319,5,2,317,643,4,647
"آذربایجان_شرقی","اسکو","مرکزی",7,520,4,1,138,663,2,665
"آذربایجان_شرقی","اسکو","مرکزی",8,706,13,4,466,1189,11,1200
"آذربایجان_شرقی","اسکو","مرکزی",9,134,4,5,232,375,1,376
"آذربایجان_شرقی","اسکو","مرکزی",10,198,4,0,269,471,5,476
"آذربایجان_شرقی","اسکو","مرکزی",11,1004,12,9,774,1799,19,1818
"آذربایجان_شرقی","اسکو","مرکزی",12,470,12,1,391,874,4,878
"آذربایجان_شرقی","اسکو","مرکزی",13,290,5,0,134,429,5,434
"آذربایجان_شرقی","اسکو","مرکزی",14,277,3,3,143,426,3,429
"آذربایجان_شرقی","اسکو","مرکزی",15,417,2,0,170,589,3,592
"آذربایجان_شرقی","اسکو","مرکزی",16,231,33,13,214,491,8,499
"آذربایجان_شرقی","اسکو","مرکزی",17,588,16,6,647,1257,5,1262
"آذربایجان_شرقی","اسکو","مرکزی",18,372,12,4,446,834,3,837
"آذربایجان_شرقی","اسکو","مرکزی",19,501,12,5,561,1079,6,1085
"آذربایجان_شرقی","اسکو","مرکزی",20,650,21,6,1002,1679,13,1692
"آذربایجان_شرقی","اسکو","مرکزی",21,251,20,6,503,780,2,782
"آذربایجان_شرقی","اسکو","مرکزی",22,171,3,0,153,327,5,332
"آذربایجان_شرقی","اسکو","مرکزی",23,353,12,2,334,701,8,709
"آذربایجان_شرقی","اسکو","مرکزی",24,474,14,2,466,956,11,967
"آذربایجان_شرقی","اسکو","مرکزی",25,470,15,4,453,942,5,947
"آذربایجان_شرقی","اسکو","مرکزی",26,132,1,3,136,272,4,276
"آذربایجان_شرقی","اسکو","مرکزی",27,398,1,3,213,615,7,622
"آذربایجان_شرقی","اسکو","مرکزی",28,671,6,1,301,979,5,984
"آذربایجان_شرقی","اسکو","مرکزی",29,652,7,2,166,827,3,830
"آذربایجان_شرقی","اسکو","مرکزی",30,558,6,1,308,873,5,878
"آذربایجان_شرقی","اسکو","مرکزی",31,426,4,2,195,627,4,631
"آذربایجان_شرقی","اسکو","مرکزی",32,313,7,1,268,589,4,593
"آذربایجان_شرقی","اسکو","مرکزی",33,412,0,0,137,549,4,553
"آذربایجان_شرقی","اسکو","مرکزی",34,383,3,2,84,472,1,473
"آذربایجان_شرقی","اسکو","مرکزی",35,262,1,0,157,420,1,421
"آذربایجان_شرقی","اسکو","مرکزی",36,450,3,4,229,686,12,698
"آذربایجان_شرقی","اسکو","مرکزی",37,260,4,3,264,531,7,538
"آذربایجان_شرقی","اسکو","مرکزی",38,734,5,2,208,949,6,955
"آذربایجان_شرقی","اسکو","مرکزی",39,283,0,0,53,336,1,337
"آذربایجان_شرقی","اسکو","مرکزی",40,325,3,0,96,424,4,428
"آذربایجان_شرقی","اسکو","مرکزی",41,379,3,0,38,420,4,424
"آذربایجان_شرقی","اسکو","مرکزی",42,343,0,8,8,359,2,361
"آذربایجان_شرقی","اسکو","مرکزی",43,531,17,5,206,759,7,766
"آذربایجان_شرقی","اسکو","مرکزی",44,542,9,2,113,666,3,669
"آذربایجان_شرقی","اسکو","مرکزی",45,242,5,2,230,479,6,485
"آذربایجان_شرقی","اسکو","مرکزی",46,115,0,0,11,126,1,127
"آذربایجان_شرقی","اسکو","مرکزی",47,136,0,0,18,154,0,154
"آذربایجان_شرقی","اسکو","مرکزی",48,210,11,0,11,232,2,234
"آذربایجان_شرقی","اسکو","مرکزی",49,482,1,4,18,505,7,512
"آذربایجان_شرقی","اسکو","مرکزی",50,467,1,0,142,610,1,611
"آذربایجان_شرقی","اسکو","مرکزی",51,425,0,0,62,487,0,487
"آذربایجان_شرقی","اسکو","مرکزی",52,742,3,1,29,775,6,781
"آذربایجان_شرقی","اسکو","مرکزی",53,687,2,0,90,779,2,781
"آذربایجان_شرقی","اسکو","ایلخچی",1,491,13,51,406,961,10,971
"آذربایجان_شرقی","اسکو","ایلخچی",2,751,14,39,793,1597,21,1618
"آذربایجان_شرقی","اسکو","ایلخچی",3,697,7,83,773,1560,14,1574
"آذربایجان_شرقی","اسکو","ایلخچی",4,341,6,32,394,773,7,780
"آذربایجان_شرقی","اسکو","ایلخچی",5,464,13,57,345,879,7,886
"آذربایجان_شرقی","اسکو","ایلخچی",6,445,1,36,409,891,14,905
"آذربایجان_شرقی","اسکو","ایلخچی",7,465,14,22,610,1111,15,1126
"آذربایجان_شرقی","اسکو","ایلخچی",8,395,11,4,99,509,8,517
"آذربایجان_شرقی","اسکو","ایلخچی",9,224,0,9,198,431,6,437
"آذربایجان_شرقی","اسکو","ایلخچی",10,483,2,0,145,630,1,631
"آذربایجان_شرقی","اسکو","ایلخچی",11,362,1,0,36,399,2,401
"آذربایجان_شرقی","اسکو","ایلخچی",12,357,3,0,83,443,6,449
"آذربایجان_شرقی","اسکو","ایلخچی",13,651,2,2,236,891,0,891
"آذربایجان_شرقی","اسکو","ایلخچی",14,572,1,0,114,687,3,690
"آذربایجان_شرقی","اسکو","ایلخچی",15,300,13,1,56,370,0,370
"آذربایجان_شرقی","اسکو","ایلخچی",16,300,2,0,37,339,1,340
"آذربایجان_شرقی","اسکو","ایلخچی",17,326,5,0,88,419,1,420
"آذربایجان_شرقی","اسکو","ایلخچی",18,79,2,0,108,189,0,189
"آذربایجان_شرقی","اسکو","ایلخچی",19,148,1,0,61,210,0,210
"آذربایجان_شرقی","اسکو","ایلخچی",20,119,1,0,31,151,0,151
"آذربایجان_شرقی","اسکو","ایلخچی",21,456,0,0,87,543,4,547
"آذربایجان_شرقی","اسکو","ایلخچی",22,436,2,3,57,498,4,502
"آذربایجان_شرقی","اسکو","ایلخچی",23,234,1,0,43,278,0,278
"آذربایجان_شرقی","اسکو","ایلخچی",24,114,0,0,26,140,1,141
"آذربایجان_شرقی","اسکو","ایلخچی",25,521,4,0,223,748,0,748
"آذربایجان_شرقی","اسکو","ایلخچی",26,106,2,0,85,193,0,193
"آذربایجان_شرقی","اسکو","ایلخچی",27,228,0,0,273,501,0,501
"آذربایجان_شرقی","اسکو","ایلخچی",28,340,3,1,107,451,2,453
"آذربایجان_شرقی","اسکو","ایلخچی",29,320,4,5,114,443,1,444
"آذربایجان_شرقی","اسکو","ایلخچی",30,358,1,1,32,392,2,394
"آذربایجان_شرقی","اسکو","ایلخچی",31,118,0,0,8,126,0,126
"آذربایجان_شرقی","اسکو","ایلخچی",32,50,0,0,54,104,0,104
"آذربایجان_شرقی","اهر","مرکزی",1,362,13,5,398,778,11,789
"آذربایجان_شرقی","اهر","مرکزی",2,771,24,11,992,1798,33,1831
"آذربایجان_شرقی","اهر","مرکزی",3,400,9,4,385,798,9,807
"آذربایجان_شرقی","اهر","مرکزی",4,443,14,6,597,1060,12,1072
"آذربایجان_شرقی","اهر","مرکزی",5,491,9,0,356,856,8,864
"آذربایجان_شرقی","اهر","مرکزی",6,504,7,2,376,889,7,896
"آذربایجان_شرقی","اهر","مرکزی",7,540,10,2,565,1117,22,1139
"آذربایجان_شرقی","اهر","مرکزی",8,367,17,4,728,1116,25,1141
"آذربایجان_شرقی","اهر","مرکزی",9,430,10,4,393,837,12,849
"آذربایجان_شرقی","اهر","مرکزی",10,397,13,3,472,885,14,899
"آذربایجان_شرقی","اهر","مرکزی",11,755,12,4,407,1178,16,1194
"آذربایجان_شرقی","اهر","مرکزی",12,440,12,7,497,956,8,964
"آذربایجان_شرقی","اهر","مرکزی",13,723,17,3,606,1349,19,1368
"آذربایجان_شرقی","اهر","مرکزی",14,678,11,1,328,1018,5,1023
"آذربایجان_شرقی","اهر","مرکزی",15,487,10,5,603,1105,8,1113
"آذربایجان_شرقی","اهر","مرکزی",16,811,10,3,712,1536,14,1550
"آذربایجان_شرقی","اهر","مرکزی",17,662,11,3,466,1142,12,1154
"آذربایجان_شرقی","اهر","مرکزی",18,497,17,2,647,1163,11,1174
"آذربایجان_شرقی","اهر","مرکزی",19,483,2,1,320,806,7,813
"آذربایجان_شرقی","اهر","مرکزی",20,339,10,5,479,833,12,845
"آذربایجان_شرقی","اهر","مرکزی",21,855,13,3,454,1325,15,1340
"آذربایجان_شرقی","اهر","مرکزی",22,460,5,2,288,755,5,760
"آذربایجان_شرقی","اهر","مرکزی",23,546,9,0,257,812,7,819
"آذربایجان_شرقی","اهر","مرکزی",24,675,0,0,127,802,1,803
"آذربایجان_شرقی","اهر","مرکزی",25,363,12,4,465,844,6,850
"آذربایجان_شرقی","اهر","مرکزی",26,537,9,1,397,944,8,952
"آذربایجان_شرقی","اهر","مرکزی",27,462,4,3,239,708,4,712
"آذربایجان_شرقی","اهر","مرکزی",28,301,8,2,399,710,12,722
"آذربایجان_شرقی","اهر","مرکزی",29,527,13,1,389,930,9,939
"آذربایجان_شرقی","اهر","مرکزی",30,691,17,5,412,1125,20,1145
"آذربایجان_شرقی","اهر","مرکزی",31,575,19,6,568,1168,11,1179
"آذربایجان_شرقی","اهر","مرکزی",32,396,7,2,284,689,5,694
"آذربایجان_شرقی","اهر","مرکزی",33,896,4,1,273,1174,2,1176
"آذربایجان_شرقی","اهر","مرکزی",34,814,11,3,327,1155,0,1155
"آذربایجان_شرقی","اهر","مرکزی",35,212,6,3,296,517,6,523
"آذربایجان_شرقی","اهر","مرکزی",36,437,14,4,515,970,20,990
"آذربایجان_شرقی","اهر","مرکزی",37,552,4,0,274,830,7,837
"آذربایجان_شرقی","اهر","مرکزی",38,505,4,0,276,785,3,788
"آذربایجان_شرقی","اهر","مرکزی",39,808,21,4,344,1177,4,1181
"آذربایجان_شرقی","اهر","مرکزی",40,674,5,4,306,989,11,1000
"آذربایجان_شرقی","اهر","مرکزی",41,674,2,1,281,958,13,971
"آذربایجان_شرقی","اهر","مرکزی",42,702,10,3,329,1044,5,1049
"آذربایجان_شرقی","اهر","مرکزی",43,792,11,1,364,1168,8,1176
"آذربایجان_شرقی","اهر","مرکزی",44,448,13,6,364,831,6,837
"آذربایجان_شرقی","اهر","مرکزی",45,282,2,3,375,662,2,664
"آذربایجان_شرقی","اهر","مرکزی",46,85,3,3,124,215,2,217
"آذربایجان_شرقی","اهر","مرکزی",47,568,6,1,412,987,8,995
"آذربایجان_شرقی","اهر","مرکزی",48,322,15,7,543,887,10,897
"آذربایجان_شرقی","اهر","مرکزی",49,125,3,1,120,249,4,253
"آذربایجان_شرقی","اهر","مرکزی",50,338,1,0,171,510,0,510
"آذربایجان_شرقی","اهر","مرکزی",51,189,2,0,49,240,0,240
"آذربایجان_شرقی","اهر","مرکزی",52,280,1,0,40,321,1,322
"آذربایجان_شرقی","اهر","مرکزی",53,182,0,0,36,218,2,220
"آذربایجان_شرقی","اهر","مرکزی",54,256,0,0,67,323,3,326
"آذربایجان_شرقی","اهر","مرکزی",55,120,1,0,33,154,2,156
"آذربایجان_شرقی","اهر","مرکزی",56,433,0,1,83,517,0,517
"آذربایجان_شرقی","اهر","مرکزی",57,479,0,2,57,538,1,539
"آذربایجان_شرقی","اهر","مرکزی",58,340,0,1,36,377,0,377
"آذربایجان_شرقی","اهر","مرکزی",59,413,0,0,120,533,2,535
"آذربایجان_شرقی","اهر","مرکزی",60,610,2,1,72,685,1,686
"آذربایجان_شرقی","اهر","مرکزی",61,335,1,0,52,388,0,388
"آذربایجان_شرقی","اهر","مرکزی",62,97,2,0,44,143,1,144
"آذربایجان_شرقی","اهر","مرکزی",63,507,0,0,82,589,5,594
"آذربایجان_شرقی","اهر","مرکزی",64,222,0,0,8,230,2,232
"آذربایجان_شرقی","اهر","مرکزی",65,188,2,2,51,243,2,245
"آذربایجان_شرقی","اهر","مرکزی",66,375,0,1,45,421,2,423
"آذربایجان_شرقی","اهر","مرکزی",67,375,4,0,72,451,0,451
"آذربایجان_شرقی","اهر","مرکزی",68,307,1,0,72,380,2,382
"آذربایجان_شرقی","اهر","مرکزی",69,574,5,2,78,659,7,666
"آذربایجان_شرقی","اهر","مرکزی",70,376,1,0,135,512,0,512
"آذربایجان_شرقی","اهر","مرکزی",71,467,4,0,103,574,4,578
"آذربایجان_شرقی","اهر","مرکزی",72,328,2,0,70,400,2,402
"آذربایجان_شرقی","اهر","مرکزی",73,177,0,0,23,200,0,200
"آذربایجان_شرقی","اهر","مرکزی",74,228,1,0,52,281,0,281
"آذربایجان_شرقی","اهر","مرکزی",75,601,0,4,101,706,8,714
"آذربایجان_شرقی","اهر","مرکزی",76,137,0,0,54,191,0,191
"آذربایجان_شرقی","اهر","مرکزی",77,430,1,0,57,488,0,488
"آذربایجان_شرقی","اهر","مرکزی",78,494,2,0,86,582,1,583
"آذربایجان_شرقی","اهر","مرکزی",79,91,1,0,123,215,0,215
"آذربایجان_شرقی","اهر","مرکزی",80,301,0,0,111,412,2,414
"آذربایجان_شرقی","اهر","مرکزی",81,18,0,0,8,26,2,28
"آذربایجان_شرقی","اهر","مرکزی",82,253,1,0,30,284,0,284
"آذربایجان_شرقی","اهر","مرکزی",83,8,0,0,5,13,0,13
"آذربایجان_شرقی","اهر","مرکزی",84,115,1,0,30,146,1,147
"آذربایجان_شرقی","اهر","مرکزی",85,308,0,0,55,363,3,366
"آذربایجان_شرقی","اهر","مرکزی",86,220,0,5,48,273,2,275
"آذربایجان_شرقی","اهر","مرکزی",87,260,0,0,58,318,2,320
"آذربایجان_شرقی","اهر","مرکزی",88,58,1,0,51,110,0,110
"آذربایجان_شرقی","اهر","مرکزی",89,284,0,0,55,339,1,340
"آذربایجان_شرقی","اهر","مرکزی",90,127,2,0,53,182,1,183
"آذربایجان_شرقی","اهر","مرکزی",91,181,1,0,87,269,2,271
"آذربایجان_شرقی","اهر","مرکزی",92,296,0,1,59,356,7,363
"آذربایجان_شرقی","اهر","مرکزی",93,93,2,0,93,188,0,188
"آذربایجان_شرقی","اهر","مرکزی",94,429,0,2,94,525,7,532
"آذربایجان_شرقی","اهر","مرکزی",95,341,1,0,192,534,1,535
"آذربایجان_شرقی","اهر","مرکزی",96,302,1,0,54,357,0,357
"آذربایجان_شرقی","اهر","مرکزی",97,104,1,0,154,259,4,263
"آذربایجان_شرقی","اهر","مرکزی",98,443,1,0,62,506,2,508
"آذربایجان_شرقی","اهر","هوراند",1,521,1,0,120,642,3,645
"آذربایجان_شرقی","اهر","هوراند",2,667,5,0,323,995,5,1000
"آذربایجان_شرقی","اهر","هوراند",3,346,5,0,130,481,0,481
"آذربایجان_شرقی","اهر","هوراند",4,125,1,0,69,195,0,195
"آذربایجان_شرقی","اهر","هوراند",5,75,0,0,25,100,0,100
"آذربایجان_شرقی","اهر","هوراند",6,183,1,0,23,207,0,207
"آذربایجان_شرقی","اهر","هوراند",7,194,0,0,70,264,2,266
"آذربایجان_شرقی","اهر","هوراند",8,126,0,0,63,189,0,189
"آذربایجان_شرقی","اهر","هوراند",9,210,0,0,25,235,0,235
"آذربایجان_شرقی","اهر","هوراند",10,337,1,0,82,420,1,421
"آذربایجان_شرقی","اهر","هوراند",11,132,0,0,13,145,0,145
"آذربایجان_شرقی","اهر","هوراند",12,389,6,0,47,442,0,442
"آذربایجان_شرقی","اهر","هوراند",13,116,0,0,101,217,0,217
"آذربایجان_شرقی","اهر","هوراند",14,223,0,0,48,271,2,273
"آذربایجان_شرقی","اهر","هوراند",15,81,1,0,18,100,0,100
"آذربایجان_شرقی","اهر","هوراند",16,192,0,0,19,211,7,218
"آذربایجان_شرقی","اهر","هوراند",17,363,3,0,37,403,1,404
"آذربایجان_شرقی","اهر","هوراند",18,312,0,0,52,364,0,364
"آذربایجان_شرقی","اهر","هوراند",19,478,0,0,53,531,4,535
"آذربایجان_شرقی","اهر","هوراند",20,288,0,0,140,428,0,428
"آذربایجان_شرقی","اهر","هوراند",21,303,2,0,107,412,0,412
"آذربایجان_شرقی","اهر","هوراند",22,108,0,0,191,299,1,300
"آذربایجان_شرقی","اهر","هوراند",23,112,1,0,189,302,1,303
"آذربایجان_شرقی","اهر","هوراند",24,207,0,0,197,404,1,405
"آذربایجان_شرقی","اهر","هوراند",25,98,1,0,18,117,0,117
"آذربایجان_شرقی","اهر","هوراند",26,156,0,0,15,171,0,171
"آذربایجان_شرقی","اهر","هوراند",27,93,0,0,69,162,1,163
"آذربایجان_شرقی","اهر","هوراند",28,138,0,0,69,207,0,207
"آذربایجان_شرقی","اهر","هوراند",29,310,0,0,86,396,1,397
"آذربایجان_شرقی","اهر","هوراند",30,214,2,0,124,340,0,340
"آذربایجان_شرقی","اهر","هوراند",31,359,2,2,70,433,5,438
"آذربایجان_شرقی","اهر","هوراند",32,238,1,0,33,272,0,272
"آذربایجان_شرقی","اهر","هوراند",33,163,0,0,48,211,0,211
"آذربایجان_شرقی","اهر","هوراند",34,127,1,0,46,174,2,176
"آذربایجان_شرقی","بستان_آباد","مرکزی",1,320,8,1,599,928,8,936
"آذربایجان_شرقی","بستان_آباد","مرکزی",2,360,6,0,353,719,8,727
"آذربایجان_شرقی","بستان_آباد","مرکزی",3,625,14,3,797,1439,11,1450
"آذربایجان_شرقی","بستان_آباد","مرکزی",4,258,6,0,439,703,0,703
"آذربایجان_شرقی","بستان_آباد","مرکزی",5,655,18,1,160,834,3,837
"آذربایجان_شرقی","بستان_آباد","مرکزی",6,510,5,1,174,690,5,695
"آذربایجان_شرقی","بستان_آباد","مرکزی",7,572,2,0,125,699,0,699
"آذربایجان_شرقی","بستان_آباد","مرکزی",8,295,4,1,190,490,4,494
"آذربایجان_شرقی","بستان_آباد","مرکزی",9,234,3,1,223,461,6,467
"آذربایجان_شرقی","بستان_آباد","مرکزی",10,254,5,3,187,449,5,454
"آذربایجان_شرقی","بستان_آباد","مرکزی",11,336,6,0,199,541,2,543
"آذربایجان_شرقی","بستان_آباد","مرکزی",12,397,8,1,468,874,5,879
"آذربایجان_شرقی","بستان_آباد","مرکزی",13,435,6,1,388,830,10,840
"آذربایجان_شرقی","بستان_آباد","مرکزی",14,181,0,0,33,214,0,214
"آذربایجان_شرقی","بستان_آباد","مرکزی",15,328,7,1,100,436,5,441
"آذربایجان_شرقی","بستان_آباد","مرکزی",16,342,5,0,65,412,3,415
"آذربایجان_شرقی","بستان_آباد","مرکزی",17,285,0,0,36,321,1,322
"آذربایجان_شرقی","بستان_آباد","مرکزی",18,166,0,0,48,214,2,216
"آذربایجان_شرقی","بستان_آباد","مرکزی",19,279,3,1,40,323,2,325
"آذربایجان_شرقی","بستان_آباد","مرکزی",20,246,2,0,44,292,1,293
"آذربایجان_شرقی","بستان_آباد","مرکزی",21,350,2,1,53,406,2,408
"آذربایجان_شرقی","بستان_آباد","مرکزی",22,836,5,0,136,977,6,983
"آذربایجان_شرقی","بستان_آباد","مرکزی",23,196,1,2,12,211,0,211
"آذربایجان_شرقی","بستان_آباد","مرکزی",24,133,3,0,72,208,2,210
"آذربایجان_شرقی","بستان_آباد","مرکزی",25,196,0,0,31,227,0,227
"آذربایجان_شرقی","بستان_آباد","مرکزی",26,275,0,0,14,289,10,299
"آذربایجان_شرقی","بستان_آباد","مرکزی",27,94,0,0,143,237,4,241
"آذربایجان_شرقی","بستان_آباد","مرکزی",28,191,1,0,53,245,2,247
"آذربایجان_شرقی","بستان_آباد","مرکزی",29,323,5,0,70,398,3,401
"آذربایجان_شرقی","بستان_آباد","مرکزی",30,296,4,0,88,388,3,391
"آذربایجان_شرقی","بستان_آباد","مرکزی",31,660,5,0,37,702,0,702
"آذربایجان_شرقی","بستان_آباد","مرکزی",32,552,4,0,51,607,3,610
"آذربایجان_شرقی","بستان_آباد","مرکزی",33,894,1,0,77,972,1,973
"آذربایجان_شرقی","بستان_آباد","مرکزی",34,808,10,1,155,974,12,986
"آذربایجان_شرقی","بستان_آباد","مرکزی",35,328,1,0,37,366,0,366
"آذربایجان_شرقی","بستان_آباد","مرکزی",36,661,4,1,258,924,7,931
"آذربایجان_شرقی","بستان_آباد","مرکزی",37,643,5,0,104,752,2,754
"آذربایجان_شرقی","بستان_آباد","مرکزی",38,370,9,0,252,631,4,635
"آذربایجان_شرقی","بستان_آباد","مرکزی",39,143,3,0,94,240,3,243
"آذربایجان_شرقی","بستان_آباد","مرکزی",40,594,4,2,124,724,7,731
"آذربایجان_شرقی","بستان_آباد","مرکزی",41,656,1,0,35,692,5,697
"آذربایجان_شرقی","بستان_آباد","مرکزی",42,332,3,0,45,380,0,380
"آذربایجان_شرقی","بستان_آباد","مرکزی",43,282,2,0,56,340,0,340
"آذربایجان_شرقی","بستان_آباد","مرکزی",44,186,1,1,19,207,5,212
"آذربایجان_شرقی","بستان_آباد","مرکزی",45,272,1,0,69,342,13,355
"آذربایجان_شرقی","بستان_آباد","مرکزی",46,118,0,0,17,135,1,136
"آذربایجان_شرقی","بستان_آباد","مرکزی",47,186,2,0,66,254,0,254
"آذربایجان_شرقی","بستان_آباد","مرکزی",48,184,0,0,19,203,0,203
"آذربایجان_شرقی","بستان_آباد","مرکزی",49,135,1,0,27,163,0,163
"آذربایجان_شرقی","بستان_آباد","مرکزی",50,272,0,0,101,373,4,377
"آذربایجان_شرقی","بستان_آباد","مرکزی",51,134,0,0,24,158,1,159
"آذربایجان_شرقی","بستان_آباد","مرکزی",52,344,0,0,35,379,4,383
"آذربایجان_شرقی","بستان_آباد","مرکزی",53,408,2,0,13,423,6,429
"آذربایجان_شرقی","بستان_آباد","مرکزی",54,167,0,0,53,220,1,221
"آذربایجان_شرقی","بستان_آباد","مرکزی",55,102,0,0,42,144,5,149
"آذربایجان_شرقی","بستان_آباد","مرکزی",56,377,0,0,27,404,5,409
"آذربایجان_شرقی","بستان_آباد","مرکزی",57,297,0,1,27,325,8,333
"آذربایجان_شرقی","بستان_آباد","مرکزی",58,326,0,0,43,369,0,369
"آذربایجان_شرقی","بستان_آباد","مرکزی",59,242,2,0,139,383,3,386
"آذربایجان_شرقی","بستان_آباد","مرکزی",60,272,1,3,90,366,1,367
"آذربایجان_شرقی","بستان_آباد","مرکزی",61,249,0,0,69,318,2,320
"آذربایجان_شرقی","بستان_آباد","مرکزی",62,315,1,0,75,391,1,392
"آذربایجان_شرقی","بستان_آباد","مرکزی",63,319,1,0,29,349,1,350
"آذربایجان_شرقی","بستان_آباد","مرکزی",64,176,3,0,31,210,3,213
"آذربایجان_شرقی","بستان_آباد","مرکزی",65,245,1,1,133,380,2,382
"آذربایجان_شرقی","بستان_آباد","مرکزی",66,214,2,1,150,367,3,370
"آذربایجان_شرقی","بستان_آباد","مرکزی",67,292,0,0,95,387,1,388
"آذربایجان_شرقی","بستان_آباد","مرکزی",68,299,0,4,55,358,3,361
"آذربایجان_شرقی","بستان_آباد","مرکزی",69,256,0,1,113,370,0,370
"آذربایجان_شرقی","بستان_آباد","مرکزی",70,196,2,1,131,330,3,333
"آذربایجان_شرقی","بستان_آباد","مرکزی",71,335,3,0,148,486,2,488
"آذربایجان_شرقی","بستان_آباد","مرکزی",72,797,5,1,201,1004,4,1008
"آذربایجان_شرقی","بستان_آباد","مرکزی",73,909,3,0,138,1050,4,1054
"آذربایجان_شرقی","بستان_آباد","مرکزی",74,362,4,0,68,434,7,441
"آذربایجان_شرقی","بستان_آباد","مرکزی",75,490,4,0,39,533,0,533
"آذربایجان_شرقی","بستان_آباد","مرکزی",76,263,0,0,28,291,6,297
"آذربایجان_شرقی","بستان_آباد","مرکزی",77,473,1,2,72,548,1,549
"آذربایجان_شرقی","بستان_آباد","مرکزی",78,391,2,0,44,437,2,439
"آذربایجان_شرقی","بستان_آباد","مرکزی",79,326,0,0,82,408,3,411
"آذربایجان_شرقی","بستان_آباد","مرکزی",80,526,1,0,32,559,2,561
"آذربایجان_شرقی","بستان_آباد","تیکمه_داش",1,196,0,3,295,494,6,500
"آذربایجان_شرقی","بستان_آباد","تیکمه_داش",2,267,3,0,283,553,2,555
"آذربایجان_شرقی","بستان_آباد","تیکمه_داش",3,243,4,1,135,383,5,388
"آذربایجان_شرقی","بستان_آباد","تیکمه_داش",4,314,3,0,175,492,4,496
"آذربایجان_شرقی","بستان_آباد","تیکمه_داش",5,471,4,0,144,619,6,625
"آذربایجان_شرقی","بستان_آباد","تیکمه_داش",6,463,2,0,268,733,6,739
"آذربایجان_شرقی","بستان_آباد","تیکمه_داش",7,473,3,0,183,659,0,659
"آذربایجان_شرقی","بستان_آباد","تیکمه_داش",8,562,1,0,77,640,5,645
"آذربایجان_شرقی","بستان_آباد","تیکمه_داش",9,709,3,1,60,773,2,775
"آذربایجان_شرقی","بستان_آباد","تیکمه_داش",10,139,1,0,71,211,2,213
"آذربایجان_شرقی","بستان_آباد","تیکمه_داش",11,70,0,0,75,145,0,145
"آذربایجان_شرقی","بستان_آباد","تیکمه_داش",12,344,0,0,88,432,3,435
"آذربایجان_شرقی","بستان_آباد","تیکمه_داش",13,295,0,3,119,417,3,420
"آذربایجان_شرقی","بستان_آباد","تیکمه_داش",14,107,2,1,97,207,6,213
"آذربایجان_شرقی","بستان_آباد","تیکمه_داش",15,102,0,0,78,180,3,183
"آذربایجان_شرقی","بستان_آباد","تیکمه_داش",16,255,0,0,83,338,3,341
"آذربایجان_شرقی","بستان_آباد","تیکمه_داش",17,108,0,0,64,172,1,173
"آذربایجان_شرقی","بستان_آباد","تیکمه_داش",18,141,2,0,45,188,4,192
"آذربایجان_شرقی","بستان_آباد","تیکمه_داش",19,207,2,0,119,328,4,332
"آذربایجان_شرقی","بستان_آباد","تیکمه_داش",20,242,0,1,108,351,2,353
"آذربایجان_شرقی","بستان_آباد","تیکمه_داش",21,44,1,0,36,81,1,82
"آذربایجان_شرقی","بستان_آباد","تیکمه_داش",22,264,0,0,63,327,0,327
"آذربایجان_شرقی","بستان_آباد","تیکمه_داش",23,187,0,0,61,248,0,248
"آذربایجان_شرقی","بستان_آباد","تیکمه_داش",24,162,1,0,37,200,0,200
"آذربایجان_شرقی","بستان_آباد","تیکمه_داش",25,125,0,0,53,178,0,178
"آذربایجان_شرقی","بستان_آباد","تیکمه_داش",26,144,2,0,34,180,0,180
"آذربایجان_شرقی","بستان_آباد","تیکمه_داش",27,227,0,0,32,259,0,259
"آذربایجان_شرقی","بستان_آباد","تیکمه_داش",28,271,3,0,97,371,2,373
"آذربایجان_شرقی","بستان_آباد","تیکمه_داش",29,186,1,0,22,209,2,211
"آذربایجان_شرقی","بستان_آباد","تیکمه_داش",30,398,3,1,91,493,0,493
"آذربایجان_شرقی","بستان_آباد","تیکمه_داش",31,83,0,0,10,93,0,93
"آذربایجان_شرقی","بستان_آباد","تیکمه_داش",32,305,2,0,28,335,9,344
"آذربایجان_شرقی","بستان_آباد","تیکمه_داش",33,371,4,4,27,406,4,410
"آذربایجان_شرقی","بستان_آباد","تیکمه_داش",34,234,0,0,9,243,0,243
"آذربایجان_شرقی","بستان_آباد","تیکمه_داش",35,152,4,0,16,172,1,173
"آذربایجان_شرقی","بستان_آباد","تیکمه_داش",36,74,0,0,19,93,1,94
"آذربایجان_شرقی","بستان_آباد","تیکمه_داش",37,131,1,0,33,165,3,168
"آذربایجان_شرقی","بستان_آباد","تیکمه_داش",38,235,1,0,36,272,2,274
"آذربایجان_شرقی","بستان_آباد","تیکمه_داش",39,211,0,0,26,237,0,237
"آذربایجان_شرقی","بستان_آباد","تیکمه_داش",40,259,3,0,19,281,2,283
"آذربایجان_شرقی","بستان_آباد","تیکمه_داش",41,119,0,0,23,142,1,143
"آذربایجان_شرقی","بستان_آباد","تیکمه_داش",42,87,1,0,16,104,2,106
"آذربایجان_شرقی","بستان_آباد","تیکمه_داش",43,87,0,0,14,101,2,103
"آذربایجان_شرقی","بستان_آباد","تیکمه_داش",44,88,0,0,16,104,1,105
"آذربایجان_شرقی","بستان_آباد","تیکمه_داش",45,112,0,0,9,121,0,121
"آذربایجان_شرقی","بناب","مرکزی",1,130,3,1,390,524,5,529
"آذربایجان_شرقی","بناب","مرکزی",2,331,9,0,462,802,14,816
"آذربایجان_شرقی","بناب","مرکزی",3,380,13,5,870,1268,9,1277
"آذربایجان_شرقی","بناب","مرکزی",4,214,0,3,128,345,2,347
"آذربایجان_شرقی","بناب","مرکزی",5,151,6,1,413,571,10,581
"آذربایجان_شرقی","بناب","مرکزی",6,390,17,4,975,1386,23,1409
"آذربایجان_شرقی","بناب","مرکزی",7,352,15,5,453,825,9,834
"آذربایجان_شرقی","بناب","مرکزی",8,385,19,2,876,1282,15,1297
"آذربایجان_شرقی","بناب","مرکزی",9,296,16,1,378,691,9,700
"آذربایجان_شرقی","بناب","مرکزی",10,134,5,0,300,439,8,447
"آذربایجان_شرقی","بناب","مرکزی",11,183,10,0,171,364,0,364
"آذربایجان_شرقی","بناب","مرکزی",12,235,10,1,233,479,3,482
"آذربایجان_شرقی","بناب","مرکزی",13,119,0,0,179,298,4,302
"آذربایجان_شرقی","بناب","مرکزی",14,183,8,2,270,463,8,471
"آذربایجان_شرقی","بناب","مرکزی",15,192,2,2,199,395,2,397
"آذربایجان_شرقی","بناب","مرکزی",16,450,6,0,499,955,5,960
"آذربایجان_شرقی","بناب","مرکزی",17,165,3,3,337,508,10,518
"آذربایجان_شرقی","بناب","مرکزی",18,390,13,1,688,1092,17,1109
"آذربایجان_شرقی","بناب","مرکزی",19,164,1,0,173,338,3,341
"آذربایجان_شرقی","بناب","مرکزی",20,295,7,2,494,798,6,804
"آذربایجان_شرقی","بناب","مرکزی",21,337,10,4,675,1026,11,1037
"آذربایجان_شرقی","بناب","مرکزی",22,445,4,3,430,882,11,893
"آذربایجان_شرقی","بناب","مرکزی",23,234,5,2,381,622,4,626
"آذربایجان_شرقی","بناب","مرکزی",24,177,5,0,432,614,5,619
"آذربایجان_شرقی","بناب","مرکزی",25,263,5,1,601,870,12,882
"آذربایجان_شرقی","بناب","مرکزی",26,242,7,0,549,798,7,805
"آذربایجان_شرقی","بناب","مرکزی",27,176,6,3,287,472,5,477
"آذربایجان_شرقی","بناب","مرکزی",28,134,3,1,381,519,4,523
"آذربایجان_شرقی","بناب","مرکزی",29,130,3,3,342,478,6,484
"آذربایجان_شرقی","بناب","مرکزی",30,388,6,4,502,900,2,902
"آذربایجان_شرقی","بناب","مرکزی",31,144,6,3,276,429,4,433
"آذربایجان_شرقی","بناب","مرکزی",32,154,4,2,288,448,5,453
"آذربایجان_شرقی","بناب","مرکزی",33,325,5,6,755,1091,9,1100
"آذربایجان_شرقی","بناب","مرکزی",34,126,5,0,296,427,7,434
"آذربایجان_شرقی","بناب","مرکزی",35,160,3,7,347,517,3,520
"آذربایجان_شرقی","بناب","مرکزی",36,260,5,0,535,800,15,815
"آذربایجان_شرقی","بناب","مرکزی",37,324,5,6,534,869,11,880
"آذربایجان_شرقی","بناب","مرکزی",38,280,6,1,423,710,9,719
"آذربایجان_شرقی","بناب","مرکزی",39,499,20,8,745,1272,11,1283
"آذربایجان_شرقی","بناب","مرکزی",40,514,9,7,658,1188,6,1194
"آذربایجان_شرقی","بناب","مرکزی",41,346,4,2,338,690,8,698
"آذربایجان_شرقی","بناب","مرکزی",42,183,0,0,168,351,1,352
"آذربایجان_شرقی","بناب","مرکزی",43,242,4,2,221,469,3,472
"آذربایجان_شرقی","بناب","مرکزی",44,772,4,0,331,1107,4,1111
"آذربایجان_شرقی","بناب","مرکزی",45,283,3,1,153,440,2,442
"آذربایجان_شرقی","بناب","مرکزی",46,477,3,3,169,652,3,655
"آذربایجان_شرقی","بناب","مرکزی",47,661,8,8,464,1141,11,1152
"آذربایجان_شرقی","بناب","مرکزی",48,517,6,4,267,794,2,796
"آذربایجان_شرقی","بناب","مرکزی",49,511,6,4,356,877,7,884
"آذربایجان_شرقی","بناب","مرکزی",50,308,6,0,334,648,7,655
"آذربایجان_شرقی","بناب","مرکزی",51,424,5,3,440,872,8,880
"آذربایجان_شرقی","بناب","مرکزی",52,127,0,0,155,282,4,286
"آذربایجان_شرقی","بناب","مرکزی",53,524,11,2,533,1070,9,1079
"آذربایجان_شرقی","بناب","مرکزی",54,430,5,0,349,784,9,793
"آذربایجان_شرقی","بناب","مرکزی",55,247,11,3,522,783,14,797
"آذربایجان_شرقی","بناب","مرکزی",56,215,6,1,370,592,8,600
"آذربایجان_شرقی","بناب","مرکزی",57,436,5,2,380,823,5,828
"آذربایجان_شرقی","بناب","مرکزی",58,335,4,3,361,703,3,706
"آذربایجان_شرقی","بناب","مرکزی",59,100,1,0,152,253,1,254
"آذربایجان_شرقی","بناب","مرکزی",60,120,2,7,100,229,3,232
"آذربایجان_شرقی","بناب","مرکزی",61,337,4,2,203,546,7,553
"آذربایجان_شرقی","بناب","مرکزی",62,260,1,0,213,474,4,478
"آذربایجان_شرقی","بناب","مرکزی",63,411,2,6,163,582,4,586
"آذربایجان_شرقی","بناب","مرکزی",64,377,6,0,148,531,5,536
"آذربایجان_شرقی","بناب","مرکزی",65,606,3,3,225,837,4,841
"آذربایجان_شرقی","بناب","مرکزی",66,486,2,0,152,640,2,642
"آذربایجان_شرقی","بناب","مرکزی",67,731,2,1,294,1028,6,1034
"آذربایجان_شرقی","بناب","مرکزی",68,274,1,0,85,360,1,361
"آذربایجان_شرقی","بناب","مرکزی",69,357,2,0,350,709,1,710
"آذربایجان_شرقی","بناب","مرکزی",70,327,1,2,133,463,4,467
"آذربایجان_شرقی","بناب","مرکزی",71,637,3,0,197,837,5,842
"آذربایجان_شرقی","بناب","مرکزی",72,508,5,3,279,795,7,802
"آذربایجان_شرقی","بناب","مرکزی",73,519,1,0,100,620,5,625
"آذربایجان_شرقی","بناب","مرکزی",74,151,0,0,111,262,4,266
"آذربایجان_شرقی","بناب","مرکزی",75,210,1,0,105,316,2,318
"آذربایجان_شرقی","بناب","مرکزی",76,352,3,0,156,511,4,515
"آذربایجان_شرقی","بناب","مرکزی",77,267,2,1,217,487,5,492
"آذربایجان_شرقی","بناب","مرکزی",78,470,0,0,215,685,2,687
"آذربایجان_شرقی","بناب","مرکزی",79,298,1,0,127,426,3,429
"آذربایجان_شرقی","بناب","مرکزی",80,321,8,6,578,913,10,923
"آذربایجان_شرقی","بناب","مرکزی",81,427,1,1,311,740,9,749
"آذربایجان_شرقی","بناب","مرکزی",82,298,0,1,53,352,3,355
"آذربایجان_شرقی","بناب","مرکزی",83,359,2,0,196,557,3,560
"آذربایجان_شرقی","بناب","مرکزی",84,331,4,0,222,557,5,562
"آذربایجان_شرقی","بناب","مرکزی",85,435,5,1,276,717,2,719
"آذربایجان_شرقی","بناب","مرکزی",86,401,1,0,185,587,7,594
"آذربایجان_شرقی","بناب","مرکزی",87,353,11,0,226,590,4,594
"آذربایجان_شرقی","بناب","مرکزی",88,173,2,0,88,263,4,267
"آذربایجان_شرقی","بناب","مرکزی",89,592,3,1,210,806,0,806
"آذربایجان_شرقی","بناب","مرکزی",90,501,4,0,352,857,8,865
"آذربایجان_شرقی","بناب","مرکزی",91,1037,0,4,252,1293,4,1297
"آذربایجان_شرقی","بناب","مرکزی",92,612,1,2,120,735,1,736
"آذربایجان_شرقی","بناب","مرکزی",93,640,0,0,170,810,6,816
"آذربایجان_شرقی","بناب","مرکزی",94,443,4,0,98,545,2,547
"آذربایجان_شرقی","بناب","مرکزی",95,369,4,2,349,724,3,727
"آذربایجان_شرقی","بناب","مرکزی",96,615,6,1,538,1160,9,1169
"آذربایجان_شرقی","بناب","مرکزی",97,315,0,4,186,505,1,506
"آذربایجان_شرقی","بناب","مرکزی",98,56,0,0,35,91,1,92
"آذربایجان_شرقی","بناب","مرکزی",99,264,0,6,65,335,4,339
"آذربایجان_شرقی","بناب","مرکزی",100,403,2,0,311,716,1,717
"آذربایجان_شرقی","بناب","مرکزی",101,230,3,0,299,532,5,537
"آذربایجان_شرقی","بناب","مرکزی",102,497,2,2,502,1003,12,1015
"آذربایجان_شرقی","بناب","مرکزی",103,515,0,2,177,694,12,706
"آذربایجان_شرقی","بناب","مرکزی",104,690,2,0,136,828,7,835
"آذربایجان_شرقی","بناب","مرکزی",105,231,1,0,199,431,1,432
"آذربایجان_شرقی","تبریز","مرکزی",1,1074,21,2,997,2094,21,2115
"آذربایجان_شرقی","تبریز","مرکزی",2,223,15,8,1250,1496,12,1508
"آذربایجان_شرقی","تبریز","مرکزی",3,287,22,9,1092,1410,9,1419
"آذربایجان_شرقی","تبریز","مرکزی",4,960,49,20,1189,2218,15,2233
"آذربایجان_شرقی","تبریز","مرکزی",5,916,35,10,870,1831,,1831
"آذربایجان_شرقی","تبریز","مرکزی",6,784,40,8,770,1602,13,1615
"آذربایجان_شرقی","تبریز","مرکزی",7,921,18,4,686,1629,16,1645
"آذربایجان_شرقی","تبریز","مرکزی",8,731,18,15,834,1598,17,1615
"آذربایجان_شرقی","تبریز","مرکزی",9,616,35,26,1519,2196,15,2211
"آذربایجان_شرقی","تبریز","مرکزی",10,210,11,5,506,732,7,739
"آذربایجان_شرقی","تبریز","مرکزی",11,242,6,6,823,1077,14,1091
"آذربایجان_شرقی","تبریز","مرکزی",12,556,19,5,1534,2114,16,2130
"آذربایجان_شرقی","تبریز","مرکزی",13,361,16,17,1111,1505,5,1510
"آذربایجان_شرقی","تبریز","مرکزی",14,432,25,4,943,1404,8,1412
"آذربایجان_شرقی","تبریز","مرکزی",15,934,46,9,1065,2054,21,2075
"آذربایجان_شرقی","تبریز","مرکزی",16,302,17,18,1013,1350,10,1360
"آذربایجان_شرقی","تبریز","مرکزی",17,299,17,6,1106,1428,1,1429
"آذربایجان_شرقی","تبریز","مرکزی",18,286,14,5,1026,1331,13,1344
"آذربایجان_شرقی","تبریز","مرکزی",19,253,12,15,788,1068,1,1069
"آذربایجان_شرقی","تبریز","مرکزی",20,687,45,15,1264,2011,28,2039
"آذربایجان_شرقی","تبریز","مرکزی",21,648,36,5,966,1655,18,1673
"آذربایجان_شرقی","تبریز","مرکزی",22,312,17,7,1616,1952,12,1964
"آذربایجان_شرقی","تبریز","مرکزی",23,423,24,11,1450,1908,22,1930
"آذربایجان_شرقی","تبریز","مرکزی",24,94,6,1,1001,1102,3,1105
"آذربایجان_شرقی","تبریز","مرکزی",25,281,22,7,1035,1345,6,1351
"آذربایجان_شرقی","تبریز","مرکزی",26,502,23,14,1208,1747,17,1764
"آذربایجان_شرقی","تبریز","مرکزی",27,519,33,8,1016,1576,18,1594
"آذربایجان_شرقی","تبریز","مرکزی",28,210,9,7,1436,1662,10,1672
"آذربایجان_شرقی","تبریز","مرکزی",29,236,16,6,899,1157,6,1163
"آذربایجان_شرقی","تبریز","مرکزی",30,287,17,18,1354,1676,16,1692
"آذربایجان_شرقی","تبریز","مرکزی",31,614,43,12,1287,1956,22,1978
"آذربایجان_شرقی","تبریز","مرکزی",32,615,31,4,904,1554,16,1570
"آذربایجان_شرقی","تبریز","مرکزی",33,600,27,2,464,1093,7,1100
"آذربایجان_شرقی","تبریز","مرکزی",34,370,30,7,1700,2107,15,2122
"آذربایجان_شرقی","تبریز","مرکزی",35,550,26,9,1567,2152,16,2168
"آذربایجان_شرقی","تبریز","مرکزی",36,276,17,15,1601,1909,8,1917
"آذربایجان_شرقی","تبریز","مرکزی",37,231,27,8,1230,1496,3,1499
"آذربایجان_شرقی","تبریز","مرکزی",38,935,11,2,588,1536,16,1552
"آذربایجان_شرقی","تبریز","مرکزی",39,563,39,6,1100,1708,24,1732
"آذربایجان_شرقی","تبریز","مرکزی",40,203,22,9,927,1161,7,1168
"آذربایجان_شرقی","تبریز","مرکزی",41,544,24,11,1199,1778,11,1789
"آذربایجان_شرقی","تبریز","مرکزی",42,543,32,8,1429,2012,11,2023
"آذربایجان_شرقی","تبریز","مرکزی",43,297,3,5,302,607,7,614
"آذربایجان_شرقی","تبریز","مرکزی",44,246,27,93,1518,1884,14,1898
"آذربایجان_شرقی","تبریز","مرکزی",45,114,14,11,1542,1681,16,1697
"آذربایجان_شرقی","تبریز","مرکزی",46,414,30,24,1277,1745,14,1759
"آذربایجان_شرقی","تبریز","مرکزی",47,552,39,9,1322,1922,22,1944
"آذربایجان_شرقی","تبریز","مرکزی",48,323,40,39,1296,1698,,1698
"آذربایجان_شرقی","تبریز","مرکزی",49,234,15,3,604,856,11,867
"آذربایجان_شرقی","تبریز","مرکزی",50,619,3,1,295,918,1,919
"آذربایجان_شرقی","تبریز","مرکزی",51,649,10,4,534,1197,12,1209
"آذربایجان_شرقی","تبریز","مرکزی",52,460,4,2,235,701,3,704
"آذربایجان_شرقی","تبریز","مرکزی",53,674,10,2,507,1193,16,1209
"آذربایجان_شرقی","تبریز","مرکزی",54,821,18,8,1383,2230,5,2235
"آذربایجان_شرقی","تبریز","مرکزی",55,705,16,4,935,1660,4,1664
"آذربایجان_شرقی","تبریز","مرکزی",56,650,39,14,1377,2080,14,2094
"آذربایجان_شرقی","تبریز","مرکزی",57,354,25,15,1849,2243,12,2255
"آذربایجان_شرقی","تبریز","مرکزی",58,275,25,6,1226,1532,8,1540
"آذربایجان_شرقی","تبریز","مرکزی",59,67,8,11,1479,1565,7,1572
"آذربایجان_شرقی","تبریز","مرکزی",60,265,31,7,1516,1819,10,1829
"آذربایجان_شرقی","تبریز","مرکزی",61,316,45,22,1857,2240,15,2255
"آذربایجان_شرقی","تبریز","مرکزی",62,131,11,11,1915,2068,7,2075
"آذربایجان_شرقی","تبریز","مرکزی",63,186,13,15,2005,2219,11,2230
"آذربایجان_شرقی","تبریز","مرکزی",64,195,14,13,1448,1670,8,1678
"آذربایجان_شرقی","تبریز","مرکزی",65,494,29,16,1381,1920,12,1932
"آذربایجان_شرقی","تبریز","مرکزی",66,698,37,9,1048,1792,22,1814
"آذربایجان_شرقی","تبریز","مرکزی",67,326,24,9,1156,1515,7,1522
"آذربایجان_شرقی","تبریز","مرکزی",68,607,28,13,1609,2257,23,2280
"آذربایجان_شرقی","تبریز","مرکزی",69,861,21,2,737,1621,10,1631
"آذربایجان_شرقی","تبریز","مرکزی",70,555,26,5,687,1273,13,1286
"آذربایجان_شرقی","تبریز","مرکزی",71,838,7,2,774,1621,11,1632
"آذربایجان_شرقی","تبریز","مرکزی",72,503,15,15,513,1046,7,1053
"آذربایجان_شرقی","تبریز","مرکزی",73,336,5,3,330,674,8,682
"آذربایجان_شرقی","تبریز","مرکزی",74,444,20,21,764,1249,10,1259
"آذربایجان_شرقی","تبریز","مرکزی",75,709,40,23,1325,2097,26,2123
"آذربایجان_شرقی","تبریز","مرکزی",76,666,28,9,1229,1932,16,1948
"آذربایجان_شرقی","تبریز","مرکزی",77,294,16,13,988,1311,25,1336
"آذربایجان_شرقی","تبریز","مرکزی",78,766,30,7,677,1480,16,1496
"آذربایجان_شرقی","تبریز","مرکزی",79,888,30,4,607,1529,15,1544
"آذربایجان_شرقی","تبریز","مرکزی",80,473,18,4,415,910,5,915
"آذربایجان_شرقی","تبریز","مرکزی",81,791,38,14,896,1739,19,1758
"آذربایجان_شرقی","تبریز","مرکزی",82,200,25,10,1580,1815,8,1823
"آذربایجان_شرقی","تبریز","مرکزی",83,523,42,3,852,1420,18,1438
"آذربایجان_شرقی","تبریز","مرکزی",84,641,36,16,859,1552,19,1571
"آذربایجان_شرقی","تبریز","مرکزی",85,644,20,11,814,1489,16,1505
"آذربایجان_شرقی","تبریز","مرکزی",86,203,20,11,874,1108,5,1113
"آذربایجان_شرقی","تبریز","مرکزی",87,441,22,3,668,1134,11,1145
"آذربایجان_شرقی","تبریز","مرکزی",88,127,14,3,702,846,8,854
"آذربایجان_شرقی","تبریز","مرکزی",89,399,29,2,829,1259,8,1267
"آذربایجان_شرقی","تبریز","مرکزی",90,719,23,7,682,1431,28,1459
"آذربایجان_شرقی","تبریز","مرکزی",91,499,14,3,496,1012,19,1031
"آذربایجان_شرقی","تبریز","مرکزی",92,479,17,10,914,1420,12,1432
"آذربایجان_شرقی","تبریز","مرکزی",93,235,10,7,546,798,4,802
"آذربایجان_شرقی","تبریز","مرکزی",94,678,27,5,827,1537,21,1558
"آذربایجان_شرقی","تبریز","مرکزی",95,604,18,4,527,1153,14,1167
"آذربایجان_شرقی","تبریز","مرکزی",96,465,24,6,515,1010,,1010
"آذربایجان_شرقی","تبریز","مرکزی",97,364,32,11,1119,1526,8,1534
"آذربایجان_شرقی","تبریز","مرکزی",98,978,30,9,871,1888,15,1903
"آذربایجان_شرقی","تبریز","مرکزی",99,760,5,4,436,1205,7,1212
"آذربایجان_شرقی","تبریز","مرکزی",100,1087,8,1,445,1541,16,1557
"آذربایجان_شرقی","تبریز","مرکزی",101,1107,9,1,424,1541,12,1553
"آذربایجان_شرقی","تبریز","مرکزی",102,1115,8,2,349,1474,8,1482
"آذربایجان_شرقی","تبریز","مرکزی",103,1085,10,5,465,1565,5,1570
"آذربایجان_شرقی","تبریز","مرکزی",104,647,13,2,373,1035,15,1050
"آذربایجان_شرقی","تبریز","مرکزی",105,490,13,,315,818,9,827
"آذربایجان_شرقی","تبریز","مرکزی",106,1112,16,5,637,1770,11,1781
"آذربایجان_شرقی","تبریز","مرکزی",107,1577,11,4,641,2233,22,2255
"آذربایجان_شرقی","تبریز","مرکزی",108,1101,6,,824,1931,9,1940
"آذربایجان_شرقی","تبریز","مرکزی",109,1274,10,2,588,1874,12,1886
"آذربایجان_شرقی","تبریز","مرکزی",110,1271,10,3,698,1982,15,1997
"آذربایجان_شرقی","تبریز","مرکزی",111,751,4,1,642,1398,11,1409
"آذربایجان_شرقی","تبریز","مرکزی",112,1288,19,11,576,1894,15,1909
"آذربایجان_شرقی","تبریز","مرکزی",113,804,12,4,673,1493,5,1498
"آذربایجان_شرقی","تبریز","مرکزی",114,627,7,5,871,1510,10,1520
"آذربایجان_شرقی","تبریز","مرکزی",115,534,15,4,955,1508,15,1523
"آذربایجان_شرقی","تبریز","مرکزی",116,576,9,4,354,943,6,949
"آذربایجان_شرقی","تبریز","مرکزی",117,753,14,1,651,1419,13,1432
"آذربایجان_شرقی","تبریز","مرکزی",118,1297,52,8,1215,2572,21,2593
"آذربایجان_شرقی","تبریز","مرکزی",119,535,22,17,1009,1583,13,1596
"آذربایجان_شرقی","تبریز","مرکزی",120,627,18,3,891,1539,8,1547
"آذربایجان_شرقی","تبریز","مرکزی",121,415,11,4,334,764,10,774
"آذربایجان_شرقی","تبریز","مرکزی",122,997,14,6,726,1743,17,1760
"آذربایجان_شرقی","تبریز","مرکزی",123,863,2,5,450,1320,11,1331
"آذربایجان_شرقی","تبریز","مرکزی",124,1030,5,6,898,1939,11,1950
"آذربایجان_شرقی","تبریز","مرکزی",125,1022,13,5,651,1691,13,1704
"آذربایجان_شرقی","تبریز","مرکزی",126,1487,12,3,749,2251,20,2271
"آذربایجان_شرقی","تبریز","مرکزی",127,266,34,9,1862,2171,11,2182
"آذربایجان_شرقی","تبریز","مرکزی",128,605,28,15,1811,2459,19,2478
"آذربایجان_شرقی","تبریز","مرکزی",129,902,30,4,644,1580,9,1589
"آذربایجان_شرقی","تبریز","مرکزی",130,363,18,6,516,903,7,910
"آذربایجان_شرقی","تبریز","مرکزی",131,610,26,3,1171,1810,26,1836
"آذربایجان_شرقی","تبریز","مرکزی",132,1015,34,9,858,1916,16,1932
"آذربایجان_شرقی","تبریز","مرکزی",133,385,18,3,908,1314,11,1325
"آذربایجان_شرقی","تبریز","مرکزی",134,396,17,5,1376,1794,16,1810
"آذربایجان_شرقی","تبریز","مرکزی",135,566,23,7,1058,1654,46,1700
"آذربایجان_شرقی","تبریز","مرکزی",136,606,27,8,1156,1797,18,1815
"آذربایجان_شرقی","تبریز","مرکزی",137,789,17,9,997,1812,22,1834
"آذربایجان_شرقی","تبریز","مرکزی",138,762,17,11,705,1495,8,1503
"آذربایجان_شرقی","تبریز","مرکزی",139,1332,13,7,833,2185,13,2198
"آذربایجان_شرقی","تبریز","مرکزی",140,937,30,3,1065,2035,14,2049
"آذربایجان_شرقی","تبریز","مرکزی",141,570,20,4,522,1116,9,1125
"آذربایجان_شرقی","تبریز","مرکزی",142,782,25,3,725,1535,14,1549
"آذربایجان_شرقی","تبریز","مرکزی",143,396,15,8,1038,1457,7,1464
"آذربایجان_شرقی","تبریز","مرکزی",144,311,18,8,1397,1734,10,1744
"آذربایجان_شرقی","تبریز","مرکزی",145,359,20,11,916,1306,15,1321
"آذربایجان_شرقی","تبریز","مرکزی",146,378,23,11,1215,1627,11,1638
"آذربایجان_شرقی","تبریز","مرکزی",147,283,8,,303,594,9,603
"آذربایجان_شرقی","تبریز","مرکزی",148,1121,34,10,975,2140,29,2169
"آذربایجان_شرقی","تبریز","مرکزی",149,328,38,3,786,1155,21,1176
"آذربایجان_شرقی","تبریز","مرکزی",150,780,28,,509,1317,11,1328
"آذربایجان_شرقی","تبریز","مرکزی",151,491,6,1,467,965,4,969
"آذربایجان_شرقی","تبریز","مرکزی",152,670,5,2,134,811,5,816
"آذربایجان_شرقی","تبریز","مرکزی",153,551,11,3,257,822,8,830
"آذربایجان_شرقی","تبریز","مرکزی",154,516,14,3,330,863,9,872
"آذربایجان_شرقی","تبریز","مرکزی",155,438,11,2,449,900,7,907
"آذربایجان_شرقی","تبریز","مرکزی",156,1227,11,1,327,1566,9,1575
"آذربایجان_شرقی","تبریز","مرکزی",157,947,,,181,1128,8,1136
"آذربایجان_شرقی","تبریز","مرکزی",158,885,2,1,398,1286,12,1298
"آذربایجان_شرقی","تبریز","مرکزی",159,1017,3,3,263,1286,14,1300
"آذربایجان_شرقی","تبریز","مرکزی",160,450,5,2,195,652,3,655
"آذربایجان_شرقی","تبریز","مرکزی",161,473,2,,122,597,9,606
"آذربایجان_شرقی","تبریز","مرکزی",162,666,6,,276,948,1,949
"آذربایجان_شرقی","تبریز","مرکزی",163,384,1,,97,482,1,483
"آذربایجان_شرقی","تبریز","مرکزی",164,414,5,1,140,560,5,565
"آذربایجان_شرقی","تبریز","مرکزی",165,566,3,3,189,761,3,764
"آذربایجان_شرقی","تبریز","مرکزی",166,273,1,,94,368,5,373
"آذربایجان_شرقی","تبریز","مرکزی",167,756,4,1,209,970,7,977
"آذربایجان_شرقی","تبریز","مرکزی",168,408,3,,93,504,1,505
"آذربایجان_شرقی","تبریز","مرکزی",169,494,2,1,195,692,8,700
"آذربایجان_شرقی","تبریز","مرکزی",170,495,2,2,185,684,3,687
"آذربایجان_شرقی","تبریز","مرکزی",171,449,4,,363,816,8,824
"آذربایجان_شرقی","تبریز","مرکزی",172,776,4,2,296,1078,8,1086
"آذربایجان_شرقی","تبریز","مرکزی",173,470,4,,222,696,4,700
"آذربایجان_شرقی","تبریز","مرکزی",174,762,10,5,300,1077,5,1082
"آذربایجان_شرقی","تبریز","مرکزی",175,1190,16,2,688,1896,,1896
"آذربایجان_شرقی","تبریز","مرکزی",176,445,7,2,252,706,6,712
"آذربایجان_شرقی","تبریز","مرکزی",177,465,2,,179,646,2,648
"آذربایجان_شرقی","تبریز","مرکزی",178,893,3,1,356,1253,8,1261
"آذربایجان_شرقی","تبریز","مرکزی",179,411,4,9,170,594,6,600
"آذربایجان_شرقی","تبریز","مرکزی",180,381,18,3,394,796,4,800
"آذربایجان_شرقی","تبریز","مرکزی",181,324,7,1,216,548,5,553
"آذربایجان_شرقی","تبریز","مرکزی",182,359,8,,178,545,5,550
"آذربایجان_شرقی","تبریز","مرکزی",183,1461,8,1,430,1900,20,1920
"آذربایجان_شرقی","تبریز","مرکزی",184,476,9,14,328,827,6,833
"آذربایجان_شرقی","تبریز","مرکزی",185,1206,6,3,667,1882,19,1901
"آذربایجان_شرقی","تبریز","مرکزی",186,367,4,1,451,823,7,830
"آذربایجان_شرقی","تبریز","مرکزی",187,1039,6,1,586,1632,22,1654
"آذربایجان_شرقی","تبریز","مرکزی",188,705,5,5,278,993,12,1005
"آذربایجان_شرقی","تبریز","مرکزی",189,946,7,,290,1243,5,1248
"آذربایجان_شرقی","تبریز","مرکزی",190,862,5,1,159,1027,5,1032
"آذربایجان_شرقی","تبریز","مرکزی",191,575,9,1,239,824,5,829
"آذربایجان_شرقی","تبریز","مرکزی",192,1224,2,,357,1583,16,1599
"آذربایجان_شرقی","تبریز","مرکزی",193,757,10,2,373,1142,18,1160
"آذربایجان_شرقی","تبریز","مرکزی",194,637,13,4,803,1457,17,1474
"آذربایجان_شرقی","تبریز","مرکزی",195,144,1,,140,285,,285
"آذربایجان_شرقی","تبریز","مرکزی",196,319,9,4,302,634,7,641
"آذربایجان_شرقی","تبریز","مرکزی",197,576,12,2,658,1248,12,1260
"آذربایجان_شرقی","تبریز","مرکزی",198,722,17,17,1107,1863,23,1886
"آذربایجان_شرقی","تبریز","مرکزی",199,1077,41,15,774,1907,13,1920
"آذربایجان_شرقی","تبریز","مرکزی",200,395,13,5,625,1038,17,1055
"آذربایجان_شرقی","تبریز","مرکزی",201,464,8,4,834,1310,12,1322
"آذربایجان_شرقی","تبریز","مرکزی",202,589,40,4,1175,1808,14,1822
"آذربایجان_شرقی","تبریز","مرکزی",203,243,9,1,349,602,4,606
"آذربایجان_شرقی","تبریز","مرکزی",204,196,7,1,155,359,6,365
"آذربایجان_شرقی","تبریز","مرکزی",205,280,11,1,295,587,7,594
"آذربایجان_شرقی","تبریز","مرکزی",206,789,31,2,721,1543,24,1567
"آذربایجان_شرقی","تبریز","مرکزی",207,311,8,1,225,545,2,547
"آذربایجان_شرقی","تبریز","مرکزی",208,314,14,5,668,1001,9,1010
"آذربایجان_شرقی","تبریز","مرکزی",209,377,8,3,254,642,5,647
"آذربایجان_شرقی","تبریز","مرکزی",210,848,20,6,659,1533,23,1556
"آذربایجان_شرقی","تبریز","مرکزی",211,596,12,4,403,1015,10,1025
"آذربایجان_شرقی","تبریز","مرکزی",212,476,5,,401,882,12,894
"آذربایجان_شرقی","تبریز","مرکزی",213,452,19,2,388,861,8,869
"آذربایجان_شرقی","تبریز","مرکزی",214,409,11,1,425,846,12,858
"آذربایجان_شرقی","تبریز","مرکزی",215,446,7,7,654,1114,8,1122
"آذربایجان_شرقی","تبریز","مرکزی",216,386,3,,159,548,10,558
"آذربایجان_شرقی","تبریز","مرکزی",217,668,10,1,459,1138,14,1152
"آذربایجان_شرقی","تبریز","مرکزی",218,454,12,1,320,787,4,791
"آذربایجان_شرقی","تبریز","مرکزی",219,514,12,1,363,890,13,903
"آذربایجان_شرقی","تبریز","مرکزی",220,500,18,3,767,1288,6,1294
"آذربایجان_شرقی","تبریز","مرکزی",221,1016,14,7,664,1701,18,1719
"آذربایجان_شرقی","تبریز","مرکزی",222,653,15,1,268,937,10,947
"آذربایجان_شرقی","تبریز","مرکزی",223,303,5,,204,512,8,520
"آذربایجان_شرقی","تبریز","مرکزی",224,597,8,,364,969,12,981
"آذربایجان_شرقی","تبریز","مرکزی",225,380,8,,309,697,8,705
"آذربایجان_شرقی","تبریز","مرکزی",226,688,8,3,319,1018,9,1027
"آذربایجان_شرقی","تبریز","مرکزی",227,117,,,83,200,,200
"آذربایجان_شرقی","تبریز","مرکزی",228,460,11,4,344,819,8,827
"آذربایجان_شرقی","تبریز","مرکزی",229,476,14,3,462,955,2,957
"آذربایجان_شرقی","تبریز","مرکزی",230,931,8,1,429,1369,8,1377
"آذربایجان_شرقی","تبریز","مرکزی",231,375,2,1,216,594,3,597
"آذربایجان_شرقی","تبریز","مرکزی",232,293,6,,76,375,3,378
"آذربایجان_شرقی","تبریز","مرکزی",233,421,,2,160,583,12,595
"آذربایجان_شرقی","تبریز","مرکزی",234,352,6,,198,556,5,561
"آذربایجان_شرقی","تبریز","مرکزی",235,788,10,2,352,1152,9,1161
"آذربایجان_شرقی","تبریز","مرکزی",236,946,11,5,389,1351,27,1378
"آذربایجان_شرقی","تبریز","مرکزی",237,771,2,1,329,1103,10,1113
"آذربایجان_شرقی","تبریز","مرکزی",238,1069,7,4,491,1571,16,1587
"آذربایجان_شرقی","تبریز","مرکزی",239,806,14,,640,1460,8,1468
"آذربایجان_شرقی","تبریز","مرکزی",240,286,8,2,237,533,8,541
"آذربایجان_شرقی","تبریز","مرکزی",241,1002,23,3,549,1577,13,1590
"آذربایجان_شرقی","تبریز","مرکزی",242,606,14,,321,941,14,955
"آذربایجان_شرقی","تبریز","مرکزی",243,1027,14,2,504,1547,10,1557
"آذربایجان_شرقی","تبریز","مرکزی",244,571,16,2,510,1099,7,1106
"آذربایجان_شرقی","تبریز","مرکزی",245,386,4,,408,798,10,808
"آذربایجان_شرقی","تبریز","مرکزی",246,732,21,1,712,1466,11,1477
"آذربایجان_شرقی","تبریز","مرکزی",247,361,2,2,192,557,6,563
"آذربایجان_شرقی","تبریز","مرکزی",248,600,10,4,471,1085,10,1095
"آذربایجان_شرقی","تبریز","مرکزی",249,656,3,1,289,949,10,959
"آذربایجان_شرقی","تبریز","مرکزی",250,512,15,1,693,1221,9,1230
"آذربایجان_شرقی","تبریز","مرکزی",251,1263,12,2,543,1820,13,1833
"آذربایجان_شرقی","تبریز","مرکزی",252,534,3,,239,776,11,787
"آذربایجان_شرقی","تبریز","مرکزی",253,635,10,10,471,1126,6,1132
"آذربایجان_شرقی","تبریز","مرکزی",254,837,7,4,555,1403,10,1413
"آذربایجان_شرقی","تبریز","مرکزی",255,1015,23,1,888,1927,19,1946
"آذربایجان_شرقی","تبریز","مرکزی",256,918,4,3,468,1393,7,1400
"آذربایجان_شرقی","تبریز","مرکزی",257,265,1,1,178,445,3,448
"آذربایجان_شرقی","تبریز","مرکزی",258,556,5,,322,883,7,890
"آذربایجان_شرقی","تبریز","مرکزی",259,907,10,3,441,1361,18,1379
"آذربایجان_شرقی","تبریز","مرکزی",260,899,7,3,263,1172,9,1181
"آذربایجان_شرقی","تبریز","مرکزی",261,1190,15,2,936,2143,20,2163
"آذربایجان_شرقی","تبریز","مرکزی",262,728,9,1,593,1331,17,1348
"آذربایجان_شرقی","تبریز","مرکزی",263,797,14,1,624,1436,10,1446
"آذربایجان_شرقی","تبریز","مرکزی",264,794,6,1,328,1129,8,1137
"آذربایجان_شرقی","تبریز","مرکزی",265,900,10,6,417,1333,11,1344
"آذربایجان_شرقی","تبریز","مرکزی",266,1017,8,1,454,1480,12,1492
"آذربایجان_شرقی","تبریز","مرکزی",267,542,6,,148,696,4,700
"آذربایجان_شرقی","تبریز","مرکزی",268,984,8,6,518,1516,6,1522
"آذربایجان_شرقی","تبریز","مرکزی",269,594,6,1,347,948,5,953
"آذربایجان_شرقی","تبریز","مرکزی",270,789,6,2,733,1530,13,1543
"آذربایجان_شرقی","تبریز","مرکزی",271,794,15,2,578,1389,24,1413
"آذربایجان_شرقی","تبریز","مرکزی",272,778,16,2,369,1165,15,1180
"آذربایجان_شرقی","تبریز","مرکزی",273,1138,17,2,362,1519,14,1533
"آذربایجان_شرقی","تبریز","مرکزی",274,981,11,,500,1492,7,1499
"آذربایجان_شرقی","تبریز","مرکزی",275,1046,16,5,712,1779,25,1804
"آذربایجان_شرقی","تبریز","مرکزی",276,1091,8,3,383,1485,12,1497
"آذربایجان_شرقی","تبریز","مرکزی",277,1165,11,6,692,1874,14,1888
"آذربایجان_شرقی","تبریز","مرکزی",278,729,15,1,571,1316,17,1333
"آذربایجان_شرقی","تبریز","مرکزی",279,738,7,,333,1078,5,1083
"آذربایجان_شرقی","تبریز","مرکزی",280,943,5,4,664,1616,11,1627
"آذربایجان_شرقی","تبریز","مرکزی",281,917,5,3,671,1596,4,1600
"آذربایجان_شرقی","تبریز","مرکزی",282,1258,10,5,810,2083,8,2091
"آذربایجان_شرقی","تبریز","مرکزی",283,1467,12,,486,1965,12,1977
"آذربایجان_شرقی","تبریز","مرکزی",284,1173,11,2,377,1563,18,1581
"آذربایجان_شرقی","تبریز","مرکزی",285,555,19,2,700,1276,7,1283
"آذربایجان_شرقی","تبریز","مرکزی",286,930,17,4,460,1411,13,1424
"آذربایجان_شرقی","تبریز","مرکزی",287,366,10,1,709,1086,13,1099
"آذربایجان_شرقی","تبریز","مرکزی",288,623,11,2,495,1131,7,1138
"آذربایجان_شرقی","تبریز","مرکزی",289,694,8,4,697,1403,21,1424
"آذربایجان_شرقی","تبریز","مرکزی",290,569,10,3,826,1408,9,1417
"آذربایجان_شرقی","تبریز","مرکزی",291,490,5,5,300,800,5,805
"آذربایجان_شرقی","تبریز","مرکزی",292,959,16,1,687,1663,14,1677
"آذربایجان_شرقی","تبریز","مرکزی",293,898,4,6,452,1360,31,1391
"آذربایجان_شرقی","تبریز","مرکزی",294,880,5,3,221,1109,,1109
"آذربایجان_شرقی","تبریز","مرکزی",295,972,5,2,322,1301,6,1307
"آذربایجان_شرقی","تبریز","مرکزی",296,239,9,1,568,817,8,825
"آذربایجان_شرقی","تبریز","مرکزی",297,815,22,9,484,1330,14,1344
"آذربایجان_شرقی","تبریز","مرکزی",298,537,18,9,553,1117,18,1135
"آذربایجان_شرقی","تبریز","مرکزی",299,573,14,4,489,1080,10,1090
"آذربایجان_شرقی","تبریز","مرکزی",300,94,1,,86,181,2,183
"آذربایجان_شرقی","تبریز","مرکزی",301,653,14,2,862,1531,17,1548
"آذربایجان_شرقی","تبریز","مرکزی",302,1028,18,1,519,1566,13,1579
"آذربایجان_شرقی","تبریز","مرکزی",303,901,18,,515,1434,15,1449
"آذربایجان_شرقی","تبریز","مرکزی",304,978,11,3,533,1525,,1525
"آذربایجان_شرقی","تبریز","مرکزی",305,1089,5,1,571,1666,24,1690
"آذربایجان_شرقی","تبریز","مرکزی",306,642,16,2,601,1261,20,1281
"آذربایجان_شرقی","تبریز","مرکزی",307,806,13,,396,1215,8,1223
"آذربایجان_شرقی","تبریز","مرکزی",308,248,4,,149,401,6,407
"آذربایجان_شرقی","تبریز","مرکزی",309,811,10,5,357,1183,11,1194
"آذربایجان_شرقی","تبریز","مرکزی",310,380,5,4,392,781,6,787
"آذربایجان_شرقی","تبریز","مرکزی",311,687,18,2,577,1284,13,1297
"آذربایجان_شرقی","تبریز","مرکزی",312,746,20,4,563,1333,7,1340
"آذربایجان_شرقی","تبریز","مرکزی",313,588,11,1,536,1136,19,1155
"آذربایجان_شرقی","تبریز","مرکزی",314,896,17,6,616,1535,18,1553
"آذربایجان_شرقی","تبریز","مرکزی",315,553,15,3,980,1551,9,1560
"آذربایجان_شرقی","تبریز","مرکزی",316,883,14,1,634,1532,13,1545
"آذربایجان_شرقی","تبریز","مرکزی",317,953,11,4,594,1562,23,1585
"آذربایجان_شرقی","تبریز","مرکزی",318,335,2,3,322,662,10,672
"آذربایجان_شرقی","تبریز","مرکزی",319,1172,13,3,718,1906,42,1948
"آذربایجان_شرقی","تبریز","مرکزی",320,953,9,7,526,1495,15,1510
"آذربایجان_شرقی","تبریز","مرکزی",321,836,14,8,954,1812,12,1824
"آذربایجان_شرقی","تبریز","مرکزی",322,1016,12,4,589,1621,12,1633
"آذربایجان_شرقی","تبریز","مرکزی",323,589,5,,525,1119,8,1127
"آذربایجان_شرقی","تبریز","مرکزی",324,926,12,6,655,1599,12,1611
"آذربایجان_شرقی","تبریز","مرکزی",325,900,9,3,345,1257,1,1258
"آذربایجان_شرقی","تبریز","مرکزی",326,1480,14,8,721,2223,5,2228
"آذربایجان_شرقی","تبریز","مرکزی",327,403,5,,205,613,6,619
"آذربایجان_شرقی","تبریز","مرکزی",328,1105,21,4,715,1845,19,1864
"آذربایجان_شرقی","تبریز","مرکزی",329,397,11,1,260,669,9,678
"آذربایجان_شرقی","تبریز","مرکزی",330,452,12,6,694,1164,12,1176
"آذربایجان_شرقی","تبریز","مرکزی",331,459,25,4,808,1296,9,1305
"آذربایجان_شرقی","تبریز","مرکزی",332,719,17,4,475,1215,8,1223
"آذربایجان_شرقی","تبریز","مرکزی",333,575,9,1,386,971,9,980
"آذربایجان_شرقی","تبریز","مرکزی",334,428,7,5,533,973,7,980
"آذربایجان_شرقی","تبریز","مرکزی",335,905,5,13,634,1557,11,1568
"آذربایجان_شرقی","تبریز","مرکزی",336,464,10,2,348,824,7,831
"آذربایجان_شرقی","تبریز","مرکزی",337,1262,36,2,951,2251,19,2270
"آذربایجان_شرقی","تبریز","مرکزی",338,298,9,4,572,883,7,890
"آذربایجان_شرقی","تبریز","مرکزی",339,752,18,1,521,1292,15,1307
"آذربایجان_شرقی","تبریز","مرکزی",340,968,10,2,550,1530,21,1551
"آذربایجان_شرقی","تبریز","مرکزی",341,814,18,3,743,1578,5,1583
"آذربایجان_شرقی","تبریز","مرکزی",342,530,10,3,337,880,18,898
"آذربایجان_شرقی","تبریز","مرکزی",343,474,8,1,246,729,11,740
"آذربایجان_شرقی","تبریز","مرکزی",344,884,24,2,524,1434,37,1471
"آذربایجان_شرقی","تبریز","مرکزی",345,1091,19,5,692,1807,23,1830
"آذربایجان_شرقی","تبریز","مرکزی",346,635,36,60,826,1557,30,1587
"آذربایجان_شرقی","تبریز","مرکزی",347,752,16,2,575,1345,22,1367
"آذربایجان_شرقی","تبریز","مرکزی",348,750,40,71,826,1687,17,1704
"آذربایجان_شرقی","تبریز","مرکزی",349,890,15,5,461,1371,16,1387
"آذربایجان_شرقی","تبریز","مرکزی",350,1007,17,5,746,1775,21,1796
"آذربایجان_شرقی","تبریز","مرکزی",351,558,12,3,589,1162,14,1176
"آذربایجان_شرقی","تبریز","مرکزی",352,894,13,3,395,1305,16,1321
"آذربایجان_شرقی","تبریز","مرکزی",353,1116,18,3,509,1646,17,1663
"آذربایجان_شرقی","تبریز","مرکزی",354,812,9,,405,1226,13,1239
"آذربایجان_شرقی","تبریز","مرکزی",355,320,6,,233,559,3,562
"آذربایجان_شرقی","تبریز","مرکزی",356,527,26,19,641,1213,16,1229
"آذربایجان_شرقی","تبریز","مرکزی",357,928,22,4,1095,2049,20,2069
"آذربایجان_شرقی","تبریز","مرکزی",358,561,10,4,822,1397,15,1412
"آذربایجان_شرقی","تبریز","مرکزی",359,1201,22,6,607,1836,20,1856
"آذربایجان_شرقی","تبریز","مرکزی",360,673,15,5,777,1470,22,1492
"آذربایجان_شرقی","تبریز","مرکزی",361,872,46,8,975,1901,23,1924
"آذربایجان_شرقی","تبریز","مرکزی",362,552,12,3,472,1039,10,1049
"آذربایجان_شرقی","تبریز","مرکزی",363,661,15,6,384,1066,16,1082
"آذربایجان_شرقی","تبریز","مرکزی",364,278,8,2,550,838,8,846
"آذربایجان_شرقی","تبریز","مرکزی",365,588,19,4,314,925,6,931
"آذربایجان_شرقی","تبریز","مرکزی",366,412,13,3,942,1370,10,1380
"آذربایجان_شرقی","تبریز","مرکزی",367,1197,20,4,459,1680,9,1689
"آذربایجان_شرقی","تبریز","مرکزی",368,804,13,2,398,1217,12,1229
"آذربایجان_شرقی","تبریز","مرکزی",369,415,11,4,742,1172,19,1191
"آذربایجان_شرقی","تبریز","مرکزی",370,330,9,2,518,859,6,865
"آذربایجان_شرقی","تبریز","مرکزی",371,1071,27,3,895,1996,15,2011
"آذربایجان_شرقی","تبریز","مرکزی",372,303,3,3,218,527,1,528
"آذربایجان_شرقی","تبریز","مرکزی",373,821,23,9,800,1653,21,1674
"آذربایجان_شرقی","تبریز","مرکزی",374,824,24,5,517,1370,13,1383
"آذربایجان_شرقی","تبریز","مرکزی",375,660,25,8,1334,2027,12,2039
"آذربایجان_شرقی","تبریز","مرکزی",376,738,20,5,928,1691,17,1708
"آذربایجان_شرقی","تبریز","مرکزی",377,603,11,5,491,1110,7,1117
"آذربایجان_شرقی","تبریز","مرکزی",378,716,10,1,398,1125,18,1143
"آذربایجان_شرقی","تبریز","مرکزی",379,624,41,5,1253,1923,13,1936
"آذربایجان_شرقی","تبریز","مرکزی",380,377,22,2,1264,1665,18,1683
"آذربایجان_شرقی","تبریز","مرکزی",381,561,29,9,936,1535,20,1555
"آذربایجان_شرقی","تبریز","مرکزی",382,799,22,11,746,1578,,1578
"آذربایجان_شرقی","تبریز","مرکزی",383,659,40,8,643,1350,20,1370
"آذربایجان_شرقی","تبریز","مرکزی",384,221,25,10,969,1225,12,1237
"آذربایجان_شرقی","تبریز","مرکزی",385,673,15,,418,1106,7,1113
"آذربایجان_شرقی","تبریز","مرکزی",386,482,12,1,422,917,8,925
"آذربایجان_شرقی","تبریز","مرکزی",387,1226,37,10,970,2243,20,2263
"آذربایجان_شرقی","تبریز","مرکزی",388,322,14,5,545,886,10,896
"آذربایجان_شرقی","تبریز","مرکزی",389,338,20,2,1132,1492,17,1509
"آذربایجان_شرقی","تبریز","مرکزی",390,369,11,3,159,542,8,550
"آذربایجان_شرقی","تبریز","مرکزی",391,438,4,2,223,667,4,671
"آذربایجان_شرقی","تبریز","مرکزی",392,569,23,7,397,996,,996
"آذربایجان_شرقی","تبریز","مرکزی",393,508,16,5,557,1086,15,1101
"آذربایجان_شرقی","تبریز","مرکزی",394,613,31,2,505,1151,15,1166
"آذربایجان_شرقی","تبریز","مرکزی",395,444,19,2,377,842,19,861
"آذربایجان_شرقی","تبریز","مرکزی",396,736,36,6,764,1542,30,1572
"آذربایجان_شرقی","تبریز","مرکزی",397,381,18,2,671,1072,9,1081
"آذربایجان_شرقی","تبریز","مرکزی",398,964,27,9,985,1985,21,2006
"آذربایجان_شرقی","تبریز","مرکزی",399,586,23,3,778,1390,14,1404
"آذربایجان_شرقی","تبریز","مرکزی",400,737,24,4,790,1555,,1555
"آذربایجان_شرقی","تبریز","مرکزی",401,782,28,8,742,1560,27,1587
"آذربایجان_شرقی","تبریز","مرکزی",402,1175,40,5,700,1920,16,1936
"آذربایجان_شرقی","تبریز","مرکزی",403,541,32,14,1164,1751,18,1769
"آذربایجان_شرقی","تبریز","مرکزی",404,636,22,6,843,1507,10,1517
"آذربایجان_شرقی","تبریز","مرکزی",405,393,20,4,772,1189,6,1195
"آذربایجان_شرقی","تبریز","مرکزی",406,303,10,1,1024,1338,5,1343
"آذربایجان_شرقی","تبریز","مرکزی",407,1088,40,13,1145,2286,18,2304
"آذربایجان_شرقی","تبریز","مرکزی",408,480,20,6,889,1395,14,1409
"آذربایجان_شرقی","تبریز","مرکزی",409,608,27,9,1064,1708,16,1724
"آذربایجان_شرقی","تبریز","مرکزی",410,256,16,5,1188,1465,10,1475
"آذربایجان_شرقی","تبریز","مرکزی",411,257,11,3,884,1155,8,1163
"آذربایجان_شرقی","تبریز","مرکزی",412,696,39,3,930,1668,18,1686
"آذربایجان_شرقی","تبریز","مرکزی",413,279,13,5,1153,1450,12,1462
"آذربایجان_شرقی","تبریز","مرکزی",414,644,40,4,1029,1717,19,1736
"آذربایجان_شرقی","تبریز","مرکزی",415,401,30,11,1003,1445,6,1451
"آذربایجان_شرقی","تبریز","مرکزی",416,649,33,10,1142,1834,27,1861
"آذربایجان_شرقی","تبریز","مرکزی",417,589,20,8,831,1448,6,1454
"آذربایجان_شرقی","تبریز","مرکزی",418,441,17,6,511,975,8,983
"آذربایجان_شرقی","تبریز","مرکزی",419,314,17,15,955,1301,13,1314
"آذربایجان_شرقی","تبریز","مرکزی",420,247,24,7,1163,1441,13,1454
"آذربایجان_شرقی","تبریز","مرکزی",421,925,29,5,923,1882,7,1889
"آذربایجان_شرقی","تبریز","مرکزی",422,188,9,10,1814,2021,77,2098
"آذربایجان_شرقی","تبریز","مرکزی",423,175,5,8,1006,1194,8,1202
"آذربایجان_شرقی","تبریز","مرکزی",424,228,15,14,1145,1402,19,1421
"آذربایجان_شرقی","تبریز","مرکزی",425,453,31,10,1072,1566,20,1586
"آذربایجان_شرقی","تبریز","مرکزی",426,231,18,9,1381,1639,12,1651
"آذربایجان_شرقی","تبریز","مرکزی",427,285,16,3,742,1046,15,1061
"آذربایجان_شرقی","تبریز","مرکزی",428,179,14,2,609,804,7,811
"آذربایجان_شرقی","تبریز","مرکزی",429,829,24,4,833,1690,16,1706
"آذربایجان_شرقی","تبریز","مرکزی",430,778,22,4,1019,1823,16,1839
"آذربایجان_شرقی","تبریز","مرکزی",431,318,27,,577,922,11,933
"آذربایجان_شرقی","تبریز","مرکزی",432,209,17,4,1085,1315,12,1327
"آذربایجان_شرقی","تبریز","مرکزی",433,661,40,15,1152,1868,16,1884
"آذربایجان_شرقی","تبریز","مرکزی",434,468,29,14,1023,1534,66,1600
"آذربایجان_شرقی","تبریز","مرکزی",435,160,11,1,473,645,4,649
"آذربایجان_شرقی","تبریز","مرکزی",436,364,8,2,401,775,120,895
"آذربایجان_شرقی","تبریز","مرکزی",437,156,13,3,424,596,7,603
"آذربایجان_شرقی","تبریز","مرکزی",438,412,15,5,458,890,8,898
"آذربایجان_شرقی","تبریز","مرکزی",439,782,16,12,525,1335,13,1348
"آذربایجان_شرقی","تبریز","مرکزی",440,628,5,4,426,1063,11,1074
"آذربایجان_شرقی","تبریز","مرکزی",441,399,26,18,1431,1874,19,1893
"آذربایجان_شرقی","تبریز","مرکزی",442,1876,15,10,650,2551,22,2573
"آذربایجان_شرقی","تبریز","مرکزی",443,879,6,9,323,1217,18,1235
"آذربایجان_شرقی","تبریز","مرکزی",444,519,10,2,331,862,8,870
"آذربایجان_شرقی","تبریز","مرکزی",445,307,3,1,62,373,,373
"آذربایجان_شرقی","تبریز","مرکزی",446,251,5,,250,506,6,512
"آذربایجان_شرقی","تبریز","مرکزی",447,271,11,5,491,778,4,782
"آذربایجان_شرقی","تبریز","مرکزی",448,701,17,11,920,1649,14,1663
"آذربایجان_شرقی","تبریز","مرکزی",449,720,10,5,413,1148,13,1161
"آذربایجان_شرقی","تبریز","مرکزی",450,630,22,14,1295,1961,32,1993
"آذربایجان_شرقی","تبریز","مرکزی",451,317,11,5,831,1164,13,1177
"آذربایجان_شرقی","تبریز","مرکزی",452,394,21,10,1133,1558,15,1573
"آذربایجان_شرقی","تبریز","مرکزی",453,1195,17,3,683,1898,25,1923
"آذربایجان_شرقی","تبریز","مرکزی",454,863,8,6,834,1711,12,1723
"آذربایجان_شرقی","تبریز","مرکزی",455,792,22,12,953,1779,17,1796
"آذربایجان_شرقی","تبریز","مرکزی",456,379,28,10,1128,1545,16,1561
"آذربایجان_شرقی","تبریز","مرکزی",457,432,34,6,1475,1947,19,1966
"آذربایجان_شرقی","تبریز","مرکزی",458,457,24,11,1463,1955,26,1981
"آذربایجان_شرقی","تبریز","مرکزی",459,1147,23,3,700,1873,18,1891
"آذربایجان_شرقی","تبریز","مرکزی",460,282,1,4,146,433,5,438
"آذربایجان_شرقی","تبریز","مرکزی",461,992,19,3,678,1692,8,1700
"آذربایجان_شرقی","تبریز","مرکزی",462,1105,13,8,454,1580,17,1597
"آذربایجان_شرقی","تبریز","مرکزی",463,1204,36,8,1122,2370,27,2397
"آذربایجان_شرقی","تبریز","مرکزی",464,620,16,8,853,1497,14,1511
"آذربایجان_شرقی","تبریز","مرکزی",465,1292,26,4,706,2028,17,2045
"آذربایجان_شرقی","تبریز","مرکزی",466,1048,22,6,765,1841,14,1855
"آذربایجان_شرقی","تبریز","مرکزی",467,641,20,4,820,1485,10,1495
"آذربایجان_شرقی","تبریز","مرکزی",468,379,5,6,745,1135,7,1142
"آذربایجان_شرقی","تبریز","مرکزی",469,1013,21,2,684,1720,30,1750
"آذربایجان_شرقی","تبریز","مرکزی",470,501,6,1,404,912,8,920
"آذربایجان_شرقی","تبریز","مرکزی",471,956,19,6,418,1399,11,1410
"آذربایجان_شرقی","تبریز","مرکزی",472,1007,7,5,582,1601,14,1615
"آذربایجان_شرقی","تبریز","مرکزی",473,998,7,2,273,1280,,1280
"آذربایجان_شرقی","تبریز","مرکزی",474,976,18,3,678,1675,18,1693
"آذربایجان_شرقی","تبریز","مرکزی",475,1139,,,400,1539,,1539
"آذربایجان_شرقی","تبریز","مرکزی",476,650,25,3,999,1677,9,1686
"آذربایجان_شرقی","تبریز","مرکزی",477,1232,17,4,955,2208,24,2232
"آذربایجان_شرقی","تبریز","مرکزی",478,365,12,4,385,766,6,772
"آذربایجان_شرقی","تبریز","مرکزی",479,930,31,4,1139,2104,16,2120
"آذربایجان_شرقی","تبریز","مرکزی",480,683,26,6,1179,1894,31,1925
"آذربایجان_شرقی","تبریز","مرکزی",481,842,17,1,808,1668,11,1679
"آذربایجان_شرقی","تبریز","مرکزی",482,897,27,4,794,1722,22,1744
"آذربایجان_شرقی","تبریز","مرکزی",483,549,16,5,1329,1899,15,1914
"آذربایجان_شرقی","تبریز","مرکزی",484,1064,25,3,735,1827,22,1849
"آذربایجان_شرقی","تبریز","مرکزی",485,445,12,1,697,1155,11,1166
"آذربایجان_شرقی","تبریز","مرکزی",486,343,5,,207,555,3,558
"آذربایجان_شرقی","تبریز","مرکزی",487,748,10,,421,1179,6,1185
"آذربایجان_شرقی","تبریز","مرکزی",488,1023,18,4,715,1760,10,1770
"آذربایجان_شرقی","تبریز","مرکزی",489,493,7,1,591,1092,11,1103
"آذربایجان_شرقی","تبریز","مرکزی",490,877,7,4,580,1468,10,1478
"آذربایجان_شرقی","تبریز","مرکزی",491,417,24,4,654,1099,,1099
"آذربایجان_شرقی","تبریز","مرکزی",492,712,11,4,814,1541,23,1564
"آذربایجان_شرقی","تبریز","مرکزی",493,458,10,,394,862,13,875
"آذربایجان_شرقی","تبریز","مرکزی",494,1002,11,1,461,1475,5,1480
"آذربایجان_شرقی","تبریز","مرکزی",495,910,9,2,426,1347,17,1364
"آذربایجان_شرقی","تبریز","مرکزی",496,1425,13,3,509,1950,22,1972
"آذربایجان_شرقی","تبریز","مرکزی",497,1030,3,2,329,1364,3,1367
"آذربایجان_شرقی","تبریز","مرکزی",498,1514,11,2,631,2158,16,2174
"آذربایجان_شرقی","تبریز","مرکزی",499,741,8,4,496,1249,13,1262
"آذربایجان_شرقی","تبریز","مرکزی",500,385,3,,171,559,5,564
"آذربایجان_شرقی","تبریز","مرکزی",501,577,2,4,403,986,12,998
"آذربایجان_شرقی","تبریز","مرکزی",502,585,4,,260,849,11,860
"آذربایجان_شرقی","تبریز","مرکزی",503,543,6,,140,689,4,693
"آذربایجان_شرقی","تبریز","مرکزی",504,731,14,3,324,1072,,1072
"آذربایجان_شرقی","تبریز","مرکزی",505,1055,13,1,319,1388,,1388
"آذربایجان_شرقی","تبریز","مرکزی",506,591,6,,132,729,3,732
"آذربایجان_شرقی","تبریز","مرکزی",507,386,35,7,729,1157,17,1174
"آذربایجان_شرقی","تبریز","مرکزی",508,481,12,9,380,882,7,889
"آذربایجان_شرقی","تبریز","مرکزی",509,309,24,9,946,1288,6,1294
"آذربایجان_شرقی","تبریز","مرکزی",510,266,14,7,306,593,6,599
"آذربایجان_شرقی","تبریز","مرکزی",511,738,19,13,949,1719,23,1742
"آذربایجان_شرقی","تبریز","مرکزی",512,187,5,18,716,926,8,934
"آذربایجان_شرقی","تبریز","مرکزی",513,1020,30,17,821,1888,22,1910
"آذربایجان_شرقی","تبریز","مرکزی",514,432,23,24,905,1384,10,1394
"آذربایجان_شرقی","تبریز","مرکزی",515,1013,16,20,740,1789,16,1805
"آذربایجان_شرقی","تبریز","مرکزی",516,678,10,20,386,1094,18,1112
"آذربایجان_شرقی","تبریز","مرکزی",517,1268,2,37,602,1909,19,1928
"آذربایجان_شرقی","تبریز","مرکزی",518,733,15,13,567,1328,5,1333
"آذربایجان_شرقی","تبریز","مرکزی",519,1345,17,46,499,1907,16,1923
"آذربایجان_شرقی","تبریز","مرکزی",520,1471,17,56,822,2366,16,2382
"آذربایجان_شرقی","تبریز","مرکزی",521,2405,9,10,707,3131,17,3148
"آذربایجان_شرقی","تبریز","مرکزی",522,129,17,11,756,913,10,923
"آذربایجان_شرقی","تبریز","مرکزی",523,435,32,7,1008,1482,15,1497
"آذربایجان_شرقی","تبریز","مرکزی",524,384,30,10,728,1152,20,1172
"آذربایجان_شرقی","تبریز","مرکزی",525,308,13,4,991,1316,10,1326
"آذربایجان_شرقی","تبریز","مرکزی",526,541,28,5,686,1260,18,1278
"آذربایجان_شرقی","تبریز","مرکزی",527,642,21,11,806,1480,21,1501
"آذربایجان_شرقی","تبریز","مرکزی",528,206,13,5,941,1165,12,1177
"آذربایجان_شرقی","تبریز","مرکزی",529,430,8,7,364,809,21,830
"آذربایجان_شرقی","تبریز","مرکزی",530,877,9,18,663,1567,9,1576
"آذربایجان_شرقی","تبریز","مرکزی",531,313,23,6,571,913,8,921
"آذربایجان_شرقی","تبریز","مرکزی",532,613,27,9,655,1304,21,1325
"آذربایجان_شرقی","تبریز","مرکزی",533,732,11,,299,1042,12,1054
"آذربایجان_شرقی","تبریز","مرکزی",534,717,23,4,601,1345,13,1358
"آذربایجان_شرقی","تبریز","مرکزی",535,1030,23,4,634,1691,22,1713
"آذربایجان_شرقی","تبریز","مرکزی",536,297,21,2,909,1229,12,1241
"آذربایجان_شرقی","تبریز","مرکزی",537,948,27,5,981,1961,48,2009
"آذربایجان_شرقی","تبریز","مرکزی",538,800,15,5,500,1320,,1320
"آذربایجان_شرقی","تبریز","مرکزی",539,517,18,1,757,1293,8,1301
"آذربایجان_شرقی","تبریز","مرکزی",540,612,9,1,353,975,12,987
"آذربایجان_شرقی","تبریز","مرکزی",541,508,6,,435,949,5,954
"آذربایجان_شرقی","تبریز","مرکزی",542,645,5,1,193,844,12,856
"آذربایجان_شرقی","تبریز","مرکزی",543,524,22,6,390,942,15,957
"آذربایجان_شرقی","تبریز","مرکزی",544,1190,10,5,585,1790,13,1803
"آذربایجان_شرقی","تبریز","مرکزی",545,803,27,5,1354,2189,12,2201
"آذربایجان_شرقی","تبریز","مرکزی",546,1181,36,4,805,2026,24,2050
"آذربایجان_شرقی","تبریز","مرکزی",547,904,14,2,501,1421,10,1431
"آذربایجان_شرقی","تبریز","مرکزی",548,1183,5,5,511,1704,8,1712
"آذربایجان_شرقی","تبریز","مرکزی",549,1482,16,5,250,1753,23,1776
"آذربایجان_شرقی","تبریز","مرکزی",550,340,3,3,212,558,3,561
"آذربایجان_شرقی","تبریز","مرکزی",551,1153,16,5,635,1809,14,1823
"آذربایجان_شرقی","تبریز","مرکزی",552,884,7,1,372,1264,2,1266
"آذربایجان_شرقی","تبریز","مرکزی",553,1735,4,2,329,2070,11,2081
"آذربایجان_شرقی","تبریز","مرکزی",554,1585,11,7,743,2346,18,2364
"آذربایجان_شرقی","تبریز","مرکزی",555,706,14,1,484,1205,13,1218
"آذربایجان_شرقی","تبریز","مرکزی",556,521,6,2,388,917,7,924
"آذربایجان_شرقی","تبریز","مرکزی",557,421,28,7,531,987,14,1001
"آذربایجان_شرقی","تبریز","مرکزی",558,499,24,10,1404,1937,7,1944
"آذربایجان_شرقی","تبریز","مرکزی",559,286,23,6,407,722,7,729
"آذربایجان_شرقی","تبریز","مرکزی",560,375,27,30,1150,1582,16,1598
"آذربایجان_شرقی","تبریز","مرکزی",561,303,27,15,951,1296,24,1320
"آذربایجان_شرقی","تبریز","مرکزی",562,459,26,4,1005,1494,16,1510
"آذربایجان_شرقی","تبریز","مرکزی",563,243,7,14,1019,1283,14,1297
"آذربایجان_شرقی","تبریز","مرکزی",564,835,25,3,730,1593,17,1610
"آذربایجان_شرقی","تبریز","مرکزی",565,647,26,6,516,1195,13,1208
"آذربایجان_شرقی","تبریز","مرکزی",566,473,21,11,1254,1759,13,1772
"آذربایجان_شرقی","تبریز","مرکزی",567,738,18,6,658,1420,21,1441
"آذربایجان_شرقی","تبریز","مرکزی",568,444,9,7,777,1237,6,1243
"آذربایجان_شرقی","تبریز","مرکزی",569,456,4,3,420,883,14,897
"آذربایجان_شرقی","تبریز","مرکزی",570,247,1,1,189,438,2,440
"آذربایجان_شرقی","تبریز","مرکزی",571,464,12,1,465,942,11,953
"آذربایجان_شرقی","تبریز","مرکزی",572,204,17,6,1087,1314,7,1321
"آذربایجان_شرقی","تبریز","مرکزی",573,600,22,11,685,1318,15,1333
"آذربایجان_شرقی","تبریز","مرکزی",574,259,8,4,290,561,5,566
"آذربایجان_شرقی","تبریز","مرکزی",575,337,17,5,306,665,26,691
"آذربایجان_شرقی","تبریز","مرکزی",576,103,3,1,185,292,4,296
"آذربایجان_شرقی","تبریز","مرکزی",577,156,3,3,113,275,2,277
"آذربایجان_شرقی","تبریز","مرکزی",578,209,8,1,237,455,7,462
"آذربایجان_شرقی","تبریز","مرکزی",579,240,2,2,169,413,9,422
"آذربایجان_شرقی","تبریز","مرکزی",580,27,,,40,67,,67
"آذربایجان_شرقی","تبریز","مرکزی",581,145,11,3,244,403,1,404
"آذربایجان_شرقی","تبریز","مرکزی",582,158,1,,214,373,4,377
"آذربایجان_شرقی","تبریز","مرکزی",583,282,8,3,266,559,9,568
"آذربایجان_شرقی","تبریز","مرکزی",584,225,9,3,280,517,7,524
"آذربایجان_شرقی","تبریز","مرکزی",585,360,5,1,205,571,2,573
"آذربایجان_شرقی","تبریز","مرکزی",586,76,4,1,93,174,1,175
"آذربایجان_شرقی","تبریز","مرکزی",587,193,6,3,97,299,5,304
"آذربایجان_شرقی","تبریز","مرکزی",588,428,13,3,620,1064,5,1069
"آذربایجان_شرقی","تبریز","مرکزی",589,627,6,3,230,866,6,872
"آذربایجان_شرقی","تبریز","مرکزی",590,630,7,3,390,1030,16,1046
"آذربایجان_شرقی","تبریز","مرکزی",591,1110,12,4,367,1493,6,1499
"آذربایجان_شرقی","تبریز","مرکزی",592,852,8,,222,1082,8,1090
"آذربایجان_شرقی","تبریز","مرکزی",593,604,10,2,389,1005,3,1008
"آذربایجان_شرقی","تبریز","مرکزی",594,203,4,,198,405,2,407
"آذربایجان_شرقی","تبریز","مرکزی",595,811,6,3,397,1217,5,1222
"آذربایجان_شرقی","تبریز","مرکزی",596,456,,2,79,537,3,540
"آذربایجان_شرقی","تبریز","مرکزی",597,412,1,,119,532,,532
"آذربایجان_شرقی","تبریز","مرکزی",598,276,2,1,292,571,3,574
"آذربایجان_شرقی","تبریز","مرکزی",599,553,4,1,349,907,17,924
"آذربایجان_شرقی","تبریز","مرکزی",600,911,1,,73,985,3,988
"آذربایجان_شرقی","تبریز","مرکزی",601,818,2,4,186,1010,10,1020
"آذربایجان_شرقی","تبریز","مرکزی",602,740,7,9,98,854,7,861
"آذربایجان_شرقی","تبریز","مرکزی",603,456,2,1,124,583,6,589
"آذربایجان_شرقی","تبریز","مرکزی",604,975,9,1,182,1167,12,1179
"آذربایجان_شرقی","تبریز","مرکزی",605,596,1,1,54,652,2,654
"آذربایجان_شرقی","تبریز","مرکزی",606,440,,,42,482,,482
"آذربایجان_شرقی","تبریز","مرکزی",607,835,9,2,220,1066,10,1076
"آذربایجان_شرقی","تبریز","مرکزی",608,714,3,1,65,783,2,785
"آذربایجان_شرقی","تبریز","مرکزی",609,1350,13,3,542,1908,18,1926
"آذربایجان_شرقی","تبریز","مرکزی",610,687,6,3,158,854,1,855
"آذربایجان_شرقی","تبریز","مرکزی",611,381,3,1,141,526,1,527
"آذربایجان_شرقی","تبریز","مرکزی",612,564,3,3,183,753,2,755
"آذربایجان_شرقی","تبریز","مرکزی",613,172,3,,427,602,6,608
"آذربایجان_شرقی","تبریز","مرکزی",614,152,,,52,204,4,208
"آذربایجان_شرقی","تبریز","مرکزی",615,367,,,170,537,1,538
"آذربایجان_شرقی","تبریز","مرکزی",616,393,,1,218,612,2,614
"آذربایجان_شرقی","تبریز","مرکزی",617,289,,,21,310,,310
"آذربایجان_شرقی","تبریز","مرکزی",618,231,1,,27,259,2,261
"آذربایجان_شرقی","تبریز","مرکزی",619,310,,,70,380,3,383
"آذربایجان_شرقی","تبریز","مرکزی",620,462,1,1,139,603,5,608
"آذربایجان_شرقی","تبریز","مرکزی",621,157,1,,89,247,2,249
"آذربایجان_شرقی","تبریز","مرکزی",622,322,1,1,128,452,10,462
"آذربایجان_شرقی","تبریز","مرکزی",623,803,1,1,77,882,,882
"آذربایجان_شرقی","تبریز","مرکزی",624,1251,2,6,456,1715,18,1733
"آذربایجان_شرقی","تبریز","مرکزی",625,1079,3,2,312,1396,14,1410
"آذربایجان_شرقی","تبریز","مرکزی",626,960,9,2,294,1265,8,1273
"آذربایجان_شرقی","تبریز","مرکزی",627,598,11,3,364,976,6,982
"آذربایجان_شرقی","تبریز","مرکزی",628,736,3,,243,982,16,998
"آذربایجان_شرقی","تبریز","مرکزی",629,1125,15,3,247,1390,,1390
"آذربایجان_شرقی","تبریز","مرکزی",630,832,4,1,99,936,2,938
"آذربایجان_شرقی","تبریز","مرکزی",631,448,1,1,91,541,,541
"آذربایجان_شرقی","تبریز","مرکزی",632,541,10,3,66,620,2,622
"آذربایجان_شرقی","تبریز","مرکزی",633,486,6,,130,622,7,629
"آذربایجان_شرقی","تبریز","مرکزی",634,596,7,1,553,1157,6,1163
"آذربایجان_شرقی","تبریز","مرکزی",635,278,3,,296,577,3,580
"آذربایجان_شرقی","تبریز","مرکزی",636,307,2,4,340,653,2,655
"آذربایجان_شرقی","تبریز","مرکزی",637,585,7,3,235,830,15,845
"آذربایجان_شرقی","تبریز","مرکزی",638,490,6,,97,593,5,598
"آذربایجان_شرقی","تبریز","مرکزی",639,206,,,167,373,1,374
"آذربایجان_شرقی","تبریز","مرکزی",640,604,5,,188,797,1,798
"آذربایجان_شرقی","تبریز","مرکزی",641,536,4,1,300,841,2,843
"آذربایجان_شرقی","تبریز","مرکزی",642,223,,,15,238,,238
"آذربایجان_شرقی","تبریز","مرکزی",643,102,2,,18,122,2,124
"آذربایجان_شرقی","تبریز","مرکزی",644,365,5,,56,426,,426
"آذربایجان_شرقی","تبریز","مرکزی",645,201,1,,62,264,1,265
"آذربایجان_شرقی","تبریز","مرکزی",646,223,,,75,298,,298
"آذربایجان_شرقی","تبریز","مرکزی",647,222,1,,26,249,3,252
"آذربایجان_شرقی","تبریز","مرکزی",648,627,11,2,634,1274,23,1297
"آذربایجان_شرقی","تبریز","مرکزی",649,501,9,2,257,769,6,775
"آذربایجان_شرقی","تبریز","مرکزی",650,360,5,2,219,586,4,590
"آذربایجان_شرقی","تبریز","مرکزی",651,514,26,4,744,1288,11,1299
"آذربایجان_شرقی","تبریز","مرکزی",652,224,3,,206,433,2,435
"آذربایجان_شرقی","تبریز","مرکزی",653,245,3,1,308,557,2,559
"آذربایجان_شرقی","تبریز","مرکزی",654,348,3,2,388,741,9,750
"آذربایجان_شرقی","تبریز","مرکزی",655,459,2,,227,688,4,692
"آذربایجان_شرقی","تبریز","مرکزی",656,585,9,,440,1034,13,1047
"آذربایجان_شرقی","تبریز","مرکزی",657,676,11,4,599,1290,24,1314
"آذربایجان_شرقی","تبریز","مرکزی",658,783,8,3,404,1198,8,1206
"آذربایجان_شرقی","تبریز","مرکزی",659,279,9,,294,582,7,589
"آذربایجان_شرقی","تبریز","مرکزی",660,764,17,11,778,1570,7,1577
"آذربایجان_شرقی","تبریز","مرکزی",661,458,13,5,567,1043,12,1055
"آذربایجان_شرقی","تبریز","مرکزی",662,1063,9,4,623,1699,14,1713
"آذربایجان_شرقی","تبریز","مرکزی",663,1000,8,,282,1290,5,1295
"آذربایجان_شرقی","تبریز","مرکزی",664,580,6,,571,1157,19,1176
"آذربایجان_شرقی","تبریز","مرکزی",665,524,9,3,518,1054,5,1059
"آذربایجان_شرقی","تبریز","خسروشهر",1,593,6,2,729,1330,13,1343
"آذربایجان_شرقی","تبریز","خسروشهر",2,389,3,0,243,635,6,641
"آذربایجان_شرقی","تبریز","خسروشهر",3,632,18,1,528,1179,14,1193
"آذربایجان_شرقی","تبریز","خسروشهر",4,405,5,1,200,611,4,615
"آذربایجان_شرقی","تبریز","خسروشهر",5,288,2,2,195,487,2,489
"آذربایجان_شرقی","تبریز","خسروشهر",6,157,0,0,153,310,4,314
"آذربایجان_شرقی","تبریز","خسروشهر",7,247,2,0,229,478,4,482
"آذربایجان_شرقی","تبریز","خسروشهر",8,353,14,1,493,861,7,868
"آذربایجان_شرقی","تبریز","خسروشهر",9,372,3,0,466,841,9,850
"آذربایجان_شرقی","تبریز","خسروشهر",10,246,6,0,192,444,3,447
"آذربایجان_شرقی","تبریز","خسروشهر",11,65,1,0,83,149,1,150
"آذربایجان_شرقی","تبریز","خسروشهر",12,130,1,1,107,239,9,248
"آذربایجان_شرقی","تبریز","خسروشهر",13,107,1,0,72,180,1,181
"آذربایجان_شرقی","تبریز","خسروشهر",14,716,7,0,440,1163,13,1176
"آذربایجان_شرقی","تبریز","خسروشهر",15,703,3,4,208,918,5,923
"آذربایجان_شرقی","تبریز","خسروشهر",16,759,7,2,479,1247,5,1252
"آذربایجان_شرقی","تبریز","خسروشهر",17,784,9,0,259,1052,6,1058
"آذربایجان_شرقی","تبریز","خسروشهر",18,530,9,3,342,884,8,892
"آذربایجان_شرقی","تبریز","خسروشهر",19,295,0,0,74,369,3,372
"آذربایجان_شرقی","تبریز","خسروشهر",20,137,5,1,195,338,6,344
"آذربایجان_شرقی","تبریز","خسروشهر",21,631,3,1,221,856,3,859
"آذربایجان_شرقی","تبریز","خسروشهر",22,428,4,4,36,472,0,472
"آذربایجان_شرقی","تبریز","خسروشهر",23,244,0,2,250,496,4,500
"آذربایجان_شرقی","تبریز","خسروشهر",24,233,0,0,104,337,1,338
"آذربایجان_شرقی","تبریز","خسروشهر",25,468,8,1,256,733,5,738
"آذربایجان_شرقی","تبریز","خسروشهر",26,433,1,1,92,527,1,528
"آذربایجان_شرقی","تبریز","خسروشهر",27,447,6,0,156,609,9,618
"آذربایجان_شرقی","تبریز","خسروشهر",28,473,5,0,91,569,2,571
"آذربایجان_شرقی","تبریز","خسروشهر",29,227,1,2,149,379,1,380
"آذربایجان_شرقی","تبریز","خسروشهر",30,247,2,1,79,329,0,329
"آذربایجان_شرقی","تبریز","خسروشهر",31,219,3,0,72,294,4,298
"آذربایجان_شرقی","تبریز","خسروشهر",32,465,2,2,158,627,7,634
"آذربایجان_شرقی","تبریز","خسروشهر",33,465,0,0,57,522,1,523
"آذربایجان_شرقی","تبریز","خسروشهر",34,253,6,0,130,389,3,392
"آذربایجان_شرقی","تبریز","خسروشهر",35,204,0,0,54,258,3,261
"آذربایجان_شرقی","جلفا","مرکزی",1,156,3,0,186,345,3,348
"آذربایجان_شرقی","جلفا","مرکزی",2,566,9,6,811,1392,5,1397
"آذربایجان_شرقی","جلفا","مرکزی",3,345,8,4,647,1004,9,1013
"آذربایجان_شرقی","جلفا","مرکزی",4,107,1,0,92,200,0,200
"آذربایجان_شرقی","جلفا","مرکزی",5,182,2,0,161,345,4,349
"آذربایجان_شرقی","جلفا","مرکزی",6,149,1,4,278,432,7,439
"آذربایجان_شرقی","جلفا","مرکزی",7,506,0,0,380,886,3,889
"آذربایجان_شرقی","جلفا","مرکزی",8,381,3,2,205,591,1,592
"آذربایجان_شرقی","جلفا","مرکزی",9,845,9,0,726,1580,6,1586
"آذربایجان_شرقی","جلفا","مرکزی",10,316,1,1,212,530,8,538
"آذربایجان_شرقی","جلفا","مرکزی",11,754,6,1,441,1202,9,1211
"آذربایجان_شرقی","جلفا","مرکزی",12,273,2,1,126,402,1,403
"آذربایجان_شرقی","جلفا","مرکزی",13,209,4,3,364,580,1,581
"آذربایجان_شرقی","جلفا","مرکزی",14,712,1,4,372,1089,3,1092
"آذربایجان_شرقی","جلفا","مرکزی",15,187,0,0,114,301,0,301
"آذربایجان_شرقی","جلفا","مرکزی",16,953,5,0,556,1514,7,1521
"آذربایجان_شرقی","جلفا","مرکزی",17,713,4,5,542,1264,5,1269
"آذربایجان_شرقی","جلفا","مرکزی",18,429,5,1,479,914,6,920
"آذربایجان_شرقی","جلفا","مرکزی",19,606,12,3,618,1239,7,1246
"آذربایجان_شرقی","جلفا","مرکزی",20,465,1,2,214,682,6,688
"آذربایجان_شرقی","جلفا","مرکزی",21,420,3,2,350,775,5,780
"آذربایجان_شرقی","جلفا","مرکزی",22,675,6,7,588,1276,14,1290
"آذربایجان_شرقی","جلفا","مرکزی",23,724,7,4,668,1403,9,1412
"آذربایجان_شرقی","جلفا","مرکزی",24,220,5,2,135,362,3,365
"آذربایجان_شرقی","جلفا","مرکزی",25,306,1,0,152,459,1,460
"آذربایجان_شرقی","جلفا","مرکزی",26,133,3,1,267,404,5,409
"آذربایجان_شرقی","جلفا","مرکزی",27,206,3,0,237,446,6,452
"آذربایجان_شرقی","جلفا","مرکزی",28,374,3,1,345,723,0,723
"آذربایجان_شرقی","جلفا","مرکزی",29,414,4,3,258,679,7,686
"آذربایجان_شرقی","جلفا","مرکزی",30,426,3,1,198,628,1,629
"آذربایجان_شرقی","جلفا","مرکزی",31,167,4,0,73,244,1,245
"آذربایجان_شرقی","جلفا","مرکزی",32,261,1,1,45,308,0,308
"آذربایجان_شرقی","جلفا","مرکزی",33,252,4,3,149,408,7,415
"آذربایجان_شرقی","جلفا","مرکزی",34,332,1,0,141,474,6,480
"آذربایجان_شرقی","جلفا","مرکزی",35,378,1,1,300,680,5,685
"آذربایجان_شرقی","جلفا","مرکزی",36,380,5,0,257,642,2,644
"آذربایجان_شرقی","جلفا","مرکزی",37,70,0,0,173,243,1,244
"آذربایجان_شرقی","جلفا","مرکزی",38,343,0,0,42,385,0,385
"آذربایجان_شرقی","جلفا","مرکزی",39,511,4,2,385,902,4,906
"آذربایجان_شرقی","جلفا","مرکزی",40,557,1,1,181,740,1,741
"آذربایجان_شرقی","جلفا","مرکزی",41,192,2,0,79,273,2,275
"آذربایجان_شرقی","جلفا","مرکزی",42,404,1,0,64,469,4,473
"آذربایجان_شرقی","جلفا","مرکزی",43,78,2,2,115,197,0,197
"آذربایجان_شرقی","جلفا","مرکزی",44,137,2,0,81,220,0,220
"آذربایجان_شرقی","جلفا","سیه_رود",1,225,2,0,276,503,4,507
"آذربایجان_شرقی","جلفا","سیه_رود",2,267,1,0,170,438,0,438
"آذربایجان_شرقی","جلفا","سیه_رود",3,422,3,0,107,532,2,534
"آذربایجان_شرقی","جلفا","سیه_رود",4,357,3,0,149,509,2,511
"آذربایجان_شرقی","جلفا","سیه_رود",5,277,1,0,47,325,0,325
"آذربایجان_شرقی","جلفا","سیه_رود",6,224,0,1,75,300,0,300
"آذربایجان_شرقی","جلفا","سیه_رود",7,340,3,0,96,439,1,440
"آذربایجان_شرقی","جلفا","سیه_رود",8,99,2,0,16,117,0,117
"آذربایجان_شرقی","جلفا","سیه_رود",9,310,4,0,152,466,4,470
"آذربایجان_شرقی","جلفا","سیه_رود",10,74,0,0,78,152,1,153
"آذربایجان_شرقی","جلفا","سیه_رود",11,228,0,0,72,300,0,300
"آذربایجان_شرقی","جلفا","سیه_رود",12,143,1,2,79,225,1,226
"آذربایجان_شرقی","جلفا","سیه_رود",13,159,1,0,55,215,1,216
"آذربایجان_شرقی","جلفا","سیه_رود",14,186,0,0,21,207,1,208
"آذربایجان_شرقی","جلفا","سیه_رود",15,242,1,0,63,306,0,306
"آذربایجان_شرقی","جلفا","سیه_رود",16,54,1,1,41,97,2,99
"آذربایجان_شرقی","جلفا","سیه_رود",17,47,0,1,32,80,1,81
"آذربایجان_شرقی","جلفا","سیه_رود",18,52,0,1,4,57,0,57
"آذربایجان_شرقی","چاراویماق","مرکزی",1,254,1,0,217,472,2,474
"آذربایجان_شرقی","چاراویماق","مرکزی",2,85,1,1,106,193,4,197
"آذربایجان_شرقی","چاراویماق","مرکزی",3,114,3,1,142,260,2,262
"آذربایجان_شرقی","چاراویماق","مرکزی",4,165,1,1,109,276,5,281
"آذربایجان_شرقی","چاراویماق","مرکزی",5,222,3,0,173,398,2,400
"آذربایجان_شرقی","چاراویماق","مرکزی",6,290,7,4,294,595,6,601
"آذربایجان_شرقی","چاراویماق","مرکزی",7,120,5,1,144,270,2,272
"آذربایجان_شرقی","چاراویماق","مرکزی",8,129,2,1,85,217,0,217
"آذربایجان_شرقی","چاراویماق","مرکزی",9,383,1,0,55,439,1,440
"آذربایجان_شرقی","چاراویماق","مرکزی",10,302,2,17,137,458,1,459
"آذربایجان_شرقی","چاراویماق","مرکزی",11,100,0,2,24,126,0,126
"آذربایجان_شرقی","چاراویماق","مرکزی",12,158,0,0,52,210,1,211
"آذربایجان_شرقی","چاراویماق","مرکزی",13,168,0,0,83,251,1,252
"آذربایجان_شرقی","چاراویماق","مرکزی",14,254,0,0,29,283,3,286
"آذربایجان_شرقی","چاراویماق","مرکزی",15,178,1,0,59,238,3,241
"آذربایجان_شرقی","چاراویماق","مرکزی",16,224,1,0,65,290,0,290
"آذربایجان_شرقی","چاراویماق","مرکزی",17,227,0,0,60,287,0,287
"آذربایجان_شرقی","چاراویماق","مرکزی",18,162,0,0,48,210,5,215
"آذربایجان_شرقی","چاراویماق","مرکزی",19,118,0,0,42,160,0,160
"آذربایجان_شرقی","چاراویماق","مرکزی",20,117,0,0,8,125,0,125
"آذربایجان_شرقی","چاراویماق","مرکزی",21,206,1,0,83,290,3,293
"آذربایجان_شرقی","چاراویماق","مرکزی",22,139,0,1,25,165,2,167
"آذربایجان_شرقی","چاراویماق","مرکزی",23,118,0,1,53,172,0,172
"آذربایجان_شرقی","چاراویماق","مرکزی",24,206,0,0,55,261,2,263
"آذربایجان_شرقی","چاراویماق","مرکزی",25,172,3,2,44,221,0,221
"آذربایجان_شرقی","چاراویماق","مرکزی",26,104,2,0,41,147,8,155
"آذربایجان_شرقی","چاراویماق","مرکزی",27,249,0,0,10,259,1,260
"آذربایجان_شرقی","چاراویماق","مرکزی",28,121,2,6,17,146,1,147
"آذربایجان_شرقی","چاراویماق","مرکزی",29,105,0,0,40,145,5,150
"آذربایجان_شرقی","چاراویماق","مرکزی",30,94,0,0,39,133,1,134
"آذربایجان_شرقی","چاراویماق","مرکزی",31,82,0,0,5,87,0,87
"آذربایجان_شرقی","چاراویماق","مرکزی",32,193,0,0,47,240,2,242
"آذربایجان_شرقی","چاراویماق","مرکزی",33,308,0,0,56,364,4,368
"آذربایجان_شرقی","چاراویماق","مرکزی",34,271,0,0,60,331,3,334
"آذربایجان_شرقی","چاراویماق","مرکزی",35,203,1,0,187,391,0,391
"آذربایجان_شرقی","چاراویماق","مرکزی",36,175,1,0,77,253,1,254
"آذربایجان_شرقی","چاراویماق","مرکزی",37,211,0,0,80,291,2,293
"آذربایجان_شرقی","چاراویماق","مرکزی",38,262,1,0,48,311,3,314
"آذربایجان_شرقی","چاراویماق","مرکزی",39,258,0,0,24,282,1,283
"آذربایجان_شرقی","چاراویماق","مرکزی",40,133,1,1,11,146,3,149
"آذربایجان_شرقی","چاراویماق","مرکزی",41,239,0,0,18,257,1,258
"آذربایجان_شرقی","چاراویماق","مرکزی",42,284,1,1,39,325,1,326
"آذربایجان_شرقی","چاراویماق","شادیان",1,168,0,0,65,233,0,233
"آذربایجان_شرقی","چاراویماق","شادیان",2,376,0,0,72,448,0,448
"آذربایجان_شرقی","چاراویماق","شادیان",3,249,3,0,75,327,1,328
"آذربایجان_شرقی","چاراویماق","شادیان",4,225,0,0,71,296,3,299
"آذربایجان_شرقی","چاراویماق","شادیان",5,184,0,1,33,218,0,218
"آذربایجان_شرقی","چاراویماق","شادیان",6,144,0,0,34,178,0,178
"آذربایجان_شرقی","چاراویماق","شادیان",7,237,1,0,34,272,7,279
"آذربایجان_شرقی","چاراویماق","شادیان",8,135,4,0,9,148,2,150
"آذربایجان_شرقی","چاراویماق","شادیان",9,83,2,0,33,118,0,118
"آذربایجان_شرقی","چاراویماق","شادیان",10,325,0,0,43,368,0,368
"آذربایجان_شرقی","چاراویماق","شادیان",11,266,0,0,72,338,2,340
"آذربایجان_شرقی","چاراویماق","شادیان",12,130,0,0,54,184,0,184
"آذربایجان_شرقی","چاراویماق","شادیان",13,162,0,0,29,191,0,191
"آذربایجان_شرقی","چاراویماق","شادیان",14,155,0,2,44,201,0,201
"آذربایجان_شرقی","چاراویماق","شادیان",15,192,0,0,26,218,0,218
"آذربایجان_شرقی","چاراویماق","شادیان",16,550,0,1,33,584,0,584
"آذربایجان_شرقی","چاراویماق","شادیان",17,55,1,0,48,104,0,104
"آذربایجان_شرقی","چاراویماق","شادیان",18,127,1,0,40,168,5,173
"آذربایجان_شرقی","چاراویماق","شادیان",19,144,0,2,27,173,0,173
"آذربایجان_شرقی","چاراویماق","شادیان",20,169,1,0,94,264,0,264
"آذربایجان_شرقی","چاراویماق","شادیان",21,218,1,0,48,267,0,267
"آذربایجان_شرقی","سراب","مرکزی",1,569,12,2,464,1047,13,1060
"آذربایجان_شرقی","سراب","مرکزی",2,367,19,3,329,718,11,729
"آذربایجان_شرقی","سراب","مرکزی",3,431,5,5,277,718,10,728
"آذربایجان_شرقی","سراب","مرکزی",4,320,6,5,382,713,12,725
"آذربایجان_شرقی","سراب","مرکزی",5,344,13,1,236,594,11,605
"آذربایجان_شرقی","سراب","مرکزی",6,351,3,0,326,680,14,694
"آذربایجان_شرقی","سراب","مرکزی",7,216,5,6,327,554,8,562
"آذربایجان_شرقی","سراب","مرکزی",8,567,19,4,533,1123,15,1138
"آذربایجان_شرقی","سراب","مرکزی",9,749,10,4,366,1129,11,1140
"آذربایجان_شرقی","سراب","مرکزی",10,481,8,1,427,917,15,932
"آذربایجان_شرقی","سراب","مرکزی",11,416,11,6,353,786,15,801
"آذربایجان_شرقی","سراب","مرکزی",12,583,6,4,433,1026,10,1036
"آذربایجان_شرقی","سراب","مرکزی",13,384,15,8,568,975,14,989
"آذربایجان_شرقی","سراب","مرکزی",14,484,7,1,398,890,10,900
"آذربایجان_شرقی","سراب","مرکزی",15,527,6,6,213,752,16,768
"آذربایجان_شرقی","سراب","مرکزی",16,950,2,0,100,1052,2,1054
"آذربایجان_شرقی","سراب","مرکزی",17,534,3,0,116,653,5,658
"آذربایجان_شرقی","سراب","مرکزی",18,473,3,0,69,545,6,551
"آذربایجان_شرقی","سراب","مرکزی",19,829,4,0,181,1014,3,1017
"آذربایجان_شرقی","سراب","مرکزی",20,502,1,1,101,605,3,608
"آذربایجان_شرقی","سراب","مرکزی",21,500,10,5,290,805,8,813
"آذربایجان_شرقی","سراب","مرکزی",22,234,0,0,90,324,6,330
"آذربایجان_شرقی","سراب","مرکزی",23,563,10,10,308,891,9,900
"آذربایجان_شرقی","سراب","مرکزی",24,381,10,7,307,705,11,716
"آذربایجان_شرقی","سراب","مرکزی",25,498,9,8,485,1000,17,1017
"آذربایجان_شرقی","سراب","مرکزی",26,398,6,2,206,612,8,620
"آذربایجان_شرقی","سراب","مرکزی",27,573,6,2,180,761,6,767
"آذربایجان_شرقی","سراب","مرکزی",28,570,11,5,501,1087,18,1105
"آذربایجان_شرقی","سراب","مرکزی",29,405,1,2,235,643,10,653
"آذربایجان_شرقی","سراب","مرکزی",30,154,1,0,86,241,1,242
"آذربایجان_شرقی","سراب","مرکزی",31,152,1,0,33,186,7,193
"آذربایجان_شرقی","سراب","مرکزی",32,340,2,0,214,556,2,558
"آذربایجان_شرقی","سراب","مرکزی",33,168,0,0,36,204,0,204
"آذربایجان_شرقی","سراب","مرکزی",34,287,0,0,43,330,3,333
"آذربایجان_شرقی","سراب","مرکزی",35,142,0,0,27,169,0,169
"آذربایجان_شرقی","سراب","مرکزی",36,232,0,2,65,299,2,301
"آذربایجان_شرقی","سراب","مرکزی",37,271,1,1,46,319,0,319
"آذربایجان_شرقی","سراب","مرکزی",38,319,0,0,21,340,2,342
"آذربایجان_شرقی","سراب","مرکزی",39,482,3,0,33,518,0,518
"آذربایجان_شرقی","سراب","مرکزی",40,481,9,0,166,656,3,659
"آذربایجان_شرقی","سراب","مرکزی",41,531,1,0,116,648,0,648
"آذربایجان_شرقی","سراب","مرکزی",42,141,3,0,44,188,0,188
"آذربایجان_شرقی","سراب","مرکزی",43,408,0,0,13,421,3,424
"آذربایجان_شرقی","سراب","مرکزی",44,272,4,3,54,333,1,334
"آذربایجان_شرقی","سراب","مرکزی",45,197,1,1,39,238,0,238
"آذربایجان_شرقی","سراب","مرکزی",46,280,1,0,26,307,2,309
"آذربایجان_شرقی","سراب","مرکزی",47,410,0,0,14,424,7,431
"آذربایجان_شرقی","سراب","مرکزی",48,746,1,1,58,806,7,813
"آذربایجان_شرقی","سراب","مرکزی",49,401,3,2,176,582,5,587
"آذربایجان_شرقی","سراب","مرکزی",50,364,2,1,106,473,2,475
"آذربایجان_شرقی","سراب","مرکزی",51,380,1,1,62,444,5,449
"آذربایجان_شرقی","سراب","مرکزی",52,509,4,2,249,764,11,775
"آذربایجان_شرقی","سراب","مرکزی",53,425,0,0,36,461,9,470
"آذربایجان_شرقی","سراب","مرکزی",54,98,0,0,14,112,1,113
"آذربایجان_شرقی","سراب","مرکزی",55,311,4,6,313,634,38,672
"آذربایجان_شرقی","سراب","مرکزی",56,203,3,1,91,298,2,300
"آذربایجان_شرقی","سراب","مرکزی",57,127,0,0,24,151,2,153
"آذربایجان_شرقی","سراب","مرکزی",58,51,0,1,6,58,0,58
"آذربایجان_شرقی","سراب","مرکزی",59,547,7,1,30,585,5,590
"آذربایجان_شرقی","سراب","مرکزی",60,499,4,1,97,601,6,607
"آذربایجان_شرقی","سراب","مرکزی",61,241,3,1,90,335,4,339
"آذربایجان_شرقی","سراب","مرکزی",62,1006,4,2,29,1041,6,1047
"آذربایجان_شرقی","سراب","مرکزی",63,141,0,0,20,161,1,162
"آذربایجان_شرقی","سراب","مرکزی",64,513,0,0,19,532,0,532
"آذربایجان_شرقی","سراب","مرکزی",65,159,0,1,19,179,2,181
"آذربایجان_شرقی","سراب","مرکزی",66,380,3,3,50,436,2,438
"آذربایجان_شرقی","سراب","مرکزی",67,399,2,0,34,435,1,436
"آذربایجان_شرقی","سراب","مرکزی",68,496,1,1,114,612,1,613
"آذربایجان_شرقی","سراب","مرکزی",69,596,5,0,88,689,5,694
"آذربایجان_شرقی","سراب","مرکزی",70,657,2,2,169,830,10,840
"آذربایجان_شرقی","سراب","مرکزی",71,242,1,0,20,263,0,263
"آذربایجان_شرقی","سراب","مرکزی",72,526,3,0,90,619,3,622
"آذربایجان_شرقی","سراب","مرکزی",73,530,0,1,53,584,0,584
"آذربایجان_شرقی","سراب","مرکزی",74,445,0,0,19,464,1,465
"آذربایجان_شرقی","سراب","مرکزی",75,245,0,1,22,268,0,268
"آذربایجان_شرقی","سراب","مرکزی",76,231,5,0,25,261,1,262
"آذربایجان_شرقی","سراب","مرکزی",77,258,2,5,41,306,5,311
"آذربایجان_شرقی","سراب","مرکزی",78,588,2,0,87,677,2,679
"آذربایجان_شرقی","سراب","مرکزی",79,537,3,2,62,604,4,608
"آذربایجان_شرقی","سراب","مرکزی",80,234,0,0,58,292,7,299
"آذربایجان_شرقی","سراب","مرکزی",81,412,3,1,29,445,1,446
"آذربایجان_شرقی","سراب","مرکزی",82,92,0,0,30,122,0,122
"آذربایجان_شرقی","سراب","مرکزی",83,112,2,0,19,133,0,133
"آذربایجان_شرقی","سراب","مرکزی",84,345,2,1,78,426,4,430
"آذربایجان_شرقی","سراب","مرکزی",85,434,2,0,59,495,1,496
"آذربایجان_شرقی","سراب","مرکزی",86,138,0,0,7,145,0,145
"آذربایجان_شرقی","سراب","مرکزی",87,155,1,2,13,171,0,171
"آذربایجان_شرقی","سراب","مرکزی",88,101,0,0,10,111,0,111
"آذربایجان_شرقی","سراب","مرکزی",89,86,0,0,35,121,0,121
"آذربایجان_شرقی","سراب","مرکزی",90,445,3,0,29,477,4,481
"آذربایجان_شرقی","سراب","مرکزی",91,435,0,0,34,469,3,472
"آذربایجان_شرقی","سراب","مرکزی",92,225,2,1,27,255,1,256
"آذربایجان_شرقی","سراب","مرکزی",93,627,6,5,198,836,8,844
"آذربایجان_شرقی","سراب","مرکزی",94,284,2,2,43,331,3,334
"آذربایجان_شرقی","سراب","مرکزی",95,279,0,0,19,298,2,300
"آذربایجان_شرقی","سراب","مرکزی",96,95,0,0,17,112,1,113
"آذربایجان_شرقی","سراب","مرکزی",97,150,3,0,50,203,1,204
"آذربایجان_شرقی","سراب","مرکزی",98,69,1,0,38,108,0,108
"آذربایجان_شرقی","سراب","مرکزی",99,180,0,2,24,206,2,208
"آذربایجان_شرقی","سراب","مرکزی",100,80,0,0,34,114,1,115
"آذربایجان_شرقی","سراب","مرکزی",101,89,0,1,21,111,3,114
"آذربایجان_شرقی","سراب","مرکزی",102,161,0,0,24,185,0,185
"آذربایجان_شرقی","سراب","مرکزی",103,258,0,0,42,300,0,300
"آذربایجان_شرقی","سراب","مرکزی",104,317,0,0,23,340,0,340
"آذربایجان_شرقی","سراب","مرکزی",105,120,0,0,16,136,0,136
"آذربایجان_شرقی","سراب","مرکزی",106,175,0,0,30,205,0,205
"آذربایجان_شرقی","سراب","مرکزی",107,316,0,0,22,338,4,342
"آذربایجان_شرقی","سراب","مرکزی",108,582,1,1,27,611,2,613
"آذربایجان_شرقی","سراب","مرکزی",109,229,0,0,44,273,3,276
"آذربایجان_شرقی","سراب","مرکزی",110,424,5,1,59,489,4,493
"آذربایجان_شرقی","سراب","مرکزی",111,489,3,0,31,523,1,524
"آذربایجان_شرقی","سراب","مرکزی",112,406,1,1,85,493,7,500
"آذربایجان_شرقی","سراب","مرکزی",113,74,2,0,33,109,0,109
"آذربایجان_شرقی","سراب","مرکزی",114,53,0,0,42,95,0,95
"آذربایجان_شرقی","سراب","مرکزی",115,68,1,0,52,121,0,121
"آذربایجان_شرقی","سراب","مهربان",1,360,1,3,269,633,6,639
"آذربایجان_شرقی","سراب","مهربان",2,338,0,2,254,594,7,601
"آذربایجان_شرقی","سراب","مهربان",3,211,2,3,264,480,7,487
"آذربایجان_شرقی","سراب","مهربان",4,500,6,7,230,743,1,744
"آذربایجان_شرقی","سراب","مهربان",5,232,1,1,223,457,1,458
"آذربایجان_شرقی","سراب","مهربان",6,253,3,0,180,436,5,441
"آذربایجان_شرقی","سراب","مهربان",7,304,2,1,32,339,15,354
"آذربایجان_شرقی","سراب","مهربان",8,567,0,1,32,600,0,600
"آذربایجان_شرقی","سراب","مهربان",9,395,6,5,120,526,1,527
"آذربایجان_شرقی","سراب","مهربان",10,562,1,2,87,652,1,653
"آذربایجان_شرقی","سراب","مهربان",11,346,3,3,40,392,4,396
"آذربایجان_شرقی","سراب","مهربان",12,236,0,0,46,282,2,284
"آذربایجان_شرقی","سراب","مهربان",13,170,1,1,36,208,2,210
"آذربایجان_شرقی","سراب","مهربان",14,506,2,2,78,588,5,593
"آذربایجان_شرقی","سراب","مهربان",15,416,6,2,149,573,6,579
"آذربایجان_شرقی","سراب","مهربان",16,137,0,0,35,172,0,172
"آذربایجان_شرقی","سراب","مهربان",17,378,1,3,118,500,3,503
"آذربایجان_شرقی","سراب","مهربان",18,208,0,0,45,253,0,253
"آذربایجان_شرقی","سراب","مهربان",19,270,1,0,24,295,0,295
"آذربایجان_شرقی","سراب","مهربان",20,304,0,0,83,387,2,389
"آذربایجان_شرقی","سراب","مهربان",21,75,0,0,12,87,1,88
"آذربایجان_شرقی","سراب","مهربان",22,123,1,0,36,160,1,161
"آذربایجان_شرقی","سراب","مهربان",23,182,0,1,37,220,1,221
"آذربایجان_شرقی","سراب","مهربان",24,622,10,4,178,814,4,818
"آذربایجان_شرقی","سراب","مهربان",25,943,17,4,408,1372,7,1379
"آذربایجان_شرقی","سراب","مهربان",26,397,5,2,214,618,2,620
"آذربایجان_شرقی","سراب","مهربان",27,522,5,2,362,891,6,897
"آذربایجان_شرقی","سراب","مهربان",28,592,6,0,196,794,3,797
"آذربایجان_شرقی","سراب","مهربان",29,565,4,1,81,651,0,651
"آذربایجان_شرقی","سراب","مهربان",30,647,3,0,49,699,1,700
"آذربایجان_شرقی","سراب","مهربان",31,243,0,1,19,263,1,264
"آذربایجان_شرقی","سراب","مهربان",32,124,1,1,26,152,0,152
"آذربایجان_شرقی","سراب","مهربان",33,348,1,0,61,410,5,415
"آذربایجان_شرقی","سراب","مهربان",34,64,0,0,53,117,0,117
"آذربایجان_شرقی","شبستر","مرکزی",1,505,13,2,1091,1611,5,1616
"آذربایجان_شرقی","شبستر","مرکزی",2,379,11,0,857,1247,14,1261
"آذربایجان_شرقی","شبستر","مرکزی",3,461,7,6,836,1310,5,1315
"آذربایجان_شرقی","شبستر","مرکزی",4,593,17,6,1209,1825,19,1844
"آذربایجان_شرقی","شبستر","مرکزی",5,393,9,4,583,989,10,999
"آذربایجان_شرقی","شبستر","مرکزی",6,457,9,1,617,1084,6,1090
"آذربایجان_شرقی","شبستر","مرکزی",7,191,5,3,317,516,3,519
"آذربایجان_شرقی","شبستر","مرکزی",8,309,6,1,521,837,7,844
"آذربایجان_شرقی","شبستر","مرکزی",9,470,8,20,958,1456,26,1482
"آذربایجان_شرقی","شبستر","مرکزی",10,242,3,3,632,880,10,890
"آذربایجان_شرقی","شبستر","مرکزی",11,79,0,0,1071,1150,2,1152
"آذربایجان_شرقی","شبستر","مرکزی",12,92,5,0,796,893,4,897
"آذربایجان_شرقی","شبستر","مرکزی",13,302,3,2,1117,1424,4,1428
"آذربایجان_شرقی","شبستر","مرکزی",14,245,3,0,543,791,1,792
"آذربایجان_شرقی","شبستر","مرکزی",15,244,3,1,699,947,5,952
"آذربایجان_شرقی","شبستر","مرکزی",16,201,3,0,477,681,4,685
"آذربایجان_شرقی","شبستر","مرکزی",17,106,2,0,600,708,2,710
"آذربایجان_شرقی","شبستر","مرکزی",18,153,2,2,564,721,2,723
"آذربایجان_شرقی","شبستر","مرکزی",19,158,5,2,500,665,8,673
"آذربایجان_شرقی","شبستر","مرکزی",20,200,1,0,445,646,3,649
"آذربایجان_شرقی","شبستر","مرکزی",21,177,2,1,677,857,9,866
"آذربایجان_شرقی","شبستر","مرکزی",22,392,6,1,431,830,3,833
"آذربایجان_شرقی","شبستر","مرکزی",23,538,6,4,543,1091,16,1107
"آذربایجان_شرقی","شبستر","مرکزی",24,495,5,1,324,825,12,837
"آذربایجان_شرقی","شبستر","مرکزی",25,546,3,3,288,840,3,843
"آذربایجان_شرقی","شبستر","مرکزی",26,663,2,3,592,1260,21,1281
"آذربایجان_شرقی","شبستر","مرکزی",27,705,8,2,492,1207,11,1218
"آذربایجان_شرقی","شبستر","مرکزی",28,902,3,1,398,1304,3,1307
"آذربایجان_شرقی","شبستر","مرکزی",29,275,0,0,106,381,0,381
"آذربایجان_شرقی","شبستر","مرکزی",30,126,1,0,157,284,0,284
"آذربایجان_شرقی","شبستر","مرکزی",31,314,1,0,553,868,4,872
"آذربایجان_شرقی","شبستر","مرکزی",32,220,0,0,261,481,2,483
"آذربایجان_شرقی","شبستر","مرکزی",33,325,5,1,672,1003,4,1007
"آذربایجان_شرقی","شبستر","مرکزی",34,191,4,0,220,415,4,419
"آذربایجان_شرقی","شبستر","مرکزی",35,165,5,0,230,400,3,403
"آذربایجان_شرقی","شبستر","مرکزی",36,269,5,0,570,844,5,849
"آذربایجان_شرقی","شبستر","مرکزی",37,182,4,2,226,414,4,418
"آذربایجان_شرقی","شبستر","مرکزی",38,243,4,0,302,549,2,551
"آذربایجان_شرقی","شبستر","مرکزی",39,186,1,0,328,515,3,518
"آذربایجان_شرقی","شبستر","مرکزی",40,288,5,0,187,480,2,482
"آذربایجان_شرقی","شبستر","مرکزی",41,294,4,0,331,629,3,632
"آذربایجان_شرقی","شبستر","مرکزی",42,470,1,1,223,695,3,698
"آذربایجان_شرقی","شبستر","مرکزی",43,236,4,1,366,607,4,611
"آذربایجان_شرقی","شبستر","مرکزی",44,317,1,1,80,399,2,401
"آذربایجان_شرقی","شبستر","مرکزی",45,352,2,1,387,742,2,744
"آذربایجان_شرقی","شبستر","مرکزی",46,523,3,0,305,831,1,832
"آذربایجان_شرقی","شبستر","مرکزی",47,230,2,1,407,640,5,645
"آذربایجان_شرقی","شبستر","مرکزی",48,674,10,2,209,895,1,896
"آذربایجان_شرقی","شبستر","مرکزی",49,413,2,0,252,667,1,668
"آذربایجان_شرقی","شبستر","مرکزی",50,232,1,0,210,443,3,446
"آذربایجان_شرقی","شبستر","مرکزی",51,196,1,2,69,268,0,268
"آذربایجان_شرقی","شبستر","تسوج",1,309,7,2,634,952,11,963
"آذربایجان_شرقی","شبستر","تسوج",2,292,7,0,429,728,3,731
"آذربایجان_شرقی","شبستر","تسوج",3,293,6,0,351,650,9,659
"آذربایجان_شرقی","شبستر","تسوج",4,282,8,1,738,1029,11,1040
"آذربایجان_شرقی","شبستر","تسوج",5,296,6,0,361,663,6,669
"آذربایجان_شرقی","شبستر","تسوج",6,441,3,0,344,788,7,795
"آذربایجان_شرقی","شبستر","تسوج",7,395,1,2,257,655,9,664
"آذربایجان_شرقی","شبستر","تسوج",8,155,2,0,168,325,0,325
"آذربایجان_شرقی","شبستر","تسوج",9,311,2,0,440,753,0,753
"آذربایجان_شرقی","شبستر","تسوج",10,599,2,0,333,934,6,940
"آذربایجان_شرقی","شبستر","تسوج",11,356,6,0,218,580,0,580
"آذربایجان_شرقی","شبستر","تسوج",12,418,0,0,83,501,3,504
"آذربایجان_شرقی","شبستر","تسوج",13,474,1,0,197,672,5,677
"آذربایجان_شرقی","شبستر","تسوج",14,379,8,1,228,616,5,621
"آذربایجان_شرقی","شبستر","تسوج",15,181,0,0,100,281,2,283
"آذربایجان_شرقی","شبستر","تسوج",16,281,2,0,89,372,0,372
"آذربایجان_شرقی","شبستر","تسوج",17,384,0,0,93,477,6,483
"آذربایجان_شرقی","شبستر","تسوج",18,313,1,0,79,393,2,395
"آذربایجان_شرقی","شبستر","تسوج",19,109,4,0,208,321,0,321
"آذربایجان_شرقی","شبستر","تسوج",20,287,0,0,111,398,2,400
"آذربایجان_شرقی","شبستر","تسوج",21,333,1,0,80,414,0,414
"آذربایجان_شرقی","شبستر","صوفیان",1,691,16,6,1061,1774,75,1849
"آذربایجان_شرقی","شبستر","صوفیان",2,575,8,3,1004,1590,32,1622
"آذربایجان_شرقی","شبستر","صوفیان",3,482,11,2,768,1263,14,1277
"آذربایجان_شرقی","شبستر","صوفیان",4,500,8,3,757,1268,30,1298
"آذربایجان_شرقی","شبستر","صوفیان",5,612,4,4,467,1087,23,1110
"آذربایجان_شرقی","شبستر","صوفیان",6,351,0,1,216,568,1,569
"آذربایجان_شرقی","شبستر","صوفیان",7,267,0,0,49,316,0,316
"آذربایجان_شرقی","شبستر","صوفیان",8,74,2,0,109,185,3,188
"آذربایجان_شرقی","شبستر","صوفیان",9,335,4,0,174,513,2,515
"آذربایجان_شرقی","شبستر","صوفیان",10,361,2,0,122,485,2,487
"آذربایجان_شرقی","شبستر","صوفیان",11,342,2,0,146,490,2,492
"آذربایجان_شرقی","شبستر","صوفیان",12,304,1,0,96,401,4,405
"آذربایجان_شرقی","شبستر","صوفیان",13,287,1,0,169,457,3,460
"آذربایجان_شرقی","شبستر","صوفیان",14,639,5,7,477,1128,11,1139
"آذربایجان_شرقی","شبستر","صوفیان",15,605,2,2,247,856,7,863
"آذربایجان_شرقی","شبستر","صوفیان",16,911,8,3,315,1237,33,1270
"آذربایجان_شرقی","شبستر","صوفیان",17,767,3,1,123,894,7,901
"آذربایجان_شرقی","شبستر","صوفیان",18,537,2,0,140,679,15,694
"آذربایجان_شرقی","شبستر","صوفیان",19,203,0,0,48,251,5,256
"آذربایجان_شرقی","شبستر","صوفیان",20,658,1,0,104,763,1,764
"آذربایجان_شرقی","شبستر","صوفیان",21,318,2,1,248,569,0,569
"آذربایجان_شرقی","شبستر","صوفیان",22,328,0,0,68,396,1,397
"آذربایجان_شرقی","شبستر","صوفیان",23,215,1,1,90,307,0,307
"آذربایجان_شرقی","شبستر","صوفیان",24,361,5,2,149,517,4,521
"آذربایجان_شرقی","شبستر","صوفیان",25,258,5,2,246,511,7,518
"آذربایجان_شرقی","شبستر","صوفیان",26,242,2,1,505,750,2,752
"آذربایجان_شرقی","شبستر","صوفیان",27,256,0,0,139,395,2,397
"آذربایجان_شرقی","شبستر","صوفیان",28,273,2,0,406,681,2,683
"آذربایجان_شرقی","شبستر","صوفیان",29,157,3,0,59,219,2,221
"آذربایجان_شرقی","شبستر","صوفیان",30,298,0,0,32,330,0,330
"آذربایجان_شرقی","شبستر","صوفیان",31,229,0,0,25,254,0,254
"آذربایجان_شرقی","شبستر","صوفیان",32,103,4,0,71,178,2,180
"آذربایجان_شرقی","شبستر","صوفیان",33,391,0,0,75,466,0,466
"آذربایجان_شرقی","شبستر","صوفیان",34,294,1,0,21,316,4,320
"آذربایجان_شرقی","شبستر","صوفیان",35,68,3,0,86,157,2,159
"آذربایجان_شرقی","عجب_شیر","مرکزی",1,386,9,0,249,644,7,651
"آذربایجان_شرقی","عجب_شیر","مرکزی",2,415,7,0,198,620,9,629
"آذربایجان_شرقی","عجب_شیر","مرکزی",3,703,9,3,627,1342,15,1357
"آذربایجان_شرقی","عجب_شیر","مرکزی",4,290,3,4,302,599,8,607
"آذربایجان_شرقی","عجب_شیر","مرکزی",5,302,1,1,201,505,1,506
"آذربایجان_شرقی","عجب_شیر","مرکزی",6,316,0,3,225,544,8,552
"آذربایجان_شرقی","عجب_شیر","مرکزی",7,544,3,5,411,963,12,975
"آذربایجان_شرقی","عجب_شیر","مرکزی",8,608,9,10,371,998,8,1006
"آذربایجان_شرقی","عجب_شیر","مرکزی",9,595,4,3,574,1176,19,1195
"آذربایجان_شرقی","عجب_شیر","مرکزی",10,580,1,2,280,863,9,872
"آذربایجان_شرقی","عجب_شیر","مرکزی",11,592,7,4,361,964,12,976
"آذربایجان_شرقی","عجب_شیر","مرکزی",12,596,5,6,285,892,15,907
"آذربایجان_شرقی","عجب_شیر","مرکزی",13,258,4,1,257,520,1,521
"آذربایجان_شرقی","عجب_شیر","مرکزی",14,471,1,2,333,807,7,814
"آذربایجان_شرقی","عجب_شیر","مرکزی",15,1081,9,3,480,1573,10,1583
"آذربایجان_شرقی","عجب_شیر","مرکزی",16,199,4,2,90,295,2,297
"آذربایجان_شرقی","عجب_شیر","مرکزی",17,636,4,2,381,1023,22,1045
"آذربایجان_شرقی","عجب_شیر","مرکزی",18,654,9,4,410,1077,10,1087
"آذربایجان_شرقی","عجب_شیر","مرکزی",19,234,1,1,200,436,0,436
"آذربایجان_شرقی","عجب_شیر","مرکزی",20,106,0,0,60,166,4,170
"آذربایجان_شرقی","عجب_شیر","مرکزی",21,133,2,0,96,231,1,232
"آذربایجان_شرقی","عجب_شیر","مرکزی",22,631,23,24,629,1307,62,1369
"آذربایجان_شرقی","عجب_شیر","مرکزی",23,375,13,15,428,831,27,858
"آذربایجان_شرقی","عجب_شیر","مرکزی",24,463,31,38,434,966,27,993
"آذربایجان_شرقی","عجب_شیر","مرکزی",25,124,0,0,90,214,1,215
"آذربایجان_شرقی","عجب_شیر","مرکزی",26,502,2,2,144,650,3,653
"آذربایجان_شرقی","عجب_شیر","مرکزی",27,634,2,1,201,838,8,846
"آذربایجان_شرقی","عجب_شیر","مرکزی",28,779,4,2,203,988,1,989
"آذربایجان_شرقی","عجب_شیر","مرکزی",29,448,3,0,50,501,4,505
"آذربایجان_شرقی","عجب_شیر","مرکزی",30,219,3,3,112,337,1,338
"آذربایجان_شرقی","عجب_شیر","مرکزی",31,521,1,0,85,607,5,612
"آذربایجان_شرقی","عجب_شیر","مرکزی",32,491,3,0,48,542,2,544
"آذربایجان_شرقی","عجب_شیر","مرکزی",33,502,1,1,102,606,0,606
"آذربایجان_شرقی","عجب_شیر","مرکزی",34,227,1,2,91,321,4,325
"آذربایجان_شرقی","عجب_شیر","مرکزی",35,585,4,0,151,740,0,740
"آذربایجان_شرقی","عجب_شیر","مرکزی",36,514,3,0,139,656,5,661
"آذربایجان_شرقی","عجب_شیر","مرکزی",37,614,5,3,134,756,8,764
"آذربایجان_شرقی","عجب_شیر","مرکزی",38,578,2,0,209,789,2,791
"آذربایجان_شرقی","عجب_شیر","مرکزی",39,251,3,4,152,410,4,414
"آذربایجان_شرقی","عجب_شیر","مرکزی",40,512,1,1,160,674,2,676
"آذربایجان_شرقی","عجب_شیر","مرکزی",41,651,1,1,196,849,6,855
"آذربایجان_شرقی","عجب_شیر","مرکزی",42,393,10,0,59,462,1,463
"آذربایجان_شرقی","عجب_شیر","مرکزی",43,313,0,0,36,349,1,350
"آذربایجان_شرقی","عجب_شیر","مرکزی",44,254,0,0,134,388,0,388
"آذربایجان_شرقی","عجب_شیر","مرکزی",45,139,0,1,42,182,2,184
"آذربایجان_شرقی","عجب_شیر","مرکزی",46,172,0,0,49,221,1,222
"آذربایجان_شرقی","عجب_شیر","مرکزی",47,172,2,1,62,237,1,238
"آذربایجان_شرقی","عجب_شیر","مرکزی",48,130,0,0,80,210,2,212
"آذربایجان_شرقی","عجب_شیر","قلعه_چای",1,232,1,0,65,298,0,298
"آذربایجان_شرقی","عجب_شیر","قلعه_چای",2,204,1,1,73,279,2,281
"آذربایجان_شرقی","عجب_شیر","قلعه_چای",3,205,0,0,60,265,0,265
"آذربایجان_شرقی","عجب_شیر","قلعه_چای",4,328,1,0,107,436,2,438
"آذربایجان_شرقی","عجب_شیر","قلعه_چای",5,193,0,0,82,275,0,275
"آذربایجان_شرقی","عجب_شیر","قلعه_چای",6,213,1,0,37,251,0,251
"آذربایجان_شرقی","عجب_شیر","قلعه_چای",7,178,0,0,45,223,2,225
"آذربایجان_شرقی","عجب_شیر","قلعه_چای",8,151,1,1,58,211,2,213
"آذربایجان_شرقی","عجب_شیر","قلعه_چای",9,92,2,0,36,130,0,130
"آذربایجان_شرقی","عجب_شیر","قلعه_چای",10,249,0,2,40,291,1,292
"آذربایجان_شرقی","عجب_شیر","قلعه_چای",11,248,0,1,125,374,4,378
"آذربایجان_شرقی","عجب_شیر","قلعه_چای",12,291,0,0,37,328,1,329
"آذربایجان_شرقی","عجب_شیر","قلعه_چای",13,484,5,6,131,626,6,632
"آذربایجان_شرقی","عجب_شیر","قلعه_چای",14,611,0,0,100,711,1,712
"آذربایجان_شرقی","عجب_شیر","قلعه_چای",15,494,3,1,96,594,2,596
"آذربایجان_شرقی","عجب_شیر","قلعه_چای",16,426,2,0,97,525,2,527
"آذربایجان_شرقی","عجب_شیر","قلعه_چای",17,358,1,4,75,438,2,440
"آذربایجان_شرقی","عجب_شیر","قلعه_چای",18,416,3,1,77,497,2,499
"آذربایجان_شرقی","عجب_شیر","قلعه_چای",19,323,0,0,45,368,0,368
"آذربایجان_شرقی","عجب_شیر","قلعه_چای",20,552,3,1,141,697,2,699
"آذربایجان_شرقی","عجب_شیر","قلعه_چای",21,382,2,0,56,440,0,440
"آذربایجان_شرقی","عجب_شیر","قلعه_چای",22,294,0,0,48,342,0,342
"آذربایجان_شرقی","عجب_شیر","قلعه_چای",23,421,0,0,6,427,2,429
"آذربایجان_شرقی","عجب_شیر","قلعه_چای",24,517,1,1,142,661,0,661
"آذربایجان_شرقی","کلیبر","مرکزی",1,277,5,6,534,822,8,830
"آذربایجان_شرقی","کلیبر","مرکزی",2,104,0,2,104,210,1,211
"آذربایجان_شرقی","کلیبر","مرکزی",3,255,9,6,669,939,7,946
"آذربایجان_شرقی","کلیبر","مرکزی",4,95,1,0,140,236,1,237
"آذربایجان_شرقی","کلیبر","مرکزی",5,126,1,0,112,239,0,239
"آذربایجان_شرقی","کلیبر","مرکزی",6,172,2,2,190,366,6,372
"آذربایجان_شرقی","کلیبر","مرکزی",7,114,6,2,221,343,2,345
"آذربایجان_شرقی","کلیبر","مرکزی",8,145,4,0,241,390,6,396
"آذربایجان_شرقی","کلیبر","مرکزی",9,216,1,2,168,387,3,390
"آذربایجان_شرقی","کلیبر","مرکزی",10,285,5,2,445,737,2,739
"آذربایجان_شرقی","کلیبر","مرکزی",11,142,1,0,107,250,3,253
"آذربایجان_شرقی","کلیبر","مرکزی",12,185,12,0,337,534,0,534
"آذربایجان_شرقی","کلیبر","مرکزی",13,136,2,0,162,300,0,300
"آذربایجان_شرقی","کلیبر","مرکزی",14,59,5,1,79,144,1,145
"آذربایجان_شرقی","کلیبر","مرکزی",15,83,0,0,69,152,0,152
"آذربایجان_شرقی","کلیبر","مرکزی",16,361,0,0,121,482,3,485
"آذربایجان_شرقی","کلیبر","مرکزی",17,265,1,0,101,367,0,367
"آذربایجان_شرقی","کلیبر","مرکزی",18,183,1,0,81,265,1,266
"آذربایجان_شرقی","کلیبر","مرکزی",19,181,0,0,18,199,0,199
"آذربایجان_شرقی","کلیبر","مرکزی",20,77,0,0,37,114,0,114
"آذربایجان_شرقی","کلیبر","مرکزی",21,154,1,0,29,184,4,188
"آذربایجان_شرقی","کلیبر","مرکزی",22,348,1,3,119,471,0,471
"آذربایجان_شرقی","کلیبر","مرکزی",23,195,1,2,117,315,0,315
"آذربایجان_شرقی","کلیبر","مرکزی",24,103,0,0,14,117,0,117
"آذربایجان_شرقی","کلیبر","مرکزی",25,184,0,0,93,277,0,277
"آذربایجان_شرقی","کلیبر","مرکزی",26,135,1,12,59,207,0,207
"آذربایجان_شرقی","کلیبر","مرکزی",27,165,0,0,63,228,1,229
"آذربایجان_شرقی","کلیبر","مرکزی",28,343,0,0,104,447,1,448
"آذربایجان_شرقی","کلیبر","مرکزی",29,197,0,12,67,276,0,276
"آذربایجان_شرقی","کلیبر","مرکزی",30,300,0,6,78,384,3,387
"آذربایجان_شرقی","کلیبر","مرکزی",31,257,0,0,32,289,1,290
"آذربایجان_شرقی","کلیبر","مرکزی",32,350,1,0,114,465,1,466
"آذربایجان_شرقی","کلیبر","مرکزی",33,72,2,0,33,107,0,107
"آذربایجان_شرقی","کلیبر","مرکزی",34,75,0,1,66,142,0,142
"آذربایجان_شرقی","کلیبر","مرکزی",35,362,2,0,161,525,0,525
"آذربایجان_شرقی","کلیبر","مرکزی",36,89,2,1,149,241,3,244
"آذربایجان_شرقی","کلیبر","مرکزی",37,125,0,2,178,305,4,309
"آذربایجان_شرقی","کلیبر","مرکزی",38,89,1,0,44,134,0,134
"آذربایجان_شرقی","کلیبر","مرکزی",39,109,1,1,312,423,0,423
"آذربایجان_شرقی","کلیبر","مرکزی",40,92,0,0,111,203,0,203
"آذربایجان_شرقی","کلیبر","مرکزی",41,207,1,0,215,423,0,423
"آذربایجان_شرقی","کلیبر","مرکزی",42,279,0,1,152,432,0,432
"آذربایجان_شرقی","کلیبر","مرکزی",43,212,1,5,53,271,0,271
"آذربایجان_شرقی","کلیبر","مرکزی",44,281,0,0,74,355,0,355
"آذربایجان_شرقی","کلیبر","مرکزی",45,325,0,0,28,353,0,353
"آذربایجان_شرقی","کلیبر","مرکزی",46,50,0,0,64,114,0,114
"آذربایجان_شرقی","کلیبر","مرکزی",47,194,2,0,235,431,2,433
"آذربایجان_شرقی","کلیبر","مرکزی",48,107,0,0,35,142,0,142
"آذربایجان_شرقی","کلیبر","مرکزی",49,18,1,0,47,66,0,66
"آذربایجان_شرقی","کلیبر","مرکزی",50,90,0,0,143,233,0,233
"آذربایجان_شرقی","کلیبر","مرکزی",51,154,0,0,84,238,0,238
"آذربایجان_شرقی","کلیبر","مرکزی",52,42,1,0,44,87,1,88
"آذربایجان_شرقی","کلیبر","مرکزی",53,100,0,0,41,141,0,141
"آذربایجان_شرقی","کلیبر","خداآفرین",1,130,4,1,274,409,4,413
"آذربایجان_شرقی","کلیبر","خداآفرین",2,154,7,0,238,399,3,402
"آذربایجان_شرقی","کلیبر","خداآفرین",3,211,1,0,288,500,1,501
"آذربایجان_شرقی","کلیبر","خداآفرین",4,214,4,0,303,521,4,525
"آذربایجان_شرقی","کلیبر","خداآفرین",5,155,1,1,143,300,0,300
"آذربایجان_شرقی","کلیبر","خداآفرین",6,157,3,2,302,464,0,464
"آذربایجان_شرقی","کلیبر","خداآفرین",7,112,1,0,198,311,0,311
"آذربایجان_شرقی","کلیبر","خداآفرین",8,176,0,1,180,357,3,360
"آذربایجان_شرقی","کلیبر","خداآفرین",9,320,1,0,409,730,0,730
"آذربایجان_شرقی","کلیبر","خداآفرین",10,90,0,0,65,155,0,155
"آذربایجان_شرقی","کلیبر","خداآفرین",11,234,0,0,137,371,0,371
"آذربایجان_شرقی","کلیبر","خداآفرین",12,32,0,0,142,174,0,174
"آذربایجان_شرقی","کلیبر","خداآفرین",13,208,1,1,96,306,0,306
"آذربایجان_شرقی","کلیبر","خداآفرین",14,134,1,5,141,281,2,283
"آذربایجان_شرقی","کلیبر","خداآفرین",15,50,1,163,161,375,5,380
"آذربایجان_شرقی","کلیبر","خداآفرین",16,180,0,164,141,485,0,485
"آذربایجان_شرقی","کلیبر","خداآفرین",17,243,4,1,239,487,0,487
"آذربایجان_شرقی","کلیبر","خداآفرین",18,112,1,0,139,252,0,252
"آذربایجان_شرقی","کلیبر","خداآفرین",19,237,0,0,76,313,0,313
"آذربایجان_شرقی","کلیبر","خداآفرین",20,100,0,0,300,400,3,403
"آذربایجان_شرقی","کلیبر","خداآفرین",21,89,0,46,136,271,0,271
"آذربایجان_شرقی","کلیبر","خداآفرین",22,54,0,0,166,220,0,220
"آذربایجان_شرقی","کلیبر","خداآفرین",23,145,2,0,421,568,0,568
"آذربایجان_شرقی","کلیبر","خداآفرین",24,88,0,0,134,222,0,222
"آذربایجان_شرقی","کلیبر","خداآفرین",25,160,0,0,227,387,3,390
"آذربایجان_شرقی","کلیبر","خداآفرین",26,195,3,1,161,360,0,360
"آذربایجان_شرقی","کلیبر","خداآفرین",27,28,0,0,83,111,0,111
"آذربایجان_شرقی","کلیبر","خداآفرین",28,156,0,0,52,208,0,208
"آذربایجان_شرقی","کلیبر","خداآفرین",29,138,0,15,125,278,0,278
"آذربایجان_شرقی","کلیبر","خداآفرین",30,75,0,0,90,165,0,165
"آذربایجان_شرقی","کلیبر","خداآفرین",31,87,0,0,20,107,0,107
"آذربایجان_شرقی","کلیبر","خداآفرین",32,166,0,1,281,448,0,448
"آذربایجان_شرقی","کلیبر","خداآفرین",33,72,2,0,173,247,2,249
"آذربایجان_شرقی","کلیبر","خداآفرین",34,87,0,0,443,530,3,533
"آذربایجان_شرقی","کلیبر","خداآفرین",35,142,1,10,232,385,0,385
"آذربایجان_شرقی","کلیبر","خداآفرین",36,79,0,0,228,307,0,307
"آذربایجان_شرقی","کلیبر","خداآفرین",37,141,0,1,136,278,0,278
"آذربایجان_شرقی","کلیبر","خداآفرین",38,181,0,0,219,400,3,403
"آذربایجان_شرقی","کلیبر","خداآفرین",39,157,1,1,186,345,1,346
"آذربایجان_شرقی","کلیبر","خداآفرین",40,203,2,0,301,506,0,506
"آذربایجان_شرقی","کلیبر","خداآفرین",41,104,1,0,115,220,4,224
"آذربایجان_شرقی","کلیبر","خداآفرین",42,185,1,1,258,445,0,445
"آذربایجان_شرقی","کلیبر","خداآفرین",43,247,1,0,269,517,2,519
"آذربایجان_شرقی","کلیبر","خداآفرین",44,135,0,2,360,497,2,499
"آذربایجان_شرقی","کلیبر","خداآفرین",45,37,1,0,16,54,0,54
"آذربایجان_شرقی","کلیبر","خداآفرین",46,26,0,0,15,41,1,42
"آذربایجان_شرقی","کلیبر","خداآفرین",47,106,0,2,90,198,0,198
"آذربایجان_شرقی","کلیبر","خداآفرین",48,219,3,0,118,340,0,340
"آذربایجان_شرقی","کلیبر","خداآفرین",49,301,2,0,286,589,1,590
"آذربایجان_شرقی","کلیبر","خداآفرین",50,88,1,0,284,373,0,373
"آذربایجان_شرقی","کلیبر","آبش_احمد",1,97,3,5,183,288,1,289
"آذربایجان_شرقی","کلیبر","آبش_احمد",2,146,5,7,190,348,1,349
"آذربایجان_شرقی","کلیبر","آبش_احمد",3,229,4,4,370,607,0,607
"آذربایجان_شرقی","کلیبر","آبش_احمد",4,204,4,0,359,567,2,569
"آذربایجان_شرقی","کلیبر","آبش_احمد",5,203,5,0,411,619,0,619
"آذربایجان_شرقی","کلیبر","آبش_احمد",6,184,1,6,265,456,2,458
"آذربایجان_شرقی","کلیبر","آبش_احمد",7,262,4,1,314,581,4,585
"آذربایجان_شرقی","کلیبر","آبش_احمد",8,224,1,2,146,373,9,382
"آذربایجان_شرقی","کلیبر","آبش_احمد",9,140,0,3,87,230,0,230
"آذربایجان_شرقی","کلیبر","آبش_احمد",10,126,0,0,107,233,0,233
"آذربایجان_شرقی","کلیبر","آبش_احمد",11,184,1,1,86,272,0,272
"آذربایجان_شرقی","کلیبر","آبش_احمد",12,156,0,1,176,333,0,333
"آذربایجان_شرقی","کلیبر","آبش_احمد",13,20,0,0,15,35,0,35
"آذربایجان_شرقی","کلیبر","آبش_احمد",14,5,0,0,11,16,0,16
"آذربایجان_شرقی","کلیبر","آبش_احمد",15,285,6,1,201,493,1,494
"آذربایجان_شرقی","کلیبر","آبش_احمد",16,80,0,0,38,118,1,119
"آذربایجان_شرقی","کلیبر","آبش_احمد",17,15,0,0,9,24,1,25
"آذربایجان_شرقی","کلیبر","آبش_احمد",18,8,0,0,6,14,2,16
"آذربایجان_شرقی","کلیبر","آبش_احمد",19,53,0,0,33,86,0,86
"آذربایجان_شرقی","کلیبر","آبش_احمد",20,31,0,0,24,55,0,55
"آذربایجان_شرقی","کلیبر","آبش_احمد",21,13,0,3,135,151,1,152
"آذربایجان_شرقی","کلیبر","آبش_احمد",22,123,0,1,208,332,0,332
"آذربایجان_شرقی","کلیبر","آبش_احمد",23,106,1,0,172,279,0,279
"آذربایجان_شرقی","کلیبر","آبش_احمد",24,137,1,0,96,234,0,234
"آذربایجان_شرقی","کلیبر","آبش_احمد",25,313,6,0,173,492,0,492
"آذربایجان_شرقی","کلیبر","آبش_احمد",26,338,1,1,116,456,0,456
"آذربایجان_شرقی","کلیبر","آبش_احمد",27,118,5,5,147,275,4,279
"آذربایجان_شرقی","کلیبر","آبش_احمد",28,183,0,0,85,268,0,268
"آذربایجان_شرقی","کلیبر","آبش_احمد",29,505,19,2,299,825,0,825
"آذربایجان_شرقی","کلیبر","آبش_احمد",30,273,4,2,104,383,0,383
"آذربایجان_شرقی","کلیبر","آبش_احمد",31,288,0,0,187,475,0,475
"آذربایجان_شرقی","کلیبر","آبش_احمد",32,101,0,0,105,206,0,206
"آذربایجان_شرقی","مراغه","مرکزی",1,671,16,10,665,1362,16,1378
"آذربایجان_شرقی","مراغه","مرکزی",2,247,1,3,412,663,14,677
"آذربایجان_شرقی","مراغه","مرکزی",3,380,7,1,271,659,2,661
"آذربایجان_شرقی","مراغه","مرکزی",4,425,9,2,359,795,11,806
"آذربایجان_شرقی","مراغه","مرکزی",5,579,17,8,540,1144,9,1153
"آذربایجان_شرقی","مراغه","مرکزی",6,511,11,6,767,1295,10,1305
"آذربایجان_شرقی","مراغه","مرکزی",7,475,6,3,506,990,10,1000
"آذربایجان_شرقی","مراغه","مرکزی",8,381,23,9,516,929,14,943
"آذربایجان_شرقی","مراغه","مرکزی",9,768,26,8,785,1587,10,1597
"آذربایجان_شرقی","مراغه","مرکزی",10,533,13,9,528,1083,14,1097
"آذربایجان_شرقی","مراغه","مرکزی",11,639,15,18,1042,1714,17,1731
"آذربایجان_شرقی","مراغه","مرکزی",12,760,19,2,628,1409,10,1419
"آذربایجان_شرقی","مراغه","مرکزی",13,751,15,8,703,1477,17,1494
"آذربایجان_شرقی","مراغه","مرکزی",14,582,15,7,686,1290,10,1300
"آذربایجان_شرقی","مراغه","مرکزی",15,408,4,0,392,804,8,812
"آذربایجان_شرقی","مراغه","مرکزی",16,563,7,4,464,1038,15,1053
"آذربایجان_شرقی","مراغه","مرکزی",17,161,1,2,129,293,2,295
"آذربایجان_شرقی","مراغه","مرکزی",18,386,11,4,319,720,8,728
"آذربایجان_شرقی","مراغه","مرکزی",19,296,5,3,298,602,10,612
"آذربایجان_شرقی","مراغه","مرکزی",20,617,4,1,341,963,12,975
"آذربایجان_شرقی","مراغه","مرکزی",21,305,4,0,255,564,6,570
"آذربایجان_شرقی","مراغه","مرکزی",22,936,17,5,608,1566,35,1601
"آذربایجان_شرقی","مراغه","مرکزی",23,660,28,4,636,1328,16,1344
"آذربایجان_شرقی","مراغه","مرکزی",24,97,4,1,103,205,3,208
"آذربایجان_شرقی","مراغه","مرکزی",25,783,23,11,506,1323,17,1340
"آذربایجان_شرقی","مراغه","مرکزی",26,425,15,8,446,894,17,911
"آذربایجان_شرقی","مراغه","مرکزی",27,729,12,5,453,1199,17,1216
"آذربایجان_شرقی","مراغه","مرکزی",28,691,20,4,755,1470,17,1487
"آذربایجان_شرقی","مراغه","مرکزی",29,672,18,4,476,1170,12,1182
"آذربایجان_شرقی","مراغه","مرکزی",30,767,7,2,412,1188,7,1195
"آذربایجان_شرقی","مراغه","مرکزی",31,458,4,3,487,952,5,957
"آذربایجان_شرقی","مراغه","مرکزی",32,609,4,2,388,1003,12,1015
"آذربایجان_شرقی","مراغه","مرکزی",33,781,19,11,560,1371,8,1379
"آذربایجان_شرقی","مراغه","مرکزی",34,462,6,6,404,878,19,897
"آذربایجان_شرقی","مراغه","مرکزی",35,536,25,13,1175,1749,13,1762
"آذربایجان_شرقی","مراغه","مرکزی",36,592,13,9,978,1592,15,1607
"آذربایجان_شرقی","مراغه","مرکزی",37,412,30,7,716,1165,10,1175
"آذربایجان_شرقی","مراغه","مرکزی",38,314,8,1,218,541,2,543
"آذربایجان_شرقی","مراغه","مرکزی",39,987,19,7,592,1605,16,1621
"آذربایجان_شرقی","مراغه","مرکزی",40,509,11,3,461,984,7,991
"آذربایجان_شرقی","مراغه","مرکزی",41,856,11,5,778,1650,19,1669
"آذربایجان_شرقی","مراغه","مرکزی",42,985,15,4,645,1649,6,1655
"آذربایجان_شرقی","مراغه","مرکزی",43,513,10,3,438,964,6,970
"آذربایجان_شرقی","مراغه","مرکزی",44,603,11,0,191,805,9,814
"آذربایجان_شرقی","مراغه","مرکزی",45,1105,21,0,888,2014,12,2026
"آذربایجان_شرقی","مراغه","مرکزی",46,747,13,0,527,1287,22,1309
"آذربایجان_شرقی","مراغه","مرکزی",47,681,23,0,509,1213,9,1222
"آذربایجان_شرقی","مراغه","مرکزی",48,491,6,2,426,925,9,934
"آذربایجان_شرقی","مراغه","مرکزی",49,490,18,0,543,1051,12,1063
"آذربایجان_شرقی","مراغه","مرکزی",50,168,8,0,212,388,8,396
"آذربایجان_شرقی","مراغه","مرکزی",51,140,3,0,124,267,2,269
"آذربایجان_شرقی","مراغه","مرکزی",52,964,16,3,442,1425,0,1425
"آذربایجان_شرقی","مراغه","مرکزی",53,855,5,3,449,1312,16,1328
"آذربایجان_شرقی","مراغه","مرکزی",54,956,11,2,552,1521,17,1538
"آذربایجان_شرقی","مراغه","مرکزی",55,901,19,11,514,1445,26,1471
"آذربایجان_شرقی","مراغه","مرکزی",56,524,2,1,296,823,12,835
"آذربایجان_شرقی","مراغه","مرکزی",57,401,8,1,231,641,3,644
"آذربایجان_شرقی","مراغه","مرکزی",58,842,10,11,365,1228,13,1241
"آذربایجان_شرقی","مراغه","مرکزی",59,719,15,3,440,1177,15,1192
"آذربایجان_شرقی","مراغه","مرکزی",60,465,1,1,182,649,3,652
"آذربایجان_شرقی","مراغه","مرکزی",61,581,9,3,466,1059,21,1080
"آذربایجان_شرقی","مراغه","مرکزی",62,483,5,1,181,670,5,675
"آذربایجان_شرقی","مراغه","مرکزی",63,745,6,4,315,1070,7,1077
"آذربایجان_شرقی","مراغه","مرکزی",64,967,14,1,324,1306,19,1325
"آذربایجان_شرقی","مراغه","مرکزی",65,769,6,4,274,1053,11,1064
"آذربایجان_شرقی","مراغه","مرکزی",66,517,7,1,187,712,10,722
"آذربایجان_شرقی","مراغه","مرکزی",67,988,12,3,371,1374,14,1388
"آذربایجان_شرقی","مراغه","مرکزی",68,872,13,2,467,1354,11,1365
"آذربایجان_شرقی","مراغه","مرکزی",69,431,3,4,170,608,1,609
"آذربایجان_شرقی","مراغه","مرکزی",70,508,0,0,114,622,5,627
"آذربایجان_شرقی","مراغه","مرکزی",71,912,5,1,320,1238,7,1245
"آذربایجان_شرقی","مراغه","مرکزی",72,976,2,2,303,1283,11,1294
"آذربایجان_شرقی","مراغه","مرکزی",73,1125,6,0,457,1588,11,1599
"آذربایجان_شرقی","مراغه","مرکزی",74,1125,11,5,336,1477,18,1495
"آذربایجان_شرقی","مراغه","مرکزی",75,1069,3,2,397,1471,8,1479
"آذربایجان_شرقی","مراغه","مرکزی",76,257,10,3,310,580,5,585
"آذربایجان_شرقی","مراغه","مرکزی",77,322,3,0,89,414,1,415
"آذربایجان_شرقی","مراغه","مرکزی",78,124,0,2,50,176,0,176
"آذربایجان_شرقی","مراغه","مرکزی",79,1130,6,4,447,1587,11,1598
"آذربایجان_شرقی","مراغه","مرکزی",80,685,15,20,347,1067,9,1076
"آذربایجان_شرقی","مراغه","مرکزی",81,603,1,0,215,819,7,826
"آذربایجان_شرقی","مراغه","مرکزی",82,755,3,2,298,1058,18,1076
"آذربایجان_شرقی","مراغه","مرکزی",83,729,4,1,329,1063,12,1075
"آذربایجان_شرقی","مراغه","مرکزی",84,722,23,4,445,1194,15,1209
"آذربایجان_شرقی","مراغه","مرکزی",85,205,4,5,294,508,11,519
"آذربایجان_شرقی","مراغه","مرکزی",86,609,8,20,611,1248,60,1308
"آذربایجان_شرقی","مراغه","مرکزی",87,123,3,1,139,266,2,268
"آذربایجان_شرقی","مراغه","مرکزی",88,117,6,0,62,185,4,189
"آذربایجان_شرقی","مراغه","مرکزی",89,151,0,1,107,259,6,265
"آذربایجان_شرقی","مراغه","مرکزی",90,290,7,1,285,583,8,591
"آذربایجان_شرقی","مراغه","مرکزی",91,629,1,2,166,798,8,806
"آذربایجان_شرقی","مراغه","مرکزی",92,284,2,3,136,425,2,427
"آذربایجان_شرقی","مراغه","مرکزی",93,1021,7,1,112,1141,2,1143
"آذربایجان_شرقی","مراغه","مرکزی",94,758,5,2,49,814,7,821
"آذربایجان_شرقی","مراغه","مرکزی",95,211,3,176,333,723,6,729
"آذربایجان_شرقی","مراغه","مرکزی",96,1085,3,23,237,1348,2,1350
"آذربایجان_شرقی","مراغه","مرکزی",97,640,2,1,78,721,2,723
"آذربایجان_شرقی","مراغه","مرکزی",98,314,0,1,38,353,4,357
"آذربایجان_شرقی","مراغه","مرکزی",99,524,4,1,62,591,2,593
"آذربایجان_شرقی","مراغه","مرکزی",100,521,0,1,123,645,9,654
"آذربایجان_شرقی","مراغه","مرکزی",101,309,0,1,29,339,6,345
"آذربایجان_شرقی","مراغه","مرکزی",102,301,0,2,109,412,0,412
"آذربایجان_شرقی","مراغه","مرکزی",103,609,2,2,72,685,1,686
"آذربایجان_شرقی","مراغه","مرکزی",104,660,1,0,72,733,5,738
"آذربایجان_شرقی","مراغه","مرکزی",105,489,1,1,54,545,1,546
"آذربایجان_شرقی","مراغه","مرکزی",106,871,3,0,195,1069,4,1073
"آذربایجان_شرقی","مراغه","مرکزی",107,747,1,1,284,1033,8,1041
"آذربایجان_شرقی","مراغه","مرکزی",108,457,0,0,190,647,5,652
"آذربایجان_شرقی","مراغه","مرکزی",109,855,6,0,130,991,12,1003
"آذربایجان_شرقی","مراغه","مرکزی",110,490,1,2,99,592,5,597
"آذربایجان_شرقی","مراغه","مرکزی",111,347,1,0,35,383,4,387
"آذربایجان_شرقی","مراغه","مرکزی",112,423,1,1,95,520,1,521
"آذربایجان_شرقی","مراغه","مرکزی",113,731,1,1,128,861,5,866
"آذربایجان_شرقی","مراغه","مرکزی",114,395,6,3,97,501,5,506
"آذربایجان_شرقی","مراغه","مرکزی",115,71,1,0,35,107,0,107
"آذربایجان_شرقی","مراغه","مرکزی",116,62,0,0,51,113,1,114
"آذربایجان_شرقی","مراغه","مرکزی",117,427,3,1,67,498,2,500
"آذربایجان_شرقی","مراغه","مرکزی",118,550,3,0,182,735,8,743
"آذربایجان_شرقی","مراغه","مرکزی",119,733,4,1,109,847,4,851
"آذربایجان_شرقی","مراغه","مرکزی",120,203,1,2,45,251,2,253
"آذربایجان_شرقی","مراغه","مرکزی",121,600,7,2,291,900,8,908
"آذربایجان_شرقی","مراغه","مرکزی",122,213,1,0,275,489,3,492
"آذربایجان_شرقی","مراغه","مرکزی",123,327,3,0,67,397,9,406
"آذربایجان_شرقی","مراغه","مرکزی",124,570,6,4,386,966,11,977
"آذربایجان_شرقی","مراغه","مرکزی",125,484,2,2,367,855,5,860
"آذربایجان_شرقی","مراغه","مرکزی",126,148,0,0,195,343,1,344
"آذربایجان_شرقی","مراغه","مرکزی",127,480,0,0,110,590,9,599
"آذربایجان_شرقی","مراغه","مرکزی",128,588,8,0,158,754,2,756
"آذربایجان_شرقی","مراغه","مرکزی",129,793,1,0,93,887,4,891
"آذربایجان_شرقی","مراغه","مرکزی",130,732,2,0,239,973,4,977
"آذربایجان_شرقی","مراغه","مرکزی",131,694,4,2,278,978,6,984
"آذربایجان_شرقی","مراغه","مرکزی",132,495,5,0,145,645,7,652
"آذربایجان_شرقی","مراغه","مرکزی",133,340,0,1,133,474,1,475
"آذربایجان_شرقی","مراغه","مرکزی",134,521,7,4,145,677,4,681
"آذربایجان_شرقی","مراغه","مرکزی",135,694,3,0,203,900,1,901
"آذربایجان_شرقی","مراغه","مرکزی",136,241,2,0,39,282,4,286
"آذربایجان_شرقی","مراغه","مرکزی",137,120,0,0,43,163,0,163
"آذربایجان_شرقی","مراغه","مرکزی",138,719,3,0,103,825,2,827
"آذربایجان_شرقی","مراغه","سراجو",1,492,7,3,228,730,5,735
"آذربایجان_شرقی","مراغه","سراجو",2,191,4,2,94,291,2,293
"آذربایجان_شرقی","مراغه","سراجو",3,158,3,2,250,413,0,413
"آذربایجان_شرقی","مراغه","سراجو",4,257,4,0,253,514,7,521
"آذربایجان_شرقی","مراغه","سراجو",5,280,6,4,379,669,6,675
"آذربایجان_شرقی","مراغه","سراجو",6,264,3,2,298,567,7,574
"آذربایجان_شرقی","مراغه","سراجو",7,338,0,0,88,426,1,427
"آذربایجان_شرقی","مراغه","سراجو",8,264,1,1,219,485,2,487
"آذربایجان_شرقی","مراغه","سراجو",9,290,0,0,165,455,1,456
"آذربایجان_شرقی","مراغه","سراجو",10,450,0,2,173,625,5,630
"آذربایجان_شرقی","مراغه","سراجو",11,215,0,0,56,271,1,272
"آذربایجان_شرقی","مراغه","سراجو",12,475,1,0,133,609,2,611
"آذربایجان_شرقی","مراغه","سراجو",13,409,0,0,127,536,0,536
"آذربایجان_شرقی","مراغه","سراجو",14,92,0,0,46,138,0,138
"آذربایجان_شرقی","مراغه","سراجو",15,52,1,0,24,77,1,78
"آذربایجان_شرقی","مراغه","سراجو",16,71,1,0,8,80,0,80
"آذربایجان_شرقی","مراغه","سراجو",17,174,2,0,14,190,1,191
"آذربایجان_شرقی","مراغه","سراجو",18,113,0,0,20,133,0,133
"آذربایجان_شرقی","مراغه","سراجو",19,197,0,0,15,212,0,212
"آذربایجان_شرقی","مراغه","سراجو",20,45,0,0,23,68,1,69
"آذربایجان_شرقی","مراغه","سراجو",21,91,1,0,5,97,0,97
"آذربایجان_شرقی","مراغه","سراجو",22,107,0,0,22,129,0,129
"آذربایجان_شرقی","مراغه","سراجو",23,316,0,0,30,346,0,346
"آذربایجان_شرقی","مراغه","سراجو",24,125,0,0,8,133,0,133
"آذربایجان_شرقی","مراغه","سراجو",25,117,0,0,23,140,0,140
"آذربایجان_شرقی","مراغه","سراجو",26,37,0,0,29,66,1,67
"آذربایجان_شرقی","مراغه","سراجو",27,96,1,0,14,111,2,113
"آذربایجان_شرقی","مراغه","سراجو",28,141,0,0,8,149,0,149
"آذربایجان_شرقی","مراغه","سراجو",29,189,1,0,38,228,0,228
"آذربایجان_شرقی","مراغه","سراجو",30,222,0,0,31,253,0,253
"آذربایجان_شرقی","مراغه","سراجو",31,198,1,0,60,259,0,259
"آذربایجان_شرقی","مراغه","سراجو",32,143,0,0,55,198,1,199
"آذربایجان_شرقی","مراغه","سراجو",33,373,3,0,82,458,7,465
"آذربایجان_شرقی","مراغه","سراجو",34,192,2,0,125,319,1,320
"آذربایجان_شرقی","مراغه","سراجو",35,181,0,0,27,208,4,212
"آذربایجان_شرقی","مراغه","سراجو",36,399,2,1,105,507,2,509
"آذربایجان_شرقی","مراغه","سراجو",37,321,0,2,76,399,1,400
"آذربایجان_شرقی","مراغه","سراجو",38,334,4,1,153,492,2,494
"آذربایجان_شرقی","مراغه","سراجو",39,113,1,0,47,161,2,163
"آذربایجان_شرقی","مرند","مرکزی",1,746,21,7,913,1687,17,1704
"آذربایجان_شرقی","مرند","مرکزی",2,535,25,7,675,1242,9,1251
"آذربایجان_شرقی","مرند","مرکزی",3,525,10,10,1053,1598,18,1616
"آذربایجان_شرقی","مرند","مرکزی",4,589,26,5,933,1553,17,1570
"آذربایجان_شرقی","مرند","مرکزی",5,806,10,8,908,1732,23,1755
"آذربایجان_شرقی","مرند","مرکزی",6,652,12,4,1127,1795,21,1816
"آذربایجان_شرقی","مرند","مرکزی",7,793,12,6,1077,1888,16,1904
"آذربایجان_شرقی","مرند","مرکزی",8,670,6,6,962,1644,12,1656
"آذربایجان_شرقی","مرند","مرکزی",9,560,19,11,953,1543,14,1557
"آذربایجان_شرقی","مرند","مرکزی",10,726,20,3,1195,1944,14,1958
"آذربایجان_شرقی","مرند","مرکزی",11,771,22,5,1143,1941,27,1968
"آذربایجان_شرقی","مرند","مرکزی",12,504,14,7,712,1237,14,1251
"آذربایجان_شرقی","مرند","مرکزی",13,310,9,2,317,638,10,648
"آذربایجان_شرقی","مرند","مرکزی",14,499,12,6,668,1185,10,1195
"آذربایجان_شرقی","مرند","مرکزی",15,729,21,3,518,1271,17,1288
"آذربایجان_شرقی","مرند","مرکزی",16,197,4,4,327,532,8,540
"آذربایجان_شرقی","مرند","مرکزی",17,470,5,3,738,1216,8,1224
"آذربایجان_شرقی","مرند","مرکزی",18,842,7,1,566,1416,11,1427
"آذربایجان_شرقی","مرند","مرکزی",19,707,3,0,502,1212,5,1217
"آذربایجان_شرقی","مرند","مرکزی",20,1302,20,4,577,1903,24,1927
"آذربایجان_شرقی","مرند","مرکزی",21,510,4,1,391,906,8,914
"آذربایجان_شرقی","مرند","مرکزی",22,915,12,4,458,1389,5,1394
"آذربایجان_شرقی","مرند","مرکزی",23,726,6,2,557,1291,9,1300
"آذربایجان_شرقی","مرند","مرکزی",24,925,10,1,676,1612,25,1637
"آذربایجان_شرقی","مرند","مرکزی",25,376,2,0,319,697,6,703
"آذربایجان_شرقی","مرند","مرکزی",26,407,11,11,598,1027,23,1050
"آذربایجان_شرقی","مرند","مرکزی",27,263,8,2,470,743,10,753
"آذربایجان_شرقی","مرند","مرکزی",28,103,1,0,195,299,1,300
"آذربایجان_شرقی","مرند","مرکزی",29,733,11,5,835,1584,17,1601
"آذربایجان_شرقی","مرند","مرکزی",30,522,10,2,789,1323,14,1337
"آذربایجان_شرقی","مرند","مرکزی",31,1127,9,4,808,1948,23,1971
"آذربایجان_شرقی","مرند","مرکزی",32,597,3,1,387,988,9,997
"آذربایجان_شرقی","مرند","مرکزی",33,704,6,7,662,1379,20,1399
"آذربایجان_شرقی","مرند","مرکزی",34,685,14,3,606,1308,19,1327
"آذربایجان_شرقی","مرند","مرکزی",35,807,16,1,1006,1830,28,1858
"آذربایجان_شرقی","مرند","مرکزی",36,744,11,7,992,1754,27,1781
"آذربایجان_شرقی","مرند","مرکزی",37,699,10,6,907,1622,15,1637
"آذربایجان_شرقی","مرند","مرکزی",38,568,10,2,608,1188,10,1198
"آذربایجان_شرقی","مرند","مرکزی",39,886,10,3,833,1732,20,1752
"آذربایجان_شرقی","مرند","مرکزی",40,393,9,3,412,817,7,824
"آذربایجان_شرقی","مرند","مرکزی",41,647,10,3,896,1556,9,1565
"آذربایجان_شرقی","مرند","مرکزی",42,589,3,0,796,1388,11,1399
"آذربایجان_شرقی","مرند","مرکزی",43,779,15,2,765,1561,12,1573
"آذربایجان_شرقی","مرند","مرکزی",44,489,7,2,582,1080,11,1091
"آذربایجان_شرقی","مرند","مرکزی",45,278,4,10,528,820,2,822
"آذربایجان_شرقی","مرند","مرکزی",46,563,5,2,876,1446,22,1468
"آذربایجان_شرقی","مرند","مرکزی",47,553,6,1,760,1320,1,1321
"آذربایجان_شرقی","مرند","مرکزی",48,403,11,7,527,948,8,956
"آذربایجان_شرقی","مرند","مرکزی",49,251,14,2,394,661,7,668
"آذربایجان_شرقی","مرند","مرکزی",50,306,8,6,250,570,18,588
"آذربایجان_شرقی","مرند","مرکزی",51,225,3,1,308,537,7,544
"آذربایجان_شرقی","مرند","مرکزی",52,328,4,3,334,669,15,684
"آذربایجان_شرقی","مرند","مرکزی",53,352,4,2,422,780,4,784
"آذربایجان_شرقی","مرند","مرکزی",54,558,1,0,505,1064,10,1074
"آذربایجان_شرقی","مرند","مرکزی",55,498,0,1,483,982,9,991
"آذربایجان_شرقی","مرند","مرکزی",56,297,1,1,646,945,4,949
"آذربایجان_شرقی","مرند","مرکزی",57,300,2,0,282,584,9,593
"آذربایجان_شرقی","مرند","مرکزی",58,287,3,0,625,915,6,921
"آذربایجان_شرقی","مرند","مرکزی",59,433,10,1,678,1122,21,1143
"آذربایجان_شرقی","مرند","مرکزی",60,422,4,0,311,737,10,747
"آذربایجان_شرقی","مرند","مرکزی",61,290,1,0,386,677,5,682
"آذربایجان_شرقی","مرند","مرکزی",62,519,3,3,397,922,4,926
"آذربایجان_شرقی","مرند","مرکزی",63,491,3,1,309,804,2,806
"آذربایجان_شرقی","مرند","مرکزی",64,394,1,0,182,577,5,582
"آذربایجان_شرقی","مرند","مرکزی",65,609,2,0,590,1201,8,1209
"آذربایجان_شرقی","مرند","مرکزی",66,899,10,1,266,1176,5,1181
"آذربایجان_شرقی","مرند","مرکزی",67,461,2,5,283,751,6,757
"آذربایجان_شرقی","مرند","مرکزی",68,94,1,0,22,117,1,118
"آذربایجان_شرقی","مرند","مرکزی",69,93,1,1,76,171,1,172
"آذربایجان_شرقی","مرند","مرکزی",70,958,10,8,441,1417,5,1422
"آذربایجان_شرقی","مرند","مرکزی",71,499,4,1,415,919,11,930
"آذربایجان_شرقی","مرند","مرکزی",72,290,0,0,73,363,2,365
"آذربایجان_شرقی","مرند","مرکزی",73,454,2,2,164,622,3,625
"آذربایجان_شرقی","مرند","مرکزی",74,389,1,1,39,430,6,436
"آذربایجان_شرقی","مرند","مرکزی",75,381,0,0,62,443,0,443
"آذربایجان_شرقی","مرند","مرکزی",76,321,1,1,31,354,0,354
"آذربایجان_شرقی","مرند","مرکزی",77,576,2,3,60,641,11,652
"آذربایجان_شرقی","مرند","مرکزی",78,233,1,1,95,330,4,334
"آذربایجان_شرقی","مرند","مرکزی",79,394,2,3,524,923,6,929
"آذربایجان_شرقی","مرند","مرکزی",80,126,0,2,107,235,2,237
"آذربایجان_شرقی","مرند","مرکزی",81,201,1,2,108,312,2,314
"آذربایجان_شرقی","مرند","مرکزی",82,109,1,3,150,263,12,275
"آذربایجان_شرقی","مرند","مرکزی",83,351,6,0,335,692,6,698
"آذربایجان_شرقی","مرند","مرکزی",84,154,1,0,104,259,2,261
"آذربایجان_شرقی","مرند","مرکزی",85,191,1,0,191,383,3,386
"آذربایجان_شرقی","مرند","مرکزی",86,216,0,0,147,363,1,364
"آذربایجان_شرقی","مرند","مرکزی",87,358,4,0,204,566,6,572
"آذربایجان_شرقی","مرند","مرکزی",88,240,0,3,55,298,2,300
"آذربایجان_شرقی","مرند","مرکزی",89,90,0,1,73,164,0,164
"آذربایجان_شرقی","مرند","مرکزی",90,326,0,0,33,359,0,359
"آذربایجان_شرقی","مرند","مرکزی",91,389,5,2,549,945,5,950
"آذربایجان_شرقی","مرند","مرکزی",92,169,0,0,224,393,0,393
"آذربایجان_شرقی","مرند","مرکزی",93,622,1,0,252,875,9,884
"آذربایجان_شرقی","مرند","مرکزی",94,498,4,0,194,696,5,701
"آذربایجان_شرقی","مرند","مرکزی",95,403,3,0,164,570,4,574
"آذربایجان_شرقی","مرند","مرکزی",96,209,1,2,224,436,0,436
"آذربایجان_شرقی","مرند","مرکزی",97,177,0,0,154,331,2,333
"آذربایجان_شرقی","مرند","مرکزی",98,92,0,0,67,159,1,160
"آذربایجان_شرقی","مرند","مرکزی",99,643,4,2,191,840,6,846
"آذربایجان_شرقی","مرند","مرکزی",100,689,4,0,440,1133,5,1138
"آذربایجان_شرقی","مرند","مرکزی",101,344,5,0,304,653,5,658
"آذربایجان_شرقی","مرند","مرکزی",102,618,3,5,238,864,11,875
"آذربایجان_شرقی","مرند","مرکزی",103,210,0,0,170,380,2,382
"آذربایجان_شرقی","مرند","مرکزی",104,566,4,1,543,1114,2,1116
"آذربایجان_شرقی","مرند","مرکزی",105,603,10,2,485,1100,0,1100
"آذربایجان_شرقی","مرند","مرکزی",106,277,2,0,250,529,3,532
"آذربایجان_شرقی","مرند","مرکزی",107,151,3,3,769,926,4,930
"آذربایجان_شرقی","مرند","مرکزی",108,383,3,1,633,1020,7,1027
"آذربایجان_شرقی","مرند","مرکزی",109,220,3,0,349,572,2,574
"آذربایجان_شرقی","مرند","مرکزی",110,205,5,3,697,910,9,919
"آذربایجان_شرقی","مرند","مرکزی",111,784,6,2,193,985,3,988
"آذربایجان_شرقی","مرند","مرکزی",112,286,0,0,139,425,4,429
"آذربایجان_شرقی","مرند","مرکزی",113,1122,2,0,200,1324,13,1337
"آذربایجان_شرقی","مرند","مرکزی",114,93,0,0,192,285,0,285
"آذربایجان_شرقی","مرند","مرکزی",115,580,2,1,245,828,4,832
"آذربایجان_شرقی","مرند","مرکزی",116,442,7,2,334,785,14,799
"آذربایجان_شرقی","مرند","مرکزی",117,151,1,2,77,231,6,237
"آذربایجان_شرقی","مرند","مرکزی",118,456,5,1,140,602,5,607
"آذربایجان_شرقی","مرند","مرکزی",119,497,6,4,556,1063,9,1072
"آذربایجان_شرقی","مرند","مرکزی",120,376,5,0,47,428,2,430
"آذربایجان_شرقی","مرند","مرکزی",121,203,7,4,149,363,5,368
"آذربایجان_شرقی","مرند","مرکزی",122,196,2,2,385,585,2,587
"آذربایجان_شرقی","مرند","مرکزی",123,911,3,5,338,1257,12,1269
"آذربایجان_شرقی","مرند","مرکزی",124,266,3,0,488,757,6,763
"آذربایجان_شرقی","مرند","مرکزی",125,453,2,2,228,685,1,686
"آذربایجان_شرقی","مرند","مرکزی",126,128,2,0,41,171,0,171
"آذربایجان_شرقی","مرند","مرکزی",127,644,8,4,361,1017,11,1028
"آذربایجان_شرقی","مرند","مرکزی",128,297,2,1,170,470,4,474
"آذربایجان_شرقی","مرند","یامچی",1,754,12,1,325,1092,5,1097
"آذربایجان_شرقی","مرند","یامچی",2,595,8,1,552,1156,15,1171
"آذربایجان_شرقی","مرند","یامچی",3,288,7,0,338,633,11,644
"آذربایجان_شرقی","مرند","یامچی",4,476,4,0,301,781,5,786
"آذربایجان_شرقی","مرند","یامچی",5,405,4,1,643,1053,7,1060
"آذربایجان_شرقی","مرند","یامچی",6,532,3,2,369,906,7,913
"آذربایجان_شرقی","مرند","یامچی",7,539,4,1,298,842,4,846
"آذربایجان_شرقی","مرند","یامچی",8,389,0,0,127,516,11,527
"آذربایجان_شرقی","مرند","یامچی",9,396,5,0,375,776,7,783
"آذربایجان_شرقی","مرند","یامچی",10,440,1,0,232,673,2,675
"آذربایجان_شرقی","مرند","یامچی",11,395,3,0,100,498,1,499
"آذربایجان_شرقی","مرند","یامچی",12,614,6,1,228,849,5,854
"آذربایجان_شرقی","مرند","یامچی",13,632,8,3,344,987,4,991
"آذربایجان_شرقی","مرند","یامچی",14,564,5,1,324,894,6,900
"آذربایجان_شرقی","مرند","یامچی",15,606,0,0,94,700,0,700
"آذربایجان_شرقی","مرند","یامچی",16,557,1,1,190,749,12,761
"آذربایجان_شرقی","مرند","یامچی",17,447,4,2,133,586,6,592
"آذربایجان_شرقی","مرند","یامچی",18,196,1,0,340,537,5,542
"آذربایجان_شرقی","مرند","یامچی",19,214,4,1,469,688,4,692
"آذربایجان_شرقی","مرند","یامچی",20,110,4,0,235,349,1,350
"آذربایجان_شرقی","مرند","یامچی",21,288,0,0,28,316,4,320
"آذربایجان_شرقی","مرند","یامچی",22,89,0,0,53,142,0,142
"آذربایجان_شرقی","مرند","یامچی",23,77,0,0,28,105,1,106
"آذربایجان_شرقی","مرند","یامچی",24,32,0,0,75,107,1,108
"آذربایجان_شرقی","مرند","یامچی",25,394,1,1,148,544,5,549
"آذربایجان_شرقی","ملکان","مرکزی",1,221,3,1,320,545,2,547
"آذربایجان_شرقی","ملکان","مرکزی",2,383,7,4,590,984,0,984
"آذربایجان_شرقی","ملکان","مرکزی",3,337,3,1,341,682,1,683
"آذربایجان_شرقی","ملکان","مرکزی",4,322,10,1,570,903,3,906
"آذربایجان_شرقی","ملکان","مرکزی",5,254,0,1,262,517,0,517
"آذربایجان_شرقی","ملکان","مرکزی",6,74,1,5,229,309,1,310
"آذربایجان_شرقی","ملکان","مرکزی",7,166,3,0,302,471,1,472
"آذربایجان_شرقی","ملکان","مرکزی",8,276,2,1,601,880,0,880
"آذربایجان_شرقی","ملکان","مرکزی",9,255,4,2,240,501,1,502
"آذربایجان_شرقی","ملکان","مرکزی",10,92,1,2,201,296,1,297
"آذربایجان_شرقی","ملکان","مرکزی",11,262,5,4,733,1004,3,1007
"آذربایجان_شرقی","ملکان","مرکزی",12,246,3,2,488,739,0,739
"آذربایجان_شرقی","ملکان","مرکزی",13,106,1,2,219,328,0,328
"آذربایجان_شرقی","ملکان","مرکزی",14,305,2,2,332,641,0,641
"آذربایجان_شرقی","ملکان","مرکزی",15,104,0,0,138,242,1,243
"آذربایجان_شرقی","ملکان","مرکزی",16,251,7,0,386,644,0,644
"آذربایجان_شرقی","ملکان","مرکزی",17,265,6,3,617,891,4,895
"آذربایجان_شرقی","ملکان","مرکزی",18,164,2,0,219,385,0,385
"آذربایجان_شرقی","ملکان","مرکزی",19,143,4,0,211,358,2,360
"آذربایجان_شرقی","ملکان","مرکزی",20,31,0,0,56,87,0,87
"آذربایجان_شرقی","ملکان","مرکزی",21,278,4,2,613,897,0,897
"آذربایجان_شرقی","ملکان","مرکزی",22,370,4,0,353,727,1,728
"آذربایجان_شرقی","ملکان","مرکزی",23,62,1,1,222,286,1,287
"آذربایجان_شرقی","ملکان","مرکزی",24,45,1,0,67,113,0,113
"آذربایجان_شرقی","ملکان","مرکزی",25,205,1,0,231,437,2,439
"آذربایجان_شرقی","ملکان","مرکزی",26,352,1,0,202,555,0,555
"آذربایجان_شرقی","ملکان","مرکزی",27,418,3,0,180,601,1,602
"آذربایجان_شرقی","ملکان","مرکزی",28,475,0,1,107,583,0,583
"آذربایجان_شرقی","ملکان","مرکزی",29,55,2,0,349,406,0,406
"آذربایجان_شرقی","ملکان","مرکزی",30,229,8,0,410,647,0,647
"آذربایجان_شرقی","ملکان","مرکزی",31,143,5,1,546,695,0,695
"آذربایجان_شرقی","ملکان","مرکزی",32,126,2,0,176,304,0,304
"آذربایجان_شرقی","ملکان","مرکزی",33,212,3,1,168,384,0,384
"آذربایجان_شرقی","ملکان","مرکزی",34,336,5,0,235,576,0,576
"آذربایجان_شرقی","ملکان","مرکزی",35,277,3,1,324,605,0,605
"آذربایجان_شرقی","ملکان","مرکزی",36,310,4,0,135,449,2,451
"آذربایجان_شرقی","ملکان","مرکزی",37,517,3,1,303,824,0,824
"آذربایجان_شرقی","ملکان","مرکزی",38,366,2,0,106,474,1,475
"آذربایجان_شرقی","ملکان","مرکزی",39,305,1,0,76,382,1,383
"آذربایجان_شرقی","ملکان","مرکزی",40,184,3,1,166,354,0,354
"آذربایجان_شرقی","ملکان","مرکزی",41,48,1,0,80,129,0,129
"آذربایجان_شرقی","ملکان","مرکزی",42,57,1,0,74,132,1,133
"آذربایجان_شرقی","ملکان","مرکزی",43,153,4,0,129,286,0,286
"آذربایجان_شرقی","ملکان","مرکزی",44,199,3,1,125,328,0,328
"آذربایجان_شرقی","ملکان","مرکزی",45,85,0,1,189,275,0,275
"آذربایجان_شرقی","ملکان","مرکزی",46,259,0,0,66,325,0,325
"آذربایجان_شرقی","ملکان","مرکزی",47,641,0,1,63,705,0,705
"آذربایجان_شرقی","ملکان","مرکزی",48,588,1,0,86,675,4,679
"آذربایجان_شرقی","ملکان","مرکزی",49,310,4,1,260,575,0,575
"آذربایجان_شرقی","ملکان","مرکزی",50,388,0,0,181,569,0,569
"آذربایجان_شرقی","ملکان","مرکزی",51,219,2,0,250,471,0,471
"آذربایجان_شرقی","ملکان","مرکزی",52,290,1,0,149,440,1,441
"آذربایجان_شرقی","ملکان","مرکزی",53,259,0,0,150,409,0,409
"آذربایجان_شرقی","ملکان","مرکزی",54,224,1,1,244,470,0,470
"آذربایجان_شرقی","ملکان","مرکزی",55,587,2,0,199,788,0,788
"آذربایجان_شرقی","ملکان","مرکزی",56,639,4,0,114,757,0,757
"آذربایجان_شرقی","ملکان","مرکزی",57,295,1,0,72,368,0,368
"آذربایجان_شرقی","ملکان","مرکزی",58,375,1,0,71,447,0,447
"آذربایجان_شرقی","ملکان","مرکزی",59,439,3,1,232,675,0,675
"آذربایجان_شرقی","ملکان","مرکزی",60,221,1,0,54,276,0,276
"آذربایجان_شرقی","ملکان","مرکزی",61,415,1,0,143,559,0,559
"آذربایجان_شرقی","ملکان","مرکزی",62,222,0,0,228,450,0,450
"آذربایجان_شرقی","ملکان","مرکزی",63,295,1,1,179,476,0,476
"آذربایجان_شرقی","ملکان","مرکزی",64,180,0,0,82,262,0,262
"آذربایجان_شرقی","ملکان","مرکزی",65,79,1,0,53,133,0,133
"آذربایجان_شرقی","ملکان","مرکزی",66,239,3,0,132,374,0,374
"آذربایجان_شرقی","ملکان","مرکزی",67,185,0,1,236,422,0,422
"آذربایجان_شرقی","ملکان","مرکزی",68,136,2,0,89,227,0,227
"آذربایجان_شرقی","ملکان","مرکزی",69,164,0,3,146,313,0,313
"آذربایجان_شرقی","ملکان","مرکزی",70,83,0,0,55,138,0,138
"آذربایجان_شرقی","ملکان","مرکزی",71,334,7,1,184,526,1,527
"آذربایجان_شرقی","ملکان","مرکزی",72,408,1,2,193,604,0,604
"آذربایجان_شرقی","ملکان","مرکزی",73,197,2,0,157,356,0,356
"آذربایجان_شرقی","ملکان","مرکزی",74,219,0,0,137,356,0,356
"آذربایجان_شرقی","ملکان","مرکزی",75,150,1,0,62,213,0,213
"آذربایجان_شرقی","ملکان","مرکزی",76,183,0,0,14,197,0,197
"آذربایجان_شرقی","ملکان","مرکزی",77,156,0,0,74,230,0,230
"آذربایجان_شرقی","ملکان","مرکزی",78,100,0,1,19,120,0,120
"آذربایجان_شرقی","ملکان","مرکزی",79,53,2,0,122,177,0,177
"آذربایجان_شرقی","ملکان","مرکزی",80,141,0,0,70,211,0,211
"آذربایجان_شرقی","ملکان","مرکزی",81,188,0,0,64,252,0,252
"آذربایجان_شرقی","ملکان","مرکزی",82,65,1,0,47,113,0,113
"آذربایجان_شرقی","ملکان","مرکزی",83,150,0,0,47,197,0,197
"آذربایجان_شرقی","ملکان","مرکزی",84,96,0,0,49,145,1,146
"آذربایجان_شرقی","ملکان","مرکزی",85,64,0,0,32,96,0,96
"آذربایجان_شرقی","ملکان","مرکزی",86,378,4,2,154,538,1,539
"آذربایجان_شرقی","ملکان","مرکزی",87,127,0,0,74,201,0,201
"آذربایجان_شرقی","ملکان","مرکزی",88,380,1,0,111,492,1,493
"آذربایجان_شرقی","ملکان","مرکزی",89,614,6,1,363,984,0,984
"آذربایجان_شرقی","ملکان","مرکزی",90,275,1,0,166,442,0,442
"آذربایجان_شرقی","ملکان","مرکزی",91,408,2,0,133,543,0,543
"آذربایجان_شرقی","ملکان","مرکزی",92,481,0,0,54,535,0,535
"آذربایجان_شرقی","ملکان","مرکزی",93,181,1,0,78,260,0,260
"آذربایجان_شرقی","ملکان","مرکزی",94,65,4,0,55,124,0,124
"آذربایجان_شرقی","ملکان","مرکزی",95,226,0,1,280,507,1,508
"آذربایجان_شرقی","ملکان","مرکزی",96,80,0,1,199,280,0,280
"آذربایجان_شرقی","ملکان","لیلان",1,397,5,8,382,792,0,792
"آذربایجان_شرقی","ملکان","لیلان",2,195,0,1,159,355,1,356
"آذربایجان_شرقی","ملکان","لیلان",3,71,0,1,83,155,0,155
"آذربایجان_شرقی","ملکان","لیلان",4,395,2,4,151,552,0,552
"آذربایجان_شرقی","ملکان","لیلان",5,373,1,3,199,576,0,576
"آذربایجان_شرقی","ملکان","لیلان",6,188,2,0,63,253,0,253
"آذربایجان_شرقی","ملکان","لیلان",7,254,1,2,126,383,0,383
"آذربایجان_شرقی","ملکان","لیلان",8,149,0,0,110,259,0,259
"آذربایجان_شرقی","ملکان","لیلان",9,380,7,0,119,506,0,506
"آذربایجان_شرقی","ملکان","لیلان",10,223,2,1,127,353,0,353
"آذربایجان_شرقی","ملکان","لیلان",11,275,0,0,62,337,0,337
"آذربایجان_شرقی","ملکان","لیلان",12,256,1,0,180,437,0,437
"آذربایجان_شرقی","ملکان","لیلان",13,77,1,0,23,101,0,101
"آذربایجان_شرقی","ملکان","لیلان",14,69,0,0,7,76,0,76
"آذربایجان_شرقی","ملکان","لیلان",15,324,3,1,223,551,2,553
"آذربایجان_شرقی","ملکان","لیلان",16,310,4,1,120,435,3,438
"آذربایجان_شرقی","ملکان","لیلان",17,396,1,0,64,461,0,461
"آذربایجان_شرقی","ملکان","لیلان",18,293,7,0,29,329,0,329
"آذربایجان_شرقی","ملکان","لیلان",19,373,2,1,281,657,2,659
"آذربایجان_شرقی","ملکان","لیلان",20,505,1,5,184,695,0,695
"آذربایجان_شرقی","ملکان","لیلان",21,139,1,0,51,191,0,191
"آذربایجان_شرقی","ملکان","لیلان",22,84,0,1,48,133,0,133
"آذربایجان_شرقی","ملکان","لیلان",23,123,0,1,75,199,2,201
"آذربایجان_شرقی","ملکان","لیلان",24,119,2,1,133,255,2,257
"آذربایجان_شرقی","ملکان","لیلان",25,299,0,1,92,392,3,395
"آذربایجان_شرقی","ملکان","لیلان",26,239,0,0,131,370,0,370
"آذربایجان_شرقی","ملکان","لیلان",27,119,1,0,72,192,0,192
"آذربایجان_شرقی","ملکان","لیلان",28,228,4,0,105,337,0,337
"آذربایجان_شرقی","ملکان","لیلان",29,151,0,1,28,180,0,180
"آذربایجان_شرقی","ملکان","لیلان",30,289,3,3,244,539,0,539
"آذربایجان_شرقی","ملکان","لیلان",31,55,1,0,163,219,0,219
"آذربایجان_شرقی","ملکان","لیلان",32,47,0,0,16,63,0,63
"آذربایجان_شرقی","ملکان","لیلان",33,120,0,0,26,146,0,146
"آذربایجان_شرقی","ملکان","لیلان",34,107,0,0,31,138,0,138
"آذربایجان_شرقی","ملکان","لیلان",35,129,1,1,133,264,0,264
"آذربایجان_شرقی","ملکان","لیلان",36,128,2,1,90,221,0,221
"آذربایجان_شرقی","ملکان","لیلان",37,272,1,1,104,378,0,378
"آذربایجان_شرقی","میانه","میانه_و_بخش_مرکزی",1,847,17,20,1010,1894,23,1917
"آذربایجان_شرقی","میانه","میانه_و_بخش_مرکزی",2,907,17,10,692,1626,17,1643
"آذربایجان_شرقی","میانه","میانه_و_بخش_مرکزی",3,570,29,1,564,1164,16,1180
"آذربایجان_شرقی","میانه","میانه_و_بخش_مرکزی",4,1067,19,17,1061,2164,20,2184
"آذربایجان_شرقی","میانه","میانه_و_بخش_مرکزی",5,702,27,7,650,1386,14,1400
"آذربایجان_شرقی","میانه","میانه_و_بخش_مرکزی",6,906,32,11,672,1621,21,1642
"آذربایجان_شرقی","میانه","میانه_و_بخش_مرکزی",7,398,12,3,317,730,12,742
"آذربایجان_شرقی","میانه","میانه_و_بخش_مرکزی",8,493,21,21,554,1089,12,1101
"آذربایجان_شرقی","میانه","میانه_و_بخش_مرکزی",9,716,16,4,713,1449,18,1467
"آذربایجان_شرقی","میانه","میانه_و_بخش_مرکزی",10,706,10,1,607,1324,12,1336
"آذربایجان_شرقی","میانه","میانه_و_بخش_مرکزی",11,858,18,7,701,1584,15,1599
"آذربایجان_شرقی","میانه","میانه_و_بخش_مرکزی",12,680,12,10,722,1424,26,1450
"آذربایجان_شرقی","میانه","میانه_و_بخش_مرکزی",13,810,12,3,370,1195,12,1207
"آذربایجان_شرقی","میانه","میانه_و_بخش_مرکزی",14,1040,19,4,394,1457,16,1473
"آذربایجان_شرقی","میانه","میانه_و_بخش_مرکزی",15,1074,12,9,277,1372,8,1380
"آذربایجان_شرقی","میانه","میانه_و_بخش_مرکزی",16,745,6,1,276,1028,11,1039
"آذربایجان_شرقی","میانه","میانه_و_بخش_مرکزی",17,1449,11,3,350,1813,21,1834
"آذربایجان_شرقی","میانه","میانه_و_بخش_مرکزی",18,628,4,1,124,757,1,758
"آذربایجان_شرقی","میانه","میانه_و_بخش_مرکزی",19,1130,9,3,372,1514,9,1523
"آذربایجان_شرقی","میانه","میانه_و_بخش_مرکزی",20,793,9,6,424,1232,19,1251
"آذربایجان_شرقی","میانه","میانه_و_بخش_مرکزی",21,1229,13,2,545,1789,17,1806
"آذربایجان_شرقی","میانه","میانه_و_بخش_مرکزی",22,700,10,0,310,1020,5,1025
"آذربایجان_شرقی","میانه","میانه_و_بخش_مرکزی",23,511,3,0,181,695,6,701
"آذربایجان_شرقی","میانه","میانه_و_بخش_مرکزی",24,630,6,4,257,897,4,901
"آذربایجان_شرقی","میانه","میانه_و_بخش_مرکزی",25,725,14,5,352,1096,15,1111
"آذربایجان_شرقی","میانه","میانه_و_بخش_مرکزی",26,707,8,5,340,1060,6,1066
"آذربایجان_شرقی","میانه","میانه_و_بخش_مرکزی",27,376,5,0,186,567,3,570
"آذربایجان_شرقی","میانه","میانه_و_بخش_مرکزی",28,1042,16,5,578,1641,15,1656
"آذربایجان_شرقی","میانه","میانه_و_بخش_مرکزی",29,826,20,5,669,1520,18,1538
"آذربایجان_شرقی","میانه","میانه_و_بخش_مرکزی",30,643,5,3,282,933,4,937
"آذربایجان_شرقی","میانه","میانه_و_بخش_مرکزی",31,559,19,1,373,952,9,961
"آذربایجان_شرقی","میانه","میانه_و_بخش_مرکزی",32,934,18,9,616,1577,10,1587
"آذربایجان_شرقی","میانه","میانه_و_بخش_مرکزی",33,596,11,2,339,948,5,953
"آذربایجان_شرقی","میانه","میانه_و_بخش_مرکزی",34,1023,4,1,217,1245,16,1261
"آذربایجان_شرقی","میانه","میانه_و_بخش_مرکزی",35,296,4,2,112,414,9,423
"آذربایجان_شرقی","میانه","میانه_و_بخش_مرکزی",36,875,4,3,263,1145,7,1152
"آذربایجان_شرقی","میانه","میانه_و_بخش_مرکزی",37,419,3,1,144,567,5,572
"آذربایجان_شرقی","میانه","میانه_و_بخش_مرکزی",38,1107,4,9,309,1429,4,1433
"آذربایجان_شرقی","میانه","میانه_و_بخش_مرکزی",39,625,3,5,166,799,4,803
"آذربایجان_شرقی","میانه","میانه_و_بخش_مرکزی",40,837,3,3,175,1018,7,1025
"آذربایجان_شرقی","میانه","میانه_و_بخش_مرکزی",41,576,2,3,136,717,1,718
"آذربایجان_شرقی","میانه","میانه_و_بخش_مرکزی",42,382,1,0,65,448,2,450
"آذربایجان_شرقی","میانه","میانه_و_بخش_مرکزی",43,740,6,7,208,961,7,968
"آذربایجان_شرقی","میانه","میانه_و_بخش_مرکزی",44,221,1,0,87,309,5,314
"آذربایجان_شرقی","میانه","میانه_و_بخش_مرکزی",45,312,0,0,97,409,0,409
"آذربایجان_شرقی","میانه","میانه_و_بخش_مرکزی",46,161,1,1,225,388,9,397
"آذربایجان_شرقی","میانه","میانه_و_بخش_مرکزی",47,264,2,0,42,308,2,310
"آذربایجان_شرقی","میانه","میانه_و_بخش_مرکزی",48,492,0,3,89,584,0,584
"آذربایجان_شرقی","میانه","میانه_و_بخش_مرکزی",49,601,0,0,52,653,0,653
"آذربایجان_شرقی","میانه","میانه_و_بخش_مرکزی",50,344,1,0,61,406,3,409
"آذربایجان_شرقی","میانه","میانه_و_بخش_مرکزی",51,331,1,0,67,399,2,401
"آذربایجان_شرقی","میانه","میانه_و_بخش_مرکزی",52,123,1,3,100,227,0,227
"آذربایجان_شرقی","میانه","میانه_و_بخش_مرکزی",53,159,1,0,71,231,3,234
"آذربایجان_شرقی","میانه","میانه_و_بخش_مرکزی",54,428,2,1,92,523,0,523
"آذربایجان_شرقی","میانه","میانه_و_بخش_مرکزی",55,818,3,1,83,905,5,910
"آذربایجان_شرقی","میانه","میانه_و_بخش_مرکزی",56,598,3,5,117,723,4,727
"آذربایجان_شرقی","میانه","میانه_و_بخش_مرکزی",57,308,0,0,61,369,3,372
"آذربایجان_شرقی","میانه","میانه_و_بخش_مرکزی",58,597,1,1,47,646,2,648
"آذربایجان_شرقی","میانه","میانه_و_بخش_مرکزی",59,355,3,5,285,648,12,660
"آذربایجان_شرقی","میانه","میانه_و_بخش_مرکزی",60,407,0,0,44,451,0,451
"آذربایجان_شرقی","میانه","میانه_و_بخش_مرکزی",61,268,0,0,15,283,0,283
"آذربایجان_شرقی","میانه","میانه_و_بخش_مرکزی",62,158,4,2,23,187,0,187
"آذربایجان_شرقی","میانه","میانه_و_بخش_مرکزی",63,156,0,0,20,176,0,176
"آذربایجان_شرقی","میانه","میانه_و_بخش_مرکزی",64,137,0,0,66,203,0,203
"آذربایجان_شرقی","میانه","میانه_و_بخش_مرکزی",65,52,0,0,12,64,0,64
"آذربایجان_شرقی","میانه","میانه_و_بخش_مرکزی",66,92,0,0,54,146,0,146
"آذربایجان_شرقی","میانه","میانه_و_بخش_مرکزی",67,238,1,0,105,344,0,344
"آذربایجان_شرقی","میانه","میانه_و_بخش_مرکزی",68,191,1,0,48,240,0,240
"آذربایجان_شرقی","میانه","میانه_و_بخش_مرکزی",69,230,2,0,74,306,5,311
"آذربایجان_شرقی","میانه","میانه_و_بخش_مرکزی",70,295,0,0,49,344,5,349
"آذربایجان_شرقی","میانه","میانه_و_بخش_مرکزی",71,265,0,0,10,275,0,275
"آذربایجان_شرقی","میانه","میانه_و_بخش_مرکزی",72,305,1,0,21,327,0,327
"آذربایجان_شرقی","میانه","میانه_و_بخش_مرکزی",73,184,0,0,7,191,1,192
"آذربایجان_شرقی","میانه","میانه_و_بخش_مرکزی",74,406,0,0,16,422,0,422
"آذربایجان_شرقی","میانه","میانه_و_بخش_مرکزی",75,52,1,0,5,58,0,58
"آذربایجان_شرقی","میانه","میانه_و_بخش_مرکزی",76,52,0,0,10,62,0,62
"آذربایجان_شرقی","میانه","میانه_و_بخش_مرکزی",77,397,0,0,42,439,0,439
"آذربایجان_شرقی","میانه","میانه_و_بخش_مرکزی",78,412,0,1,24,437,0,437
"آذربایجان_شرقی","میانه","میانه_و_بخش_مرکزی",79,167,1,0,5,173,0,173
"آذربایجان_شرقی","میانه","میانه_و_بخش_مرکزی",80,277,1,1,18,297,1,298
"آذربایجان_شرقی","میانه","میانه_و_بخش_مرکزی",81,92,2,0,29,123,0,123
"آذربایجان_شرقی","میانه","میانه_و_بخش_مرکزی",82,279,5,0,20,304,0,304
"آذربایجان_شرقی","میانه","میانه_و_بخش_مرکزی",83,157,0,0,31,188,0,188
"آذربایجان_شرقی","میانه","میانه_و_بخش_مرکزی",84,132,2,0,8,142,1,143
"آذربایجان_شرقی","میانه","میانه_و_بخش_مرکزی",85,271,0,1,25,297,2,299
"آذربایجان_شرقی","میانه","میانه_و_بخش_مرکزی",86,325,1,0,17,343,3,346
"آذربایجان_شرقی","میانه","میانه_و_بخش_مرکزی",87,335,1,0,14,350,3,353
"آذربایجان_شرقی","میانه","میانه_و_بخش_مرکزی",88,293,0,2,21,316,1,317
"آذربایجان_شرقی","میانه","میانه_و_بخش_مرکزی",89,32,1,0,4,37,0,37
"آذربایجان_شرقی","میانه","میانه_و_بخش_مرکزی",90,143,0,1,40,184,0,184
"آذربایجان_شرقی","میانه","میانه_و_بخش_مرکزی",91,257,1,1,94,353,1,354
"آذربایجان_شرقی","میانه","میانه_و_بخش_مرکزی",92,139,1,4,46,190,1,191
"آذربایجان_شرقی","میانه","میانه_و_بخش_مرکزی",93,193,0,0,8,201,0,201
"آذربایجان_شرقی","میانه","میانه_و_بخش_مرکزی",94,109,0,0,5,114,0,114
"آذربایجان_شرقی","میانه","میانه_و_بخش_مرکزی",95,188,0,0,10,198,0,198
"آذربایجان_شرقی","میانه","میانه_و_بخش_مرکزی",96,163,0,0,20,183,0,183
"آذربایجان_شرقی","میانه","میانه_و_بخش_مرکزی",97,87,0,0,3,90,2,92
"آذربایجان_شرقی","میانه","میانه_و_بخش_مرکزی",98,83,1,0,9,93,0,93
"آذربایجان_شرقی","میانه","میانه_و_بخش_مرکزی",99,98,0,0,21,119,0,119
"آذربایجان_شرقی","میانه","میانه_و_بخش_مرکزی",100,289,0,0,23,312,1,313
"آذربایجان_شرقی","میانه","کاغدکنان",1,430,7,1,124,562,5,567
"آذربایجان_شرقی","میانه","کاغدکنان",2,353,7,0,171,531,10,541
"آذربایجان_شرقی","میانه","کاغدکنان",3,244,0,0,132,376,1,377
"آذربایجان_شرقی","میانه","کاغدکنان",4,151,1,1,14,167,1,168
"آذربایجان_شرقی","میانه","کاغدکنان",5,115,1,0,8,124,0,124
"آذربایجان_شرقی","میانه","کاغدکنان",6,299,2,0,31,332,2,334
"آذربایجان_شرقی","میانه","کاغدکنان",7,186,0,0,11,197,1,198
"آذربایجان_شرقی","میانه","کاغدکنان",8,184,2,0,33,219,0,219
"آذربایجان_شرقی","میانه","کاغدکنان",9,130,1,0,7,138,3,141
"آذربایجان_شرقی","میانه","کاغدکنان",10,140,1,0,32,173,0,173
"آذربایجان_شرقی","میانه","کاغدکنان",11,242,0,1,41,284,3,287
"آذربایجان_شرقی","میانه","کاغدکنان",12,248,1,0,32,281,3,284
"آذربایجان_شرقی","میانه","کاغدکنان",13,186,0,0,9,195,0,195
"آذربایجان_شرقی","میانه","کاغدکنان",14,52,0,1,55,108,0,108
"آذربایجان_شرقی","میانه","کاغدکنان",15,100,0,0,12,112,0,112
"آذربایجان_شرقی","میانه","کاغدکنان",16,82,1,0,43,126,0,126
"آذربایجان_شرقی","میانه","کاغدکنان",17,110,0,0,16,126,0,126
"آذربایجان_شرقی","میانه","کاغدکنان",18,135,1,0,16,152,3,155
"آذربایجان_شرقی","میانه","کاغدکنان",19,181,1,0,31,213,2,215
"آذربایجان_شرقی","میانه","کاغدکنان",20,89,0,0,42,131,0,131
"آذربایجان_شرقی","میانه","کاغدکنان",21,85,0,0,17,102,0,102
"آذربایجان_شرقی","میانه","کاغدکنان",22,84,1,0,19,104,0,104
"آذربایجان_شرقی","میانه","کاغدکنان",23,154,1,0,35,190,0,190
"آذربایجان_شرقی","میانه","کاغدکنان",24,172,0,0,22,194,1,195
"آذربایجان_شرقی","میانه","کاغدکنان",25,43,1,0,62,106,0,106
"آذربایجان_شرقی","میانه","کاغدکنان",26,133,0,0,12,145,2,147
"آذربایجان_شرقی","میانه","کاغدکنان",27,253,1,0,33,287,0,287
"آذربایجان_شرقی","میانه","کاغدکنان",28,92,0,0,21,113,1,114
"آذربایجان_شرقی","میانه","کاغدکنان",29,107,2,1,22,132,0,132
"آذربایجان_شرقی","میانه","کاغدکنان",30,81,0,0,10,91,0,91
"آذربایجان_شرقی","میانه","ترکنچای",1,401,6,1,396,804,13,817
"آذربایجان_شرقی","میانه","ترکنچای",2,725,3,0,343,1071,6,1077
"آذربایجان_شرقی","میانه","ترکنچای",3,506,2,1,335,844,12,856
"آذربایجان_شرقی","میانه","ترکنچای",4,711,2,1,248,962,7,969
"آذربایجان_شرقی","میانه","ترکنچای",5,338,1,0,46,385,1,386
"آذربایجان_شرقی","میانه","ترکنچای",6,267,1,0,27,295,0,295
"آذربایجان_شرقی","میانه","ترکنچای",7,513,2,1,101,617,7,624
"آذربایجان_شرقی","میانه","ترکنچای",8,805,1,0,44,850,3,853
"آذربایجان_شرقی","میانه","ترکنچای",9,234,0,0,32,266,1,267
"آذربایجان_شرقی","میانه","ترکنچای",10,285,0,0,23,308,0,308
"آذربایجان_شرقی","میانه","ترکنچای",11,240,0,0,50,290,3,293
"آذربایجان_شرقی","میانه","ترکنچای",12,323,1,0,41,365,2,367
"آذربایجان_شرقی","میانه","ترکنچای",13,233,0,3,45,281,0,281
"آذربایجان_شرقی","میانه","ترکنچای",14,325,0,0,24,349,1,350
"آذربایجان_شرقی","میانه","ترکنچای",15,475,0,0,45,520,0,520
"آذربایجان_شرقی","میانه","ترکنچای",16,148,0,0,19,167,0,167
"آذربایجان_شرقی","میانه","ترکنچای",17,145,0,1,84,230,5,235
"آذربایجان_شرقی","میانه","ترکنچای",18,195,0,0,36,231,0,231
"آذربایجان_شرقی","میانه","ترکنچای",19,204,0,0,27,231,0,231
"آذربایجان_شرقی","میانه","ترکنچای",20,98,0,2,47,147,0,147
"آذربایجان_شرقی","میانه","ترکنچای",21,214,1,0,12,227,1,228
"آذربایجان_شرقی","میانه","ترکنچای",22,264,3,0,52,319,2,321
"آذربایجان_شرقی","میانه","ترکنچای",23,88,1,0,24,113,2,115
"آذربایجان_شرقی","میانه","ترکنچای",24,251,0,1,31,283,0,283
"آذربایجان_شرقی","میانه","ترکنچای",25,186,5,0,50,241,3,244
"آذربایجان_شرقی","میانه","ترکنچای",26,311,2,0,45,358,2,360
"آذربایجان_شرقی","میانه","ترکنچای",27,178,2,1,60,241,3,244
"آذربایجان_شرقی","میانه","ترکنچای",28,248,2,0,45,295,2,297
"آذربایجان_شرقی","میانه","ترکنچای",29,155,0,0,82,237,0,237
"آذربایجان_شرقی","میانه","ترکنچای",30,224,0,1,30,255,4,259
"آذربایجان_شرقی","میانه","ترکنچای",31,79,0,0,51,130,1,131
"آذربایجان_شرقی","میانه","ترکنچای",32,281,2,0,37,320,1,321
"آذربایجان_شرقی","میانه","ترکنچای",33,161,1,0,39,201,2,203
"آذربایجان_شرقی","میانه","ترکنچای",34,78,3,0,25,106,0,106
"آذربایجان_شرقی","میانه","ترکنچای",35,209,0,0,68,277,0,277
"آذربایجان_شرقی","میانه","ترکنچای",36,158,2,0,58,218,2,220
"آذربایجان_شرقی","میانه","ترکنچای",37,307,1,0,105,413,3,416
"آذربایجان_شرقی","میانه","کندوان",1,448,2,0,206,656,3,659
"آذربایجان_شرقی","میانه","کندوان",2,498,7,0,114,619,4,623
"آذربایجان_شرقی","میانه","کندوان",3,238,0,2,75,315,3,318
"آذربایجان_شرقی","میانه","کندوان",4,336,0,1,19,356,1,357
"آذربایجان_شرقی","میانه","کندوان",5,92,0,0,9,101,0,101
"آذربایجان_شرقی","میانه","کندوان",6,309,2,1,164,476,6,482
"آذربایجان_شرقی","میانه","کندوان",7,435,4,0,103,542,0,542
"آذربایجان_شرقی","میانه","کندوان",8,210,0,0,57,267,1,268
"آذربایجان_شرقی","میانه","کندوان",9,207,1,1,128,337,15,352
"آذربایجان_شرقی","میانه","کندوان",10,156,0,1,20,177,2,179
"آذربایجان_شرقی","میانه","کندوان",11,326,4,0,66,396,3,399
"آذربایجان_شرقی","میانه","کندوان",12,294,1,0,46,341,0,341
"آذربایجان_شرقی","میانه","کندوان",13,265,1,0,87,353,2,355
"آذربایجان_شرقی","میانه","کندوان",14,241,1,0,20,262,1,263
"آذربایجان_شرقی","میانه","کندوان",15,180,0,0,7,187,2,189
"آذربایجان_شرقی","میانه","کندوان",16,225,0,1,26,252,2,254
"آذربایجان_شرقی","میانه","کندوان",17,70,1,0,48,119,0,119
"آذربایجان_شرقی","میانه","کندوان",18,139,0,0,41,180,0,180
"آذربایجان_شرقی","میانه","کندوان",19,447,4,0,121,572,3,575
"آذربایجان_شرقی","میانه","کندوان",20,221,0,0,21,242,0,242
"آذربایجان_شرقی","میانه","کندوان",21,327,0,0,15,342,0,342
"آذربایجان_شرقی","میانه","کندوان",22,504,1,0,56,561,7,568
"آذربایجان_شرقی","میانه","کندوان",23,305,2,0,195,502,0,502
"آذربایجان_شرقی","میانه","کندوان",24,240,1,0,43,284,0,284
"آذربایجان_شرقی","میانه","کندوان",25,257,0,0,73,330,0,330
"آذربایجان_شرقی","میانه","کندوان",26,255,0,0,48,303,8,311
"آذربایجان_شرقی","میانه","کندوان",27,89,0,0,16,105,1,106
"آذربایجان_شرقی","میانه","کندوان",28,208,0,0,6,214,0,214
"آذربایجان_شرقی","میانه","کندوان",29,415,1,0,47,463,5,468
"آذربایجان_شرقی","میانه","کندوان",30,347,0,0,86,433,2,435
"آذربایجان_شرقی","میانه","کندوان",31,272,0,0,27,299,1,300
"آذربایجان_شرقی","میانه","کندوان",32,205,0,0,39,244,1,245
"آذربایجان_شرقی","میانه","کندوان",33,267,1,0,32,300,0,300
"آذربایجان_شرقی","میانه","کندوان",34,210,1,0,35,246,0,246
"آذربایجان_شرقی","میانه","کندوان",35,311,0,0,70,381,1,382
"آذربایجان_شرقی","میانه","کندوان",36,102,1,0,26,129,0,129
"آذربایجان_شرقی","میانه","کندوان",37,135,0,0,17,152,0,152
"آذربایجان_شرقی","میانه","کندوان",38,286,0,1,15,302,0,302
"آذربایجان_شرقی","میانه","کندوان",39,171,1,0,30,202,0,202
"آذربایجان_شرقی","میانه","کندوان",40,93,0,0,12,105,1,106
"آذربایجان_شرقی","میانه","کندوان",41,193,0,1,15,209,0,209
"آذربایجان_شرقی","میانه","کندوان",42,310,4,1,57,372,1,373
"آذربایجان_شرقی","میانه","کندوان",43,68,0,0,10,78,0,78
"آذربایجان_شرقی","هریس","مرکزی",1,507,15,1,516,1039,10,1049
"آذربایجان_شرقی","هریس","مرکزی",2,304,16,2,609,931,9,940
"آذربایجان_شرقی","هریس","مرکزی",3,558,7,4,399,968,16,984
"آذربایجان_شرقی","هریس","مرکزی",4,650,9,0,350,1009,12,1021
"آذربایجان_شرقی","هریس","مرکزی",5,550,8,0,385,943,5,948
"آذربایجان_شرقی","هریس","مرکزی",6,366,6,1,267,640,3,643
"آذربایجان_شرقی","هریس","مرکزی",7,83,1,1,44,129,0,129
"آذربایجان_شرقی","هریس","مرکزی",8,308,1,1,65,375,1,376
"آذربایجان_شرقی","هریس","مرکزی",9,240,1,0,58,299,1,300
"آذربایجان_شرقی","هریس","مرکزی",10,42,0,0,27,69,0,69
"آذربایجان_شرقی","هریس","مرکزی",11,120,0,2,247,369,1,370
"آذربایجان_شرقی","هریس","مرکزی",12,514,10,3,486,1013,35,1048
"آذربایجان_شرقی","هریس","مرکزی",13,336,9,1,191,537,1,538
"آذربایجان_شرقی","هریس","مرکزی",14,476,4,2,255,737,7,744
"آذربایجان_شرقی","هریس","مرکزی",15,119,1,3,152,275,0,275
"آذربایجان_شرقی","هریس","مرکزی",16,223,1,2,407,633,6,639
"آذربایجان_شرقی","هریس","مرکزی",17,432,11,3,545,991,9,1000
"آذربایجان_شرقی","هریس","مرکزی",18,581,2,3,455,1041,2,1043
"آذربایجان_شرقی","هریس","مرکزی",19,381,1,2,331,715,1,716
"آذربایجان_شرقی","هریس","مرکزی",20,692,9,0,233,934,13,947
"آذربایجان_شرقی","هریس","مرکزی",21,672,1,1,149,823,12,835
"آذربایجان_شرقی","هریس","مرکزی",22,609,2,0,123,734,6,740
"آذربایجان_شرقی","هریس","مرکزی",23,326,2,0,148,476,1,477
"آذربایجان_شرقی","هریس","مرکزی",24,455,1,2,76,534,3,537
"آذربایجان_شرقی","هریس","مرکزی",25,229,1,0,24,254,0,254
"آذربایجان_شرقی","هریس","مرکزی",26,149,0,1,62,212,2,214
"آذربایجان_شرقی","هریس","مرکزی",27,162,1,0,59,222,1,223
"آذربایجان_شرقی","هریس","مرکزی",28,255,0,0,18,273,1,274
"آذربایجان_شرقی","هریس","مرکزی",29,159,2,0,36,197,4,201
"آذربایجان_شرقی","هریس","مرکزی",30,168,2,2,39,211,2,213
"آذربایجان_شرقی","هریس","مرکزی",31,118,0,1,28,147,0,147
"آذربایجان_شرقی","هریس","مرکزی",32,207,1,0,52,260,1,261
"آذربایجان_شرقی","هریس","مرکزی",33,250,1,0,37,288,1,289
"آذربایجان_شرقی","هریس","مرکزی",34,287,3,0,65,355,2,357
"آذربایجان_شرقی","هریس","مرکزی",35,316,2,0,32,350,0,350
"آذربایجان_شرقی","هریس","مرکزی",36,286,0,0,39,325,1,326
"آذربایجان_شرقی","هریس","مرکزی",37,317,1,0,34,352,0,352
"آذربایجان_شرقی","هریس","مرکزی",38,35,0,0,56,91,0,91
"آذربایجان_شرقی","هریس","مرکزی",39,251,1,3,93,348,2,350
"آذربایجان_شرقی","هریس","مرکزی",40,187,1,19,44,251,0,251
"آذربایجان_شرقی","هریس","مرکزی",41,69,0,0,11,80,0,80
"آذربایجان_شرقی","هریس","مرکزی",42,192,0,0,54,246,2,248
"آذربایجان_شرقی","هریس","مرکزی",43,139,1,0,108,248,1,249
"آذربایجان_شرقی","هریس","مرکزی",44,72,1,0,22,95,0,95
"آذربایجان_شرقی","هریس","مرکزی",45,158,0,1,62,221,3,224
"آذربایجان_شرقی","هریس","مرکزی",46,236,1,0,52,289,1,290
"آذربایجان_شرقی","هریس","مرکزی",47,121,0,0,53,174,0,174
"آذربایجان_شرقی","هریس","مرکزی",48,145,0,1,97,243,1,244
"آذربایجان_شرقی","هریس","مرکزی",49,149,3,0,43,195,0,195
"آذربایجان_شرقی","هریس","خواجه",1,358,4,3,326,691,21,712
"آذربایجان_شرقی","هریس","خواجه",2,517,10,0,291,818,9,827
"آذربایجان_شرقی","هریس","خواجه",3,353,0,0,525,878,10,888
"آذربایجان_شرقی","هریس","خواجه",4,181,0,0,119,300,1,301
"آذربایجان_شرقی","هریس","خواجه",5,158,2,0,189,349,2,351
"آذربایجان_شرقی","هریس","خواجه",6,427,2,0,62,491,1,492
"آذربایجان_شرقی","هریس","خواجه",7,242,0,1,197,440,9,449
"آذربایجان_شرقی","هریس","خواجه",8,329,1,0,132,462,1,463
"آذربایجان_شرقی","هریس","خواجه",9,432,8,0,422,862,7,869
"آذربایجان_شرقی","هریس","خواجه",10,531,1,0,275,807,12,819
"آذربایجان_شرقی","هریس","خواجه",11,314,13,0,116,443,6,449
"آذربایجان_شرقی","هریس","خواجه",12,363,3,3,137,506,2,508
"آذربایجان_شرقی","هریس","خواجه",13,529,0,1,61,591,1,592
"آذربایجان_شرقی","هریس","خواجه",14,247,1,0,100,348,6,354
"آذربایجان_شرقی","هریس","خواجه",15,74,0,0,26,100,0,100
"آذربایجان_شرقی","هریس","خواجه",16,402,4,1,212,619,6,625
"آذربایجان_شرقی","هریس","خواجه",17,252,1,0,155,408,7,415
"آذربایجان_شرقی","هریس","خواجه",18,338,2,1,104,445,2,447
"آذربایجان_شرقی","هریس","خواجه",19,285,2,0,160,447,5,452
"آذربایجان_شرقی","هریس","خواجه",20,376,1,0,70,447,3,450
"آذربایجان_شرقی","هریس","خواجه",21,608,1,0,56,665,10,675
"آذربایجان_شرقی","هریس","خواجه",22,363,4,1,116,484,2,486
"آذربایجان_شرقی","هریس","خواجه",23,222,2,1,90,315,5,320
"آذربایجان_شرقی","هریس","خواجه",24,217,3,0,33,253,15,268
"آذربایجان_شرقی","هریس","خواجه",25,496,3,0,147,646,7,653
"آذربایجان_شرقی","هریس","خواجه",26,174,0,0,48,222,2,224
"آذربایجان_شرقی","هریس","خواجه",27,375,0,8,51,434,3,437
"آذربایجان_شرقی","هریس","خواجه",28,193,2,0,31,226,2,228
"آذربایجان_شرقی","هریس","خواجه",29,122,0,0,124,246,0,246
"آذربایجان_شرقی","هریس","خواجه",30,212,1,0,131,344,4,348
"آذربایجان_شرقی","هریس","خواجه",31,162,0,0,52,214,7,221
"آذربایجان_شرقی","هریس","خواجه",32,241,0,0,14,255,1,256
"آذربایجان_شرقی","هریس","خواجه",33,85,1,0,58,144,0,144
"آذربایجان_شرقی","هریس","خواجه",34,340,0,0,50,390,0,390
"آذربایجان_شرقی","هریس","خواجه",35,264,1,0,42,307,3,310
"آذربایجان_شرقی","هریس","خواجه",36,86,0,0,21,107,2,109
"آذربایجان_شرقی","هریس","خواجه",37,104,0,1,27,132,2,134
"آذربایجان_شرقی","هریس","خواجه",38,169,3,0,72,244,8,252
"آذربایجان_شرقی","هریس","خواجه",39,317,0,0,28,345,1,346
"آذربایجان_شرقی","هریس","خواجه",40,138,1,0,7,146,1,147
"آذربایجان_شرقی","هریس","خواجه",41,153,1,0,69,223,6,229
"آذربایجان_شرقی","هشترود","مرکزی",1,333,11,1,795,1140,9,1149
"آذربایجان_شرقی","هشترود","مرکزی",2,444,11,5,526,986,17,1003
"آذربایجان_شرقی","هشترود","مرکزی",3,362,12,5,715,1094,8,1102
"آذربایجان_شرقی","هشترود","مرکزی",4,188,2,0,338,528,4,532
"آذربایجان_شرقی","هشترود","مرکزی",5,316,7,0,341,664,2,666
"آذربایجان_شرقی","هشترود","مرکزی",6,203,4,3,473,683,8,691
"آذربایجان_شرقی","هشترود","مرکزی",7,159,8,0,414,581,8,589
"آذربایجان_شرقی","هشترود","مرکزی",8,274,3,0,385,662,5,667
"آذربایجان_شرقی","هشترود","مرکزی",9,228,4,1,161,394,2,396
"آذربایجان_شرقی","هشترود","مرکزی",10,127,3,2,213,345,7,352
"آذربایجان_شرقی","هشترود","مرکزی",11,358,12,1,370,741,9,750
"آذربایجان_شرقی","هشترود","مرکزی",12,343,3,2,264,612,8,620
"آذربایجان_شرقی","هشترود","مرکزی",13,233,3,2,174,412,6,418
"آذربایجان_شرقی","هشترود","مرکزی",14,176,2,3,294,475,2,477
"آذربایجان_شرقی","هشترود","مرکزی",15,196,7,4,454,661,3,664
"آذربایجان_شرقی","هشترود","مرکزی",16,190,2,1,291,484,3,487
"آذربایجان_شرقی","هشترود","مرکزی",17,208,3,0,170,381,3,384
"آذربایجان_شرقی","هشترود","مرکزی",18,133,2,0,118,253,2,255
"آذربایجان_شرقی","هشترود","مرکزی",19,229,0,2,160,391,4,395
"آذربایجان_شرقی","هشترود","مرکزی",20,119,1,0,183,303,3,306
"آذربایجان_شرقی","هشترود","مرکزی",21,97,2,0,180,279,2,281
"آذربایجان_شرقی","هشترود","مرکزی",22,176,1,0,179,356,6,362
"آذربایجان_شرقی","هشترود","مرکزی",23,300,0,0,105,405,3,408
"آذربایجان_شرقی","هشترود","مرکزی",24,237,1,0,143,381,1,382
"آذربایجان_شرقی","هشترود","مرکزی",25,177,1,0,155,333,1,334
"آذربایجان_شرقی","هشترود","مرکزی",26,224,2,2,121,349,3,352
"آذربایجان_شرقی","هشترود","مرکزی",27,151,0,2,215,368,1,369
"آذربایجان_شرقی","هشترود","مرکزی",28,298,3,0,87,388,2,390
"آذربایجان_شرقی","هشترود","مرکزی",29,188,0,0,120,308,4,312
"آذربایجان_شرقی","هشترود","مرکزی",30,308,0,2,92,402,2,404
"آذربایجان_شرقی","هشترود","مرکزی",31,249,0,0,67,316,0,316
"آذربایجان_شرقی","هشترود","مرکزی",32,322,1,2,260,585,3,588
"آذربایجان_شرقی","هشترود","مرکزی",33,150,0,0,29,179,1,180
"آذربایجان_شرقی","هشترود","مرکزی",34,250,0,0,64,314,1,315
"آذربایجان_شرقی","هشترود","مرکزی",35,55,3,4,49,111,0,111
"آذربایجان_شرقی","هشترود","مرکزی",36,109,4,0,45,158,1,159
"آذربایجان_شرقی","هشترود","مرکزی",37,184,0,0,148,332,1,333
"آذربایجان_شرقی","هشترود","مرکزی",38,173,1,0,49,223,5,228
"آذربایجان_شرقی","هشترود","مرکزی",39,172,1,0,80,253,3,256
"آذربایجان_شرقی","هشترود","مرکزی",40,97,0,0,130,227,1,228
"آذربایجان_شرقی","هشترود","مرکزی",41,276,1,0,196,473,7,480
"آذربایجان_شرقی","هشترود","مرکزی",42,180,1,1,99,281,0,281
"آذربایجان_شرقی","هشترود","مرکزی",43,126,0,0,89,215,0,215
"آذربایجان_شرقی","هشترود","مرکزی",44,181,2,0,272,455,7,462
"آذربایجان_شرقی","هشترود","مرکزی",45,143,0,1,123,267,4,271
"آذربایجان_شرقی","هشترود","مرکزی",46,353,1,2,120,476,3,479
"آذربایجان_شرقی","هشترود","مرکزی",47,183,4,0,169,356,6,362
"آذربایجان_شرقی","هشترود","مرکزی",48,126,1,0,37,164,0,164
"آذربایجان_شرقی","هشترود","مرکزی",49,225,1,0,86,312,3,315
"آذربایجان_شرقی","هشترود","مرکزی",50,192,3,3,72,270,3,273
"آذربایجان_شرقی","هشترود","مرکزی",51,208,0,5,192,405,1,406
"آذربایجان_شرقی","هشترود","مرکزی",52,245,1,0,104,350,0,350
"آذربایجان_شرقی","هشترود","مرکزی",53,152,1,0,103,256,1,257
"آذربایجان_شرقی","هشترود","مرکزی",54,332,0,1,89,422,0,422
"آذربایجان_شرقی","هشترود","مرکزی",55,164,1,0,49,214,1,215
"آذربایجان_شرقی","هشترود","مرکزی",56,226,2,1,207,436,0,436
"آذربایجان_شرقی","هشترود","مرکزی",57,97,0,0,149,246,2,248
"آذربایجان_شرقی","هشترود","مرکزی",58,38,0,0,142,180,0,180
"آذربایجان_شرقی","هشترود","مرکزی",59,109,0,0,152,261,1,262
"آذربایجان_شرقی","هشترود","مرکزی",60,59,0,0,63,122,2,124
"آذربایجان_شرقی","هشترود","مرکزی",61,57,0,0,53,110,1,111
"آذربایجان_شرقی","هشترود","مرکزی",62,391,0,0,70,461,7,468
"آذربایجان_شرقی","هشترود","نظرکهریزی",1,234,2,0,102,338,0,338
"آذربایجان_شرقی","هشترود","نظرکهریزی",2,279,2,0,80,361,0,361
"آذربایجان_شرقی","هشترود","نظرکهریزی",3,99,0,0,168,267,1,268
"آذربایجان_شرقی","هشترود","نظرکهریزی",4,137,3,0,83,223,3,226
"آذربایجان_شرقی","هشترود","نظرکهریزی",5,158,0,0,97,255,0,255
"آذربایجان_شرقی","هشترود","نظرکهریزی",6,183,4,0,52,239,1,240
"آذربایجان_شرقی","هشترود","نظرکهریزی",7,151,0,0,56,207,1,208
"آذربایجان_شرقی","هشترود","نظرکهریزی",8,212,0,0,130,342,0,342
"آذربایجان_شرقی","هشترود","نظرکهریزی",9,106,0,0,19,125,8,133
"آذربایجان_شرقی","هشترود","نظرکهریزی",10,388,0,0,105,493,2,495
"آذربایجان_شرقی","هشترود","نظرکهریزی",11,374,7,1,26,408,0,408
"آذربایجان_شرقی","هشترود","نظرکهریزی",12,210,2,0,54,266,0,266
"آذربایجان_شرقی","هشترود","نظرکهریزی",13,162,7,0,69,238,0,238
"آذربایجان_شرقی","هشترود","نظرکهریزی",14,326,1,1,81,409,1,410
"آذربایجان_شرقی","هشترود","نظرکهریزی",15,354,0,0,52,406,0,406
"آذربایجان_شرقی","هشترود","نظرکهریزی",16,314,1,1,102,418,0,418
"آذربایجان_شرقی","هشترود","نظرکهریزی",17,277,1,0,108,386,0,386
"آذربایجان_شرقی","هشترود","نظرکهریزی",18,190,0,0,70,260,1,261
"آذربایجان_شرقی","هشترود","نظرکهریزی",19,512,0,0,39,551,0,551
"آذربایجان_شرقی","هشترود","نظرکهریزی",20,254,0,0,92,346,0,346
"آذربایجان_شرقی","هشترود","نظرکهریزی",21,215,0,0,19,234,1,235
"آذربایجان_شرقی","هشترود","نظرکهریزی",22,197,0,0,97,294,6,300
"آذربایجان_شرقی","هشترود","نظرکهریزی",23,167,0,0,73,240,2,242
"آذربایجان_شرقی","هشترود","نظرکهریزی",24,147,0,1,68,216,3,219
"آذربایجان_شرقی","هشترود","نظرکهریزی",25,311,0,1,101,413,1,414
"آذربایجان_شرقی","هشترود","نظرکهریزی",26,259,0,0,27,286,2,288
"آذربایجان_شرقی","هشترود","نظرکهریزی",27,206,0,7,91,304,2,306
"آذربایجان_شرقی","هشترود","نظرکهریزی",28,153,2,1,23,179,2,181
"آذربایجان_شرقی","هشترود","نظرکهریزی",29,232,1,0,38,271,2,273
"آذربایجان_شرقی","هشترود","نظرکهریزی",30,77,0,0,6,83,0,83
"آذربایجان_شرقی","ورزقان","مرکزی",1,354,6,2,331,693,15,708
"آذربایجان_شرقی","ورزقان","مرکزی",2,316,6,1,301,624,10,634
"آذربایجان_شرقی","ورزقان","مرکزی",3,348,7,3,540,898,13,911
"آذربایجان_شرقی","ورزقان","مرکزی",4,256,9,0,521,786,17,803
"آذربایجان_شرقی","ورزقان","مرکزی",5,310,0,5,234,549,18,567
"آذربایجان_شرقی","ورزقان","مرکزی",6,313,1,2,327,643,9,652
"آذربایجان_شرقی","ورزقان","مرکزی",7,352,3,1,164,520,7,527
"آذربایجان_شرقی","ورزقان","مرکزی",8,219,1,1,171,392,16,408
"آذربایجان_شرقی","ورزقان","مرکزی",9,179,1,0,212,392,8,400
"آذربایجان_شرقی","ورزقان","مرکزی",10,93,3,1,153,250,13,263
"آذربایجان_شرقی","ورزقان","مرکزی",11,120,0,2,158,280,12,292
"آذربایجان_شرقی","ورزقان","مرکزی",12,281,0,0,96,377,17,394
"آذربایجان_شرقی","ورزقان","مرکزی",13,250,0,1,194,445,10,455
"آذربایجان_شرقی","ورزقان","مرکزی",14,303,0,0,85,388,4,392
"آذربایجان_شرقی","ورزقان","مرکزی",15,123,0,0,170,293,5,298
"آذربایجان_شرقی","ورزقان","مرکزی",16,153,0,0,31,184,2,186
"آذربایجان_شرقی","ورزقان","مرکزی",17,54,0,0,35,89,2,91
"آذربایجان_شرقی","ورزقان","مرکزی",18,253,0,0,106,359,8,367
"آذربایجان_شرقی","ورزقان","مرکزی",19,396,0,0,283,679,11,690
"آذربایجان_شرقی","ورزقان","مرکزی",20,187,1,0,105,293,7,300
"آذربایجان_شرقی","ورزقان","مرکزی",21,185,1,0,72,258,18,276
"آذربایجان_شرقی","ورزقان","مرکزی",22,168,0,0,102,270,4,274
"آذربایجان_شرقی","ورزقان","مرکزی",23,59,0,0,8,67,0,67
"آذربایجان_شرقی","ورزقان","مرکزی",24,90,0,0,27,117,4,121
"آذربایجان_شرقی","ورزقان","مرکزی",25,67,0,0,9,76,2,78
"آذربایجان_شرقی","ورزقان","مرکزی",26,203,0,0,8,211,5,216
"آذربایجان_شرقی","ورزقان","مرکزی",27,380,0,1,121,502,11,513
"آذربایجان_شرقی","ورزقان","مرکزی",28,223,2,2,303,530,10,540
"آذربایجان_شرقی","ورزقان","مرکزی",29,502,2,2,154,660,21,681
"آذربایجان_شرقی","ورزقان","مرکزی",30,630,0,1,171,802,17,819
"آذربایجان_شرقی","ورزقان","مرکزی",31,155,0,0,74,229,4,233
"آذربایجان_شرقی","ورزقان","مرکزی",32,328,1,4,92,425,16,441
"آذربایجان_شرقی","ورزقان","مرکزی",33,387,1,0,38,426,12,438
"آذربایجان_شرقی","ورزقان","مرکزی",34,299,0,0,28,327,0,327
"آذربایجان_شرقی","ورزقان","مرکزی",35,181,0,0,47,228,15,243
"آذربایجان_شرقی","ورزقان","مرکزی",36,453,2,2,64,521,4,525
"آذربایجان_شرقی","ورزقان","مرکزی",37,420,2,0,49,471,4,475
"آذربایجان_شرقی","ورزقان","مرکزی",38,62,0,0,68,130,1,131
"آذربایجان_شرقی","ورزقان","مرکزی",39,224,0,0,64,288,2,290
"آذربایجان_شرقی","ورزقان","مرکزی",40,156,1,0,55,212,0,212
"آذربایجان_شرقی","ورزقان","مرکزی",41,49,0,0,14,63,0,63
"آذربایجان_شرقی","ورزقان","مرکزی",42,123,1,0,42,166,2,168
"آذربایجان_شرقی","ورزقان","مرکزی",43,436,0,4,114,554,17,571
"آذربایجان_شرقی","ورزقان","مرکزی",44,314,0,1,111,426,3,429
"آذربایجان_شرقی","ورزقان","مرکزی",45,305,1,0,339,645,5,650
"آذربایجان_شرقی","ورزقان","مرکزی",46,197,2,0,344,543,7,550
"آذربایجان_شرقی","ورزقان","مرکزی",47,392,1,2,74,469,16,485
"آذربایجان_شرقی","ورزقان","مرکزی",48,283,6,1,46,336,5,341
"آذربایجان_شرقی","ورزقان","مرکزی",49,187,0,0,50,237,21,258
"آذربایجان_شرقی","ورزقان","مرکزی",50,263,0,0,16,279,6,285
"آذربایجان_شرقی","ورزقان","مرکزی",51,192,0,0,77,269,3,272
"آذربایجان_شرقی","ورزقان","مرکزی",52,349,0,0,226,575,6,581
"آذربایجان_شرقی","ورزقان","مرکزی",53,227,0,0,135,362,8,370
"آذربایجان_شرقی","ورزقان","مرکزی",54,192,2,1,147,342,4,346
"آذربایجان_شرقی","ورزقان","مرکزی",55,434,0,0,354,788,10,798
"آذربایجان_شرقی","ورزقان","مرکزی",56,374,2,0,434,810,18,828
"آذربایجان_شرقی","ورزقان","مرکزی",57,271,1,0,119,391,3,394
"آذربایجان_شرقی","ورزقان","مرکزی",58,248,1,0,209,458,22,480
"آذربایجان_شرقی","ورزقان","مرکزی",59,224,2,1,123,350,5,355
"آذربایجان_شرقی","ورزقان","مرکزی",60,171,3,0,62,236,5,241
"آذربایجان_شرقی","ورزقان","مرکزی",61,103,0,0,27,130,2,132
"آذربایجان_شرقی","ورزقان","مرکزی",62,149,0,0,75,224,0,224
"آذربایجان_شرقی","ورزقان","مرکزی",63,41,1,0,63,105,1,106
"آذربایجان_شرقی","ورزقان","خاروانا",1,197,1,1,334,533,17,550
"آذربایجان_شرقی","ورزقان","خاروانا",2,333,4,5,269,611,11,622
"آذربایجان_شرقی","ورزقان","خاروانا",3,140,0,2,68,210,14,224
"آذربایجان_شرقی","ورزقان","خاروانا",4,42,0,0,65,107,5,112
"آذربایجان_شرقی","ورزقان","خاروانا",5,61,0,0,19,80,4,84
"آذربایجان_شرقی","ورزقان","خاروانا",6,274,1,3,138,416,9,425
"آذربایجان_شرقی","ورزقان","خاروانا",7,204,0,0,19,223,0,223
"آذربایجان_شرقی","ورزقان","خاروانا",8,96,0,0,49,145,1,146
"آذربایجان_شرقی","ورزقان","خاروانا",9,91,0,0,31,122,5,127
"آذربایجان_شرقی","ورزقان","خاروانا",10,78,0,0,40,118,3,121
"آذربایجان_شرقی","ورزقان","خاروانا",11,90,0,0,14,104,1,105
"آذربایجان_شرقی","ورزقان","خاروانا",12,83,0,0,63,146,0,146
"آذربایجان_شرقی","ورزقان","خاروانا",13,112,0,0,30,142,0,142
"آذربایجان_شرقی","ورزقان","خاروانا",14,284,1,1,61,347,5,352
"آذربایجان_شرقی","ورزقان","خاروانا",15,223,4,2,49,278,12,290
"آذربایجان_شرقی","ورزقان","خاروانا",16,272,3,2,55,332,17,349
"آذربایجان_شرقی","ورزقان","خاروانا",17,341,0,0,17,358,0,358
"آذربایجان_شرقی","ورزقان","خاروانا",18,81,2,0,23,106,2,108
"آذربایجان_شرقی","ورزقان","خاروانا",19,141,0,2,12,155,2,157
"آذربایجان_شرقی","ورزقان","خاروانا",20,373,1,1,130,505,26,531
"آذربایجان_شرقی","ورزقان","خاروانا",21,93,0,0,15,108,1,109
"آذربایجان_شرقی","ورزقان","خاروانا",22,218,0,1,62,281,12,293
"آذربایجان_شرقی","ورزقان","خاروانا",23,336,3,1,50,390,6,396
"آذربایجان_شرقی","ورزقان","خاروانا",24,315,4,8,60,387,11,398
"آذربایجان_شرقی","ورزقان","خاروانا",25,213,1,0,83,297,2,299
"آذربایجان_شرقی","ورزقان","خاروانا",26,120,2,0,52,174,4,178
"آذربایجان_شرقی","ورزقان","خاروانا",27,81,2,1,110,194,1,195
"آذربایجان_شرقی","ورزقان","خاروانا",28,37,0,0,33,70,0,70
"آذربایجان_شرقی","ورزقان","خاروانا",29,190,2,0,75,267,6,273
"آذربایجان_شرقی","ورزقان","خاروانا",30,110,0,0,82,192,4,196
"آذربایجان_شرقی","ورزقان","خاروانا",31,33,0,0,7,40,0,40
"آذربایجان_شرقی","ورزقان","خاروانا",32,32,0,0,9,41,0,41
"آذربایجان_شرقی","ورزقان","خاروانا",33,44,1,1,57,103,2,105
"آذربایجان_غربی","ارومیه","مرکزی",1,1225,0,7,475,1707,14,1721
"آذربایجان_غربی","ارومیه","مرکزی",2,1608,14,4,599,2225,13,2238
"آذربایجان_غربی","ارومیه","مرکزی",3,1732,19,5,753,2509,13,2522
"آذربایجان_غربی","ارومیه","مرکزی",4,1627,6,1,650,2284,68,2352
"آذربایجان_غربی","ارومیه","مرکزی",5,1167,14,4,476,1661,9,1670
"آذربایجان_غربی","ارومیه","مرکزی",6,1685,7,5,450,2147,13,2160
"آذربایجان_غربی","ارومیه","مرکزی",7,1329,3,6,481,1819,9,1828
"آذربایجان_غربی","ارومیه","مرکزی",8,1401,8,7,586,2002,10,2012
"آذربایجان_غربی","ارومیه","مرکزی",9,1200,24,7,673,1904,13,1917
"آذربایجان_غربی","ارومیه","مرکزی",10,1344,15,11,830,2200,19,2219
"آذربایجان_غربی","ارومیه","مرکزی",11,1048,7,8,390,1453,18,1471
"آذربایجان_غربی","ارومیه","مرکزی",12,1554,22,16,785,2377,26,2403
"آذربایجان_غربی","ارومیه","مرکزی",13,1269,16,2,692,1979,27,2006
"آذربایجان_غربی","ارومیه","مرکزی",14,1259,10,5,632,1906,15,1921
"آذربایجان_غربی","ارومیه","مرکزی",15,1095,7,5,525,1632,7,1639
"آذربایجان_غربی","ارومیه","مرکزی",16,895,11,7,558,1471,2,1473
"آذربایجان_غربی","ارومیه","مرکزی",17,1014,14,5,361,1394,7,1401
"آذربایجان_غربی","ارومیه","مرکزی",18,809,9,3,358,1179,13,1192
"آذربایجان_غربی","ارومیه","مرکزی",19,1541,7,0,462,2010,9,2019
"آذربایجان_غربی","ارومیه","مرکزی",20,1191,7,3,404,1605,5,1610
"آذربایجان_غربی","ارومیه","مرکزی",21,1343,12,8,461,1824,4,1828
"آذربایجان_غربی","ارومیه","مرکزی",22,996,2,1,213,1212,13,1225
"آذربایجان_غربی","ارومیه","مرکزی",23,1885,10,73,373,2341,9,2350
"آذربایجان_غربی","ارومیه","مرکزی",24,1896,7,2,286,2191,14,2205
"آذربایجان_غربی","ارومیه","مرکزی",25,1865,8,7,448,2328,0,2328
"آذربایجان_غربی","ارومیه","مرکزی",26,1706,8,28,642,2384,9,2393
"آذربایجان_غربی","ارومیه","مرکزی",27,1631,6,13,618,2268,7,2275
"آذربایجان_غربی","ارومیه","مرکزی",28,2399,24,10,903,3336,12,3348
"آذربایجان_غربی","ارومیه","مرکزی",29,981,14,5,465,1465,13,1478
"آذربایجان_غربی","ارومیه","مرکزی",30,1500,16,7,704,2227,8,2235
"آذربایجان_غربی","ارومیه","مرکزی",31,1456,19,7,791,2273,107,2380
"آذربایجان_غربی","ارومیه","مرکزی",32,1172,6,7,456,1641,7,1648
"آذربایجان_غربی","ارومیه","مرکزی",33,1507,9,4,449,1969,10,1979
"آذربایجان_غربی","ارومیه","مرکزی",34,1628,5,4,359,1996,12,2008
"آذربایجان_غربی","ارومیه","مرکزی",35,1285,14,6,437,1742,6,1748
"آذربایجان_غربی","ارومیه","مرکزی",36,774,14,3,593,1384,10,1394
"آذربایجان_غربی","ارومیه","مرکزی",37,1091,17,6,696,1810,13,1823
"آذربایجان_غربی","ارومیه","مرکزی",38,1069,9,4,433,1515,8,1523
"آذربایجان_غربی","ارومیه","مرکزی",39,1209,13,0,415,1637,13,1650
"آذربایجان_غربی","ارومیه","مرکزی",40,820,5,0,516,1341,13,1354
"آذربایجان_غربی","ارومیه","مرکزی",41,610,13,38,1036,1697,25,1722
"آذربایجان_غربی","ارومیه","مرکزی",42,953,21,6,533,1513,7,1520
"آذربایجان_غربی","ارومیه","مرکزی",43,1251,17,9,557,1834,10,1844
"آذربایجان_غربی","ارومیه","مرکزی",44,759,21,8,557,1345,6,1351
"آذربایجان_غربی","ارومیه","مرکزی",45,648,14,7,351,1020,4,1024
"آذربایجان_غربی","ارومیه","مرکزی",46,864,13,5,790,1672,9,1681
"آذربایجان_غربی","ارومیه","مرکزی",47,1238,9,13,872,2132,7,2139
"آذربایجان_غربی","ارومیه","مرکزی",48,1373,4,14,735,2126,25,2151
"آذربایجان_غربی","ارومیه","مرکزی",49,656,12,73,994,1735,14,1749
"آذربایجان_غربی","ارومیه","مرکزی",50,844,15,15,989,1863,14,1877
"آذربایجان_غربی","ارومیه","مرکزی",51,1870,12,20,678,2580,17,2597
"آذربایجان_غربی","ارومیه","مرکزی",52,1093,11,28,888,2020,12,2032
"آذربایجان_غربی","ارومیه","مرکزی",53,545,10,80,1037,1672,21,1693
"آذربایجان_غربی","ارومیه","مرکزی",54,1057,9,4,792,1862,0,1862
"آذربایجان_غربی","ارومیه","مرکزی",55,922,6,12,584,1524,10,1534
"آذربایجان_غربی","ارومیه","مرکزی",56,878,13,13,558,1462,9,1471
"آذربایجان_غربی","ارومیه","مرکزی",57,971,27,26,873,1897,16,1913
"آذربایجان_غربی","ارومیه","مرکزی",58,1166,22,28,1325,2541,8,2549
"آذربایجان_غربی","ارومیه","مرکزی",59,1167,17,4,801,1989,19,2008
"آذربایجان_غربی","ارومیه","مرکزی",60,970,23,10,847,1850,14,1864
"آذربایجان_غربی","ارومیه","مرکزی",61,1114,23,15,1094,2246,20,2266
"آذربایجان_غربی","ارومیه","مرکزی",62,1202,26,5,791,2024,12,2036
"آذربایجان_غربی","ارومیه","مرکزی",63,896,22,6,1086,2010,4,2014
"آذربایجان_غربی","ارومیه","مرکزی",64,1060,24,25,954,2063,16,2079
"آذربایجان_غربی","ارومیه","مرکزی",65,806,37,16,1040,1899,19,1918
"آذربایجان_غربی","ارومیه","مرکزی",66,871,27,7,1163,2068,10,2078
"آذربایجان_غربی","ارومیه","مرکزی",67,771,20,5,1228,2024,29,2053
"آذربایجان_غربی","ارومیه","مرکزی",68,1019,19,8,874,1920,12,1932
"آذربایجان_غربی","ارومیه","مرکزی",69,1090,22,8,1027,2147,14,2161
"آذربایجان_غربی","ارومیه","مرکزی",70,534,20,19,1069,1642,22,1664
"آذربایجان_غربی","ارومیه","مرکزی",71,881,32,4,1087,2004,22,2026
"آذربایجان_غربی","ارومیه","مرکزی",72,544,26,10,964,1544,0,1544
"آذربایجان_غربی","ارومیه","مرکزی",73,1084,26,15,1187,2312,21,2333
"آذربایجان_غربی","ارومیه","مرکزی",74,767,20,9,1081,1877,15,1892
"آذربایجان_غربی","ارومیه","مرکزی",75,856,14,15,737,1622,31,1653
"آذربایجان_غربی","ارومیه","مرکزی",76,1163,31,23,920,2137,11,2148
"آذربایجان_غربی","ارومیه","مرکزی",77,946,23,8,662,1639,11,1650
"آذربایجان_غربی","ارومیه","مرکزی",78,362,18,19,1208,1607,12,1619
"آذربایجان_غربی","ارومیه","مرکزی",79,718,21,9,1109,1857,12,1869
"آذربایجان_غربی","ارومیه","مرکزی",80,762,14,8,629,1413,18,1431
"آذربایجان_غربی","ارومیه","مرکزی",81,1059,16,7,803,1885,13,1898
"آذربایجان_غربی","ارومیه","مرکزی",82,731,29,14,1222,1996,12,2008
"آذربایجان_غربی","ارومیه","مرکزی",83,855,18,5,781,1659,7,1666
"آذربایجان_غربی","ارومیه","مرکزی",84,1179,16,4,651,1850,8,1858
"آذربایجان_غربی","ارومیه","مرکزی",85,1323,8,3,448,1782,10,1792
"آذربایجان_غربی","ارومیه","مرکزی",86,808,37,11,1556,2412,13,2425
"آذربایجان_غربی","ارومیه","مرکزی",87,714,34,12,1486,2246,20,2266
"آذربایجان_غربی","ارومیه","مرکزی",88,757,31,10,1679,2477,23,2500
"آذربایجان_غربی","ارومیه","مرکزی",89,1451,44,9,947,2451,47,2498
"آذربایجان_غربی","ارومیه","مرکزی",90,976,15,19,1308,2318,14,2332
"آذربایجان_غربی","ارومیه","مرکزی",91,994,24,2,762,1782,6,1788
"آذربایجان_غربی","ارومیه","مرکزی",92,455,18,23,980,1476,8,1484
"آذربایجان_غربی","ارومیه","مرکزی",93,639,20,20,1410,2089,15,2104
"آذربایجان_غربی","ارومیه","مرکزی",94,1864,36,12,1708,3620,19,3639
"آذربایجان_غربی","ارومیه","مرکزی",95,809,22,8,944,1783,6,1789
"آذربایجان_غربی","ارومیه","مرکزی",96,1053,20,19,881,1973,21,1994
"آذربایجان_غربی","ارومیه","مرکزی",97,994,33,2,960,1989,14,2003
"آذربایجان_غربی","ارومیه","مرکزی",98,813,20,4,799,1636,12,1648
"آذربایجان_غربی","ارومیه","مرکزی",99,637,36,27,1626,2326,15,2341
"آذربایجان_غربی","ارومیه","مرکزی",100,887,34,8,1116,2045,10,2055
"آذربایجان_غربی","ارومیه","مرکزی",101,1006,57,11,2139,3213,24,3237
"آذربایجان_غربی","ارومیه","مرکزی",102,491,16,6,1376,1889,5,1894
"آذربایجان_غربی","ارومیه","مرکزی",103,806,26,12,1386,2230,14,2244
"آذربایجان_غربی","ارومیه","مرکزی",104,1096,32,18,1866,3012,17,3029
"آذربایجان_غربی","ارومیه","مرکزی",105,1360,30,3,941,2334,9,2343
"آذربایجان_غربی","ارومیه","مرکزی",106,886,32,14,1780,2712,15,2727
"آذربایجان_غربی","ارومیه","مرکزی",107,1400,41,18,1247,2706,16,2722
"آذربایجان_غربی","ارومیه","مرکزی",108,896,27,3,817,1743,19,1762
"آذربایجان_غربی","ارومیه","مرکزی",109,1151,53,10,1925,3139,23,3162
"آذربایجان_غربی","ارومیه","مرکزی",110,818,19,13,993,1843,20,1863
"آذربایجان_غربی","ارومیه","مرکزی",111,531,20,4,1164,1719,11,1730
"آذربایجان_غربی","ارومیه","مرکزی",112,841,17,12,966,1836,12,1848
"آذربایجان_غربی","ارومیه","مرکزی",113,585,25,14,1305,1929,10,1939
"آذربایجان_غربی","ارومیه","مرکزی",114,473,13,9,1132,1627,23,1650
"آذربایجان_غربی","ارومیه","مرکزی",115,367,33,19,1548,1967,7,1974
"آذربایجان_غربی","ارومیه","مرکزی",116,526,24,9,1379,1938,5,1943
"آذربایجان_غربی","ارومیه","مرکزی",117,573,11,25,1066,1675,23,1698
"آذربایجان_غربی","ارومیه","مرکزی",118,589,27,23,1562,2201,16,2217
"آذربایجان_غربی","ارومیه","مرکزی",119,337,27,10,1914,2288,11,2299
"آذربایجان_غربی","ارومیه","مرکزی",120,710,19,45,1321,2095,15,2110
"آذربایجان_غربی","ارومیه","مرکزی",121,819,43,18,1517,2397,20,2417
"آذربایجان_غربی","ارومیه","مرکزی",122,1300,31,9,991,2331,23,2354
"آذربایجان_غربی","ارومیه","مرکزی",123,1047,33,12,1264,2356,19,2375
"آذربایجان_غربی","ارومیه","مرکزی",124,1015,27,2,867,1911,17,1928
"آذربایجان_غربی","ارومیه","مرکزی",125,819,32,20,1191,2062,25,2087
"آذربایجان_غربی","ارومیه","مرکزی",126,799,17,17,1069,1902,13,1915
"آذربایجان_غربی","ارومیه","مرکزی",127,832,21,14,1195,2062,13,2075
"آذربایجان_غربی","ارومیه","مرکزی",128,830,18,10,1342,2200,12,2212
"آذربایجان_غربی","ارومیه","مرکزی",129,1217,33,10,1253,2513,20,2533
"آذربایجان_غربی","ارومیه","مرکزی",130,1061,17,5,818,1901,19,1920
"آذربایجان_غربی","ارومیه","مرکزی",131,703,13,27,1011,1754,37,1791
"آذربایجان_غربی","ارومیه","مرکزی",132,756,18,49,1397,2220,50,2270
"آذربایجان_غربی","ارومیه","مرکزی",133,835,27,24,1228,2114,15,2129
"آذربایجان_غربی","ارومیه","مرکزی",134,882,30,32,1327,2271,14,2285
"آذربایجان_غربی","ارومیه","مرکزی",135,838,22,23,1639,2522,16,2538
"آذربایجان_غربی","ارومیه","مرکزی",136,1005,21,12,1208,2246,19,2265
"آذربایجان_غربی","ارومیه","مرکزی",137,1291,13,8,993,2305,10,2315
"آذربایجان_غربی","ارومیه","مرکزی",138,1267,15,17,999,2298,18,2316
"آذربایجان_غربی","ارومیه","مرکزی",139,1009,5,1,655,1670,16,1686
"آذربایجان_غربی","ارومیه","مرکزی",140,1016,10,12,850,1888,30,1918
"آذربایجان_غربی","ارومیه","مرکزی",141,1073,2,15,481,1571,16,1587
"آذربایجان_غربی","ارومیه","مرکزی",142,504,11,25,877,1417,21,1438
"آذربایجان_غربی","ارومیه","مرکزی",143,392,4,9,614,1019,0,1019
"آذربایجان_غربی","ارومیه","مرکزی",144,434,6,4,219,663,0,663
"آذربایجان_غربی","ارومیه","مرکزی",145,753,6,1,439,1199,17,1216
"آذربایجان_غربی","ارومیه","مرکزی",146,612,9,2,430,1053,9,1062
"آذربایجان_غربی","ارومیه","مرکزی",147,998,31,8,245,1282,31,1313
"آذربایجان_غربی","ارومیه","مرکزی",148,813,18,6,947,1784,11,1795
"آذربایجان_غربی","ارومیه","مرکزی",149,507,13,0,415,935,7,942
"آذربایجان_غربی","ارومیه","مرکزی",150,555,7,9,577,1148,9,1157
"آذربایجان_غربی","ارومیه","مرکزی",151,1633,4,101,481,2219,8,2227
"آذربایجان_غربی","ارومیه","مرکزی",152,973,9,83,436,1501,9,1510
"آذربایجان_غربی","ارومیه","مرکزی",153,779,5,2,366,1152,5,1157
"آذربایجان_غربی","ارومیه","مرکزی",154,497,2,10,228,737,0,737
"آذربایجان_غربی","ارومیه","مرکزی",155,950,9,4,516,1479,7,1486
"آذربایجان_غربی","ارومیه","مرکزی",156,430,4,3,171,608,13,621
"آذربایجان_غربی","ارومیه","مرکزی",157,997,3,3,186,1189,7,1196
"آذربایجان_غربی","ارومیه","مرکزی",158,458,3,2,166,629,4,633
"آذربایجان_غربی","ارومیه","مرکزی",159,470,9,9,269,757,9,766
"آذربایجان_غربی","ارومیه","مرکزی",160,445,0,3,217,665,0,665
"آذربایجان_غربی","ارومیه","مرکزی",161,262,4,1,298,565,5,570
"آذربایجان_غربی","ارومیه","مرکزی",162,545,1,1,67,614,1,615
"آذربایجان_غربی","ارومیه","مرکزی",163,434,0,1,56,491,0,491
"آذربایجان_غربی","ارومیه","مرکزی",164,1191,5,5,329,1530,8,1538
"آذربایجان_غربی","ارومیه","مرکزی",165,935,9,10,482,1436,9,1445
"آذربایجان_غربی","ارومیه","مرکزی",166,464,4,9,219,696,9,705
"آذربایجان_غربی","ارومیه","مرکزی",167,349,3,1,105,458,3,461
"آذربایجان_غربی","ارومیه","مرکزی",168,851,8,21,641,1521,35,1556
"آذربایجان_غربی","ارومیه","مرکزی",169,195,9,1,249,454,0,454
"آذربایجان_غربی","ارومیه","مرکزی",170,446,2,1,128,577,5,582
"آذربایجان_غربی","ارومیه","مرکزی",171,354,0,0,154,508,6,514
"آذربایجان_غربی","ارومیه","مرکزی",172,479,9,3,376,867,6,873
"آذربایجان_غربی","ارومیه","مرکزی",173,513,4,0,171,688,2,690
"آذربایجان_غربی","ارومیه","مرکزی",174,436,3,3,154,596,2,598
"آذربایجان_غربی","ارومیه","مرکزی",175,696,19,33,1029,1777,18,1795
"آذربایجان_غربی","ارومیه","مرکزی",176,378,2,0,188,568,0,568
"آذربایجان_غربی","ارومیه","مرکزی",177,371,4,0,89,464,2,466
"آذربایجان_غربی","ارومیه","مرکزی",178,742,8,2,360,1112,8,1120
"آذربایجان_غربی","ارومیه","مرکزی",179,353,1,0,99,453,4,457
"آذربایجان_غربی","ارومیه","مرکزی",180,1196,5,0,418,1619,0,1619
"آذربایجان_غربی","ارومیه","مرکزی",181,485,5,0,347,837,1,838
"آذربایجان_غربی","ارومیه","مرکزی",182,325,3,0,176,504,0,504
"آذربایجان_غربی","ارومیه","مرکزی",183,453,5,1,276,735,2,737
"آذربایجان_غربی","ارومیه","مرکزی",184,340,12,19,817,1188,47,1235
"آذربایجان_غربی","ارومیه","مرکزی",185,393,1,0,112,506,3,509
"آذربایجان_غربی","ارومیه","مرکزی",186,687,1,0,294,982,0,982
"آذربایجان_غربی","ارومیه","مرکزی",187,336,13,21,709,1079,17,1096
"آذربایجان_غربی","ارومیه","مرکزی",188,277,3,1,222,503,4,507
"آذربایجان_غربی","ارومیه","مرکزی",189,385,5,3,228,621,1,622
"آذربایجان_غربی","ارومیه","مرکزی",190,338,2,0,66,406,5,411
"آذربایجان_غربی","ارومیه","مرکزی",191,518,0,2,238,758,0,758
"آذربایجان_غربی","ارومیه","مرکزی",192,261,3,19,130,413,5,418
"آذربایجان_غربی","ارومیه","مرکزی",193,454,8,3,447,912,3,915
"آذربایجان_غربی","ارومیه","مرکزی",194,238,3,5,151,397,0,397
"آذربایجان_غربی","ارومیه","مرکزی",195,477,4,0,175,656,2,658
"آذربایجان_غربی","ارومیه","مرکزی",196,139,1,1,114,255,2,257
"آذربایجان_غربی","ارومیه","مرکزی",197,450,8,1,384,843,6,849
"آذربایجان_غربی","ارومیه","مرکزی",198,432,6,0,330,768,0,768
"آذربایجان_غربی","ارومیه","مرکزی",199,599,9,1,453,1062,4,1066
"آذربایجان_غربی","ارومیه","مرکزی",200,486,2,0,80,568,4,572
"آذربایجان_غربی","ارومیه","مرکزی",201,389,6,18,688,1101,14,1115
"آذربایجان_غربی","ارومیه","مرکزی",202,532,9,16,488,1045,6,1051
"آذربایجان_غربی","ارومیه","مرکزی",203,310,7,2,155,474,3,477
"آذربایجان_غربی","ارومیه","مرکزی",204,601,24,11,629,1265,9,1274
"آذربایجان_غربی","ارومیه","مرکزی",205,339,6,3,145,493,6,499
"آذربایجان_غربی","ارومیه","مرکزی",206,153,3,1,117,274,7,281
"آذربایجان_غربی","ارومیه","مرکزی",207,374,15,5,405,799,6,805
"آذربایجان_غربی","ارومیه","مرکزی",208,824,14,12,742,1592,15,1607
"آذربایجان_غربی","ارومیه","مرکزی",209,309,8,4,359,680,5,685
"آذربایجان_غربی","ارومیه","مرکزی",210,311,4,14,331,660,3,663
"آذربایجان_غربی","ارومیه","مرکزی",211,211,1,7,159,378,0,378
"آذربایجان_غربی","ارومیه","مرکزی",212,569,0,1,198,768,2,770
"آذربایجان_غربی","ارومیه","مرکزی",213,645,11,18,936,1610,19,1629
"آذربایجان_غربی","ارومیه","مرکزی",214,447,6,2,509,964,4,968
"آذربایجان_غربی","ارومیه","مرکزی",215,871,10,1,412,1294,6,1300
"آذربایجان_غربی","ارومیه","مرکزی",216,427,8,3,312,750,1,751
"آذربایجان_غربی","ارومیه","مرکزی",217,209,4,2,287,502,5,507
"آذربایجان_غربی","ارومیه","مرکزی",218,173,1,0,112,286,2,288
"آذربایجان_غربی","ارومیه","مرکزی",219,581,14,2,446,1043,10,1053
"آذربایجان_غربی","ارومیه","مرکزی",220,452,4,33,238,727,3,730
"آذربایجان_غربی","ارومیه","مرکزی",221,307,3,1,198,509,6,515
"آذربایجان_غربی","ارومیه","مرکزی",222,425,1,0,118,544,3,547
"آذربایجان_غربی","ارومیه","مرکزی",223,774,2,0,165,941,3,944
"آذربایجان_غربی","ارومیه","مرکزی",224,486,3,1,135,625,4,629
"آذربایجان_غربی","ارومیه","مرکزی",225,619,2,0,159,780,0,780
"آذربایجان_غربی","ارومیه","مرکزی",226,443,2,0,145,590,2,592
"آذربایجان_غربی","ارومیه","مرکزی",227,587,3,0,157,747,8,755
"آذربایجان_غربی","ارومیه","مرکزی",228,270,2,0,109,381,1,382
"آذربایجان_غربی","ارومیه","مرکزی",229,515,5,1,192,713,2,715
"آذربایجان_غربی","ارومیه","مرکزی",230,328,4,6,177,515,7,522
"آذربایجان_غربی","ارومیه","مرکزی",231,353,3,12,177,545,6,551
"آذربایجان_غربی","ارومیه","مرکزی",232,648,3,0,147,798,2,800
"آذربایجان_غربی","ارومیه","مرکزی",233,791,7,0,286,1084,7,1091
"آذربایجان_غربی","ارومیه","مرکزی",234,404,5,30,259,698,9,707
"آذربایجان_غربی","ارومیه","مرکزی",235,335,1,11,170,517,7,524
"آذربایجان_غربی","ارومیه","مرکزی",236,95,2,4,250,351,4,355
"آذربایجان_غربی","ارومیه","مرکزی",237,559,3,2,90,654,6,660
"آذربایجان_غربی","ارومیه","مرکزی",238,621,4,0,271,896,4,900
"آذربایجان_غربی","ارومیه","مرکزی",239,850,2,0,184,1036,4,1040
"آذربایجان_غربی","ارومیه","مرکزی",240,515,6,0,140,661,4,665
"آذربایجان_غربی","ارومیه","مرکزی",241,234,4,5,191,434,0,434
"آذربایجان_غربی","ارومیه","مرکزی",242,141,1,1,211,354,8,362
"آذربایجان_غربی","ارومیه","مرکزی",243,369,2,10,159,540,23,563
"آذربایجان_غربی","ارومیه","مرکزی",244,471,9,22,777,1279,19,1298
"آذربایجان_غربی","ارومیه","مرکزی",245,458,8,12,315,793,3,796
"آذربایجان_غربی","ارومیه","مرکزی",246,436,0,35,122,593,5,598
"آذربایجان_غربی","ارومیه","مرکزی",247,754,4,5,320,1083,7,1090
"آذربایجان_غربی","ارومیه","مرکزی",248,266,3,0,142,411,7,418
"آذربایجان_غربی","ارومیه","مرکزی",249,624,5,1,203,833,8,841
"آذربایجان_غربی","ارومیه","مرکزی",250,570,3,1,142,716,2,718
"آذربایجان_غربی","ارومیه","انزل",1,381,3,1,647,1032,3,1035
"آذربایجان_غربی","ارومیه","انزل",2,566,2,0,540,1108,0,1108
"آذربایجان_غربی","ارومیه","انزل",3,420,1,1,61,483,2,485
"آذربایجان_غربی","ارومیه","انزل",4,477,1,0,38,516,1,517
"آذربایجان_غربی","ارومیه","انزل",5,437,2,0,869,1308,13,1321
"آذربایجان_غربی","ارومیه","انزل",6,482,0,0,364,846,1,847
"آذربایجان_غربی","ارومیه","انزل",7,210,1,1,386,598,7,605
"آذربایجان_غربی","ارومیه","انزل",8,204,1,1,234,440,3,443
"آذربایجان_غربی","ارومیه","انزل",9,419,4,5,266,694,14,708
"آذربایجان_غربی","ارومیه","انزل",10,306,2,7,511,826,5,831
"آذربایجان_غربی","ارومیه","انزل",11,506,7,0,67,580,5,585
"آذربایجان_غربی","ارومیه","انزل",12,402,1,0,94,497,1,498
"آذربایجان_غربی","ارومیه","انزل",13,426,3,10,173,612,8,620
"آذربایجان_غربی","ارومیه","انزل",14,166,3,2,112,283,0,283
"آذربایجان_غربی","ارومیه","انزل",15,114,3,0,154,271,0,271
"آذربایجان_غربی","ارومیه","انزل",16,331,5,10,203,549,5,554
"آذربایجان_غربی","ارومیه","انزل",17,41,1,2,61,105,0,105
"آذربایجان_غربی","ارومیه","انزل",18,168,0,7,263,438,11,449
"آذربایجان_غربی","ارومیه","انزل",19,105,10,0,235,350,2,352
"آذربایجان_غربی","ارومیه","انزل",20,55,0,1,99,155,2,157
"آذربایجان_غربی","ارومیه","انزل",21,91,2,0,163,256,4,260
"آذربایجان_غربی","ارومیه","انزل",22,16,2,0,178,196,0,196
"آذربایجان_غربی","ارومیه","انزل",23,50,0,9,119,178,4,182
"آذربایجان_غربی","ارومیه","انزل",24,122,4,3,241,370,8,378
"آذربایجان_غربی","ارومیه","نازلو",25,1018,11,4,591,1624,9,1633
"آذربایجان_غربی","ارومیه","نازلو",26,710,6,3,502,1221,11,1232
"آذربایجان_غربی","ارومیه","نازلو",27,460,2,0,262,724,1,725
"آذربایجان_غربی","ارومیه","نازلو",28,410,4,2,196,612,3,615
"آذربایجان_غربی","ارومیه","نازلو",29,946,2,7,253,1208,5,1213
"آذربایجان_غربی","ارومیه","نازلو",30,345,1,1,86,433,0,433
"آذربایجان_غربی","ارومیه","نازلو",31,569,5,0,169,743,3,746
"آذربایجان_غربی","ارومیه","نازلو",32,461,2,0,237,700,4,704
"آذربایجان_غربی","ارومیه","نازلو",33,404,4,2,134,544,1,545
"آذربایجان_غربی","ارومیه","نازلو",34,354,4,2,429,789,4,793
"آذربایجان_غربی","ارومیه","نازلو",35,387,1,2,79,469,0,469
"آذربایجان_غربی","ارومیه","نازلو",36,368,0,0,112,480,1,481
"آذربایجان_غربی","ارومیه","نازلو",37,512,4,1,149,666,2,668
"آذربایجان_غربی","ارومیه","نازلو",38,384,1,0,75,460,2,462
"آذربایجان_غربی","ارومیه","نازلو",39,649,1,0,161,811,9,820
"آذربایجان_غربی","ارومیه","نازلو",40,553,3,1,110,667,0,667
"آذربایجان_غربی","ارومیه","نازلو",41,452,2,0,145,599,1,600
"آذربایجان_غربی","ارومیه","نازلو",42,403,5,9,495,912,12,924
"آذربایجان_غربی","ارومیه","نازلو",43,712,11,6,405,1134,9,1143
"آذربایجان_غربی","ارومیه","نازلو",44,347,1,0,71,419,0,419
"آذربایجان_غربی","ارومیه","نازلو",45,282,31,52,578,943,31,974
"آذربایجان_غربی","ارومیه","نازلو",46,302,2,15,332,651,6,657
"آذربایجان_غربی","ارومیه","نازلو",47,479,8,2,163,652,2,654
"آذربایجان_غربی","ارومیه","نازلو",48,229,1,14,323,567,14,581
"آذربایجان_غربی","ارومیه","نازلو",49,343,3,1,205,552,1,553
"آذربایجان_غربی","ارومیه","نازلو",50,160,0,1,287,448,3,451
"آذربایجان_غربی","ارومیه","نازلو",51,516,2,1,161,680,4,684
"آذربایجان_غربی","ارومیه","نازلو",52,209,2,8,248,467,2,469
"آذربایجان_غربی","ارومیه","نازلو",53,494,1,15,235,745,1,746
"آذربایجان_غربی","ارومیه","نازلو",54,521,1,0,136,658,0,658
"آذربایجان_غربی","ارومیه","نازلو",55,525,0,34,146,705,4,709
"آذربایجان_غربی","ارومیه","نازلو",56,457,1,1,102,561,7,568
"آذربایجان_غربی","ارومیه","نازلو",57,418,4,9,129,560,0,560
"آذربایجان_غربی","ارومیه","نازلو",58,310,3,0,70,383,1,384
"آذربایجان_غربی","ارومیه","نازلو",59,284,2,0,41,327,0,327
"آذربایجان_غربی","ارومیه","نازلو",60,352,0,2,121,475,2,477
"آذربایجان_غربی","ارومیه","نازلو",61,600,2,0,143,745,5,750
"آذربایجان_غربی","ارومیه","نازلو",62,110,3,16,71,200,0,200
"آذربایجان_غربی","ارومیه","سیلوانا",1,118,9,17,200,344,33,377
"آذربایجان_غربی","ارومیه","سیلوانا",2,230,8,75,368,681,40,721
"آذربایجان_غربی","ارومیه","سیلوانا",3,173,5,35,203,416,10,426
"آذربایجان_غربی","ارومیه","سیلوانا",4,200,4,24,357,585,14,599
"آذربایجان_غربی","ارومیه","سیلوانا",5,384,0,2,154,540,11,551
"آذربایجان_غربی","ارومیه","سیلوانا",6,197,5,5,142,349,2,351
"آذربایجان_غربی","ارومیه","سیلوانا",7,115,6,40,320,481,19,500
"آذربایجان_غربی","ارومیه","سیلوانا",8,217,4,7,243,471,17,488
"آذربایجان_غربی","ارومیه","سیلوانا",9,75,0,13,227,315,15,330
"آذربایجان_غربی","ارومیه","سیلوانا",10,135,3,14,275,427,7,434
"آذربایجان_غربی","ارومیه","سیلوانا",11,270,4,11,256,541,12,553
"آذربایجان_غربی","ارومیه","سیلوانا",12,120,3,1,358,482,16,498
"آذربایجان_غربی","ارومیه","سیلوانا",13,148,7,14,515,684,21,705
"آذربایجان_غربی","ارومیه","سیلوانا",14,164,3,4,297,468,9,477
"آذربایجان_غربی","ارومیه","سیلوانا",15,115,1,15,196,327,7,334
"آذربایجان_غربی","ارومیه","سیلوانا",16,69,4,7,272,352,4,356
"آذربایجان_غربی","ارومیه","سیلوانا",17,108,16,19,316,459,5,464
"آذربایجان_غربی","ارومیه","سیلوانا",18,121,3,5,323,452,6,458
"آذربایجان_غربی","ارومیه","سیلوانا",19,170,4,7,200,381,30,411
"آذربایجان_غربی","ارومیه","سیلوانا",20,277,0,1,236,514,6,520
"آذربایجان_غربی","ارومیه","سیلوانا",21,328,4,18,206,556,20,576
"آذربایجان_غربی","ارومیه","سیلوانا",22,206,4,24,476,710,47,757
"آذربایجان_غربی","ارومیه","سیلوانا",23,332,10,5,439,786,16,802
"آذربایجان_غربی","ارومیه","سیلوانا",24,267,4,5,514,790,8,798
"آذربایجان_غربی","ارومیه","سیلوانا",25,226,1,4,226,457,13,470
"آذربایجان_غربی","ارومیه","سیلوانا",26,200,2,8,281,491,9,500
"آذربایجان_غربی","ارومیه","سیلوانا",27,168,3,34,473,678,17,695
"آذربایجان_غربی","ارومیه","سیلوانا",28,243,4,15,451,713,9,722
"آذربایجان_غربی","ارومیه","سیلوانا",29,170,1,12,417,600,10,610
"آذربایجان_غربی","ارومیه","سیلوانا",30,94,0,19,225,338,1,339
"آذربایجان_غربی","ارومیه","سیلوانا",31,54,2,8,257,321,10,331
"آذربایجان_غربی","ارومیه","سیلوانا",32,94,3,0,266,363,0,363
"آذربایجان_غربی","ارومیه","سیلوانا",33,128,2,12,262,404,9,413
"آذربایجان_غربی","ارومیه","سیلوانا",34,198,6,11,255,470,9,479
"آذربایجان_غربی","ارومیه","سیلوانا",35,99,1,6,237,343,2,345
"آذربایجان_غربی","ارومیه","سیلوانا",36,103,6,7,346,462,7,469
"آذربایجان_غربی","ارومیه","سیلوانا",37,59,7,28,279,373,8,381
"آذربایجان_غربی","ارومیه","سیلوانا",38,45,2,6,217,270,8,278
"آذربایجان_غربی","ارومیه","سیلوانا",39,11,0,1,246,258,2,260
"آذربایجان_غربی","ارومیه","صومای_پرادوست",1,174,9,12,445,640,12,652
"آذربایجان_غربی","ارومیه","صومای_پرادوست",2,69,1,0,380,450,11,461
"آذربایجان_غربی","ارومیه","صومای_پرادوست",3,130,0,11,512,653,18,671
"آذربایجان_غربی","ارومیه","صومای_پرادوست",4,79,0,5,144,228,2,230
"آذربایجان_غربی","ارومیه","صومای_پرادوست",5,39,6,9,310,364,7,371
"آذربایجان_غربی","ارومیه","صومای_پرادوست",6,205,6,6,256,473,3,476
"آذربایجان_غربی","ارومیه","صومای_پرادوست",7,32,5,4,213,254,1,255
"آذربایجان_غربی","ارومیه","صومای_پرادوست",8,57,2,4,427,490,0,490
"آذربایجان_غربی","ارومیه","صومای_پرادوست",9,106,1,11,276,394,5,399
"آذربایجان_غربی","ارومیه","صومای_پرادوست",10,157,3,0,254,414,1,415
"آذربایجان_غربی","ارومیه","صومای_پرادوست",11,85,3,8,537,633,5,638
"آذربایجان_غربی","ارومیه","صومای_پرادوست",12,113,2,7,157,279,2,281
"آذربایجان_غربی","ارومیه","صومای_پرادوست",13,151,1,4,251,407,8,415
"آذربایجان_غربی","ارومیه","صومای_پرادوست",14,58,3,3,474,538,12,550
"آذربایجان_غربی","ارومیه","صومای_پرادوست",15,37,0,3,324,364,2,366
"آذربایجان_غربی","ارومیه","صومای_پرادوست",16,167,6,10,356,539,9,548
"آذربایجان_غربی","ارومیه","صومای_پرادوست",17,18,0,0,374,392,1,393
"آذربایجان_غربی","ارومیه","صومای_پرادوست",18,54,1,1,377,433,0,433
"آذربایجان_غربی","ارومیه","صومای_پرادوست",19,90,2,4,578,674,9,683
"آذربایجان_غربی","ارومیه","صومای_پرادوست",20,23,1,11,386,421,6,427
"آذربایجان_غربی","ارومیه","صومای_پرادوست",21,54,1,16,250,321,6,327
"آذربایجان_غربی","ارومیه","صومای_پرادوست",22,68,3,15,320,406,3,409
"آذربایجان_غربی","ارومیه","صومای_پرادوست",23,48,1,4,475,528,6,534
"آذربایجان_غربی","ارومیه","صومای_پرادوست",24,57,0,8,413,478,10,488
"آذربایجان_غربی","ارومیه","صومای_پرادوست",25,88,3,4,310,405,9,414
"آذربایجان_غربی","ارومیه","صومای_پرادوست",26,91,1,1,237,330,1,331
"آذربایجان_غربی","ارومیه","صومای_پرادوست",27,98,1,0,330,429,4,433
"آذربایجان_غربی","ارومیه","صومای_پرادوست",28,55,2,0,311,368,11,379
"آذربایجان_غربی","ارومیه","صومای_پرادوست",29,113,3,7,333,456,3,459
"آذربایجان_غربی","ارومیه","صومای_پرادوست",30,120,2,5,192,319,4,323
"آذربایجان_غربی","ارومیه","صومای_پرادوست",31,110,1,1,144,256,4,260
"آذربایجان_غربی","ارومیه","صومای_پرادوست",32,50,3,1,191,245,2,247
"آذربایجان_غربی","ارومیه","صومای_پرادوست",33,64,5,4,151,224,7,231
"آذربایجان_غربی","اشنویه","مرکزی",1,315,9,22,547,893,28,921
"آذربایجان_غربی","اشنویه","مرکزی",2,285,11,33,598,927,46,973
"آذربایجان_غربی","اشنویه","مرکزی",3,234,10,36,337,617,20,637
"آذربایجان_غربی","اشنویه","مرکزی",4,156,22,31,500,709,33,742
"آذربایجان_غربی","اشنویه","مرکزی",5,126,0,29,289,444,20,464
"آذربایجان_غربی","اشنویه","مرکزی",6,162,4,4,251,421,22,443
"آذربایجان_غربی","اشنویه","مرکزی",7,287,16,37,390,730,26,756
"آذربایجان_غربی","اشنویه","مرکزی",8,84,9,7,120,220,3,223
"آذربایجان_غربی","اشنویه","مرکزی",9,209,6,38,463,716,30,746
"آذربایجان_غربی","اشنویه","مرکزی",10,213,10,34,462,719,39,758
"آذربایجان_غربی","اشنویه","مرکزی",11,77,7,9,154,247,14,261
"آذربایجان_غربی","اشنویه","مرکزی",12,254,19,39,365,677,23,700
"آذربایجان_غربی","اشنویه","مرکزی",13,190,1,11,245,447,11,458
"آذربایجان_غربی","اشنویه","مرکزی",14,281,22,55,770,1128,38,1166
"آذربایجان_غربی","اشنویه","مرکزی",15,103,3,14,260,380,12,392
"آذربایجان_غربی","اشنویه","مرکزی",16,55,4,7,138,204,5,209
"آذربایجان_غربی","اشنویه","مرکزی",17,63,6,15,141,225,8,233
"آذربایجان_غربی","اشنویه","مرکزی",18,100,10,9,150,269,13,282
"آذربایجان_غربی","اشنویه","مرکزی",19,68,5,7,168,248,4,252
"آذربایجان_غربی","اشنویه","مرکزی",20,115,5,20,228,368,11,379
"آذربایجان_غربی","اشنویه","مرکزی",21,150,5,25,211,391,15,406
"آذربایجان_غربی","اشنویه","مرکزی",22,72,3,3,104,182,8,190
"آذربایجان_غربی","اشنویه","مرکزی",23,77,2,8,158,245,8,253
"آذربایجان_غربی","اشنویه","مرکزی",24,75,3,5,107,190,2,192
"آذربایجان_غربی","اشنویه","مرکزی",25,175,0,0,78,253,4,257
"آذربایجان_غربی","اشنویه","مرکزی",26,159,7,28,242,436,24,460
"آذربایجان_غربی","اشنویه","مرکزی",27,80,6,9,81,176,6,182
"آذربایجان_غربی","اشنویه","مرکزی",28,296,1,2,107,406,2,408
"آذربایجان_غربی","اشنویه","مرکزی",29,429,1,3,130,563,18,581
"آذربایجان_غربی","اشنویه","مرکزی",30,161,5,13,158,337,12,349
"آذربایجان_غربی","اشنویه","مرکزی",31,68,0,14,168,250,4,254
"آذربایجان_غربی","اشنویه","مرکزی",32,69,0,17,271,357,9,366
"آذربایجان_غربی","اشنویه","مرکزی",33,133,0,6,37,176,7,183
"آذربایجان_غربی","اشنویه","مرکزی",34,58,3,5,87,153,9,162
"آذربایجان_غربی","اشنویه","مرکزی",35,69,7,16,97,189,8,197
"آذربایجان_غربی","اشنویه","مرکزی",36,250,2,5,179,436,13,449
"آذربایجان_غربی","اشنویه","مرکزی",37,417,9,2,57,485,3,488
"آذربایجان_غربی","اشنویه","مرکزی",38,333,3,1,214,551,9,560
"آذربایجان_غربی","اشنویه","مرکزی",39,291,10,19,120,440,24,464
"آذربایجان_غربی","اشنویه","مرکزی",40,174,1,3,305,483,6,489
"آذربایجان_غربی","اشنویه","مرکزی",41,178,5,8,147,338,14,352
"آذربایجان_غربی","اشنویه","مرکزی",42,113,0,5,206,324,11,335
"آذربایجان_غربی","اشنویه","مرکزی",43,110,0,13,100,223,3,226
"آذربایجان_غربی","اشنویه","مرکزی",44,120,4,27,139,290,10,300
"آذربایجان_غربی","اشنویه","نالوس",1,183,3,27,186,399,9,408
"آذربایجان_غربی","اشنویه","نالوس",2,55,0,2,79,136,6,142
"آذربایجان_غربی","اشنویه","نالوس",3,112,1,27,79,219,5,224
"آذربایجان_غربی","اشنویه","نالوس",4,53,2,11,125,191,7,198
"آذربایجان_غربی","اشنویه","نالوس",5,48,4,22,117,191,9,200
"آذربایجان_غربی","اشنویه","نالوس",6,77,4,20,234,335,14,349
"آذربایجان_غربی","اشنویه","نالوس",7,90,4,50,163,307,12,319
"آذربایجان_غربی","اشنویه","نالوس",8,73,6,14,170,263,11,274
"آذربایجان_غربی","اشنویه","نالوس",9,63,5,47,257,372,12,384
"آذربایجان_غربی","اشنویه","نالوس",10,45,2,56,100,203,14,217
"آذربایجان_غربی","اشنویه","نالوس",11,104,2,19,148,273,14,287
"آذربایجان_غربی","اشنویه","نالوس",12,93,7,22,285,407,6,413
"آذربایجان_غربی","اشنویه","نالوس",13,115,7,12,131,265,18,283
"آذربایجان_غربی","اشنویه","نالوس",14,119,1,19,83,222,9,231
"آذربایجان_غربی","اشنویه","نالوس",15,185,7,11,176,379,22,401
"آذربایجان_غربی","اشنویه","نالوس",16,60,5,24,157,246,19,265
"آذربایجان_غربی","اشنویه","نالوس",17,58,4,14,121,197,9,206
"آذربایجان_غربی","بوکان","مرکزی",1,158,2,44,613,817,18,835
"آذربایجان_غربی","بوکان","مرکزی",2,127,7,32,435,601,28,629
"آذربایجان_غربی","بوکان","مرکزی",3,88,7,17,278,390,8,398
"آذربایجان_غربی","بوکان","مرکزی",4,72,2,11,144,229,12,241
"آذربایجان_غربی","بوکان","مرکزی",5,195,5,19,344,563,15,578
"آذربایجان_غربی","بوکان","مرکزی",6,154,7,31,515,707,38,745
"آذربایجان_غربی","بوکان","مرکزی",7,219,4,24,357,604,25,629
"آذربایجان_غربی","بوکان","مرکزی",8,98,7,10,220,335,20,355
"آذربایجان_غربی","بوکان","مرکزی",9,80,1,12,284,377,10,387
"آذربایجان_غربی","بوکان","مرکزی",10,24,0,4,127,155,6,161
"آذربایجان_غربی","بوکان","مرکزی",11,92,3,2,271,368,22,390
"آذربایجان_غربی","بوکان","مرکزی",12,167,8,38,485,698,22,720
"آذربایجان_غربی","بوکان","مرکزی",13,174,11,33,511,729,32,761
"آذربایجان_غربی","بوکان","مرکزی",14,92,5,18,222,337,15,352
"آذربایجان_غربی","بوکان","مرکزی",15,171,5,22,346,544,23,567
"آذربایجان_غربی","بوکان","مرکزی",16,160,12,34,639,845,19,864
"آذربایجان_غربی","بوکان","مرکزی",17,72,5,25,288,390,13,403
"آذربایجان_غربی","بوکان","مرکزی",18,51,23,15,166,255,8,263
"آذربایجان_غربی","بوکان","مرکزی",19,106,5,25,478,614,25,639
"آذربایجان_غربی","بوکان","مرکزی",20,147,7,15,366,535,27,562
"آذربایجان_غربی","بوکان","مرکزی",21,211,9,45,780,1045,43,1088
"آذربایجان_غربی","بوکان","مرکزی",22,76,4,29,260,369,14,383
"آذربایجان_غربی","بوکان","مرکزی",23,125,12,20,427,584,21,605
"آذربایجان_غربی","بوکان","مرکزی",24,153,9,26,496,684,35,719
"آذربایجان_غربی","بوکان","مرکزی",25,157,12,28,517,714,30,744
"آذربایجان_غربی","بوکان","مرکزی",26,139,9,43,567,758,19,777
"آذربایجان_غربی","بوکان","مرکزی",27,120,11,25,422,578,22,600
"آذربایجان_غربی","بوکان","مرکزی",28,79,3,16,236,334,8,342
"آذربایجان_غربی","بوکان","مرکزی",29,82,9,35,393,519,17,536
"آذربایجان_غربی","بوکان","مرکزی",30,113,4,25,243,385,23,408
"آذربایجان_غربی","بوکان","مرکزی",31,47,1,14,175,237,14,251
"آذربایجان_غربی","بوکان","مرکزی",32,192,9,22,433,656,26,682
"آذربایجان_غربی","بوکان","مرکزی",33,158,5,20,226,409,20,429
"آذربایجان_غربی","بوکان","مرکزی",34,196,4,26,470,696,25,721
"آذربایجان_غربی","بوکان","مرکزی",35,289,7,18,438,752,30,782
"آذربایجان_غربی","بوکان","مرکزی",36,96,4,11,228,339,16,355
"آذربایجان_غربی","بوکان","مرکزی",37,141,11,19,378,549,22,571
"آذربایجان_غربی","بوکان","مرکزی",38,245,11,20,593,869,22,891
"آذربایجان_غربی","بوکان","مرکزی",39,125,7,8,282,422,20,442
"آذربایجان_غربی","بوکان","مرکزی",40,331,11,30,538,910,25,935
"آذربایجان_غربی","بوکان","مرکزی",41,136,6,2,212,356,9,365
"آذربایجان_غربی","بوکان","مرکزی",42,223,6,23,510,762,31,793
"آذربایجان_غربی","بوکان","مرکزی",43,183,5,24,313,525,17,542
"آذربایجان_غربی","بوکان","مرکزی",44,100,8,16,200,324,23,347
"آذربایجان_غربی","بوکان","مرکزی",45,160,13,11,282,466,13,479
"آذربایجان_غربی","بوکان","مرکزی",46,242,10,28,412,692,18,710
"آذربایجان_غربی","بوکان","مرکزی",47,176,8,21,434,639,26,665
"آذربایجان_غربی","بوکان","مرکزی",48,92,3,29,431,555,19,574
"آذربایجان_غربی","بوکان","مرکزی",49,155,5,18,314,492,16,508
"آذربایجان_غربی","بوکان","مرکزی",50,75,7,12,213,307,12,319
"آذربایجان_غربی","بوکان","مرکزی",51,130,12,24,377,543,23,566
"آذربایجان_غربی","بوکان","مرکزی",52,100,6,13,235,354,15,369
"آذربایجان_غربی","بوکان","مرکزی",53,120,16,20,426,582,20,602
"آذربایجان_غربی","بوکان","مرکزی",54,64,6,15,260,345,17,362
"آذربایجان_غربی","بوکان","مرکزی",55,92,3,14,295,404,22,426
"آذربایجان_غربی","بوکان","مرکزی",56,133,11,47,445,636,38,674
"آذربایجان_غربی","بوکان","مرکزی",57,64,7,11,349,431,19,450
"آذربایجان_غربی","بوکان","مرکزی",58,73,7,15,291,386,21,407
"آذربایجان_غربی","بوکان","مرکزی",59,183,6,36,557,782,29,811
"آذربایجان_غربی","بوکان","مرکزی",60,121,8,15,327,471,17,488
"آذربایجان_غربی","بوکان","مرکزی",61,152,6,21,297,476,12,488
"آذربایجان_غربی","بوکان","مرکزی",62,115,8,18,274,415,16,431
"آذربایجان_غربی","بوکان","مرکزی",63,194,5,55,473,727,22,749
"آذربایجان_غربی","بوکان","مرکزی",64,108,5,17,334,464,22,486
"آذربایجان_غربی","بوکان","مرکزی",65,160,6,38,314,518,23,541
"آذربایجان_غربی","بوکان","مرکزی",66,143,7,15,417,582,28,610
"آذربایجان_غربی","بوکان","مرکزی",67,132,8,33,410,583,22,605
"آذربایجان_غربی","بوکان","مرکزی",68,61,13,13,211,298,13,311
"آذربایجان_غربی","بوکان","مرکزی",69,126,17,7,359,509,23,532
"آذربایجان_غربی","بوکان","مرکزی",70,144,4,25,390,563,17,580
"آذربایجان_غربی","بوکان","مرکزی",71,117,6,12,271,406,15,421
"آذربایجان_غربی","بوکان","مرکزی",72,53,0,3,105,161,7,168
"آذربایجان_غربی","بوکان","مرکزی",73,120,2,9,184,315,14,329
"آذربایجان_غربی","بوکان","مرکزی",74,50,5,16,185,256,14,270
"آذربایجان_غربی","بوکان","مرکزی",75,17,1,3,51,72,4,76
"آذربایجان_غربی","بوکان","مرکزی",76,74,10,18,153,255,16,271
"آذربایجان_غربی","بوکان","مرکزی",77,126,4,21,328,479,21,500
"آذربایجان_غربی","بوکان","مرکزی",78,154,7,37,426,624,37,661
"آذربایجان_غربی","بوکان","مرکزی",79,106,11,19,197,333,10,343
"آذربایجان_غربی","بوکان","مرکزی",80,81,5,22,163,271,7,278
"آذربایجان_غربی","بوکان","مرکزی",81,64,9,20,114,207,21,228
"آذربایجان_غربی","بوکان","مرکزی",82,97,7,23,235,362,25,387
"آذربایجان_غربی","بوکان","مرکزی",83,88,2,11,94,195,7,202
"آذربایجان_غربی","بوکان","مرکزی",84,144,3,3,152,302,5,307
"آذربایجان_غربی","بوکان","مرکزی",85,131,4,6,141,282,7,289
"آذربایجان_غربی","بوکان","مرکزی",86,66,6,10,131,213,8,221
"آذربایجان_غربی","بوکان","مرکزی",87,169,9,14,173,365,6,371
"آذربایجان_غربی","بوکان","مرکزی",88,144,6,7,125,282,7,289
"آذربایجان_غربی","بوکان","مرکزی",89,170,2,6,120,298,7,305
"آذربایجان_غربی","بوکان","مرکزی",90,124,4,21,97,246,9,255
"آذربایجان_غربی","بوکان","مرکزی",91,91,1,5,29,126,3,129
"آذربایجان_غربی","بوکان","مرکزی",92,83,2,12,109,206,10,216
"آذربایجان_غربی","بوکان","مرکزی",93,173,4,4,120,301,4,305
"آذربایجان_غربی","بوکان","مرکزی",94,220,4,5,142,371,9,380
"آذربایجان_غربی","بوکان","مرکزی",95,141,3,6,122,272,3,275
"آذربایجان_غربی","بوکان","مرکزی",96,252,3,34,159,448,10,458
"آذربایجان_غربی","بوکان","مرکزی",97,138,6,14,182,340,10,350
"آذربایجان_غربی","بوکان","مرکزی",98,26,2,13,51,92,7,99
"آذربایجان_غربی","بوکان","مرکزی",99,55,2,8,61,126,11,137
"آذربایجان_غربی","بوکان","مرکزی",100,30,13,9,77,129,1,130
"آذربایجان_غربی","بوکان","مرکزی",101,26,4,7,40,77,3,80
"آذربایجان_غربی","بوکان","مرکزی",102,122,3,19,107,251,15,266
"آذربایجان_غربی","بوکان","مرکزی",103,30,1,7,48,86,5,91
"آذربایجان_غربی","بوکان","مرکزی",104,128,0,5,122,255,5,260
"آذربایجان_غربی","بوکان","مرکزی",105,24,1,26,53,104,8,112
"آذربایجان_غربی","بوکان","مرکزی",106,47,2,31,75,155,3,158
"آذربایجان_غربی","بوکان","مرکزی",107,65,1,13,110,189,11,200
"آذربایجان_غربی","بوکان","مرکزی",108,49,1,4,76,130,7,137
"آذربایجان_غربی","بوکان","مرکزی",109,28,1,7,81,117,2,119
"آذربایجان_غربی","بوکان","مرکزی",110,78,5,6,57,146,11,157
"آذربایجان_غربی","بوکان","مرکزی",111,92,1,10,74,177,4,181
"آذربایجان_غربی","بوکان","مرکزی",112,95,3,7,68,173,2,175
"آذربایجان_غربی","بوکان","مرکزی",113,35,0,11,91,137,6,143
"آذربایجان_غربی","بوکان","مرکزی",114,58,3,17,93,171,8,179
"آذربایجان_غربی","بوکان","مرکزی",115,91,2,17,95,205,5,210
"آذربایجان_غربی","بوکان","مرکزی",116,51,2,4,68,125,5,130
"آذربایجان_غربی","بوکان","مرکزی",117,33,6,6,54,99,2,101
"آذربایجان_غربی","بوکان","مرکزی",118,43,4,10,91,148,4,152
"آذربایجان_غربی","بوکان","مرکزی",119,47,8,10,149,214,6,220
"آذربایجان_غربی","بوکان","مرکزی",120,43,2,18,88,151,12,163
"آذربایجان_غربی","بوکان","مرکزی",121,48,3,11,35,97,4,101
"آذربایجان_غربی","بوکان","مرکزی",122,130,6,16,241,393,12,405
"آذربایجان_غربی","بوکان","مرکزی",123,160,6,8,520,694,21,715
"آذربایجان_غربی","بوکان","مرکزی",124,153,7,9,176,345,5,350
"آذربایجان_غربی","بوکان","مرکزی",125,120,2,5,207,334,12,346
"آذربایجان_غربی","بوکان","مرکزی",126,84,4,8,220,316,18,334
"آذربایجان_غربی","بوکان","مرکزی",127,106,6,29,157,298,13,311
"آذربایجان_غربی","بوکان","مرکزی",128,57,2,3,240,302,12,314
"آذربایجان_غربی","بوکان","مرکزی",129,91,6,18,285,400,12,412
"آذربایجان_غربی","بوکان","مرکزی",130,93,1,25,188,307,10,317
"آذربایجان_غربی","بوکان","مرکزی",131,28,0,9,56,93,7,100
"آذربایجان_غربی","بوکان","مرکزی",132,58,1,5,98,162,12,174
"آذربایجان_غربی","بوکان","مرکزی",133,81,1,66,139,287,9,296
"آذربایجان_غربی","بوکان","مرکزی",134,98,2,33,62,195,11,206
"آذربایجان_غربی","بوکان","مرکزی",135,94,1,17,103,215,14,229
"آذربایجان_غربی","بوکان","مرکزی",136,72,4,18,134,228,14,242
"آذربایجان_غربی","بوکان","مرکزی",137,72,1,17,74,164,5,169
"آذربایجان_غربی","بوکان","مرکزی",138,87,2,10,128,227,18,245
"آذربایجان_غربی","بوکان","مرکزی",139,78,6,15,138,237,15,252
"آذربایجان_غربی","بوکان","مرکزی",140,46,1,5,64,116,6,122
"آذربایجان_غربی","بوکان","مرکزی",141,49,2,8,174,233,7,240
"آذربایجان_غربی","بوکان","مرکزی",142,39,3,4,99,145,8,153
"آذربایجان_غربی","بوکان","مرکزی",143,132,4,2,104,242,11,253
"آذربایجان_غربی","بوکان","مرکزی",144,57,10,12,144,223,4,227
"آذربایجان_غربی","بوکان","مرکزی",145,45,4,10,42,101,9,110
"آذربایجان_غربی","بوکان","مرکزی",146,56,2,8,78,144,1,145
"آذربایجان_غربی","بوکان","مرکزی",147,127,0,9,67,203,2,205
"آذربایجان_غربی","بوکان","مرکزی",148,70,2,3,67,142,4,146
"آذربایجان_غربی","بوکان","مرکزی",149,110,2,18,39,169,7,176
"آذربایجان_غربی","بوکان","مرکزی",150,72,2,5,64,143,11,154
"آذربایجان_غربی","پلدشت","مرکزی",1,195,1,2,633,831,4,835
"آذربایجان_غربی","پلدشت","مرکزی",2,188,1,3,739,931,3,934
"آذربایجان_غربی","پلدشت","مرکزی",3,357,1,0,564,922,3,925
"آذربایجان_غربی","پلدشت","مرکزی",4,257,10,1,563,831,3,834
"آذربایجان_غربی","پلدشت","مرکزی",5,190,2,0,301,493,2,495
"آذربایجان_غربی","پلدشت","مرکزی",6,186,2,3,513,704,4,708
"آذربایجان_غربی","پلدشت","مرکزی",7,162,3,1,266,432,1,433
"آذربایجان_غربی","پلدشت","مرکزی",8,250,3,1,198,452,1,453
"آذربایجان_غربی","پلدشت","مرکزی",9,147,5,1,229,382,7,389
"آذربایجان_غربی","پلدشت","مرکزی",10,295,10,5,274,584,0,584
"آذربایجان_غربی","پلدشت","مرکزی",11,214,1,3,257,475,1,476
"آذربایجان_غربی","پلدشت","مرکزی",12,207,2,14,207,430,3,433
"آذربایجان_غربی","پلدشت","مرکزی",13,135,1,0,280,416,4,420
"آذربایجان_غربی","پلدشت","مرکزی",14,129,0,0,148,277,1,278
"آذربایجان_غربی","پلدشت","مرکزی",15,199,10,0,170,379,0,379
"آذربایجان_غربی","پلدشت","مرکزی",16,169,10,44,129,352,9,361
"آذربایجان_غربی","پلدشت","مرکزی",17,257,0,13,77,347,3,350
"آذربایجان_غربی","پلدشت","مرکزی",18,274,5,6,131,416,2,418
"آذربایجان_غربی","پلدشت","مرکزی",19,333,1,3,69,406,4,410
"آذربایجان_غربی","پلدشت","مرکزی",20,408,12,15,160,595,3,598
"آذربایجان_غربی","پلدشت","مرکزی",21,482,4,27,96,609,1,610
"آذربایجان_غربی","پلدشت","مرکزی",22,417,2,7,84,510,0,510
"آذربایجان_غربی","پلدشت","مرکزی",23,288,47,83,79,497,27,524
"آذربایجان_غربی","پلدشت","مرکزی",24,242,4,0,154,400,1,401
"آذربایجان_غربی","پلدشت","مرکزی",25,253,0,46,285,584,4,588
"آذربایجان_غربی","پلدشت","ارس",1,247,2,1,201,451,1,452
"آذربایجان_غربی","پلدشت","ارس",2,485,0,1,220,706,5,711
"آذربایجان_غربی","پلدشت","ارس",3,259,1,0,193,453,8,461
"آذربایجان_غربی","پلدشت","ارس",4,69,0,0,109,178,0,178
"آذربایجان_غربی","پلدشت","ارس",5,438,3,0,548,989,6,995
"آذربایجان_غربی","پلدشت","ارس",6,53,0,0,87,140,0,140
"آذربایجان_غربی","پلدشت","ارس",7,192,2,1,387,582,0,582
"آذربایجان_غربی","پلدشت","ارس",8,232,4,0,181,417,3,420
"آذربایجان_غربی","پلدشت","ارس",9,327,4,7,58,396,1,397
"آذربایجان_غربی","پلدشت","ارس",10,335,2,0,221,558,1,559
"آذربایجان_غربی","پلدشت","ارس",11,50,0,1,37,88,0,88
"آذربایجان_غربی","پلدشت","ارس",12,165,4,6,97,272,0,272
"آذربایجان_غربی","پلدشت","ارس",13,316,0,5,212,533,0,533
"آذربایجان_غربی","پلدشت","ارس",14,292,3,8,94,397,13,410
"آذربایجان_غربی","پلدشت","ارس",15,172,0,3,58,233,9,242
"آذربایجان_غربی","پلدشت","ارس",16,123,0,6,140,269,1,270
"آذربایجان_غربی","پیرانشهر","مرکزی",1,184,14,26,475,699,16,715
"آذربایجان_غربی","پیرانشهر","مرکزی",2,202,16,32,687,937,29,966
"آذربایجان_غربی","پیرانشهر","مرکزی",3,235,20,49,703,1007,46,1053
"آذربایجان_غربی","پیرانشهر","مرکزی",4,422,16,27,822,1287,20,1307
"آذربایجان_غربی","پیرانشهر","مرکزی",5,91,9,8,143,251,13,264
"آذربایجان_غربی","پیرانشهر","مرکزی",6,192,14,22,425,653,13,666
"آذربایجان_غربی","پیرانشهر","مرکزی",7,187,14,28,559,788,12,800
"آذربایجان_غربی","پیرانشهر","مرکزی",8,101,8,17,343,469,12,481
"آذربایجان_غربی","پیرانشهر","مرکزی",9,310,28,68,994,1400,40,1440
"آذربایجان_غربی","پیرانشهر","مرکزی",10,139,6,18,408,571,27,598
"آذربایجان_غربی","پیرانشهر","مرکزی",11,144,14,43,406,607,27,634
"آذربایجان_غربی","پیرانشهر","مرکزی",12,250,22,55,858,1185,39,1224
"آذربایجان_غربی","پیرانشهر","مرکزی",13,117,17,32,564,730,32,762
"آذربایجان_غربی","پیرانشهر","مرکزی",14,115,8,41,304,468,15,483
"آذربایجان_غربی","پیرانشهر","مرکزی",15,207,22,45,750,1024,46,1070
"آذربایجان_غربی","پیرانشهر","مرکزی",16,234,44,37,955,1270,45,1315
"آذربایجان_غربی","پیرانشهر","مرکزی",17,193,16,35,521,765,13,778
"آذربایجان_غربی","پیرانشهر","مرکزی",18,114,19,36,524,693,27,720
"آذربایجان_غربی","پیرانشهر","مرکزی",19,116,15,10,386,527,12,539
"آذربایجان_غربی","پیرانشهر","مرکزی",20,51,6,10,156,223,8,231
"آذربایجان_غربی","پیرانشهر","مرکزی",21,101,13,25,335,474,15,489
"آذربایجان_غربی","پیرانشهر","مرکزی",22,252,34,22,713,1021,32,1053
"آذربایجان_غربی","پیرانشهر","مرکزی",23,225,23,7,139,394,6,400
"آذربایجان_غربی","پیرانشهر","مرکزی",24,258,11,10,184,463,9,472
"آذربایجان_غربی","پیرانشهر","مرکزی",25,171,16,35,589,811,28,839
"آذربایجان_غربی","پیرانشهر","مرکزی",26,97,9,19,323,448,10,458
"آذربایجان_غربی","پیرانشهر","مرکزی",27,74,12,28,233,347,9,356
"آذربایجان_غربی","پیرانشهر","مرکزی",28,173,11,28,431,643,15,658
"آذربایجان_غربی","پیرانشهر","مرکزی",29,194,8,4,99,305,1,306
"آذربایجان_غربی","پیرانشهر","مرکزی",30,173,23,18,366,580,20,600
"آذربایجان_غربی","پیرانشهر","مرکزی",31,55,1,25,191,272,7,279
"آذربایجان_غربی","پیرانشهر","مرکزی",32,40,5,7,143,195,3,198
"آذربایجان_غربی","پیرانشهر","مرکزی",33,128,3,14,277,422,6,428
"آذربایجان_غربی","پیرانشهر","مرکزی",34,38,3,4,260,305,8,313
"آذربایجان_غربی","پیرانشهر","مرکزی",35,128,4,15,175,322,13,335
"آذربایجان_غربی","پیرانشهر","مرکزی",36,161,1,10,222,394,14,408
"آذربایجان_غربی","پیرانشهر","مرکزی",37,101,2,31,156,290,4,294
"آذربایجان_غربی","پیرانشهر","مرکزی",38,95,18,19,218,350,13,363
"آذربایجان_غربی","پیرانشهر","مرکزی",39,55,4,4,64,127,4,131
"آذربایجان_غربی","پیرانشهر","مرکزی",40,107,4,15,114,240,0,240
"آذربایجان_غربی","پیرانشهر","مرکزی",41,123,7,22,107,259,11,270
"آذربایجان_غربی","پیرانشهر","مرکزی",42,266,11,5,301,583,6,589
"آذربایجان_غربی","پیرانشهر","مرکزی",43,116,5,10,154,285,5,290
"آذربایجان_غربی","پیرانشهر","مرکزی",44,122,2,9,201,334,4,338
"آذربایجان_غربی","پیرانشهر","مرکزی",45,46,2,2,67,117,1,118
"آذربایجان_غربی","پیرانشهر","مرکزی",46,30,0,0,141,171,1,172
"آذربایجان_غربی","پیرانشهر","مرکزی",47,114,2,10,255,381,14,395
"آذربایجان_غربی","پیرانشهر","مرکزی",48,106,5,15,152,278,13,291
"آذربایجان_غربی","پیرانشهر","مرکزی",49,56,1,4,72,133,5,138
"آذربایجان_غربی","پیرانشهر","مرکزی",50,66,0,4,56,126,1,127
"آذربایجان_غربی","پیرانشهر","مرکزی",51,85,3,15,66,169,4,173
"آذربایجان_غربی","پیرانشهر","مرکزی",52,146,4,8,101,259,5,264
"آذربایجان_غربی","پیرانشهر","مرکزی",53,117,12,15,265,409,12,421
"آذربایجان_غربی","پیرانشهر","مرکزی",54,632,11,12,464,1119,28,1147
"آذربایجان_غربی","پیرانشهر","مرکزی",55,160,10,42,301,513,16,529
"آذربایجان_غربی","پیرانشهر","مرکزی",56,39,2,6,170,217,6,223
"آذربایجان_غربی","پیرانشهر","مرکزی",57,37,3,20,169,229,10,239
"آذربایجان_غربی","پیرانشهر","مرکزی",58,136,0,25,161,322,13,335
"آذربایجان_غربی","پیرانشهر","مرکزی",59,30,5,30,125,190,8,198
"آذربایجان_غربی","پیرانشهر","مرکزی",60,77,4,9,135,225,4,229
"آذربایجان_غربی","پیرانشهر","لاجان",1,146,11,27,357,541,18,559
"آذربایجان_غربی","پیرانشهر","لاجان",2,52,1,6,105,164,8,172
"آذربایجان_غربی","پیرانشهر","لاجان",3,104,4,37,294,439,24,463
"آذربایجان_غربی","پیرانشهر","لاجان",4,67,4,8,238,317,7,324
"آذربایجان_غربی","پیرانشهر","لاجان",5,428,9,4,348,789,12,801
"آذربایجان_غربی","پیرانشهر","لاجان",6,148,12,19,428,607,19,626
"آذربایجان_غربی","پیرانشهر","لاجان",7,40,3,3,191,237,4,241
"آذربایجان_غربی","پیرانشهر","لاجان",8,98,9,22,310,439,12,451
"آذربایجان_غربی","پیرانشهر","لاجان",9,197,7,7,176,387,4,391
"آذربایجان_غربی","پیرانشهر","لاجان",10,72,4,24,182,282,8,290
"آذربایجان_غربی","پیرانشهر","لاجان",11,40,3,14,110,167,7,174
"آذربایجان_غربی","پیرانشهر","لاجان",12,39,1,14,198,252,11,263
"آذربایجان_غربی","پیرانشهر","لاجان",13,57,0,11,100,168,1,169
"آذربایجان_غربی","پیرانشهر","لاجان",14,157,2,22,125,306,20,326
"آذربایجان_غربی","پیرانشهر","لاجان",15,62,3,8,26,99,3,102
"آذربایجان_غربی","پیرانشهر","لاجان",16,76,4,41,126,247,4,251
"آذربایجان_غربی","پیرانشهر","لاجان",17,43,0,13,142,198,7,205
"آذربایجان_غربی","پیرانشهر","لاجان",18,34,5,38,38,115,3,118
"آذربایجان_غربی","پیرانشهر","لاجان",19,30,3,20,119,172,4,176
"آذربایجان_غربی","پیرانشهر","لاجان",20,16,0,16,100,132,0,132
"آذربایجان_غربی","پیرانشهر","لاجان",21,123,0,59,79,261,13,274
"آذربایجان_غربی","پیرانشهر","لاجان",22,28,0,17,37,82,1,83
"آذربایجان_غربی","پیرانشهر","لاجان",23,40,0,4,64,108,0,108
"آذربایجان_غربی","پیرانشهر","لاجان",24,65,6,14,117,202,17,219
"آذربایجان_غربی","پیرانشهر","لاجان",25,42,1,15,74,132,6,138
"آذربایجان_غربی","پیرانشهر","لاجان",26,57,1,17,69,144,6,150
"آذربایجان_غربی","پیرانشهر","لاجان",27,102,1,3,110,216,8,224
"آذربایجان_غربی","پیرانشهر","لاجان",28,83,35,18,189,325,8,333
"آذربایجان_غربی","پیرانشهر","لاجان",29,67,4,24,285,380,16,396
"آذربایجان_غربی","پیرانشهر","لاجان",30,23,4,7,71,105,8,113
"آذربایجان_غربی","تکاب","مرکزی",1,217,4,5,400,626,14,640
"آذربایجان_غربی","تکاب","مرکزی",2,600,8,7,798,1413,21,1434
"آذربایجان_غربی","تکاب","مرکزی",3,285,7,2,495,789,17,806
"آذربایجان_غربی","تکاب","مرکزی",4,518,16,7,574,1115,11,1126
"آذربایجان_غربی","تکاب","مرکزی",5,176,5,1,317,499,8,507
"آذربایجان_غربی","تکاب","مرکزی",6,516,3,5,377,901,18,919
"آذربایجان_غربی","تکاب","مرکزی",7,580,17,6,919,1522,29,1551
"آذربایجان_غربی","تکاب","مرکزی",8,517,4,0,386,907,9,916
"آذربایجان_غربی","تکاب","مرکزی",9,502,10,3,754,1269,20,1289
"آذربایجان_غربی","تکاب","مرکزی",10,666,7,4,570,1247,37,1284
"آذربایجان_غربی","تکاب","مرکزی",11,659,10,0,277,946,23,969
"آذربایجان_غربی","تکاب","مرکزی",12,651,8,0,444,1103,38,1141
"آذربایجان_غربی","تکاب","مرکزی",13,460,8,5,660,1133,16,1149
"آذربایجان_غربی","تکاب","مرکزی",14,136,4,1,225,366,4,370
"آذربایجان_غربی","تکاب","مرکزی",15,572,11,6,497,1086,23,1109
"آذربایجان_غربی","تکاب","مرکزی",16,567,3,1,476,1047,20,1067
"آذربایجان_غربی","تکاب","مرکزی",17,192,2,2,220,416,3,419
"آذربایجان_غربی","تکاب","مرکزی",18,549,8,7,524,1088,9,1097
"آذربایجان_غربی","تکاب","مرکزی",19,413,7,26,762,1208,19,1227
"آذربایجان_غربی","تکاب","مرکزی",20,161,4,14,398,577,10,587
"آذربایجان_غربی","تکاب","مرکزی",21,550,8,18,825,1401,49,1450
"آذربایجان_غربی","تکاب","مرکزی",22,530,12,4,949,1495,35,1530
"آذربایجان_غربی","تکاب","مرکزی",23,251,5,8,372,636,26,662
"آذربایجان_غربی","تکاب","مرکزی",24,208,3,1,287,499,14,513
"آذربایجان_غربی","تکاب","مرکزی",25,270,7,13,614,904,28,932
"آذربایجان_غربی","تکاب","مرکزی",26,179,1,4,72,256,6,262
"آذربایجان_غربی","تکاب","مرکزی",27,584,2,2,210,798,13,811
"آذربایجان_غربی","تکاب","مرکزی",28,308,0,0,42,350,8,358
"آذربایجان_غربی","تکاب","مرکزی",29,484,1,4,147,636,11,647
"آذربایجان_غربی","تکاب","مرکزی",30,564,1,1,90,656,11,667
"آذربایجان_غربی","تکاب","مرکزی",31,313,0,0,48,361,1,362
"آذربایجان_غربی","تکاب","مرکزی",32,405,2,0,95,502,2,504
"آذربایجان_غربی","تکاب","مرکزی",33,444,0,0,61,505,12,517
"آذربایجان_غربی","تکاب","مرکزی",34,180,0,0,102,282,10,292
"آذربایجان_غربی","تکاب","مرکزی",35,277,2,2,167,448,21,469
"آذربایجان_غربی","تکاب","مرکزی",36,187,0,3,118,308,12,320
"آذربایجان_غربی","تکاب","مرکزی",37,89,1,2,178,270,4,274
"آذربایجان_غربی","تکاب","مرکزی",38,156,2,3,253,414,10,424
"آذربایجان_غربی","تکاب","مرکزی",39,209,1,1,311,522,9,531
"آذربایجان_غربی","تکاب","مرکزی",40,135,0,1,128,264,0,264
"آذربایجان_غربی","تکاب","مرکزی",41,56,0,0,117,173,2,175
"آذربایجان_غربی","تکاب","مرکزی",42,202,0,0,228,430,7,437
"آذربایجان_غربی","تکاب","مرکزی",43,203,0,0,25,228,7,235
"آذربایجان_غربی","تکاب","مرکزی",44,229,1,1,83,314,16,330
"آذربایجان_غربی","تکاب","تخت_سلیمان",1,275,2,4,293,574,23,597
"آذربایجان_غربی","تکاب","تخت_سلیمان",2,248,9,8,419,684,14,698
"آذربایجان_غربی","تکاب","تخت_سلیمان",3,505,12,0,162,679,8,687
"آذربایجان_غربی","تکاب","تخت_سلیمان",4,274,3,6,399,682,28,710
"آذربایجان_غربی","تکاب","تخت_سلیمان",5,355,8,5,641,1009,10,1019
"آذربایجان_غربی","تکاب","تخت_سلیمان",6,614,1,2,124,741,20,761
"آذربایجان_غربی","تکاب","تخت_سلیمان",7,540,6,5,409,960,14,974
"آذربایجان_غربی","تکاب","تخت_سلیمان",8,139,1,4,224,368,26,394
"آذربایجان_غربی","تکاب","تخت_سلیمان",9,41,1,2,114,158,6,164
"آذربایجان_غربی","تکاب","تخت_سلیمان",10,459,3,0,234,696,18,714
"آذربایجان_غربی","تکاب","تخت_سلیمان",11,368,1,0,112,481,19,500
"آذربایجان_غربی","تکاب","تخت_سلیمان",12,444,2,0,69,515,5,520
"آذربایجان_غربی","تکاب","تخت_سلیمان",13,253,1,0,82,336,2,338
"آذربایجان_غربی","تکاب","تخت_سلیمان",14,491,1,27,167,686,9,695
"آذربایجان_غربی","تکاب","تخت_سلیمان",15,436,3,0,110,549,10,559
"آذربایجان_غربی","تکاب","تخت_سلیمان",16,338,0,0,143,481,10,491
"آذربایجان_غربی","تکاب","تخت_سلیمان",17,208,0,0,35,243,2,245
"آذربایجان_غربی","تکاب","تخت_سلیمان",18,243,0,0,31,274,1,275
"آذربایجان_غربی","تکاب","تخت_سلیمان",19,218,0,0,129,347,8,355
"آذربایجان_غربی","تکاب","تخت_سلیمان",20,284,0,0,69,353,8,361
"آذربایجان_غربی","تکاب","تخت_سلیمان",21,277,0,0,64,341,2,343
"آذربایجان_غربی","تکاب","تخت_سلیمان",22,264,16,4,283,567,12,579
"آذربایجان_غربی","تکاب","تخت_سلیمان",23,46,0,0,42,88,1,89
"آذربایجان_غربی","چالدران","مرکزی",1,281,13,16,420,730,16,746
"آذربایجان_غربی","چالدران","مرکزی",2,393,11,8,782,1194,13,1207
"آذربایجان_غربی","چالدران","مرکزی",3,117,2,2,187,308,3,311
"آذربایجان_غربی","چالدران","مرکزی",4,122,2,0,103,227,1,228
"آذربایجان_غربی","چالدران","مرکزی",5,398,7,0,334,739,3,742
"آذربایجان_غربی","چالدران","مرکزی",6,261,1,0,236,498,1,499
"آذربایجان_غربی","چالدران","مرکزی",7,106,3,13,110,232,0,232
"آذربایجان_غربی","چالدران","مرکزی",8,182,5,8,278,473,4,477
"آذربایجان_غربی","چالدران","مرکزی",9,153,0,3,176,332,1,333
"آذربایجان_غربی","چالدران","مرکزی",10,318,8,5,158,489,10,499
"آذربایجان_غربی","چالدران","مرکزی",11,95,6,23,178,302,11,313
"آذربایجان_غربی","چالدران","مرکزی",12,143,2,4,199,348,9,357
"آذربایجان_غربی","چالدران","مرکزی",13,158,4,2,167,331,1,332
"آذربایجان_غربی","چالدران","مرکزی",14,196,1,0,193,390,1,391
"آذربایجان_غربی","چالدران","مرکزی",15,63,0,1,51,115,1,116
"آذربایجان_غربی","چالدران","مرکزی",16,229,11,14,102,356,1,357
"آذربایجان_غربی","چالدران","مرکزی",17,431,4,4,111,550,1,551
"آذربایجان_غربی","چالدران","مرکزی",18,333,2,1,33,369,2,371
"آذربایجان_غربی","چالدران","مرکزی",19,160,3,7,75,245,0,245
"آذربایجان_غربی","چالدران","مرکزی",20,176,0,9,180,365,9,374
"آذربایجان_غربی","چالدران","مرکزی",21,142,4,5,214,365,4,369
"آذربایجان_غربی","چالدران","مرکزی",22,16,0,0,263,279,0,279
"آذربایجان_غربی","چالدران","مرکزی",23,448,5,10,96,559,0,559
"آذربایجان_غربی","چالدران","مرکزی",24,90,1,2,155,248,1,249
"آذربایجان_غربی","چالدران","مرکزی",25,29,0,0,273,302,1,303
"آذربایجان_غربی","چالدران","مرکزی",26,184,2,12,153,351,5,356
"آذربایجان_غربی","چالدران","مرکزی",27,448,6,31,350,835,35,870
"آذربایجان_غربی","چالدران","مرکزی",28,136,6,12,307,461,5,466
"آذربایجان_غربی","چالدران","مرکزی",29,148,10,1,110,269,7,276
"آذربایجان_غربی","چالدران","مرکزی",30,78,5,1,87,171,4,175
"آذربایجان_غربی","چالدران","مرکزی",31,149,0,12,153,314,3,317
"آذربایجان_غربی","چالدران","مرکزی",32,259,2,0,68,329,0,329
"آذربایجان_غربی","چالدران","مرکزی",33,245,1,0,45,291,0,291
"آذربایجان_غربی","چالدران","مرکزی",34,148,3,3,116,270,2,272
"آذربایجان_غربی","چالدران","مرکزی",35,112,6,14,161,293,0,293
"آذربایجان_غربی","چالدران","مرکزی",36,41,1,1,68,111,0,111
"آذربایجان_غربی","چالدران","مرکزی",37,165,0,0,17,182,2,184
"آذربایجان_غربی","چالدران","مرکزی",38,221,0,0,94,315,0,315
"آذربایجان_غربی","چالدران","مرکزی",39,305,2,0,77,384,1,385
"آذربایجان_غربی","چالدران","مرکزی",40,173,1,0,47,221,0,221
"آذربایجان_غربی","چالدران","مرکزی",41,190,1,8,99,298,4,302
"آذربایجان_غربی","چالدران","مرکزی",42,195,0,0,139,334,5,339
"آذربایجان_غربی","چالدران","مرکزی",43,101,2,1,89,193,1,194
"آذربایجان_غربی","چالدران","مرکزی",44,146,1,0,107,254,1,255
"آذربایجان_غربی","چالدران","مرکزی",45,245,0,0,57,302,0,302
"آذربایجان_غربی","چالدران","مرکزی",46,207,1,0,92,300,0,300
"آذربایجان_غربی","چالدران","مرکزی",47,202,0,0,68,270,1,271
"آذربایجان_غربی","چالدران","مرکزی",48,328,0,0,113,441,3,444
"آذربایجان_غربی","چالدران","مرکزی",49,73,0,0,46,119,2,121
"آذربایجان_غربی","چالدران","مرکزی",50,107,8,2,82,199,1,200
"آذربایجان_غربی","چالدران","دشتک",1,206,2,0,290,498,3,501
"آذربایجان_غربی","چالدران","دشتک",2,139,2,0,355,496,2,498
"آذربایجان_غربی","چالدران","دشتک",3,132,2,3,265,402,1,403
"آذربایجان_غربی","چالدران","دشتک",4,145,1,1,146,293,1,294
"آذربایجان_غربی","چالدران","دشتک",5,45,0,0,138,183,1,184
"آذربایجان_غربی","چالدران","دشتک",6,113,0,0,152,265,1,266
"آذربایجان_غربی","چالدران","دشتک",7,172,0,5,185,362,0,362
"آذربایجان_غربی","چالدران","دشتک",8,44,0,0,110,154,0,154
"آذربایجان_غربی","چالدران","دشتک",9,126,1,0,133,260,0,260
"آذربایجان_غربی","چالدران","دشتک",10,104,1,1,172,278,2,280
"آذربایجان_غربی","چالدران","دشتک",11,166,1,8,173,348,1,349
"آذربایجان_غربی","چالدران","دشتک",12,133,2,0,147,282,2,284
"آذربایجان_غربی","چالدران","دشتک",13,142,1,0,78,221,0,221
"آذربایجان_غربی","چالدران","دشتک",14,90,1,0,59,150,0,150
"آذربایجان_غربی","چالدران","دشتک",15,83,1,1,159,244,0,244
"آذربایجان_غربی","چالدران","دشتک",16,48,0,1,95,144,0,144
"آذربایجان_غربی","چالدران","دشتک",17,149,1,4,137,291,6,297
"آذربایجان_غربی","چایپاره","مرکزی",1,315,12,0,346,673,2,675
"آذربایجان_غربی","چایپاره","مرکزی",2,117,0,0,166,283,1,284
"آذربایجان_غربی","چایپاره","مرکزی",3,238,7,2,405,652,6,658
"آذربایجان_غربی","چایپاره","مرکزی",4,354,5,0,662,1021,7,1028
"آذربایجان_غربی","چایپاره","مرکزی",5,262,2,3,528,795,2,797
"آذربایجان_غربی","چایپاره","مرکزی",6,363,5,0,514,882,4,886
"آذربایجان_غربی","چایپاره","مرکزی",7,571,4,4,596,1175,10,1185
"آذربایجان_غربی","چایپاره","مرکزی",8,554,16,6,1183,1759,3,1762
"آذربایجان_غربی","چایپاره","مرکزی",9,589,7,2,686,1284,6,1290
"آذربایجان_غربی","چایپاره","مرکزی",10,360,6,8,805,1179,8,1187
"آذربایجان_غربی","چایپاره","مرکزی",11,323,6,1,335,665,2,667
"آذربایجان_غربی","چایپاره","مرکزی",12,518,3,3,210,734,2,736
"آذربایجان_غربی","چایپاره","مرکزی",13,326,4,6,191,527,4,531
"آذربایجان_غربی","چایپاره","مرکزی",14,261,1,6,581,849,1,850
"آذربایجان_غربی","چایپاره","مرکزی",15,177,5,6,67,255,3,258
"آذربایجان_غربی","چایپاره","مرکزی",16,364,5,0,280,649,1,650
"آذربایجان_غربی","چایپاره","مرکزی",17,536,1,0,296,833,5,838
"آذربایجان_غربی","چایپاره","مرکزی",18,381,3,0,85,469,5,474
"آذربایجان_غربی","چایپاره","مرکزی",19,253,1,0,130,384,0,384
"آذربایجان_غربی","چایپاره","مرکزی",20,296,4,0,159,459,5,464
"آذربایجان_غربی","چایپاره","مرکزی",21,431,1,0,235,667,2,669
"آذربایجان_غربی","چایپاره","مرکزی",22,114,1,4,144,263,6,269
"آذربایجان_غربی","چایپاره","مرکزی",23,140,1,0,91,232,0,232
"آذربایجان_غربی","چایپاره","مرکزی",24,239,2,1,184,426,5,431
"آذربایجان_غربی","چایپاره","مرکزی",25,139,0,1,75,215,0,215
"آذربایجان_غربی","چایپاره","مرکزی",26,287,0,0,171,458,0,458
"آذربایجان_غربی","چایپاره","مرکزی",27,210,0,1,221,432,5,437
"آذربایجان_غربی","چایپاره","مرکزی",28,56,1,0,38,95,0,95
"آذربایجان_غربی","چایپاره","مرکزی",29,99,0,2,73,174,0,174
"آذربایجان_غربی","چایپاره","مرکزی",30,65,1,2,100,168,3,171
"آذربایجان_غربی","چایپاره","حاجیلار",1,258,5,0,182,445,2,447
"آذربایجان_غربی","چایپاره","حاجیلار",2,264,1,0,110,375,0,375
"آذربایجان_غربی","چایپاره","حاجیلار",3,206,7,31,50,294,0,294
"آذربایجان_غربی","چایپاره","حاجیلار",4,258,1,0,153,412,1,413
"آذربایجان_غربی","چایپاره","حاجیلار",5,133,0,0,82,215,1,216
"آذربایجان_غربی","چایپاره","حاجیلار",6,176,0,1,60,237,1,238
"آذربایجان_غربی","چایپاره","حاجیلار",7,179,1,1,56,237,1,238
"آذربایجان_غربی","چایپاره","حاجیلار",8,254,5,0,76,335,3,338
"آذربایجان_غربی","چایپاره","حاجیلار",9,348,6,3,86,443,1,444
"آذربایجان_غربی","چایپاره","حاجیلار",10,217,4,2,87,310,2,312
"آذربایجان_غربی","چایپاره","حاجیلار",11,274,3,10,165,452,3,455
"آذربایجان_غربی","چایپاره","حاجیلار",12,374,0,2,98,474,0,474
"آذربایجان_غربی","خوی","مرکزی",1,635,13,15,945,1608,13,1621
"آذربایجان_غربی","خوی","مرکزی",2,255,11,8,366,640,14,654
"آذربایجان_غربی","خوی","مرکزی",3,167,5,0,165,337,2,339
"آذربایجان_غربی","خوی","مرکزی",4,222,13,8,467,710,12,722
"آذربایجان_غربی","خوی","مرکزی",5,524,13,0,856,1393,7,1400
"آذربایجان_غربی","خوی","مرکزی",6,621,10,8,839,1478,14,1492
"آذربایجان_غربی","خوی","مرکزی",7,496,15,0,546,1057,3,1060
"آذربایجان_غربی","خوی","مرکزی",8,149,4,1,207,361,1,362
"آذربایجان_غربی","خوی","مرکزی",9,697,10,0,608,1315,8,1323
"آذربایجان_غربی","خوی","مرکزی",10,876,17,1,955,1849,5,1854
"آذربایجان_غربی","خوی","مرکزی",11,633,15,4,713,1365,2,1367
"آذربایجان_غربی","خوی","مرکزی",12,671,13,1,900,1585,6,1591
"آذربایجان_غربی","خوی","مرکزی",13,642,16,2,881,1541,21,1562
"آذربایجان_غربی","خوی","مرکزی",14,441,9,2,555,1007,11,1018
"آذربایجان_غربی","خوی","مرکزی",15,784,11,3,639,1437,12,1449
"آذربایجان_غربی","خوی","مرکزی",16,503,5,1,461,970,8,978
"آذربایجان_غربی","خوی","مرکزی",17,414,2,0,272,688,3,691
"آذربایجان_غربی","خوی","مرکزی",18,302,2,0,232,536,0,536
"آذربایجان_غربی","خوی","مرکزی",19,230,5,1,221,457,6,463
"آذربایجان_غربی","خوی","مرکزی",20,364,2,0,322,688,2,690
"آذربایجان_غربی","خوی","مرکزی",21,505,25,4,647,1181,17,1198
"آذربایجان_غربی","خوی","مرکزی",22,431,14,1,520,966,6,972
"آذربایجان_غربی","خوی","مرکزی",23,489,8,10,719,1226,13,1239
"آذربایجان_غربی","خوی","مرکزی",24,546,24,9,845,1424,18,1442
"آذربایجان_غربی","خوی","مرکزی",25,469,31,7,1129,1636,8,1644
"آذربایجان_غربی","خوی","مرکزی",26,360,16,8,782,1166,18,1184
"آذربایجان_غربی","خوی","مرکزی",27,812,23,9,893,1737,14,1751
"آذربایجان_غربی","خوی","مرکزی",28,570,28,1,803,1402,9,1411
"آذربایجان_غربی","خوی","مرکزی",29,403,36,5,1122,1566,9,1575
"آذربایجان_غربی","خوی","مرکزی",30,240,15,4,556,815,7,822
"آذربایجان_غربی","خوی","مرکزی",31,357,16,9,529,911,16,927
"آذربایجان_غربی","خوی","مرکزی",32,223,8,6,445,682,5,687
"آذربایجان_غربی","خوی","مرکزی",33,290,14,2,872,1178,13,1191
"آذربایجان_غربی","خوی","مرکزی",34,469,22,7,1014,1512,14,1526
"آذربایجان_غربی","خوی","مرکزی",35,647,18,4,827,1496,18,1514
"آذربایجان_غربی","خوی","مرکزی",36,374,13,0,534,921,6,927
"آذربایجان_غربی","خوی","مرکزی",37,297,9,1,477,784,16,800
"آذربایجان_غربی","خوی","مرکزی",38,421,18,2,522,963,12,975
"آذربایجان_غربی","خوی","مرکزی",39,467,22,1,708,1198,7,1205
"آذربایجان_غربی","خوی","مرکزی",40,450,10,6,723,1189,4,1193
"آذربایجان_غربی","خوی","مرکزی",41,667,22,4,744,1437,15,1452
"آذربایجان_غربی","خوی","مرکزی",42,463,16,6,1020,1505,15,1520
"آذربایجان_غربی","خوی","مرکزی",43,515,7,4,571,1097,4,1101
"آذربایجان_غربی","خوی","مرکزی",44,976,28,2,805,1811,17,1828
"آذربایجان_غربی","خوی","مرکزی",45,990,14,4,879,1887,12,1899
"آذربایجان_غربی","خوی","مرکزی",46,648,16,0,563,1227,16,1243
"آذربایجان_غربی","خوی","مرکزی",47,702,16,3,831,1552,10,1562
"آذربایجان_غربی","خوی","مرکزی",48,989,15,1,812,1817,13,1830
"آذربایجان_غربی","خوی","مرکزی",49,930,12,2,638,1582,18,1600
"آذربایجان_غربی","خوی","مرکزی",50,577,12,4,365,958,12,970
"آذربایجان_غربی","خوی","مرکزی",51,421,5,1,404,831,7,838
"آذربایجان_غربی","خوی","مرکزی",52,893,22,2,459,1376,9,1385
"آذربایجان_غربی","خوی","مرکزی",53,458,8,2,492,960,9,969
"آذربایجان_غربی","خوی","مرکزی",54,849,12,7,814,1682,22,1704
"آذربایجان_غربی","خوی","مرکزی",55,512,7,0,356,875,8,883
"آذربایجان_غربی","خوی","مرکزی",56,464,11,5,509,989,2,991
"آذربایجان_غربی","خوی","مرکزی",57,772,13,1,535,1321,13,1334
"آذربایجان_غربی","خوی","مرکزی",58,513,19,0,407,939,5,944
"آذربایجان_غربی","خوی","مرکزی",59,253,9,2,282,546,9,555
"آذربایجان_غربی","خوی","مرکزی",60,413,4,2,370,789,1,790
"آذربایجان_غربی","خوی","مرکزی",61,847,11,3,511,1372,15,1387
"آذربایجان_غربی","خوی","مرکزی",62,764,9,26,694,1493,9,1502
"آذربایجان_غربی","خوی","مرکزی",63,800,7,10,588,1405,23,1428
"آذربایجان_غربی","خوی","مرکزی",64,353,2,3,292,650,5,655
"آذربایجان_غربی","خوی","مرکزی",65,579,7,5,566,1157,8,1165
"آذربایجان_غربی","خوی","مرکزی",66,1113,14,9,905,2041,40,2081
"آذربایجان_غربی","خوی","مرکزی",67,591,14,2,515,1122,3,1125
"آذربایجان_غربی","خوی","مرکزی",68,801,28,7,948,1784,14,1798
"آذربایجان_غربی","خوی","مرکزی",69,693,16,2,745,1456,20,1476
"آذربایجان_غربی","خوی","مرکزی",70,438,3,0,382,823,3,826
"آذربایجان_غربی","خوی","مرکزی",71,575,9,4,451,1039,6,1045
"آذربایجان_غربی","خوی","مرکزی",72,487,5,1,366,859,4,863
"آذربایجان_غربی","خوی","مرکزی",73,430,7,0,284,721,6,727
"آذربایجان_غربی","خوی","مرکزی",74,1250,14,5,713,1982,10,1992
"آذربایجان_غربی","خوی","مرکزی",75,883,26,16,877,1802,11,1813
"آذربایجان_غربی","خوی","مرکزی",76,659,7,4,644,1314,11,1325
"آذربایجان_غربی","خوی","مرکزی",77,362,4,4,325,695,11,706
"آذربایجان_غربی","خوی","مرکزی",78,374,2,1,204,581,3,584
"آذربایجان_غربی","خوی","مرکزی",79,664,5,0,521,1190,8,1198
"آذربایجان_غربی","خوی","مرکزی",80,362,7,2,320,691,5,696
"آذربایجان_غربی","خوی","مرکزی",81,611,21,0,830,1462,10,1472
"آذربایجان_غربی","خوی","مرکزی",82,400,24,3,749,1176,7,1183
"آذربایجان_غربی","خوی","مرکزی",83,1032,28,9,1218,2287,13,2300
"آذربایجان_غربی","خوی","مرکزی",84,113,3,3,106,225,1,226
"آذربایجان_غربی","خوی","مرکزی",85,201,4,0,210,415,6,421
"آذربایجان_غربی","خوی","مرکزی",86,222,6,1,182,411,10,421
"آذربایجان_غربی","خوی","مرکزی",87,665,11,2,530,1208,12,1220
"آذربایجان_غربی","خوی","مرکزی",88,606,1,1,448,1056,8,1064
"آذربایجان_غربی","خوی","مرکزی",89,745,9,1,516,1271,11,1282
"آذربایجان_غربی","خوی","مرکزی",90,374,7,1,246,628,7,635
"آذربایجان_غربی","خوی","مرکزی",91,343,6,1,188,538,7,545
"آذربایجان_غربی","خوی","مرکزی",92,763,12,12,613,1400,0,1400
"آذربایجان_غربی","خوی","مرکزی",93,402,4,3,878,1287,10,1297
"آذربایجان_غربی","خوی","مرکزی",94,414,9,10,885,1318,8,1326
"آذربایجان_غربی","خوی","مرکزی",95,829,16,5,319,1169,3,1172
"آذربایجان_غربی","خوی","مرکزی",96,751,1,5,119,876,3,879
"آذربایجان_غربی","خوی","مرکزی",97,285,4,2,65,356,0,356
"آذربایجان_غربی","خوی","مرکزی",98,509,4,1,193,707,2,709
"آذربایجان_غربی","خوی","مرکزی",99,500,4,0,333,837,8,845
"آذربایجان_غربی","خوی","مرکزی",100,1080,5,0,226,1311,5,1316
"آذربایجان_غربی","خوی","مرکزی",101,931,11,1,137,1080,1,1081
"آذربایجان_غربی","خوی","مرکزی",102,492,4,2,197,695,3,698
"آذربایجان_غربی","خوی","مرکزی",103,573,1,1,252,827,10,837
"آذربایجان_غربی","خوی","مرکزی",104,523,8,5,138,674,10,684
"آذربایجان_غربی","خوی","مرکزی",105,303,1,3,215,522,12,534
"آذربایجان_غربی","خوی","مرکزی",106,79,0,10,508,597,7,604
"آذربایجان_غربی","خوی","مرکزی",107,786,15,5,279,1085,15,1100
"آذربایجان_غربی","خوی","مرکزی",108,525,4,3,541,1073,30,1103
"آذربایجان_غربی","خوی","مرکزی",109,789,9,1,208,1007,11,1018
"آذربایجان_غربی","خوی","مرکزی",110,577,0,0,128,705,5,710
"آذربایجان_غربی","خوی","مرکزی",111,906,7,0,232,1145,2,1147
"آذربایجان_غربی","خوی","مرکزی",112,487,6,1,227,721,9,730
"آذربایجان_غربی","خوی","مرکزی",113,362,3,2,309,676,5,681
"آذربایجان_غربی","خوی","مرکزی",114,791,8,1,218,1018,2,1020
"آذربایجان_غربی","خوی","مرکزی",115,443,8,0,380,831,7,838
"آذربایجان_غربی","خوی","مرکزی",116,603,3,1,572,1179,4,1183
"آذربایجان_غربی","خوی","مرکزی",117,820,7,0,494,1321,2,1323
"آذربایجان_غربی","خوی","مرکزی",118,606,4,1,308,919,7,926
"آذربایجان_غربی","خوی","مرکزی",119,805,4,0,266,1075,9,1084
"آذربایجان_غربی","خوی","مرکزی",120,587,7,1,198,793,7,800
"آذربایجان_غربی","خوی","مرکزی",121,689,4,1,263,957,2,959
"آذربایجان_غربی","خوی","مرکزی",122,534,4,29,317,884,4,888
"آذربایجان_غربی","خوی","مرکزی",123,425,2,2,233,662,2,664
"آذربایجان_غربی","خوی","مرکزی",124,358,5,0,191,554,4,558
"آذربایجان_غربی","خوی","مرکزی",125,156,2,0,59,217,7,224
"آذربایجان_غربی","خوی","مرکزی",126,116,2,0,38,156,0,156
"آذربایجان_غربی","خوی","مرکزی",127,154,0,0,51,205,2,207
"آذربایجان_غربی","خوی","مرکزی",128,737,10,6,218,971,9,980
"آذربایجان_غربی","خوی","مرکزی",129,571,0,1,215,787,16,803
"آذربایجان_غربی","خوی","مرکزی",130,1069,12,8,492,1581,12,1593
"آذربایجان_غربی","خوی","مرکزی",131,298,4,1,279,582,5,1621
"آذربایجان_غربی","خوی","ایواوغلی",1,328,8,1,492,829,23,852
"آذربایجان_غربی","خوی","ایواوغلی",2,443,4,0,495,942,6,948
"آذربایجان_غربی","خوی","ایواوغلی",3,476,0,0,271,747,7,754
"آذربایجان_غربی","خوی","ایواوغلی",4,350,1,0,170,521,0,521
"آذربایجان_غربی","خوی","ایواوغلی",5,422,4,1,266,693,0,693
"آذربایجان_غربی","خوی","ایواوغلی",6,214,1,0,148,363,2,365
"آذربایجان_غربی","خوی","ایواوغلی",7,538,5,0,298,841,7,848
"آذربایجان_غربی","خوی","ایواوغلی",8,616,12,5,284,917,0,917
"آذربایجان_غربی","خوی","ایواوغلی",9,216,4,0,208,428,5,433
"آذربایجان_غربی","خوی","ایواوغلی",10,375,5,1,75,456,2,458
"آذربایجان_غربی","خوی","ایواوغلی",11,433,1,3,203,640,2,642
"آذربایجان_غربی","خوی","ایواوغلی",12,484,5,1,239,729,5,734
"آذربایجان_غربی","خوی","ایواوغلی",13,392,5,1,250,648,3,651
"آذربایجان_غربی","خوی","ایواوغلی",14,208,2,0,61,271,0,271
"آذربایجان_غربی","خوی","ایواوغلی",15,628,5,1,160,794,1,795
"آذربایجان_غربی","خوی","صفائیه",1,462,5,1,233,701,1,702
"آذربایجان_غربی","خوی","صفائیه",2,600,3,1,231,835,8,843
"آذربایجان_غربی","خوی","صفائیه",3,439,2,0,67,508,5,513
"آذربایجان_غربی","خوی","صفائیه",4,443,1,0,69,513,4,517
"آذربایجان_غربی","خوی","صفائیه",5,399,3,1,87,490,14,504
"آذربایجان_غربی","خوی","صفائیه",6,390,5,1,107,503,2,505
"آذربایجان_غربی","خوی","صفائیه",7,47,5,3,89,144,0,144
"آذربایجان_غربی","خوی","صفائیه",8,203,9,3,118,333,1,334
"آذربایجان_غربی","خوی","صفائیه",9,250,2,7,282,541,10,551
"آذربایجان_غربی","خوی","صفائیه",10,237,3,0,63,303,5,308
"آذربایجان_غربی","خوی","صفائیه",11,300,9,9,338,656,3,659
"آذربایجان_غربی","خوی","صفائیه",12,150,2,3,173,328,10,338
"آذربایجان_غربی","خوی","صفائیه",13,53,2,6,472,533,8,541
"آذربایجان_غربی","خوی","صفائیه",14,129,4,4,368,505,13,518
"آذربایجان_غربی","خوی","صفائیه",15,29,1,4,298,332,1,333
"آذربایجان_غربی","خوی","صفائیه",16,45,4,2,270,321,6,327
"آذربایجان_غربی","خوی","صفائیه",17,288,2,1,284,575,2,577
"آذربایجان_غربی","خوی","قطور",1,287,7,30,543,867,27,894
"آذربایجان_غربی","خوی","قطور",2,318,10,25,428,781,19,800
"آذربایجان_غربی","خوی","قطور",3,126,10,39,396,571,22,593
"آذربایجان_غربی","خوی","قطور",4,74,0,13,303,390,3,393
"آذربایجان_غربی","خوی","قطور",5,409,4,1,143,557,8,565
"آذربایجان_غربی","خوی","قطور",6,183,1,7,228,419,8,427
"آذربایجان_غربی","خوی","قطور",7,190,3,28,468,689,19,708
"آذربایجان_غربی","خوی","قطور",8,13,1,6,232,252,32,284
"آذربایجان_غربی","خوی","قطور",9,148,4,4,383,539,11,550
"آذربایجان_غربی","خوی","قطور",10,140,9,12,395,556,8,564
"آذربایجان_غربی","خوی","قطور",11,105,1,1,544,651,19,670
"آذربایجان_غربی","خوی","قطور",12,37,0,1,261,299,11,310
"آذربایجان_غربی","خوی","قطور",13,116,3,9,191,319,19,338
"آذربایجان_غربی","خوی","قطور",14,171,10,7,358,546,4,550
"آذربایجان_غربی","خوی","قطور",15,121,4,6,317,448,6,454
"آذربایجان_غربی","سردشت","مرکزی",1,481,12,40,555,1088,30,1118
"آذربایجان_غربی","سردشت","مرکزی",2,350,8,25,526,909,87,996
"آذربایجان_غربی","سردشت","مرکزی",3,192,6,23,405,626,15,641
"آذربایجان_غربی","سردشت","مرکزی",4,254,4,15,300,573,29,602
"آذربایجان_غربی","سردشت","مرکزی",5,106,3,12,209,330,11,341
"آذربایجان_غربی","سردشت","مرکزی",6,154,6,17,226,403,19,422
"آذربایجان_غربی","سردشت","مرکزی",7,151,2,14,263,430,15,445
"آذربایجان_غربی","سردشت","مرکزی",8,221,6,15,348,590,22,612
"آذربایجان_غربی","سردشت","مرکزی",9,233,4,23,401,661,22,683
"آذربایجان_غربی","سردشت","مرکزی",10,286,2,14,272,574,31,605
"آذربایجان_غربی","سردشت","مرکزی",11,363,9,26,381,779,37,816
"آذربایجان_غربی","سردشت","مرکزی",12,469,13,34,476,992,40,1032
"آذربایجان_غربی","سردشت","مرکزی",13,408,2,10,257,677,28,705
"آذربایجان_غربی","سردشت","مرکزی",14,276,3,20,446,745,42,787
"آذربایجان_غربی","سردشت","مرکزی",15,422,6,31,294,753,44,797
"آذربایجان_غربی","سردشت","مرکزی",16,133,0,15,184,332,12,344
"آذربایجان_غربی","سردشت","مرکزی",17,293,6,10,460,769,11,780
"آذربایجان_غربی","سردشت","مرکزی",18,394,9,32,334,769,25,794
"آذربایجان_غربی","سردشت","مرکزی",19,111,5,19,254,389,7,396
"آذربایجان_غربی","سردشت","مرکزی",20,368,8,15,355,746,31,777
"آذربایجان_غربی","سردشت","مرکزی",21,369,9,26,428,832,50,882
"آذربایجان_غربی","سردشت","مرکزی",22,154,2,13,212,381,17,398
"آذربایجان_غربی","سردشت","مرکزی",23,278,5,7,105,395,7,402
"آذربایجان_غربی","سردشت","مرکزی",24,224,7,17,218,466,12,478
"آذربایجان_غربی","سردشت","مرکزی",25,186,1,13,195,395,9,404
"آذربایجان_غربی","سردشت","مرکزی",26,226,5,10,210,451,21,472
"آذربایجان_غربی","سردشت","مرکزی",27,232,7,23,407,669,30,699
"آذربایجان_غربی","سردشت","مرکزی",28,69,2,9,82,162,6,168
"آذربایجان_غربی","سردشت","مرکزی",29,377,3,36,506,922,35,957
"آذربایجان_غربی","سردشت","مرکزی",30,177,4,21,268,470,28,498
"آذربایجان_غربی","سردشت","مرکزی",31,83,2,18,105,208,7,215
"آذربایجان_غربی","سردشت","مرکزی",32,197,3,47,214,461,22,483
"آذربایجان_غربی","سردشت","مرکزی",33,98,1,4,41,144,8,152
"آذربایجان_غربی","سردشت","مرکزی",34,58,2,48,154,262,4,266
"آذربایجان_غربی","سردشت","مرکزی",35,156,1,16,46,219,8,227
"آذربایجان_غربی","سردشت","مرکزی",36,59,1,5,57,122,8,130
"آذربایجان_غربی","سردشت","مرکزی",37,306,2,5,238,551,14,565
"آذربایجان_غربی","سردشت","مرکزی",38,237,1,39,115,392,10,402
"آذربایجان_غربی","سردشت","مرکزی",39,103,3,20,130,256,1,257
"آذربایجان_غربی","سردشت","مرکزی",40,134,0,7,386,527,14,541
"آذربایجان_غربی","سردشت","مرکزی",41,53,1,4,27,85,2,87
"آذربایجان_غربی","سردشت","مرکزی",42,110,4,10,96,220,7,227
"آذربایجان_غربی","سردشت","مرکزی",43,246,5,25,116,392,19,411
"آذربایجان_غربی","سردشت","مرکزی",44,83,2,12,56,153,8,161
"آذربایجان_غربی","سردشت","مرکزی",45,363,1,19,101,484,11,495
"آذربایجان_غربی","سردشت","مرکزی",46,152,3,17,50,222,19,241
"آذربایجان_غربی","سردشت","مرکزی",47,267,2,7,95,371,35,406
"آذربایجان_غربی","سردشت","مرکزی",48,117,0,7,103,227,9,236
"آذربایجان_غربی","سردشت","مرکزی",49,186,1,9,165,361,14,375
"آذربایجان_غربی","سردشت","مرکزی",50,191,3,15,421,630,3,633
"آذربایجان_غربی","سردشت","مرکزی",51,334,8,57,476,875,25,900
"آذربایجان_غربی","سردشت","مرکزی",52,148,5,2,345,500,12,512
"آذربایجان_غربی","سردشت","مرکزی",53,173,1,29,152,355,17,372
"آذربایجان_غربی","سردشت","مرکزی",54,526,4,60,274,864,8,872
"آذربایجان_غربی","سردشت","مرکزی",55,132,2,0,34,168,4,172
"آذربایجان_غربی","سردشت","مرکزی",56,111,1,21,255,388,11,399
"آذربایجان_غربی","سردشت","مرکزی",57,168,0,20,429,617,8,625
"آذربایجان_غربی","سردشت","مرکزی",58,104,1,8,59,172,7,179
"آذربایجان_غربی","سردشت","مرکزی",59,81,0,6,36,123,2,125
"آذربایجان_غربی","سردشت","مرکزی",60,111,0,8,86,205,3,208
"آذربایجان_غربی","سردشت","مرکزی",61,101,0,14,129,244,20,264
"آذربایجان_غربی","سردشت","مرکزی",62,47,1,4,130,182,0,182
"آذربایجان_غربی","سردشت","مرکزی",63,149,1,48,94,292,14,306
"آذربایجان_غربی","سردشت","مرکزی",64,109,0,10,122,241,13,254
"آذربایجان_غربی","سردشت","مرکزی",65,43,0,12,69,124,2,126
"آذربایجان_غربی","سردشت","مرکزی",66,77,0,3,154,234,13,247
"آذربایجان_غربی","سردشت","مرکزی",67,297,10,24,148,479,7,486
"آذربایجان_غربی","سردشت","مرکزی",68,101,3,11,159,274,14,288
"آذربایجان_غربی","سردشت","مرکزی",69,123,6,13,166,308,6,314
"آذربایجان_غربی","سردشت","مرکزی",70,187,1,9,120,317,10,327
"آذربایجان_غربی","سردشت","مرکزی",71,179,4,22,56,261,6,267
"آذربایجان_غربی","سردشت","مرکزی",72,114,2,5,103,224,1,225
"آذربایجان_غربی","سردشت","مرکزی",73,60,2,5,126,193,3,196
"آذربایجان_غربی","سردشت","مرکزی",74,149,2,5,133,289,12,301
"آذربایجان_غربی","سردشت","مرکزی",75,154,1,16,145,316,13,329
"آذربایجان_غربی","سردشت","مرکزی",76,206,2,1,84,293,6,299
"آذربایجان_غربی","سردشت","مرکزی",77,250,3,12,309,574,10,584
"آذربایجان_غربی","سردشت","مرکزی",78,121,1,10,166,298,6,304
"آذربایجان_غربی","سردشت","مرکزی",79,147,23,0,284,454,20,474
"آذربایجان_غربی","سردشت","مرکزی",80,233,7,22,459,721,20,741
"آذربایجان_غربی","سردشت","مرکزی",81,98,2,30,189,319,7,326
"آذربایجان_غربی","سردشت","مرکزی",82,238,9,9,251,507,11,518
"آذربایجان_غربی","سردشت","مرکزی",83,265,16,16,392,689,33,722
"آذربایجان_غربی","سردشت","مرکزی",84,125,10,9,108,252,7,259
"آذربایجان_غربی","سردشت","مرکزی",85,120,2,1,119,242,4,246
"آذربایجان_غربی","سلماس","مرکزی",1,690,11,15,942,1658,11,1669
"آذربایجان_غربی","سلماس","مرکزی",2,270,5,7,477,759,2,761
"آذربایجان_غربی","سلماس","مرکزی",3,488,5,10,708,1211,4,1215
"آذربایجان_غربی","سلماس","مرکزی",4,544,10,10,796,1360,9,1369
"آذربایجان_غربی","سلماس","مرکزی",5,637,15,4,929,1585,17,1602
"آذربایجان_غربی","سلماس","مرکزی",6,352,11,11,1017,1391,5,1396
"آذربایجان_غربی","سلماس","مرکزی",7,365,9,10,851,1235,17,1252
"آذربایجان_غربی","سلماس","مرکزی",8,411,10,3,1070,1494,12,1506
"آذربایجان_غربی","سلماس","مرکزی",9,452,7,1,769,1229,11,1240
"آذربایجان_غربی","سلماس","مرکزی",10,368,8,5,506,887,7,894
"آذربایجان_غربی","سلماس","مرکزی",11,268,5,1,296,570,2,572
"آذربایجان_غربی","سلماس","مرکزی",12,336,7,0,339,682,5,687
"آذربایجان_غربی","سلماس","مرکزی",13,536,2,2,399,939,5,944
"آذربایجان_غربی","سلماس","مرکزی",14,541,16,5,400,962,7,969
"آذربایجان_غربی","سلماس","مرکزی",15,574,2,5,416,997,3,1000
"آذربایجان_غربی","سلماس","مرکزی",16,619,4,5,604,1232,7,1239
"آذربایجان_غربی","سلماس","مرکزی",17,262,3,1,188,454,3,457
"آذربایجان_غربی","سلماس","مرکزی",18,315,3,1,289,608,2,610
"آذربایجان_غربی","سلماس","مرکزی",19,392,8,18,477,895,21,916
"آذربایجان_غربی","سلماس","مرکزی",20,626,5,2,509,1142,2,1144
"آذربایجان_غربی","سلماس","مرکزی",21,771,10,1,644,1426,6,1432
"آذربایجان_غربی","سلماس","مرکزی",22,846,10,3,634,1493,14,1507
"آذربایجان_غربی","سلماس","مرکزی",23,461,2,7,532,1002,6,1008
"آذربایجان_غربی","سلماس","مرکزی",24,454,2,8,335,799,1,800
"آذربایجان_غربی","سلماس","مرکزی",25,529,5,12,820,1366,9,1375
"آذربایجان_غربی","سلماس","مرکزی",26,330,5,0,449,784,1,785
"آذربایجان_غربی","سلماس","مرکزی",27,687,11,7,527,1232,10,1242
"آذربایجان_غربی","سلماس","مرکزی",28,632,21,8,685,1346,5,1351
"آذربایجان_غربی","سلماس","مرکزی",29,544,4,3,656,1207,3,1210
"آذربایجان_غربی","سلماس","مرکزی",30,442,9,5,700,1156,8,1164
"آذربایجان_غربی","سلماس","مرکزی",31,526,6,3,620,1155,8,1163
"آذربایجان_غربی","سلماس","مرکزی",32,700,13,5,647,1365,16,1381
"آذربایجان_غربی","سلماس","مرکزی",33,613,9,6,1052,1680,15,1695
"آذربایجان_غربی","سلماس","مرکزی",34,539,10,11,649,1209,20,1229
"آذربایجان_غربی","سلماس","مرکزی",35,699,9,7,790,1505,6,1511
"آذربایجان_غربی","سلماس","مرکزی",36,305,2,10,361,678,11,689
"آذربایجان_غربی","سلماس","مرکزی",37,480,4,1,476,961,7,968
"آذربایجان_غربی","سلماس","مرکزی",38,338,31,33,943,1345,33,1378
"آذربایجان_غربی","سلماس","مرکزی",39,480,10,45,813,1348,21,1369
"آذربایجان_غربی","سلماس","مرکزی",40,365,3,4,490,862,4,866
"آذربایجان_غربی","سلماس","مرکزی",41,193,3,3,158,357,4,361
"آذربایجان_غربی","سلماس","مرکزی",42,213,7,1,186,407,7,414
"آذربایجان_غربی","سلماس","مرکزی",43,407,4,1,551,963,6,969
"آذربایجان_غربی","سلماس","مرکزی",44,356,3,2,436,797,5,802
"آذربایجان_غربی","سلماس","مرکزی",45,209,9,1,387,606,7,613
"آذربایجان_غربی","سلماس","مرکزی",46,471,3,4,691,1169,5,1174
"آذربایجان_غربی","سلماس","مرکزی",47,370,2,2,341,715,9,724
"آذربایجان_غربی","سلماس","مرکزی",48,468,3,3,539,1013,4,1017
"آذربایجان_غربی","سلماس","مرکزی",49,492,2,4,524,1022,5,1027
"آذربایجان_غربی","سلماس","مرکزی",50,186,4,13,293,496,9,505
"آذربایجان_غربی","سلماس","مرکزی",51,490,9,18,379,896,9,905
"آذربایجان_غربی","سلماس","مرکزی",52,371,4,21,388,784,11,795
"آذربایجان_غربی","سلماس","مرکزی",53,461,2,3,241,707,5,712
"آذربایجان_غربی","سلماس","مرکزی",54,558,5,16,184,763,11,774
"آذربایجان_غربی","سلماس","مرکزی",55,627,3,5,308,943,12,955
"آذربایجان_غربی","سلماس","مرکزی",56,625,3,6,590,1224,18,1242
"آذربایجان_غربی","سلماس","مرکزی",57,251,0,18,345,614,8,622
"آذربایجان_غربی","سلماس","مرکزی",58,1030,6,6,127,1169,4,1173
"آذربایجان_غربی","سلماس","مرکزی",59,66,2,16,354,438,4,442
"آذربایجان_غربی","سلماس","مرکزی",60,109,0,16,340,465,6,471
"آذربایجان_غربی","سلماس","مرکزی",61,327,7,36,685,1055,20,1075
"آذربایجان_غربی","سلماس","مرکزی",62,563,3,4,426,996,4,1000
"آذربایجان_غربی","سلماس","مرکزی",63,394,1,6,227,628,12,640
"آذربایجان_غربی","سلماس","مرکزی",64,480,4,4,280,768,5,773
"آذربایجان_غربی","سلماس","مرکزی",65,412,2,10,318,742,6,748
"آذربایجان_غربی","سلماس","مرکزی",66,525,0,0,98,623,2,625
"آذربایجان_غربی","سلماس","مرکزی",67,744,1,1,171,917,0,917
"آذربایجان_غربی","سلماس","مرکزی",68,556,3,1,188,748,4,752
"آذربایجان_غربی","سلماس","مرکزی",69,379,0,2,211,592,2,594
"آذربایجان_غربی","سلماس","مرکزی",70,565,8,0,159,732,6,738
"آذربایجان_غربی","سلماس","مرکزی",71,645,6,3,366,1020,12,1032
"آذربایجان_غربی","سلماس","مرکزی",72,560,2,0,101,663,1,664
"آذربایجان_غربی","سلماس","مرکزی",73,539,4,1,187,731,3,734
"آذربایجان_غربی","سلماس","مرکزی",74,375,0,2,185,562,3,565
"آذربایجان_غربی","سلماس","مرکزی",75,603,2,0,208,813,3,816
"آذربایجان_غربی","سلماس","مرکزی",76,370,11,2,188,571,7,578
"آذربایجان_غربی","سلماس","مرکزی",77,192,3,0,113,308,3,311
"آذربایجان_غربی","سلماس","مرکزی",78,377,7,14,593,991,11,1002
"آذربایجان_غربی","سلماس","مرکزی",79,182,3,11,683,879,22,901
"آذربایجان_غربی","سلماس","مرکزی",80,411,7,9,369,796,18,814
"آذربایجان_غربی","سلماس","مرکزی",81,42,2,5,451,500,4,504
"آذربایجان_غربی","سلماس","مرکزی",82,400,0,6,158,564,1,565
"آذربایجان_غربی","سلماس","مرکزی",83,557,2,1,179,739,2,741
"آذربایجان_غربی","سلماس","مرکزی",84,559,1,0,169,729,5,734
"آذربایجان_غربی","سلماس","مرکزی",85,790,2,1,308,1101,5,1106
"آذربایجان_غربی","سلماس","مرکزی",86,657,0,0,146,803,4,807
"آذربایجان_غربی","سلماس","کوهسار",87,84,1,12,236,333,0,333
"آذربایجان_غربی","سلماس","کوهسار",88,89,2,15,242,348,2,350
"آذربایجان_غربی","سلماس","کوهسار",89,68,3,20,537,628,3,631
"آذربایجان_غربی","سلماس","کوهسار",90,113,1,3,475,592,4,596
"آذربایجان_غربی","سلماس","کوهسار",91,142,3,8,416,569,8,577
"آذربایجان_غربی","سلماس","کوهسار",92,313,1,8,116,438,3,441
"آذربایجان_غربی","سلماس","کوهسار",93,239,3,9,402,653,8,661
"آذربایجان_غربی","سلماس","کوهسار",94,86,0,0,225,311,0,311
"آذربایجان_غربی","سلماس","کوهسار",95,62,0,5,261,328,4,332
"آذربایجان_غربی","سلماس","کوهسار",96,48,1,14,256,319,2,321
"آذربایجان_غربی","سلماس","کوهسار",97,105,2,27,338,472,1,473
"آذربایجان_غربی","سلماس","کوهسار",98,94,2,3,714,813,1,814
"آذربایجان_غربی","سلماس","کوهسار",99,163,0,19,68,250,3,253
"آذربایجان_غربی","سلماس","کوهسار",100,79,2,7,144,232,13,245
"آذربایجان_غربی","سلماس","کوهسار",101,380,3,23,204,610,5,615
"آذربایجان_غربی","سلماس","کوهسار",102,68,2,0,293,363,5,368
"آذربایجان_غربی","سلماس","کوهسار",103,111,5,7,315,438,12,450
"آذربایجان_غربی","سلماس","کوهسار",104,108,0,1,91,200,0,200
"آذربایجان_غربی","سلماس","کوهسار",105,89,1,4,182,276,5,281
"آذربایجان_غربی","سلماس","کوهسار",106,79,1,1,108,189,0,189
"آذربایجان_غربی","سلماس","کوهسار",107,49,2,2,288,341,1,342
"آذربایجان_غربی","سلماس","کوهسار",108,187,2,0,276,465,3,468
"آذربایجان_غربی","سلماس","کوهسار",109,381,1,2,127,511,5,516
"آذربایجان_غربی","سلماس","کوهسار",110,218,10,8,269,505,22,527
"آذربایجان_غربی","سلماس","کوهسار",111,77,2,4,329,412,0,412
"آذربایجان_غربی","سلماس","کوهسار",112,88,0,1,228,317,0,317
"آذربایجان_غربی","سلماس","کوهسار",113,17,2,2,310,331,2,333
"آذربایجان_غربی","سلماس","کوهسار",114,84,2,3,247,336,3,339
"آذربایجان_غربی","سلماس","کوهسار",115,87,3,1,245,336,3,339
"آذربایجان_غربی","شاهین_دژ","مرکزی",1,653,11,1,380,1045,22,1067
"آذربایجان_غربی","شاهین_دژ","مرکزی",2,590,8,2,637,1237,26,1263
"آذربایجان_غربی","شاهین_دژ","مرکزی",3,434,4,0,328,766,2,768
"آذربایجان_غربی","شاهین_دژ","مرکزی",4,507,8,6,244,765,0,765
"آذربایجان_غربی","شاهین_دژ","مرکزی",5,478,8,3,693,1182,14,1196
"آذربایجان_غربی","شاهین_دژ","مرکزی",6,226,9,4,331,570,12,582
"آذربایجان_غربی","شاهین_دژ","مرکزی",7,833,6,2,441,1282,22,1304
"آذربایجان_غربی","شاهین_دژ","مرکزی",8,346,8,8,702,1064,12,1076
"آذربایجان_غربی","شاهین_دژ","مرکزی",9,255,8,1,524,788,14,802
"آذربایجان_غربی","شاهین_دژ","مرکزی",10,326,7,0,336,669,17,686
"آذربایجان_غربی","شاهین_دژ","مرکزی",11,196,11,8,496,711,9,720
"آذربایجان_غربی","شاهین_دژ","مرکزی",12,285,13,3,583,884,16,900
"آذربایجان_غربی","شاهین_دژ","مرکزی",13,323,13,16,601,953,22,975
"آذربایجان_غربی","شاهین_دژ","مرکزی",14,416,7,25,736,1184,41,1225
"آذربایجان_غربی","شاهین_دژ","مرکزی",15,474,7,6,295,782,21,803
"آذربایجان_غربی","شاهین_دژ","مرکزی",16,379,10,8,403,800,36,836
"آذربایجان_غربی","شاهین_دژ","مرکزی",17,560,0,4,364,928,21,949
"آذربایجان_غربی","شاهین_دژ","مرکزی",18,287,3,2,439,731,10,741
"آذربایجان_غربی","شاهین_دژ","مرکزی",19,278,9,3,542,832,13,845
"آذربایجان_غربی","شاهین_دژ","مرکزی",20,551,6,3,265,825,28,853
"آذربایجان_غربی","شاهین_دژ","مرکزی",21,182,6,3,230,421,12,433
"آذربایجان_غربی","شاهین_دژ","مرکزی",22,669,1,0,199,869,15,884
"آذربایجان_غربی","شاهین_دژ","مرکزی",23,639,0,0,246,885,23,908
"آذربایجان_غربی","شاهین_دژ","مرکزی",24,260,1,13,286,560,26,586
"آذربایجان_غربی","شاهین_دژ","مرکزی",25,319,3,2,668,992,14,1006
"آذربایجان_غربی","شاهین_دژ","مرکزی",26,390,6,1,471,868,18,886
"آذربایجان_غربی","شاهین_دژ","مرکزی",27,246,7,1,388,642,12,654
"آذربایجان_غربی","شاهین_دژ","مرکزی",28,414,10,1,470,895,6,901
"آذربایجان_غربی","شاهین_دژ","مرکزی",29,246,2,0,226,474,8,482
"آذربایجان_غربی","شاهین_دژ","مرکزی",30,201,0,8,284,493,20,513
"آذربایجان_غربی","شاهین_دژ","مرکزی",31,365,5,0,57,427,4,431
"آذربایجان_غربی","شاهین_دژ","مرکزی",32,269,0,0,27,296,9,305
"آذربایجان_غربی","شاهین_دژ","مرکزی",33,147,2,0,31,180,3,183
"آذربایجان_غربی","شاهین_دژ","مرکزی",34,138,2,12,177,329,3,332
"آذربایجان_غربی","شاهین_دژ","مرکزی",35,155,1,12,221,389,13,402
"آذربایجان_غربی","شاهین_دژ","مرکزی",36,145,4,1,113,263,16,279
"آذربایجان_غربی","شاهین_دژ","مرکزی",37,244,0,4,242,490,10,500
"آذربایجان_غربی","شاهین_دژ","مرکزی",38,152,0,0,10,162,4,166
"آذربایجان_غربی","شاهین_دژ","مرکزی",39,51,3,5,119,178,5,183
"آذربایجان_غربی","شاهین_دژ","مرکزی",40,100,3,20,185,308,20,328
"آذربایجان_غربی","شاهین_دژ","مرکزی",41,345,1,0,60,406,4,410
"آذربایجان_غربی","شاهین_دژ","مرکزی",42,367,3,29,232,631,16,647
"آذربایجان_غربی","شاهین_دژ","مرکزی",43,124,4,7,222,357,5,362
"آذربایجان_غربی","شاهین_دژ","مرکزی",44,77,7,2,130,216,0,216
"آذربایجان_غربی","شاهین_دژ","مرکزی",45,211,2,7,91,311,19,330
"آذربایجان_غربی","شاهین_دژ","مرکزی",46,94,3,1,264,362,36,398
"آذربایجان_غربی","شاهین_دژ","مرکزی",47,242,2,6,369,619,22,641
"آذربایجان_غربی","شاهین_دژ","مرکزی",48,158,6,5,348,517,7,524
"آذربایجان_غربی","شاهین_دژ","مرکزی",49,180,0,18,201,399,15,414
"آذربایجان_غربی","شاهین_دژ","مرکزی",50,420,6,0,304,730,6,736
"آذربایجان_غربی","شاهین_دژ","مرکزی",51,79,0,1,25,105,1,106
"آذربایجان_غربی","شاهین_دژ","مرکزی",52,542,5,2,355,904,14,918
"آذربایجان_غربی","شاهین_دژ","کشاورز",1,280,7,2,385,674,6,680
"آذربایجان_غربی","شاهین_دژ","کشاورز",2,262,2,1,181,446,5,451
"آذربایجان_غربی","شاهین_دژ","کشاورز",3,243,3,0,239,485,13,498
"آذربایجان_غربی","شاهین_دژ","کشاورز",4,179,4,1,229,413,8,421
"آذربایجان_غربی","شاهین_دژ","کشاورز",5,474,2,0,170,646,13,659
"آذربایجان_غربی","شاهین_دژ","کشاورز",6,378,4,8,444,834,15,849
"آذربایجان_غربی","شاهین_دژ","کشاورز",7,389,2,0,181,572,0,572
"آذربایجان_غربی","شاهین_دژ","کشاورز",8,518,9,0,332,859,15,874
"آذربایجان_غربی","شاهین_دژ","کشاورز",9,518,5,3,206,732,19,751
"آذربایجان_غربی","شاهین_دژ","کشاورز",10,273,2,0,201,476,0,476
"آذربایجان_غربی","شاهین_دژ","کشاورز",11,391,3,2,222,618,0,618
"آذربایجان_غربی","شاهین_دژ","کشاورز",12,422,2,0,183,607,15,622
"آذربایجان_غربی","شاهین_دژ","کشاورز",13,293,2,2,174,471,5,476
"آذربایجان_غربی","شاهین_دژ","کشاورز",14,213,1,0,32,246,4,250
"آذربایجان_غربی","شاهین_دژ","کشاورز",15,340,1,0,67,408,8,416
"آذربایجان_غربی","شاهین_دژ","کشاورز",16,201,0,0,70,271,0,271
"آذربایجان_غربی","شاهین_دژ","کشاورز",17,81,0,0,71,152,0,152
"آذربایجان_غربی","شاهین_دژ","کشاورز",18,122,0,0,24,146,0,146
"آذربایجان_غربی","شاهین_دژ","کشاورز",19,89,1,0,63,153,9,162
"آذربایجان_غربی","شاهین_دژ","کشاورز",20,366,0,0,118,484,6,490
"آذربایجان_غربی","شاهین_دژ","کشاورز",21,138,2,0,10,150,1,151
"آذربایجان_غربی","شاهین_دژ","کشاورز",22,232,0,0,51,283,2,285
"آذربایجان_غربی","شوط","مرکزی",1,368,9,30,802,1209,12,1221
"آذربایجان_غربی","شوط","مرکزی",2,170,10,22,392,594,11,605
"آذربایجان_غربی","شوط","مرکزی",3,507,9,8,1029,1553,11,1564
"آذربایجان_غربی","شوط","مرکزی",4,368,4,4,528,904,7,911
"آذربایجان_غربی","شوط","مرکزی",5,186,3,0,199,388,2,390
"آذربایجان_غربی","شوط","مرکزی",6,231,2,1,414,648,4,652
"آذربایجان_غربی","شوط","مرکزی",7,164,5,9,351,529,2,531
"آذربایجان_غربی","شوط","مرکزی",8,359,17,26,821,1223,14,1237
"آذربایجان_غربی","شوط","مرکزی",9,416,4,8,966,1394,5,1399
"آذربایجان_غربی","شوط","مرکزی",10,304,5,9,454,772,4,776
"آذربایجان_غربی","شوط","مرکزی",11,407,4,5,505,921,3,924
"آذربایجان_غربی","شوط","مرکزی",12,223,3,12,331,569,7,576
"آذربایجان_غربی","شوط","مرکزی",13,258,0,16,474,748,0,748
"آذربایجان_غربی","شوط","مرکزی",14,282,15,26,544,867,13,880
"آذربایجان_غربی","شوط","مرکزی",15,387,3,17,483,890,3,893
"آذربایجان_غربی","شوط","مرکزی",16,116,0,1,306,423,3,426
"آذربایجان_غربی","شوط","مرکزی",17,230,1,25,243,499,2,501
"آذربایجان_غربی","شوط","مرکزی",18,275,6,4,258,543,7,550
"آذربایجان_غربی","شوط","مرکزی",19,158,1,13,372,544,2,546
"آذربایجان_غربی","شوط","مرکزی",20,355,1,5,168,529,1,530
"آذربایجان_غربی","شوط","مرکزی",21,407,2,3,104,516,0,516
"آذربایجان_غربی","شوط","مرکزی",22,319,2,27,302,650,9,659
"آذربایجان_غربی","شوط","مرکزی",23,128,3,17,222,370,2,372
"آذربایجان_غربی","شوط","مرکزی",24,305,5,15,334,659,5,664
"آذربایجان_غربی","شوط","مرکزی",25,101,2,3,132,238,0,238
"آذربایجان_غربی","شوط","مرکزی",26,333,1,10,292,636,0,636
"آذربایجان_غربی","شوط","قره_قویون",27,267,0,20,133,420,1,421
"آذربایجان_غربی","شوط","قره_قویون",28,184,0,10,184,378,7,385
"آذربایجان_غربی","شوط","قره_قویون",29,473,10,32,422,937,1,938
"آذربایجان_غربی","شوط","قره_قویون",30,266,3,7,238,514,1,515
"آذربایجان_غربی","شوط","قره_قویون",31,140,2,18,180,340,4,344
"آذربایجان_غربی","شوط","قره_قویون",32,230,0,27,198,455,0,455
"آذربایجان_غربی","شوط","قره_قویون",33,198,1,0,125,324,4,328
"آذربایجان_غربی","شوط","قره_قویون",34,217,0,21,121,359,0,359
"آذربایجان_غربی","شوط","قره_قویون",35,203,1,6,72,282,3,285
"آذربایجان_غربی","شوط","قره_قویون",36,172,0,2,393,567,8,575
"آذربایجان_غربی","شوط","قره_قویون",37,343,4,2,236,585,1,586
"آذربایجان_غربی","شوط","قره_قویون",38,288,0,1,154,443,0,443
"آذربایجان_غربی","شوط","قره_قویون",39,203,0,0,105,308,0,308
"آذربایجان_غربی","شوط","قره_قویون",40,272,0,0,116,388,1,389
"آذربایجان_غربی","شوط","قره_قویون",41,206,1,5,71,283,0,283
"آذربایجان_غربی","شوط","قره_قویون",42,111,1,33,98,243,0,243
"آذربایجان_غربی","ماکو","مرکزی",1,189,5,6,373,573,2,575
"آذربایجان_غربی","ماکو","مرکزی",2,507,12,14,862,1395,8,1403
"آذربایجان_غربی","ماکو","مرکزی",3,246,5,1,657,909,8,917
"آذربایجان_غربی","ماکو","مرکزی",4,195,4,0,499,698,2,700
"آذربایجان_غربی","ماکو","مرکزی",5,186,2,0,301,489,1,490
"آذربایجان_غربی","ماکو","مرکزی",6,284,5,1,319,609,5,614
"آذربایجان_غربی","ماکو","مرکزی",7,136,2,2,245,385,3,388
"آذربایجان_غربی","ماکو","مرکزی",8,132,3,3,189,327,0,327
"آذربایجان_غربی","ماکو","مرکزی",9,137,0,2,355,494,1,495
"آذربایجان_غربی","ماکو","مرکزی",10,70,1,0,144,215,1,216
"آذربایجان_غربی","ماکو","مرکزی",11,190,4,4,360,558,3,561
"آذربایجان_غربی","ماکو","مرکزی",12,102,0,0,139,241,4,245
"آذربایجان_غربی","ماکو","مرکزی",13,164,5,9,557,735,1,736
"آذربایجان_غربی","ماکو","مرکزی",14,244,4,2,494,744,5,749
"آذربایجان_غربی","ماکو","مرکزی",15,250,4,3,577,834,5,839
"آذربایجان_غربی","ماکو","مرکزی",16,186,5,6,529,726,10,736
"آذربایجان_غربی","ماکو","مرکزی",17,108,7,5,253,373,3,376
"آذربایجان_غربی","ماکو","مرکزی",18,189,6,12,571,778,4,782
"آذربایجان_غربی","ماکو","مرکزی",19,231,16,14,631,892,5,897
"آذربایجان_غربی","ماکو","مرکزی",20,204,4,3,749,960,6,966
"آذربایجان_غربی","ماکو","مرکزی",21,383,12,4,870,1269,6,1275
"آذربایجان_غربی","ماکو","مرکزی",22,266,0,8,346,620,3,623
"آذربایجان_غربی","ماکو","مرکزی",23,457,13,13,1040,1523,26,1549
"آذربایجان_غربی","ماکو","مرکزی",24,194,9,8,609,820,3,823
"آذربایجان_غربی","ماکو","مرکزی",25,359,15,10,1088,1472,7,1479
"آذربایجان_غربی","ماکو","مرکزی",26,346,20,10,781,1157,11,1168
"آذربایجان_غربی","ماکو","مرکزی",27,324,13,8,988,1333,6,1339
"آذربایجان_غربی","ماکو","مرکزی",28,158,4,7,198,367,2,369
"آذربایجان_غربی","ماکو","مرکزی",29,294,9,11,550,864,6,870
"آذربایجان_غربی","ماکو","مرکزی",30,326,18,25,904,1273,5,1278
"آذربایجان_غربی","ماکو","مرکزی",31,113,8,13,456,590,2,592
"آذربایجان_غربی","ماکو","مرکزی",32,306,3,0,276,585,7,592
"آذربایجان_غربی","ماکو","مرکزی",33,316,7,32,643,998,8,1006
"آذربایجان_غربی","ماکو","مرکزی",34,128,2,4,311,445,1,446
"آذربایجان_غربی","ماکو","مرکزی",35,105,14,12,291,422,7,429
"آذربایجان_غربی","ماکو","مرکزی",36,227,5,3,279,514,1,515
"آذربایجان_غربی","ماکو","مرکزی",37,124,2,11,431,568,1,569
"آذربایجان_غربی","ماکو","مرکزی",38,202,14,7,236,459,0,459
"آذربایجان_غربی","ماکو","مرکزی",39,327,6,1,115,449,3,452
"آذربایجان_غربی","ماکو","مرکزی",40,369,9,80,249,707,2,709
"آذربایجان_غربی","ماکو","مرکزی",41,264,14,26,650,954,8,962
"آذربایجان_غربی","ماکو","مرکزی",42,151,0,8,176,335,1,336
"آذربایجان_غربی","ماکو","مرکزی",43,189,3,0,231,423,3,426
"آذربایجان_غربی","ماکو","مرکزی",44,132,0,0,168,300,2,302
"آذربایجان_غربی","ماکو","مرکزی",45,228,6,6,248,488,5,493
"آذربایجان_غربی","ماکو","مرکزی",46,139,0,12,207,358,2,360
"آذربایجان_غربی","ماکو","مرکزی",47,60,0,3,145,208,3,211
"آذربایجان_غربی","ماکو","مرکزی",48,99,2,3,151,255,3,258
"آذربایجان_غربی","ماکو","مرکزی",49,138,16,7,114,275,1,276
"آذربایجان_غربی","ماکو","مرکزی",50,78,1,3,138,220,10,230
"آذربایجان_غربی","ماکو","مرکزی",51,103,0,7,59,169,3,172
"آذربایجان_غربی","ماکو","مرکزی",52,118,0,9,94,221,6,227
"آذربایجان_غربی","ماکو","مرکزی",53,19,17,0,60,96,0,96
"آذربایجان_غربی","ماکو","مرکزی",54,96,2,6,109,213,3,216
"آذربایجان_غربی","ماکو","مرکزی",55,95,0,0,82,177,1,178
"آذربایجان_غربی","ماکو","مرکزی",56,116,1,0,166,283,0,283
"آذربایجان_غربی","ماکو","مرکزی",57,29,1,4,200,234,1,235
"آذربایجان_غربی","ماکو","بازرگان",1,229,7,11,468,715,8,723
"آذربایجان_غربی","ماکو","بازرگان",2,232,7,23,736,998,2,1000
"آذربایجان_غربی","ماکو","بازرگان",3,244,2,4,480,730,5,735
"آذربایجان_غربی","ماکو","بازرگان",4,337,9,29,867,1242,13,1255
"آذربایجان_غربی","ماکو","بازرگان",5,88,4,9,226,327,1,328
"آذربایجان_غربی","ماکو","بازرگان",6,192,6,11,837,1046,9,1055
"آذربایجان_غربی","ماکو","بازرگان",7,350,3,2,302,657,4,661
"آذربایجان_غربی","ماکو","بازرگان",8,122,5,17,484,628,2,630
"آذربایجان_غربی","ماکو","بازرگان",9,68,5,33,242,348,3,351
"آذربایجان_غربی","ماکو","بازرگان",10,81,0,25,210,316,4,320
"آذربایجان_غربی","ماکو","بازرگان",11,131,5,15,321,472,3,475
"آذربایجان_غربی","ماکو","بازرگان",12,7,0,0,111,118,2,120
"آذربایجان_غربی","ماکو","بازرگان",13,45,3,0,79,127,0,127
"آذربایجان_غربی","ماکو","بازرگان",14,117,1,2,119,239,4,243
"آذربایجان_غربی","ماکو","بازرگان",15,158,5,30,197,390,5,395
"آذربایجان_غربی","ماکو","بازرگان",16,36,0,9,108,153,2,155
"آذربایجان_غربی","ماکو","بازرگان",17,16,1,6,131,154,0,154
"آذربایجان_غربی","ماکو","بازرگان",18,103,1,10,70,184,3,187
"آذربایجان_غربی","مهاباد","مرکزی",1,212,18,59,784,1073,27,1100
"آذربایجان_غربی","مهاباد","مرکزی",2,295,20,71,1175,1561,39,1600
"آذربایجان_غربی","مهاباد","مرکزی",3,198,10,40,788,1036,48,1084
"آذربایجان_غربی","مهاباد","مرکزی",4,105,4,32,363,504,13,517
"آذربایجان_غربی","مهاباد","مرکزی",5,82,4,29,361,476,24,500
"آذربایجان_غربی","مهاباد","مرکزی",6,281,21,96,807,1205,36,1241
"آذربایجان_غربی","مهاباد","مرکزی",7,228,13,61,625,927,27,954
"آذربایجان_غربی","مهاباد","مرکزی",8,869,23,29,340,1261,22,1283
"آذربایجان_غربی","مهاباد","مرکزی",9,309,19,48,697,1073,32,1105
"آذربایجان_غربی","مهاباد","مرکزی",10,450,32,77,1014,1573,60,1633
"آذربایجان_غربی","مهاباد","مرکزی",11,340,19,51,731,1141,40,1181
"آذربایجان_غربی","مهاباد","مرکزی",12,190,9,36,709,944,25,969
"آذربایجان_غربی","مهاباد","مرکزی",13,256,26,44,827,1153,17,1170
"آذربایجان_غربی","مهاباد","مرکزی",14,266,18,60,616,960,28,988
"آذربایجان_غربی","مهاباد","مرکزی",15,182,16,54,711,963,37,1000
"آذربایجان_غربی","مهاباد","مرکزی",16,152,8,56,318,534,44,578
"آذربایجان_غربی","مهاباد","مرکزی",17,168,12,28,283,491,15,506
"آذربایجان_غربی","مهاباد","مرکزی",18,247,21,49,503,820,30,850
"آذربایجان_غربی","مهاباد","مرکزی",19,292,6,62,526,886,27,913
"آذربایجان_غربی","مهاباد","مرکزی",20,294,14,78,549,935,23,958
"آذربایجان_غربی","مهاباد","مرکزی",21,264,14,70,360,708,32,740
"آذربایجان_غربی","مهاباد","مرکزی",22,304,2,50,446,802,42,844
"آذربایجان_غربی","مهاباد","مرکزی",23,513,19,101,837,1470,42,1512
"آذربایجان_غربی","مهاباد","مرکزی",24,389,25,99,779,1292,50,1342
"آذربایجان_غربی","مهاباد","مرکزی",25,310,26,81,873,1290,61,1351
"آذربایجان_غربی","مهاباد","مرکزی",26,138,15,22,390,565,30,595
"آذربایجان_غربی","مهاباد","مرکزی",27,289,22,80,948,1339,50,1389
"آذربایجان_غربی","مهاباد","مرکزی",28,139,11,23,501,674,44,718
"آذربایجان_غربی","مهاباد","مرکزی",29,426,15,55,807,1303,47,1350
"آذربایجان_غربی","مهاباد","مرکزی",30,281,15,29,647,972,47,1019
"آذربایجان_غربی","مهاباد","مرکزی",31,496,19,66,669,1250,42,1292
"آذربایجان_غربی","مهاباد","مرکزی",32,315,16,59,637,1027,40,1067
"آذربایجان_غربی","مهاباد","مرکزی",33,48,7,11,197,263,13,276
"آذربایجان_غربی","مهاباد","مرکزی",34,229,5,16,318,568,26,594
"آذربایجان_غربی","مهاباد","مرکزی",35,186,20,17,330,553,27,580
"آذربایجان_غربی","مهاباد","مرکزی",36,239,13,57,560,869,32,901
"آذربایجان_غربی","مهاباد","مرکزی",37,285,18,37,645,985,37,1022
"آذربایجان_غربی","مهاباد","مرکزی",38,263,11,19,439,732,19,751
"آذربایجان_غربی","مهاباد","مرکزی",39,323,27,56,914,1320,60,1380
"آذربایجان_غربی","مهاباد","مرکزی",40,145,22,27,554,748,25,773
"آذربایجان_غربی","مهاباد","مرکزی",41,197,14,31,621,863,42,905
"آذربایجان_غربی","مهاباد","مرکزی",42,308,14,64,1106,1492,59,1551
"آذربایجان_غربی","مهاباد","مرکزی",43,221,22,46,550,839,39,878
"آذربایجان_غربی","مهاباد","مرکزی",44,229,22,51,847,1149,32,1181
"آذربایجان_غربی","مهاباد","مرکزی",45,260,22,82,1189,1553,46,1599
"آذربایجان_غربی","مهاباد","مرکزی",46,117,3,43,575,738,20,758
"آذربایجان_غربی","مهاباد","مرکزی",47,277,8,0,40,325,4,329
"آذربایجان_غربی","مهاباد","مرکزی",48,100,6,12,234,352,13,365
"آذربایجان_غربی","مهاباد","مرکزی",49,305,5,16,306,632,12,644
"آذربایجان_غربی","مهاباد","مرکزی",50,65,2,13,164,244,9,253
"آذربایجان_غربی","مهاباد","مرکزی",51,54,2,11,197,264,7,271
"آذربایجان_غربی","مهاباد","مرکزی",52,105,13,16,167,301,14,315
"آذربایجان_غربی","مهاباد","مرکزی",53,150,1,15,197,363,5,368
"آذربایجان_غربی","مهاباد","مرکزی",54,402,4,37,497,940,41,981
"آذربایجان_غربی","مهاباد","مرکزی",55,260,8,33,326,627,17,644
"آذربایجان_غربی","مهاباد","مرکزی",56,209,5,24,422,660,19,679
"آذربایجان_غربی","مهاباد","مرکزی",57,194,8,49,192,443,42,485
"آذربایجان_غربی","مهاباد","مرکزی",58,302,4,17,190,513,17,530
"آذربایجان_غربی","مهاباد","مرکزی",59,252,24,16,236,528,18,546
"آذربایجان_غربی","مهاباد","مرکزی",60,86,2,0,47,135,2,137
"آذربایجان_غربی","مهاباد","مرکزی",61,151,3,11,180,345,18,363
"آذربایجان_غربی","مهاباد","مرکزی",62,200,16,34,350,600,27,627
"آذربایجان_غربی","مهاباد","مرکزی",63,102,9,56,251,418,31,449
"آذربایجان_غربی","مهاباد","مرکزی",64,298,15,19,334,666,36,702
"آذربایجان_غربی","مهاباد","مرکزی",65,45,4,9,158,216,12,228
"آذربایجان_غربی","مهاباد","مرکزی",66,134,12,15,310,471,20,491
"آذربایجان_غربی","مهاباد","مرکزی",67,19,1,17,55,92,4,96
"آذربایجان_غربی","مهاباد","مرکزی",68,138,3,10,340,491,19,510
"آذربایجان_غربی","مهاباد","مرکزی",69,323,10,7,179,519,19,538
"آذربایجان_غربی","مهاباد","مرکزی",70,159,4,14,144,321,16,337
"آذربایجان_غربی","مهاباد","مرکزی",71,146,1,20,138,305,7,312
"آذربایجان_غربی","مهاباد","مرکزی",72,203,7,55,256,521,29,550
"آذربایجان_غربی","مهاباد","مرکزی",73,70,3,35,164,272,12,284
"آذربایجان_غربی","مهاباد","مرکزی",74,84,0,10,59,153,2,155
"آذربایجان_غربی","مهاباد","مرکزی",75,47,46,14,3,110,2,112
"آذربایجان_غربی","مهاباد","مرکزی",76,36,1,8,80,125,5,130
"آذربایجان_غربی","مهاباد","مرکزی",77,91,4,19,163,277,4,281
"آذربایجان_غربی","مهاباد","مرکزی",78,68,3,23,112,206,5,211
"آذربایجان_غربی","مهاباد","مرکزی",79,235,1,28,159,423,11,434
"آذربایجان_غربی","مهاباد","مرکزی",80,97,10,9,121,237,15,252
"آذربایجان_غربی","مهاباد","مرکزی",81,107,3,16,127,253,11,264
"آذربایجان_غربی","مهاباد","مرکزی",82,96,3,20,304,423,12,435
"آذربایجان_غربی","مهاباد","مرکزی",83,69,1,6,76,152,3,155
"آذربایجان_غربی","مهاباد","مرکزی",84,61,0,10,45,116,1,117
"آذربایجان_غربی","مهاباد","مرکزی",85,56,0,3,19,78,2,80
"آذربایجان_غربی","مهاباد","مرکزی",86,50,2,10,77,139,6,145
"آذربایجان_غربی","مهاباد","مرکزی",87,60,2,17,112,191,3,194
"آذربایجان_غربی","مهاباد","مرکزی",88,211,3,14,125,353,10,363
"آذربایجان_غربی","مهاباد","مرکزی",89,31,1,49,134,215,4,219
"آذربایجان_غربی","مهاباد","مرکزی",90,165,3,19,151,338,6,344
"آذربایجان_غربی","مهاباد","مرکزی",91,68,6,17,71,162,5,167
"آذربایجان_غربی","مهاباد","مرکزی",92,60,2,3,44,109,6,115
"آذربایجان_غربی","مهاباد","مرکزی",93,90,2,25,66,183,2,185
"آذربایجان_غربی","مهاباد","مرکزی",94,139,2,38,51,230,7,237
"آذربایجان_غربی","مهاباد","مرکزی",95,90,1,15,57,163,11,174
"آذربایجان_غربی","مهاباد","مرکزی",96,55,1,27,72,155,4,159
"آذربایجان_غربی","مهاباد","مرکزی",97,54,1,14,151,220,2,222
"آذربایجان_غربی","مهاباد","مرکزی",98,31,0,8,62,101,5,106
"آذربایجان_غربی","مهاباد","مرکزی",99,38,0,9,27,74,2,76
"آذربایجان_غربی","مهاباد","مرکزی",100,98,5,6,44,153,0,153
"آذربایجان_غربی","مهاباد","مرکزی",101,82,4,13,96,195,3,198
"آذربایجان_غربی","مهاباد","مرکزی",102,61,2,11,73,147,0,147
"آذربایجان_غربی","مهاباد","مرکزی",103,40,5,10,46,101,8,109
"آذربایجان_غربی","مهاباد","مرکزی",104,130,1,28,73,232,3,235
"آذربایجان_غربی","مهاباد","مرکزی",105,69,3,2,47,121,0,121
"آذربایجان_غربی","مهاباد","مرکزی",106,32,2,43,20,97,0,97
"آذربایجان_غربی","مهاباد","مرکزی",107,55,0,6,14,75,1,76
"آذربایجان_غربی","مهاباد","مرکزی",108,95,2,5,28,130,0,130
"آذربایجان_غربی","مهاباد","مرکزی",109,49,0,2,37,88,5,93
"آذربایجان_غربی","مهاباد","مرکزی",110,20,1,4,93,118,1,119
"آذربایجان_غربی","میاندوآب","شهر",1,402,8,12,528,950,49,999
"آذربایجان_غربی","میاندوآب","شهر",2,281,4,3,460,748,6,754
"آذربایجان_غربی","میاندوآب","شهر",3,641,4,57,552,1254,36,1290
"آذربایجان_غربی","میاندوآب","شهر",4,550,3,48,526,1127,22,1149
"آذربایجان_غربی","میاندوآب","شهر",5,325,8,73,521,927,11,938
"آذربایجان_غربی","میاندوآب","شهر",6,530,4,10,482,1026,26,1052
"آذربایجان_غربی","میاندوآب","شهر",7,463,3,19,707,1192,48,1240
"آذربایجان_غربی","میاندوآب","شهر",8,469,0,22,459,950,45,995
"آذربایجان_غربی","میاندوآب","شهر",9,616,13,77,743,1449,37,1486
"آذربایجان_غربی","میاندوآب","شهر",10,480,4,38,627,1149,28,1177
"آذربایجان_غربی","میاندوآب","شهر",11,302,0,6,580,888,24,912
"آذربایجان_غربی","میاندوآب","شهر",12,463,11,81,583,1138,31,1169
"آذربایجان_غربی","میاندوآب","شهر",13,523,8,230,477,1238,44,1282
"آذربایجان_غربی","میاندوآب","شهر",14,653,3,60,558,1274,22,1296
"آذربایجان_غربی","میاندوآب","شهر",15,398,5,55,814,1272,27,1299
"آذربایجان_غربی","میاندوآب","شهر",16,554,14,36,795,1399,19,1418
"آذربایجان_غربی","میاندوآب","شهر",17,440,9,10,774,1233,10,1243
"آذربایجان_غربی","میاندوآب","شهر",18,535,6,8,664,1213,15,1228
"آذربایجان_غربی","میاندوآب","شهر",19,431,20,8,838,1297,21,1318
"آذربایجان_غربی","میاندوآب","شهر",20,243,9,3,617,872,34,906
"آذربایجان_غربی","میاندوآب","شهر",21,342,10,15,861,1228,24,1252
"آذربایجان_غربی","میاندوآب","شهر",22,337,5,10,636,988,18,1006
"آذربایجان_غربی","میاندوآب","شهر",23,283,9,11,866,1169,27,1196
"آذربایجان_غربی","میاندوآب","شهر",24,331,7,21,865,1224,17,1241
"آذربایجان_غربی","میاندوآب","شهر",25,421,14,17,915,1367,28,1395
"آذربایجان_غربی","میاندوآب","شهر",26,453,10,36,1148,1647,22,1669
"آذربایجان_غربی","میاندوآب","شهر",27,393,9,33,949,1384,5,1389
"آذربایجان_غربی","میاندوآب","شهر",28,318,3,24,866,1211,14,1225
"آذربایجان_غربی","میاندوآب","شهر",29,401,6,21,760,1188,40,1228
"آذربایجان_غربی","میاندوآب","شهر",30,343,9,57,862,1271,26,1297
"آذربایجان_غربی","میاندوآب","شهر",31,323,8,4,570,905,20,925
"آذربایجان_غربی","میاندوآب","شهر",32,725,2,6,739,1472,32,1504
"آذربایجان_غربی","میاندوآب","شهر",33,508,8,38,1024,1578,20,1598
"آذربایجان_غربی","میاندوآب","شهر",34,285,11,8,858,1162,25,1187
"آذربایجان_غربی","میاندوآب","شهر",35,351,2,4,507,864,11,875
"آذربایجان_غربی","میاندوآب","شهر",36,374,11,2,676,1063,0,1063
"آذربایجان_غربی","میاندوآب","شهر",37,407,9,6,598,1020,15,1035
"آذربایجان_غربی","میاندوآب","شهر",38,440,18,7,629,1094,29,1123
"آذربایجان_غربی","میاندوآب","شهر",39,445,4,16,559,1024,25,1049
"آذربایجان_غربی","میاندوآب","شهر",40,582,10,1,512,1105,21,1126
"آذربایجان_غربی","میاندوآب","شهر",41,650,7,2,471,1130,20,1150
"آذربایجان_غربی","میاندوآب","شهر",42,845,10,1,685,1541,28,1569
"آذربایجان_غربی","میاندوآب","شهر",43,708,5,2,375,1090,39,1129
"آذربایجان_غربی","میاندوآب","شهر",44,275,3,0,338,616,0,616
"آذربایجان_غربی","میاندوآب","شهر",45,380,6,3,686,1075,36,1111
"آذربایجان_غربی","میاندوآب","شهر",46,380,4,1,740,1125,16,1141
"آذربایجان_غربی","میاندوآب","شهر",47,366,7,1,589,963,17,980
"آذربایجان_غربی","میاندوآب","شهر",48,364,3,11,547,925,27,952
"آذربایجان_غربی","میاندوآب","شهر",49,166,5,13,265,449,8,457
"آذربایجان_غربی","میاندوآب","مرکزی",50,448,4,1,456,909,26,935
"آذربایجان_غربی","میاندوآب","مرکزی",51,505,6,7,404,922,33,955
"آذربایجان_غربی","میاندوآب","مرکزی",52,403,1,1,375,780,19,799
"آذربایجان_غربی","میاندوآب","مرکزی",53,423,0,1,275,699,17,716
"آذربایجان_غربی","میاندوآب","مرکزی",54,662,2,1,463,1128,29,1157
"آذربایجان_غربی","میاندوآب","مرکزی",55,499,4,6,648,1157,21,1178
"آذربایجان_غربی","میاندوآب","مرکزی",56,903,3,0,113,1019,34,1053
"آذربایجان_غربی","میاندوآب","مرکزی",57,463,3,0,247,713,22,735
"آذربایجان_غربی","میاندوآب","مرکزی",58,541,1,0,181,723,20,743
"آذربایجان_غربی","میاندوآب","مرکزی",59,287,1,0,338,626,13,639
"آذربایجان_غربی","میاندوآب","مرکزی",60,329,0,0,164,493,16,509
"آذربایجان_غربی","میاندوآب","مرکزی",61,633,0,0,161,794,35,829
"آذربایجان_غربی","میاندوآب","مرکزی",62,448,1,145,136,730,14,744
"آذربایجان_غربی","میاندوآب","مرکزی",63,659,5,4,127,795,0,795
"آذربایجان_غربی","میاندوآب","مرکزی",64,701,2,0,248,951,10,961
"آذربایجان_غربی","میاندوآب","مرکزی",65,533,0,26,201,760,40,800
"آذربایجان_غربی","میاندوآب","مرکزی",66,446,1,181,56,684,43,727
"آذربایجان_غربی","میاندوآب","مرکزی",67,277,3,159,95,534,12,546
"آذربایجان_غربی","میاندوآب","مرکزی",68,452,12,17,69,550,3,553
"آذربایجان_غربی","میاندوآب","مرکزی",69,594,4,0,81,679,28,707
"آذربایجان_غربی","میاندوآب","مرکزی",70,161,0,9,235,405,44,449
"آذربایجان_غربی","میاندوآب","مرکزی",71,174,5,25,258,462,30,492
"آذربایجان_غربی","میاندوآب","مرکزی",72,548,5,4,417,974,15,989
"آذربایجان_غربی","میاندوآب","مرکزی",73,565,4,3,426,998,40,1038
"آذربایجان_غربی","میاندوآب","مرکزی",74,543,6,1,265,815,14,829
"آذربایجان_غربی","میاندوآب","مرکزی",75,221,3,0,246,470,4,474
"آذربایجان_غربی","میاندوآب","مرکزی",76,271,1,38,371,681,11,692
"آذربایجان_غربی","میاندوآب","مرکزی",77,388,1,2,394,785,15,800
"آذربایجان_غربی","میاندوآب","مرکزی",78,140,3,14,195,352,9,361
"آذربایجان_غربی","میاندوآب","مرکزی",79,365,8,148,246,767,33,800
"آذربایجان_غربی","میاندوآب","مرکزی",80,351,5,0,209,565,30,595
"آذربایجان_غربی","میاندوآب","مرکزی",81,502,11,16,261,790,14,804
"آذربایجان_غربی","میاندوآب","مرکزی",82,693,1,2,255,951,23,974
"آذربایجان_غربی","میاندوآب","مرکزی",83,332,0,227,152,711,29,740
"آذربایجان_غربی","میاندوآب","مرکزی",84,321,3,363,214,901,20,921
"آذربایجان_غربی","میاندوآب","مرکزی",85,521,5,95,376,997,26,1023
"آذربایجان_غربی","میاندوآب","مرکزی",86,240,3,22,281,546,9,555
"آذربایجان_غربی","میاندوآب","مرکزی",87,218,7,41,181,447,20,467
"آذربایجان_غربی","میاندوآب","مرکزی",88,123,0,3,153,279,11,290
"آذربایجان_غربی","میاندوآب","مرکزی",89,129,7,6,143,285,8,293
"آذربایجان_غربی","میاندوآب","مرکزی",90,160,13,49,179,401,32,433
"آذربایجان_غربی","میاندوآب","مرکزی",91,195,3,32,345,575,30,605
"آذربایجان_غربی","میاندوآب","مرکزی",92,159,9,35,429,632,0,632
"آذربایجان_غربی","میاندوآب","مرکزی",93,208,1,7,255,471,10,481
"آذربایجان_غربی","میاندوآب","مرکزی",94,327,2,0,218,547,3,550
"آذربایجان_غربی","میاندوآب","مرکزی",95,303,6,46,463,818,31,849
"آذربایجان_غربی","میاندوآب","مرکزی",96,128,7,15,361,511,37,548
"آذربایجان_غربی","میاندوآب","مرکزی",97,119,13,34,140,306,10,316
"آذربایجان_غربی","میاندوآب","مرکزی",98,156,13,36,354,559,28,587
"آذربایجان_غربی","میاندوآب","مرکزی",99,38,4,9,161,212,2,214
"آذربایجان_غربی","میاندوآب","مرکزی",100,291,1,53,185,530,34,564
"آذربایجان_غربی","میاندوآب","مرکزی",101,188,6,23,394,611,18,629
"آذربایجان_غربی","میاندوآب","مرکزی",102,582,4,6,618,1210,26,1236
"آذربایجان_غربی","میاندوآب","باروق",1,442,6,0,278,726,16,742
"آذربایجان_غربی","میاندوآب","باروق",2,573,8,4,389,974,20,994
"آذربایجان_غربی","میاندوآب","باروق",3,259,4,2,212,477,6,483
"آذربایجان_غربی","میاندوآب","باروق",4,395,1,0,270,666,15,681
"آذربایجان_غربی","میاندوآب","باروق",5,459,1,0,349,809,13,822
"آذربایجان_غربی","میاندوآب","باروق",6,370,2,2,232,606,19,625
"آذربایجان_غربی","میاندوآب","باروق",7,632,3,0,153,788,10,798
"آذربایجان_غربی","میاندوآب","باروق",8,271,3,1,199,474,2,476
"آذربایجان_غربی","میاندوآب","باروق",9,394,1,0,153,548,4,552
"آذربایجان_غربی","میاندوآب","باروق",10,273,0,0,111,384,0,384
"آذربایجان_غربی","میاندوآب","باروق",11,374,0,1,277,652,37,689
"آذربایجان_غربی","میاندوآب","باروق",12,218,0,0,43,261,2,263
"آذربایجان_غربی","میاندوآب","باروق",13,233,0,0,173,406,0,406
"آذربایجان_غربی","میاندوآب","باروق",14,216,2,0,128,346,3,349
"آذربایجان_غربی","میاندوآب","باروق",15,178,0,1,69,248,10,258
"آذربایجان_غربی","میاندوآب","باروق",16,78,0,0,38,116,1,117
"آذربایجان_غربی","میاندوآب","باروق",17,39,0,0,55,94,0,94
"آذربایجان_غربی","میاندوآب","باروق",18,107,0,0,143,250,12,262
"آذربایجان_غربی","میاندوآب","باروق",19,58,0,0,40,98,0,98
"آذربایجان_غربی","میاندوآب","باروق",20,155,0,0,29,184,5,189
"آذربایجان_غربی","میاندوآب","باروق",21,221,0,0,73,294,6,300
"آذربایجان_غربی","میاندوآب","باروق",22,249,0,0,34,283,0,283
"آذربایجان_غربی","میاندوآب","باروق",23,242,1,0,50,293,1,294
"آذربایجان_غربی","میاندوآب","باروق",24,192,0,0,53,245,2,247
"آذربایجان_غربی","میاندوآب","باروق",25,247,1,0,72,320,4,324
"آذربایجان_غربی","میاندوآب","باروق",26,180,1,0,52,233,0,233
"آذربایجان_غربی","میاندوآب","مرحمت_آباد",1,548,2,1,442,993,31,1024
"آذربایجان_غربی","میاندوآب","مرحمت_آباد",2,402,8,0,513,923,27,950
"آذربایجان_غربی","میاندوآب","مرحمت_آباد",3,590,16,1,508,1115,21,1136
"آذربایجان_غربی","میاندوآب","مرحمت_آباد",4,353,4,2,448,807,19,826
"آذربایجان_غربی","میاندوآب","مرحمت_آباد",5,321,1,1,357,680,20,700
"آذربایجان_غربی","میاندوآب","مرحمت_آباد",6,482,4,0,252,738,18,756
"آذربایجان_غربی","میاندوآب","مرحمت_آباد",7,439,3,1,148,591,9,600
"آذربایجان_غربی","میاندوآب","مرحمت_آباد",8,455,5,1,100,561,9,570
"آذربایجان_غربی","میاندوآب","مرحمت_آباد",9,718,6,0,380,1104,37,1141
"آذربایجان_غربی","میاندوآب","مرحمت_آباد",10,611,5,1,144,761,44,805
"آذربایجان_غربی","میاندوآب","مرحمت_آباد",11,213,2,1,408,624,14,638
"آذربایجان_غربی","میاندوآب","مرحمت_آباد",12,390,3,0,421,814,9,823
"آذربایجان_غربی","میاندوآب","مرحمت_آباد",13,304,8,0,316,628,7,635
"آذربایجان_غربی","میاندوآب","مرحمت_آباد",14,253,7,2,243,505,26,531
"آذربایجان_غربی","میاندوآب","مرحمت_آباد",15,443,0,0,284,727,18,745
"آذربایجان_غربی","میاندوآب","مرحمت_آباد",16,282,3,0,265,550,11,561
"آذربایجان_غربی","میاندوآب","مرحمت_آباد",17,355,2,0,216,573,27,600
"آذربایجان_غربی","نقده","مرکزی",1,307,10,4,353,674,0,674
"آذربایجان_غربی","نقده","مرکزی",2,421,6,4,507,938,3,941
"آذربایجان_غربی","نقده","مرکزی",3,289,7,0,300,596,4,600
"آذربایجان_غربی","نقده","مرکزی",4,550,17,4,1020,1591,6,1597
"آذربایجان_غربی","نقده","مرکزی",5,232,2,3,314,551,7,558
"آذربایجان_غربی","نقده","مرکزی",6,339,3,0,447,789,1,790
"آذربایجان_غربی","نقده","مرکزی",7,314,6,0,501,821,2,823
"آذربایجان_غربی","نقده","مرکزی",8,311,9,1,427,748,3,751
"آذربایجان_غربی","نقده","مرکزی",9,247,4,3,398,652,3,655
"آذربایجان_غربی","نقده","مرکزی",10,453,17,2,838,1310,16,1326
"آذربایجان_غربی","نقده","مرکزی",11,448,9,3,894,1354,8,1362
"آذربایجان_غربی","نقده","مرکزی",12,225,10,3,515,753,1,754
"آذربایجان_غربی","نقده","مرکزی",13,260,12,3,421,696,3,699
"آذربایجان_غربی","نقده","مرکزی",14,199,7,2,436,644,3,647
"آذربایجان_غربی","نقده","مرکزی",15,585,15,4,1020,1624,8,1632
"آذربایجان_غربی","نقده","مرکزی",16,303,6,0,389,698,4,702
"آذربایجان_غربی","نقده","مرکزی",17,403,6,5,728,1142,4,1146
"آذربایجان_غربی","نقده","مرکزی",18,495,16,7,876,1394,6,1400
"آذربایجان_غربی","نقده","مرکزی",19,261,6,3,503,773,2,775
"آذربایجان_غربی","نقده","مرکزی",20,171,16,20,341,548,16,564
"آذربایجان_غربی","نقده","مرکزی",21,255,10,32,234,531,13,544
"آذربایجان_غربی","نقده","مرکزی",22,258,16,57,383,714,41,755
"آذربایجان_غربی","نقده","مرکزی",23,425,19,84,721,1249,46,1295
"آذربایجان_غربی","نقده","مرکزی",24,139,4,4,208,355,7,362
"آذربایجان_غربی","نقده","مرکزی",25,246,9,31,355,641,6,647
"آذربایجان_غربی","نقده","مرکزی",26,342,15,74,557,988,40,1028
"آذربایجان_غربی","نقده","مرکزی",27,273,22,47,345,687,28,715
"آذربایجان_غربی","نقده","مرکزی",28,279,22,31,534,866,18,884
"آذربایجان_غربی","نقده","مرکزی",29,450,28,54,633,1165,36,1201
"آذربایجان_غربی","نقده","مرکزی",30,662,7,3,427,1099,6,1105
"آذربایجان_غربی","نقده","مرکزی",31,550,19,14,675,1258,15,1273
"آذربایجان_غربی","نقده","مرکزی",32,431,8,0,523,962,4,966
"آذربایجان_غربی","نقده","مرکزی",33,547,4,5,500,1056,9,1065
"آذربایجان_غربی","نقده","مرکزی",34,727,7,2,498,1234,6,1240
"آذربایجان_غربی","نقده","مرکزی",35,539,8,0,369,916,4,920
"آذربایجان_غربی","نقده","مرکزی",36,443,15,3,758,1219,6,1225
"آذربایجان_غربی","نقده","مرکزی",37,462,14,5,1036,1517,6,1523
"آذربایجان_غربی","نقده","مرکزی",38,274,5,2,357,638,0,638
"آذربایجان_غربی","نقده","مرکزی",39,170,1,1,230,402,0,402
"آذربایجان_غربی","نقده","مرکزی",40,152,7,3,291,453,5,458
"آذربایجان_غربی","نقده","مرکزی",41,196,5,1,281,483,3,486
"آذربایجان_غربی","نقده","مرکزی",42,120,3,1,136,260,4,264
"آذربایجان_غربی","نقده","مرکزی",43,132,5,1,123,261,18,279
"آذربایجان_غربی","نقده","مرکزی",44,137,2,2,386,527,5,532
"آذربایجان_غربی","نقده","مرکزی",45,196,2,1,232,431,3,434
"آذربایجان_غربی","نقده","مرکزی",46,170,4,3,201,378,1,379
"آذربایجان_غربی","نقده","مرکزی",47,312,2,1,256,571,1,572
"آذربایجان_غربی","نقده","مرکزی",48,55,1,9,75,140,0,140
"آذربایجان_غربی","نقده","مرکزی",49,405,5,0,191,601,2,603
"آذربایجان_غربی","نقده","مرکزی",50,343,6,2,361,712,7,719
"آذربایجان_غربی","نقده","مرکزی",51,647,3,3,236,889,7,896
"آذربایجان_غربی","نقده","مرکزی",52,259,3,5,328,595,4,599
"آذربایجان_غربی","نقده","مرکزی",53,283,12,14,239,548,8,556
"آذربایجان_غربی","نقده","مرکزی",54,238,4,0,220,462,0,462
"آذربایجان_غربی","نقده","مرکزی",55,149,6,22,176,353,8,361
"آذربایجان_غربی","نقده","مرکزی",56,234,7,24,154,419,17,436
"آذربایجان_غربی","نقده","مرکزی",57,252,6,0,288,546,2,548
"آذربایجان_غربی","نقده","مرکزی",58,198,9,50,162,419,4,423
"آذربایجان_غربی","نقده","مرکزی",59,203,15,24,115,357,21,378
"آذربایجان_غربی","نقده","مرکزی",60,85,3,18,128,234,14,248
"آذربایجان_غربی","نقده","مرکزی",61,204,2,22,199,427,12,439
"آذربایجان_غربی","نقده","مرکزی",62,164,9,16,120,309,15,324
"آذربایجان_غربی","نقده","مرکزی",63,139,6,24,124,293,12,305
"آذربایجان_غربی","نقده","مرکزی",64,166,6,5,133,310,3,313
"آذربایجان_غربی","نقده","مرکزی",65,82,5,16,180,283,9,292
"آذربایجان_غربی","نقده","مرکزی",66,106,3,22,201,332,5,337
"آذربایجان_غربی","نقده","مرکزی",67,119,1,4,145,269,3,272
"آذربایجان_غربی","نقده","مرکزی",68,115,2,8,190,315,6,321
"آذربایجان_غربی","نقده","مرکزی",69,120,2,9,122,253,0,253
"آذربایجان_غربی","نقده","مرکزی",70,115,0,6,73,194,0,194
"آذربایجان_غربی","نقده","محمدیار",71,262,0,0,225,487,1,488
"آذربایجان_غربی","نقده","محمدیار",72,250,3,0,247,500,2,502
"آذربایجان_غربی","نقده","محمدیار",73,273,0,0,244,517,0,517
"آذربایجان_غربی","نقده","محمدیار",74,251,4,2,438,695,5,700
"آذربایجان_غربی","نقده","محمدیار",75,381,9,2,635,1027,5,1032
"آذربایجان_غربی","نقده","محمدیار",76,181,1,1,185,368,1,369
"آذربایجان_غربی","نقده","محمدیار",77,227,5,3,414,649,4,653
"آذربایجان_غربی","نقده","محمدیار",78,323,1,0,263,587,0,587
"آذربایجان_غربی","نقده","محمدیار",79,124,1,1,83,209,3,212
"آذربایجان_غربی","نقده","محمدیار",80,139,3,0,280,422,6,428
"آذربایجان_غربی","نقده","محمدیار",81,237,0,0,178,415,0,415
"آذربایجان_غربی","نقده","محمدیار",82,353,4,1,289,647,3,650
"آذربایجان_غربی","نقده","محمدیار",83,297,3,5,214,519,3,522
"آذربایجان_غربی","نقده","محمدیار",84,227,10,5,237,479,14,493
"آذربایجان_غربی","نقده","محمدیار",85,443,4,21,108,576,7,583
"آذربایجان_غربی","نقده","محمدیار",86,265,8,5,95,373,12,385
"آذربایجان_غربی","نقده","محمدیار",87,189,9,16,137,351,13,364
"آذربایجان_غربی","نقده","محمدیار",88,268,3,6,290,567,9,576
"آذربایجان_غربی","نقده","محمدیار",89,165,0,0,121,286,1,287
"آذربایجان_غربی","نقده","محمدیار",90,237,0,0,189,426,1,427
"آذربایجان_غربی","نقده","محمدیار",91,150,9,4,118,281,20,301
"آذربایجان_غربی","نقده","محمدیار",92,110,0,0,100,210,0,210
"آذربایجان_غربی","نقده","محمدیار",93,188,2,6,123,319,10,329
"آذربایجان_غربی","نقده","محمدیار",94,68,0,2,111,181,0,181
"آذربایجان_غربی","نقده","محمدیار",95,118,0,0,81,199,1,200
"آذربایجان_غربی","نقده","محمدیار",96,139,1,2,218,360,0,360
"آذربایجان_غربی","نقده","محمدیار",97,173,2,0,155,330,0,330
"اردبیل","اردبیل","مرکزی",1,886,77,11,1735,2709,27,2736
"اردبیل","اردبیل","مرکزی",2,598,48,3,833,1482,8,1490
"اردبیل","اردبیل","مرکزی",3,257,26,5,964,1252,15,1267
"اردبیل","اردبیل","مرکزی",4,558,47,7,1419,2031,18,2049
"اردبیل","اردبیل","مرکزی",5,581,49,14,1441,2085,20,2105
"اردبیل","اردبیل","مرکزی",6,845,40,14,1316,2215,24,2239
"اردبیل","اردبیل","مرکزی",7,412,41,4,986,1443,6,1449
"اردبیل","اردبیل","مرکزی",8,608,37,11,1251,1907,18,1925
"اردبیل","اردبیل","مرکزی",9,661,40,16,1588,2305,17,2322
"اردبیل","اردبیل","مرکزی",10,818,43,9,1305,2175,20,2195
"اردبیل","اردبیل","مرکزی",11,401,39,5,1018,1463,14,1477
"اردبیل","اردبیل","مرکزی",12,978,38,6,1086,2108,28,2136
"اردبیل","اردبیل","مرکزی",13,634,32,5,1206,1877,17,1894
"اردبیل","اردبیل","مرکزی",14,317,36,9,1203,1565,3,1568
"اردبیل","اردبیل","مرکزی",15,571,35,10,921,1537,22,1559
"اردبیل","اردبیل","مرکزی",16,583,23,6,766,1378,14,1392
"اردبیل","اردبیل","مرکزی",17,416,10,3,608,1037,9,1046
"اردبیل","اردبیل","مرکزی",18,864,39,5,1339,2247,17,2264
"اردبیل","اردبیل","مرکزی",19,474,41,7,1051,1573,17,1590
"اردبیل","اردبیل","مرکزی",20,281,9,2,432,724,5,729
"اردبیل","اردبیل","مرکزی",21,749,13,2,615,1379,18,1397
"اردبیل","اردبیل","مرکزی",22,732,13,0,585,1330,0,1330
"اردبیل","اردبیل","مرکزی",23,652,20,5,731,1408,10,1418
"اردبیل","اردبیل","مرکزی",24,806,9,7,598,1420,7,1427
"اردبیل","اردبیل","مرکزی",25,733,11,3,499,1246,21,1267
"اردبیل","اردبیل","مرکزی",26,1096,46,3,1034,2179,18,2197
"اردبیل","اردبیل","مرکزی",27,649,17,9,993,1668,31,1699
"اردبیل","اردبیل","مرکزی",28,474,10,0,274,758,3,761
"اردبیل","اردبیل","مرکزی",29,799,25,11,795,1630,13,1643
"اردبیل","اردبیل","مرکزی",30,791,19,2,557,1369,11,1380
"اردبیل","اردبیل","مرکزی",31,885,31,2,666,1584,13,1597
"اردبیل","اردبیل","مرکزی",32,1234,17,1,716,1968,15,1983
"اردبیل","اردبیل","مرکزی",33,382,22,5,867,1276,9,1285
"اردبیل","اردبیل","مرکزی",34,597,20,6,850,1473,4,1477
"اردبیل","اردبیل","مرکزی",35,443,18,6,745,1212,7,1219
"اردبیل","اردبیل","مرکزی",36,691,12,0,336,1039,10,1049
"اردبیل","اردبیل","مرکزی",37,1013,19,6,609,1647,6,1653
"اردبیل","اردبیل","مرکزی",38,520,27,3,924,1474,11,1485
"اردبیل","اردبیل","مرکزی",39,821,24,6,1107,1958,18,1976
"اردبیل","اردبیل","مرکزی",40,376,19,3,707,1105,14,1119
"اردبیل","اردبیل","مرکزی",41,391,28,2,835,1256,12,1268
"اردبیل","اردبیل","مرکزی",42,187,22,2,349,560,0,560
"اردبیل","اردبیل","مرکزی",43,201,24,5,363,593,3,596
"اردبیل","اردبیل","مرکزی",44,230,23,7,487,747,7,754
"اردبیل","اردبیل","مرکزی",45,196,14,0,317,527,5,532
"اردبیل","اردبیل","مرکزی",46,266,26,2,537,831,3,834
"اردبیل","اردبیل","مرکزی",47,358,22,3,573,956,7,963
"اردبیل","اردبیل","مرکزی",48,770,41,7,1019,1837,14,1851
"اردبیل","اردبیل","مرکزی",49,593,24,2,770,1389,18,1407
"اردبیل","اردبیل","مرکزی",50,212,16,2,460,690,2,692
"اردبیل","اردبیل","مرکزی",51,137,16,4,454,611,6,617
"اردبیل","اردبیل","مرکزی",52,586,30,7,1150,1773,6,1779
"اردبیل","اردبیل","مرکزی",53,411,27,12,899,1349,17,1366
"اردبیل","اردبیل","مرکزی",54,316,23,10,1350,1699,23,1722
"اردبیل","اردبیل","مرکزی",55,310,17,16,1636,1979,16,1995
"اردبیل","اردبیل","مرکزی",56,368,13,5,581,967,6,973
"اردبیل","اردبیل","مرکزی",57,989,84,22,2058,3153,37,3190
"اردبیل","اردبیل","مرکزی",58,318,26,8,751,1103,14,1117
"اردبیل","اردبیل","مرکزی",59,358,51,9,1372,1790,10,1800
"اردبیل","اردبیل","مرکزی",60,359,23,10,1274,1666,13,1679
"اردبیل","اردبیل","مرکزی",61,720,38,11,1365,2134,21,2155
"اردبیل","اردبیل","مرکزی",62,444,40,16,1512,2012,20,2032
"اردبیل","اردبیل","مرکزی",63,323,33,5,749,1110,14,1124
"اردبیل","اردبیل","مرکزی",64,412,16,5,585,1018,15,1033
"اردبیل","اردبیل","مرکزی",65,477,35,2,652,1166,10,1176
"اردبیل","اردبیل","مرکزی",66,861,33,11,1111,2016,13,2029
"اردبیل","اردبیل","مرکزی",67,630,46,13,1166,1855,14,1869
"اردبیل","اردبیل","مرکزی",68,788,39,19,1223,2069,32,2101
"اردبیل","اردبیل","مرکزی",69,274,35,7,994,1310,17,1327
"اردبیل","اردبیل","مرکزی",70,527,35,6,705,1273,10,1283
"اردبیل","اردبیل","مرکزی",71,779,31,9,1161,1980,17,1997
"اردبیل","اردبیل","مرکزی",72,947,27,3,819,1796,20,1816
"اردبیل","اردبیل","مرکزی",73,902,26,3,706,1637,13,1650
"اردبیل","اردبیل","مرکزی",74,460,27,8,726,1221,12,1233
"اردبیل","اردبیل","مرکزی",75,353,33,8,587,981,13,994
"اردبیل","اردبیل","مرکزی",76,369,15,5,416,805,17,822
"اردبیل","اردبیل","مرکزی",77,362,21,1,547,931,9,940
"اردبیل","اردبیل","مرکزی",78,637,17,5,554,1213,7,1220
"اردبیل","اردبیل","مرکزی",79,756,16,3,701,1476,11,1487
"اردبیل","اردبیل","مرکزی",80,750,29,6,892,1677,12,1689
"اردبیل","اردبیل","مرکزی",81,888,23,5,850,1766,10,1776
"اردبیل","اردبیل","مرکزی",82,591,27,2,483,1103,10,1113
"اردبیل","اردبیل","مرکزی",83,626,18,3,641,1288,28,1316
"اردبیل","اردبیل","مرکزی",84,686,26,2,726,1440,11,1451
"اردبیل","اردبیل","مرکزی",85,736,27,2,608,1373,7,1380
"اردبیل","اردبیل","مرکزی",86,350,24,9,855,1238,20,1258
"اردبیل","اردبیل","مرکزی",87,227,26,6,598,857,0,857
"اردبیل","اردبیل","مرکزی",88,232,20,2,763,1017,15,1032
"اردبیل","اردبیل","مرکزی",89,471,47,25,1137,1680,25,1705
"اردبیل","اردبیل","مرکزی",90,205,18,7,561,791,7,798
"اردبیل","اردبیل","مرکزی",91,852,57,21,1426,2356,33,2389
"اردبیل","اردبیل","مرکزی",92,234,16,11,688,949,5,954
"اردبیل","اردبیل","مرکزی",93,300,15,1,351,667,12,679
"اردبیل","اردبیل","مرکزی",94,102,8,3,340,453,8,461
"اردبیل","اردبیل","مرکزی",95,216,15,2,674,907,7,914
"اردبیل","اردبیل","مرکزی",96,258,16,4,447,725,2,727
"اردبیل","اردبیل","مرکزی",97,348,17,4,437,806,10,816
"اردبیل","اردبیل","مرکزی",98,378,25,8,657,1068,13,1081
"اردبیل","اردبیل","مرکزی",99,103,3,2,250,358,5,363
"اردبیل","اردبیل","مرکزی",100,470,37,12,849,1368,10,1378
"اردبیل","اردبیل","مرکزی",101,248,16,1,383,648,9,657
"اردبیل","اردبیل","مرکزی",102,170,14,1,332,517,4,521
"اردبیل","اردبیل","مرکزی",103,377,28,7,811,1223,31,1254
"اردبیل","اردبیل","مرکزی",104,278,12,2,510,802,8,810
"اردبیل","اردبیل","مرکزی",105,322,6,3,418,749,2,751
"اردبیل","اردبیل","مرکزی",106,229,8,1,327,565,8,573
"اردبیل","اردبیل","مرکزی",107,413,21,10,725,1169,18,1187
"اردبیل","اردبیل","مرکزی",108,179,5,7,301,492,7,499
"اردبیل","اردبیل","مرکزی",109,234,16,3,447,700,6,706
"اردبیل","اردبیل","مرکزی",110,188,17,5,420,630,6,636
"اردبیل","اردبیل","مرکزی",111,780,38,3,678,1499,15,1514
"اردبیل","اردبیل","مرکزی",112,496,23,1,487,1007,10,1017
"اردبیل","اردبیل","مرکزی",113,574,15,4,492,1085,13,1098
"اردبیل","اردبیل","مرکزی",114,581,13,0,529,1123,7,1130
"اردبیل","اردبیل","مرکزی",115,501,8,9,453,971,9,980
"اردبیل","اردبیل","مرکزی",116,658,35,8,890,1591,18,1609
"اردبیل","اردبیل","مرکزی",117,403,13,6,673,1095,4,1099
"اردبیل","اردبیل","مرکزی",118,599,25,4,619,1247,8,1255
"اردبیل","اردبیل","مرکزی",119,804,27,2,888,1721,23,1744
"اردبیل","اردبیل","مرکزی",120,794,12,2,542,1350,11,1361
"اردبیل","اردبیل","مرکزی",121,810,26,3,719,1558,13,1571
"اردبیل","اردبیل","مرکزی",122,305,15,6,433,759,9,768
"اردبیل","اردبیل","مرکزی",123,689,13,1,513,1216,8,1224
"اردبیل","اردبیل","مرکزی",124,810,16,3,469,1298,9,1307
"اردبیل","اردبیل","مرکزی",125,743,15,33,415,1206,3,1209
"اردبیل","اردبیل","مرکزی",126,453,8,6,462,929,3,932
"اردبیل","اردبیل","مرکزی",127,280,24,1,219,524,6,530
"اردبیل","اردبیل","مرکزی",128,297,12,2,289,600,2,602
"اردبیل","اردبیل","مرکزی",129,267,12,2,285,566,2,568
"اردبیل","اردبیل","مرکزی",130,1244,9,0,337,1590,2,1592
"اردبیل","اردبیل","مرکزی",131,909,11,5,610,1535,11,1546
"اردبیل","اردبیل","مرکزی",132,771,21,3,481,1276,4,1280
"اردبیل","اردبیل","مرکزی",133,817,19,0,668,1504,10,1514
"اردبیل","اردبیل","مرکزی",134,419,6,6,305,736,2,738
"اردبیل","اردبیل","مرکزی",135,1072,18,1,670,1761,14,1775
"اردبیل","اردبیل","مرکزی",136,996,18,5,706,1725,15,1740
"اردبیل","اردبیل","مرکزی",137,1268,12,6,689,1975,11,1986
"اردبیل","اردبیل","مرکزی",138,714,2,1,283,1000,7,1007
"اردبیل","اردبیل","مرکزی",139,366,11,1,327,705,10,715
"اردبیل","اردبیل","مرکزی",140,517,6,2,440,965,11,976
"اردبیل","اردبیل","مرکزی",141,491,4,5,357,857,9,866
"اردبیل","اردبیل","مرکزی",142,1119,7,5,535,1666,2,1668
"اردبیل","اردبیل","مرکزی",143,950,5,6,531,1492,21,1513
"اردبیل","اردبیل","مرکزی",144,923,9,5,441,1378,15,1393
"اردبیل","اردبیل","مرکزی",145,608,12,0,373,993,3,996
"اردبیل","اردبیل","مرکزی",146,618,15,2,490,1125,0,1125
"اردبیل","اردبیل","مرکزی",147,809,8,0,393,1210,5,1215
"اردبیل","اردبیل","مرکزی",148,675,4,4,474,1157,10,1167
"اردبیل","اردبیل","مرکزی",149,664,9,3,595,1271,12,1283
"اردبیل","اردبیل","مرکزی",150,1197,18,14,661,1890,9,1899
"اردبیل","اردبیل","مرکزی",151,1085,7,5,650,1747,19,1766
"اردبیل","اردبیل","مرکزی",152,1147,16,4,488,1655,10,1665
"اردبیل","اردبیل","مرکزی",153,703,6,1,290,1000,6,1006
"اردبیل","اردبیل","مرکزی",154,566,20,4,676,1266,4,1270
"اردبیل","اردبیل","مرکزی",155,800,16,14,671,1501,14,1515
"اردبیل","اردبیل","مرکزی",156,701,21,6,758,1486,8,1494
"اردبیل","اردبیل","مرکزی",157,753,32,3,1029,1817,10,1827
"اردبیل","اردبیل","مرکزی",158,530,13,2,690,1235,11,1246
"اردبیل","اردبیل","مرکزی",159,476,12,5,500,993,4,997
"اردبیل","اردبیل","مرکزی",160,573,30,9,678,1290,16,1306
"اردبیل","اردبیل","مرکزی",161,389,23,1,448,861,8,869
"اردبیل","اردبیل","مرکزی",162,853,24,4,730,1611,15,1626
"اردبیل","اردبیل","مرکزی",163,717,29,4,952,1702,27,1729
"اردبیل","اردبیل","مرکزی",164,407,22,2,573,1004,10,1014
"اردبیل","اردبیل","مرکزی",165,419,28,6,728,1181,7,1188
"اردبیل","اردبیل","مرکزی",166,257,13,3,241,514,3,517
"اردبیل","اردبیل","مرکزی",167,722,47,8,1213,1990,24,2014
"اردبیل","اردبیل","مرکزی",168,477,25,6,799,1307,13,1320
"اردبیل","اردبیل","مرکزی",169,372,7,2,79,460,10,470
"اردبیل","اردبیل","مرکزی",170,201,11,0,177,389,8,397
"اردبیل","اردبیل","مرکزی",171,361,31,9,401,802,23,825
"اردبیل","اردبیل","مرکزی",172,210,22,6,471,709,2,711
"اردبیل","اردبیل","مرکزی",173,540,21,9,607,1177,8,1185
"اردبیل","اردبیل","مرکزی",174,1174,11,3,461,1649,19,1668
"اردبیل","اردبیل","مرکزی",175,818,9,1,294,1122,7,1129
"اردبیل","اردبیل","مرکزی",176,772,11,2,332,1117,6,1123
"اردبیل","اردبیل","مرکزی",177,511,17,1,637,1166,9,1175
"اردبیل","اردبیل","مرکزی",178,110,4,2,90,206,2,208
"اردبیل","اردبیل","مرکزی",179,136,5,0,146,287,2,289
"اردبیل","اردبیل","مرکزی",180,680,16,3,162,861,6,867
"اردبیل","اردبیل","مرکزی",181,425,6,1,142,574,0,574
"اردبیل","اردبیل","مرکزی",182,223,7,2,141,373,2,375
"اردبیل","اردبیل","مرکزی",183,522,9,4,286,821,4,825
"اردبیل","اردبیل","مرکزی",184,308,1,0,114,423,6,429
"اردبیل","اردبیل","مرکزی",185,307,5,1,172,485,8,493
"اردبیل","اردبیل","مرکزی",186,623,6,1,127,757,0,757
"اردبیل","اردبیل","مرکزی",187,481,13,2,314,810,2,812
"اردبیل","اردبیل","مرکزی",188,271,11,1,178,461,9,470
"اردبیل","اردبیل","مرکزی",189,318,4,0,90,412,2,414
"اردبیل","اردبیل","مرکزی",190,283,4,0,26,313,1,314
"اردبیل","اردبیل","مرکزی",191,340,1,14,27,382,2,384
"اردبیل","اردبیل","مرکزی",192,354,1,1,21,377,1,378
"اردبیل","اردبیل","مرکزی",193,309,0,0,32,341,2,343
"اردبیل","اردبیل","مرکزی",194,277,0,0,48,325,2,327
"اردبیل","اردبیل","مرکزی",195,242,1,0,71,314,2,316
"اردبیل","اردبیل","مرکزی",196,463,0,0,76,539,2,541
"اردبیل","اردبیل","مرکزی",197,398,1,0,100,499,1,500
"اردبیل","اردبیل","مرکزی",198,352,0,0,133,485,2,487
"اردبیل","اردبیل","مرکزی",199,70,1,0,20,91,0,91
"اردبیل","اردبیل","مرکزی",200,370,0,2,40,412,1,413
"اردبیل","اردبیل","مرکزی",201,455,0,2,93,550,2,552
"اردبیل","اردبیل","مرکزی",202,182,0,0,31,213,0,213
"اردبیل","اردبیل","مرکزی",203,148,2,0,54,204,4,208
"اردبیل","اردبیل","مرکزی",204,177,4,0,43,224,2,226
"اردبیل","اردبیل","مرکزی",205,129,6,0,54,189,1,190
"اردبیل","اردبیل","مرکزی",206,132,1,0,108,241,1,242
"اردبیل","اردبیل","مرکزی",207,88,0,0,34,122,0,122
"اردبیل","اردبیل","مرکزی",208,234,3,0,79,316,0,316
"اردبیل","اردبیل","مرکزی",209,159,0,0,68,227,6,233
"اردبیل","اردبیل","مرکزی",210,107,1,0,39,147,2,149
"اردبیل","اردبیل","مرکزی",211,737,8,1,152,898,2,900
"اردبیل","اردبیل","مرکزی",212,407,9,5,314,735,11,746
"اردبیل","اردبیل","مرکزی",213,156,1,3,64,224,0,224
"اردبیل","اردبیل","مرکزی",214,469,5,0,194,668,2,670
"اردبیل","اردبیل","مرکزی",215,333,5,1,172,511,2,513
"اردبیل","اردبیل","مرکزی",216,684,7,1,309,1001,2,1003
"اردبیل","اردبیل","مرکزی",217,267,10,0,119,396,2,398
"اردبیل","اردبیل","مرکزی",218,391,14,5,212,622,2,624
"اردبیل","اردبیل","مرکزی",219,210,16,2,307,535,6,541
"اردبیل","اردبیل","مرکزی",220,483,2,1,93,579,1,580
"اردبیل","اردبیل","مرکزی",221,295,2,1,52,350,0,350
"اردبیل","اردبیل","مرکزی",222,284,5,0,132,421,6,427
"اردبیل","اردبیل","مرکزی",223,296,1,10,201,508,1,509
"اردبیل","اردبیل","مرکزی",224,341,1,2,78,422,2,424
"اردبیل","اردبیل","مرکزی",225,460,2,1,74,537,2,539
"اردبیل","اردبیل","مرکزی",226,345,4,2,145,496,5,501
"اردبیل","اردبیل","مرکزی",227,327,8,2,111,448,2,450
"اردبیل","اردبیل","مرکزی",228,228,1,1,65,295,4,299
"اردبیل","اردبیل","مرکزی",229,945,3,1,41,990,5,995
"اردبیل","اردبیل","مرکزی",230,340,1,0,9,350,0,350
"اردبیل","اردبیل","مرکزی",231,240,5,2,93,340,2,342
"اردبیل","اردبیل","مرکزی",232,153,0,1,81,235,7,242
"اردبیل","اردبیل","مرکزی",233,325,5,0,116,446,4,450
"اردبیل","اردبیل","مرکزی",234,352,3,0,162,517,4,521
"اردبیل","اردبیل","مرکزی",235,211,0,0,32,243,1,244
"اردبیل","اردبیل","مرکزی",236,921,23,3,241,1188,10,1198
"اردبیل","اردبیل","مرکزی",237,88,0,1,33,122,0,122
"اردبیل","اردبیل","مرکزی",238,36,1,0,49,86,1,87
"اردبیل","اردبیل","مرکزی",239,244,0,0,89,333,2,335
"اردبیل","اردبیل","مرکزی",240,201,4,0,65,270,0,270
"اردبیل","اردبیل","مرکزی",241,398,4,0,233,635,2,637
"اردبیل","اردبیل","مرکزی",242,276,2,0,145,423,2,425
"اردبیل","اردبیل","مرکزی",243,261,4,0,164,429,2,431
"اردبیل","اردبیل","مرکزی",1,469,16,2,955,1442,15,1457
"اردبیل","اردبیل","سرعین",2,480,15,4,815,1314,11,1325
"اردبیل","اردبیل","سرعین",3,400,21,3,709,1133,6,1139
"اردبیل","اردبیل","سرعین",4,312,13,3,759,1087,7,1094
"اردبیل","اردبیل","سرعین",5,256,4,1,160,421,7,428
"اردبیل","اردبیل","سرعین",6,329,1,3,75,408,3,411
"اردبیل","اردبیل","سرعین",7,477,0,0,48,525,0,525
"اردبیل","اردبیل","سرعین",8,337,3,1,83,424,3,427
"اردبیل","اردبیل","سرعین",9,255,2,0,86,343,1,344
"اردبیل","اردبیل","سرعین",10,382,0,2,83,467,0,467
"اردبیل","اردبیل","سرعین",11,296,4,1,137,438,4,442
"اردبیل","اردبیل","سرعین",12,357,0,0,86,443,3,446
"اردبیل","اردبیل","سرعین",13,379,2,1,124,506,2,508
"اردبیل","اردبیل","سرعین",14,429,3,0,101,533,9,542
"اردبیل","اردبیل","سرعین",15,376,0,0,162,538,10,548
"اردبیل","اردبیل","سرعین",16,132,1,0,29,162,1,163
"اردبیل","اردبیل","سرعین",17,143,0,0,157,300,0,300
"اردبیل","اردبیل","سرعین",18,287,0,2,150,439,5,444
"اردبیل","اردبیل","سرعین",19,247,3,1,47,298,2,300
"اردبیل","اردبیل","سرعین",20,229,0,0,71,300,1,301
"اردبیل","اردبیل","هیر",1,217,1,5,331,554,5,559
"اردبیل","اردبیل","هیر",2,302,2,1,170,475,1,476
"اردبیل","اردبیل","هیر",3,191,5,5,224,425,0,425
"اردبیل","اردبیل","هیر",4,749,4,1,160,914,3,917
"اردبیل","اردبیل","هیر",5,139,2,0,97,238,1,239
"اردبیل","اردبیل","هیر",6,585,3,9,178,775,2,777
"اردبیل","اردبیل","هیر",7,471,2,0,51,524,1,525
"اردبیل","اردبیل","هیر",8,143,3,1,40,187,4,191
"اردبیل","اردبیل","هیر",9,527,10,3,230,770,6,776
"اردبیل","اردبیل","هیر",10,650,5,3,139,797,2,799
"اردبیل","اردبیل","هیر",11,151,1,1,147,300,1,301
"اردبیل","اردبیل","هیر",12,738,4,0,80,822,2,824
"اردبیل","اردبیل","هیر",13,414,2,0,71,487,0,487
"اردبیل","اردبیل","هیر",14,122,0,0,55,177,1,178
"اردبیل","اردبیل","هیر",15,73,1,0,26,100,0,100
"اردبیل","اردبیل","هیر",16,174,3,0,87,264,4,268
"اردبیل","اردبیل","هیر",17,134,1,0,92,227,2,229
"اردبیل","اردبیل","هیر",18,95,1,0,88,184,1,185
"اردبیل","اردبیل","هیر",19,403,1,1,291,696,0,696
"اردبیل","اردبیل","هیر",20,209,1,1,19,230,0,230
"اردبیل","اردبیل","هیر",21,291,0,0,23,314,0,314
"اردبیل","اردبیل","هیر",22,239,0,1,79,319,3,322
"اردبیل","اردبیل","هیر",23,316,5,2,79,402,1,403
"اردبیل","اردبیل","هیر",24,205,1,0,25,231,1,232
"اردبیل","اردبیل","هیر",25,232,2,0,183,417,1,418
"اردبیل","اردبیل","هیر",26,88,0,0,20,108,0,108
"اردبیل","اردبیل","هیر",27,177,0,0,57,234,0,234
"اردبیل","اردبیل","هیر",28,237,2,0,58,297,1,298
"اردبیل","اردبیل","هیر",29,50,2,1,48,101,0,101
"اردبیل","بیله_سوار","مرکزی",1,323,7,1,626,957,5,962
"اردبیل","بیله_سوار","مرکزی",2,242,2,0,375,619,6,625
"اردبیل","بیله_سوار","مرکزی",3,219,3,1,207,430,3,433
"اردبیل","بیله_سوار","مرکزی",4,386,6,2,383,777,6,783
"اردبیل","بیله_سوار","مرکزی",5,268,1,4,297,570,3,573
"اردبیل","بیله_سوار","مرکزی",6,291,3,0,508,802,5,807
"اردبیل","بیله_سوار","مرکزی",7,305,9,0,530,844,4,848
"اردبیل","بیله_سوار","مرکزی",8,263,1,1,393,658,4,662
"اردبیل","بیله_سوار","مرکزی",9,82,0,1,119,202,3,205
"اردبیل","بیله_سوار","مرکزی",10,207,2,2,248,459,3,462
"اردبیل","بیله_سوار","مرکزی",11,321,6,3,335,665,5,670
"اردبیل","بیله_سوار","مرکزی",12,111,1,1,233,346,3,349
"اردبیل","بیله_سوار","مرکزی",13,624,6,3,197,830,2,832
"اردبیل","بیله_سوار","مرکزی",14,364,1,0,276,641,3,644
"اردبیل","بیله_سوار","مرکزی",15,263,4,0,243,510,3,513
"اردبیل","بیله_سوار","مرکزی",16,193,3,0,80,276,0,276
"اردبیل","بیله_سوار","مرکزی",17,346,0,8,223,577,1,578
"اردبیل","بیله_سوار","مرکزی",18,411,4,0,385,800,0,800
"اردبیل","بیله_سوار","مرکزی",19,196,2,4,290,492,1,493
"اردبیل","بیله_سوار","مرکزی",20,188,1,0,94,283,1,284
"اردبیل","بیله_سوار","مرکزی",21,174,0,5,203,382,2,384
"اردبیل","بیله_سوار","مرکزی",22,184,0,0,260,444,6,450
"اردبیل","بیله_سوار","مرکزی",23,208,2,11,155,376,6,382
"اردبیل","بیله_سوار","مرکزی",24,201,3,2,201,407,0,407
"اردبیل","بیله_سوار","مرکزی",25,69,0,1,44,114,0,114
"اردبیل","بیله_سوار","مرکزی",26,81,2,0,30,113,0,113
"اردبیل","بیله_سوار","مرکزی",27,180,1,1,106,288,5,293
"اردبیل","بیله_سوار","مرکزی",28,103,0,1,316,420,1,421
"اردبیل","بیله_سوار","مرکزی",29,217,1,0,170,388,2,390
"اردبیل","بیله_سوار","مرکزی",30,111,1,0,57,169,1,170
"اردبیل","بیله_سوار","مرکزی",31,87,1,0,90,178,4,182
"اردبیل","بیله_سوار","مرکزی",32,137,0,0,100,237,1,238
"اردبیل","بیله_سوار","مرکزی",33,102,0,0,76,178,1,179
"اردبیل","بیله_سوار","قشلاق_دشت",1,180,2,3,375,560,2,562
"اردبیل","بیله_سوار","قشلاق_دشت",2,297,6,5,286,594,5,599
"اردبیل","بیله_سوار","قشلاق_دشت",3,246,1,0,116,363,7,370
"اردبیل","بیله_سوار","قشلاق_دشت",4,267,2,0,254,523,4,527
"اردبیل","بیله_سوار","قشلاق_دشت",5,194,5,0,394,593,6,599
"اردبیل","بیله_سوار","قشلاق_دشت",6,172,1,1,120,294,4,298
"اردبیل","بیله_سوار","قشلاق_دشت",7,150,1,2,131,284,0,284
"اردبیل","بیله_سوار","قشلاق_دشت",8,219,3,0,187,409,1,410
"اردبیل","بیله_سوار","قشلاق_دشت",9,195,1,0,199,395,0,395
"اردبیل","بیله_سوار","قشلاق_دشت",10,223,4,0,216,443,2,445
"اردبیل","بیله_سوار","قشلاق_دشت",11,158,0,1,141,300,1,301
"اردبیل","بیله_سوار","قشلاق_دشت",12,263,3,4,113,383,1,384
"اردبیل","بیله_سوار","قشلاق_دشت",13,170,3,0,216,389,2,391
"اردبیل","بیله_سوار","قشلاق_دشت",14,134,0,0,119,253,1,254
"اردبیل","بیله_سوار","قشلاق_دشت",15,73,0,3,124,200,0,200
"اردبیل","بیله_سوار","قشلاق_دشت",16,115,0,0,54,169,0,169
"اردبیل","بیله_سوار","قشلاق_دشت",17,47,0,1,76,124,0,124
"اردبیل","بیله_سوار","قشلاق_دشت",18,17,0,0,108,125,0,125
"اردبیل","بیله_سوار","قشلاق_دشت",19,13,0,0,15,28,0,28
"اردبیل","بیله_سوار","قشلاق_دشت",20,23,0,0,82,105,2,107
"اردبیل","بیله_سوار","قشلاق_دشت",21,56,0,1,140,197,1,198
"اردبیل","بیله_سوار","قشلاق_دشت",22,132,1,0,120,253,0,253
"اردبیل","بیله_سوار","قشلاق_دشت",23,33,0,0,116,149,1,150
"اردبیل","بیله_سوار","قشلاق_دشت",24,67,1,0,111,179,0,179
"اردبیل","بیله_سوار","قشلاق_دشت",25,21,0,0,29,50,1,51
"اردبیل","بیله_سوار","قشلاق_دشت",26,17,0,0,48,65,0,65
"اردبیل","بیله_سوار","قشلاق_دشت",27,42,0,2,139,183,0,183
"اردبیل","بیله_سوار","قشلاق_دشت",28,34,0,0,19,53,0,53
"اردبیل","بیله_سوار","قشلاق_دشت",29,44,0,0,125,169,0,169
"اردبیل","بیله_سوار","قشلاق_دشت",30,93,0,0,100,193,0,193
"اردبیل","بیله_سوار","قشلاق_دشت",31,45,0,0,91,136,0,136
"اردبیل","بیله_سوار","قشلاق_دشت",32,165,2,0,107,274,7,281
"اردبیل","بیله_سوار","قشلاق_دشت",33,225,0,0,145,370,0,370
"اردبیل","بیله_سوار","قشلاق_دشت",34,131,0,0,120,251,2,253
"اردبیل","بیله_سوار","قشلاق_دشت",35,48,0,0,194,242,1,243
"اردبیل","بیله_سوار","قشلاق_دشت",36,90,1,0,75,166,1,167
"اردبیل","بیله_سوار","قشلاق_دشت",37,125,0,0,81,206,0,206
"اردبیل","بیله_سوار","قشلاق_دشت",38,46,0,0,41,87,3,90
"اردبیل","بیله_سوار","قشلاق_دشت",39,27,2,0,11,40,0,40
"اردبیل","بیله_سوار","قشلاق_دشت",40,31,0,0,9,40,0,40
"اردبیل","بیله_سوار","قشلاق_دشت",41,83,1,0,46,130,0,130
"اردبیل","بیله_سوار","قشلاق_دشت",42,2,0,0,19,21,0,21
"اردبیل","بیله_سوار","قشلاق_دشت",43,10,0,0,39,49,0,49
"اردبیل","بیله_سوار","قشلاق_دشت",44,130,0,0,85,215,2,217
"اردبیل","پارس_آباد","مرکزی",1,376,9,5,816,1206,4,1210
"اردبیل","پارس_آباد","مرکزی",2,130,2,0,185,317,1,318
"اردبیل","پارس_آباد","مرکزی",3,311,6,3,893,1213,6,1219
"اردبیل","پارس_آباد","مرکزی",4,211,3,1,271,486,5,491
"اردبیل","پارس_آباد","مرکزی",5,231,1,2,453,687,2,689
"اردبیل","پارس_آباد","مرکزی",6,289,2,1,391,683,3,686
"اردبیل","پارس_آباد","مرکزی",7,207,1,0,467,675,4,679
"اردبیل","پارس_آباد","مرکزی",8,52,0,0,289,341,0,341
"اردبیل","پارس_آباد","مرکزی",9,223,4,5,538,770,3,773
"اردبیل","پارس_آباد","مرکزی",10,514,4,5,695,1218,0,1218
"اردبیل","پارس_آباد","مرکزی",11,426,4,1,479,910,5,915
"اردبیل","پارس_آباد","مرکزی",12,344,1,0,485,830,2,832
"اردبیل","پارس_آباد","مرکزی",13,138,1,0,250,389,3,392
"اردبیل","پارس_آباد","مرکزی",14,121,4,3,452,580,3,583
"اردبیل","پارس_آباد","مرکزی",15,220,5,0,494,719,5,724
"اردبیل","پارس_آباد","مرکزی",16,199,9,1,472,681,7,688
"اردبیل","پارس_آباد","مرکزی",17,146,0,0,510,656,0,656
"اردبیل","پارس_آباد","مرکزی",18,207,0,2,652,861,2,863
"اردبیل","پارس_آباد","مرکزی",19,243,14,4,1063,1324,4,1328
"اردبیل","پارس_آباد","مرکزی",20,222,3,0,254,479,3,482
"اردبیل","پارس_آباد","مرکزی",21,147,1,0,164,312,1,313
"اردبیل","پارس_آباد","مرکزی",22,138,3,0,535,676,5,681
"اردبیل","پارس_آباد","مرکزی",23,294,5,4,720,1023,3,1026
"اردبیل","پارس_آباد","مرکزی",24,195,6,1,611,813,2,815
"اردبیل","پارس_آباد","مرکزی",25,300,6,0,635,941,8,949
"اردبیل","پارس_آباد","مرکزی",26,169,3,0,370,542,3,545
"اردبیل","پارس_آباد","مرکزی",27,121,0,2,257,380,2,382
"اردبیل","پارس_آباد","مرکزی",28,188,7,1,730,926,3,929
"اردبیل","پارس_آباد","مرکزی",29,164,0,0,397,561,0,561
"اردبیل","پارس_آباد","مرکزی",30,167,3,1,243,414,0,414
"اردبیل","پارس_آباد","مرکزی",31,215,2,1,330,548,8,556
"اردبیل","پارس_آباد","مرکزی",32,177,2,0,232,411,1,412
"اردبیل","پارس_آباد","مرکزی",33,217,0,0,233,450,2,452
"اردبیل","پارس_آباد","مرکزی",34,473,3,4,649,1129,7,1136
"اردبیل","پارس_آباد","مرکزی",35,371,0,2,538,911,6,917
"اردبیل","پارس_آباد","مرکزی",36,549,4,1,612,1166,5,1171
"اردبیل","پارس_آباد","مرکزی",37,212,4,1,259,476,2,478
"اردبیل","پارس_آباد","مرکزی",38,320,12,0,743,1075,15,1090
"اردبیل","پارس_آباد","مرکزی",39,151,6,2,298,457,5,462
"اردبیل","پارس_آباد","مرکزی",40,404,2,2,757,1165,8,1173
"اردبیل","پارس_آباد","مرکزی",41,213,7,2,577,799,1,800
"اردبیل","پارس_آباد","مرکزی",42,227,3,3,649,882,3,885
"اردبیل","پارس_آباد","مرکزی",43,486,3,2,545,1036,4,1040
"اردبیل","پارس_آباد","مرکزی",44,321,6,3,580,910,0,910
"اردبیل","پارس_آباد","مرکزی",45,484,2,11,640,1137,2,1139
"اردبیل","پارس_آباد","مرکزی",46,353,4,6,930,1293,9,1302
"اردبیل","پارس_آباد","مرکزی",47,368,6,5,682,1061,7,1068
"اردبیل","پارس_آباد","مرکزی",48,138,6,3,565,712,1,713
"اردبیل","پارس_آباد","مرکزی",49,268,12,2,488,770,2,772
"اردبیل","پارس_آباد","مرکزی",50,292,3,0,342,637,6,643
"اردبیل","پارس_آباد","مرکزی",51,308,7,3,432,750,1,751
"اردبیل","پارس_آباد","مرکزی",52,219,3,1,358,581,4,585
"اردبیل","پارس_آباد","مرکزی",53,213,2,1,443,659,3,662
"اردبیل","پارس_آباد","مرکزی",54,189,4,0,295,488,2,490
"اردبیل","پارس_آباد","مرکزی",55,192,2,0,145,339,2,341
"اردبیل","پارس_آباد","مرکزی",56,226,2,0,304,532,3,535
"اردبیل","پارس_آباد","مرکزی",57,80,1,0,152,233,1,234
"اردبیل","پارس_آباد","مرکزی",58,256,3,0,265,524,2,526
"اردبیل","پارس_آباد","مرکزی",59,367,0,2,412,781,5,786
"اردبیل","پارس_آباد","مرکزی",60,175,2,1,132,310,2,312
"اردبیل","پارس_آباد","مرکزی",61,45,0,0,107,152,1,153
"اردبیل","پارس_آباد","مرکزی",62,281,1,3,207,492,0,492
"اردبیل","پارس_آباد","مرکزی",63,363,3,1,830,1197,6,1203
"اردبیل","پارس_آباد","مرکزی",64,154,2,1,488,645,3,648
"اردبیل","پارس_آباد","مرکزی",65,334,5,0,598,937,2,939
"اردبیل","پارس_آباد","مرکزی",66,451,3,2,555,1011,1,1012
"اردبیل","پارس_آباد","مرکزی",67,281,0,0,329,610,0,610
"اردبیل","پارس_آباد","مرکزی",68,73,1,0,331,405,2,407
"اردبیل","پارس_آباد","مرکزی",69,140,1,0,322,463,2,465
"اردبیل","پارس_آباد","مرکزی",70,96,0,0,219,315,3,318
"اردبیل","پارس_آباد","مرکزی",71,45,1,0,60,106,0,106
"اردبیل","پارس_آباد","مرکزی",72,44,0,0,270,314,1,315
"اردبیل","پارس_آباد","مرکزی",73,15,0,0,36,51,1,52
"اردبیل","پارس_آباد","مرکزی",74,21,2,0,122,145,1,146
"اردبیل","پارس_آباد","مرکزی",75,145,3,0,658,806,0,806
"اردبیل","پارس_آباد","مرکزی",76,113,4,2,615,734,2,736
"اردبیل","پارس_آباد","مرکزی",77,119,0,1,288,408,0,408
"اردبیل","پارس_آباد","مرکزی",78,55,0,0,118,173,0,173
"اردبیل","پارس_آباد","مرکزی",79,157,1,0,335,493,0,493
"اردبیل","پارس_آباد","مرکزی",80,101,3,0,328,432,6,438
"اردبیل","پارس_آباد","مرکزی",81,96,2,2,307,407,0,407
"اردبیل","پارس_آباد","مرکزی",82,209,3,0,298,510,1,511
"اردبیل","پارس_آباد","مرکزی",83,177,1,0,709,887,5,892
"اردبیل","پارس_آباد","مرکزی",84,166,5,0,291,462,2,464
"اردبیل","پارس_آباد","مرکزی",85,88,1,0,454,543,1,544
"اردبیل","پارس_آباد","مرکزی",86,232,2,0,187,421,1,422
"اردبیل","پارس_آباد","مرکزی",87,123,0,0,233,356,1,357
"اردبیل","پارس_آباد","مرکزی",88,207,0,1,304,512,3,515
"اردبیل","پارس_آباد","مرکزی",89,278,3,0,291,572,1,573
"اردبیل","پارس_آباد","مرکزی",90,378,0,0,265,643,1,644
"اردبیل","پارس_آباد","مرکزی",91,171,2,0,355,528,0,528
"اردبیل","پارس_آباد","مرکزی",92,365,2,0,482,849,0,849
"اردبیل","پارس_آباد","مرکزی",93,113,0,0,328,441,2,443
"اردبیل","پارس_آباد","مرکزی",94,417,2,1,349,769,1,770
"اردبیل","پارس_آباد","مرکزی",95,185,3,3,418,609,3,612
"اردبیل","پارس_آباد","اسلاندوز",1,393,4,1,358,756,1,757
"اردبیل","پارس_آباد","اسلاندوز",2,260,1,0,286,547,0,547
"اردبیل","پارس_آباد","اسلاندوز",3,270,2,0,331,603,3,606
"اردبیل","پارس_آباد","اسلاندوز",4,265,0,0,204,469,1,470
"اردبیل","پارس_آباد","اسلاندوز",5,86,1,0,146,233,0,233
"اردبیل","پارس_آباد","اسلاندوز",6,256,1,0,217,474,4,478
"اردبیل","پارس_آباد","اسلاندوز",7,335,3,1,174,513,3,516
"اردبیل","پارس_آباد","اسلاندوز",8,210,0,1,82,293,1,294
"اردبیل","پارس_آباد","اسلاندوز",9,233,0,0,58,291,0,291
"اردبیل","پارس_آباد","اسلاندوز",10,81,0,0,68,149,0,149
"اردبیل","پارس_آباد","اسلاندوز",11,304,0,0,39,343,0,343
"اردبیل","پارس_آباد","اسلاندوز",12,190,0,0,63,253,2,255
"اردبیل","پارس_آباد","اسلاندوز",13,95,1,0,56,152,1,153
"اردبیل","پارس_آباد","اسلاندوز",14,262,0,0,84,346,0,346
"اردبیل","پارس_آباد","اسلاندوز",15,246,0,0,91,337,0,337
"اردبیل","پارس_آباد","اسلاندوز",16,321,2,2,114,439,0,439
"اردبیل","پارس_آباد","اسلاندوز",17,133,4,0,174,311,1,312
"اردبیل","پارس_آباد","اسلاندوز",18,71,0,0,43,114,0,114
"اردبیل","پارس_آباد","اسلاندوز",19,258,1,0,214,473,1,474
"اردبیل","پارس_آباد","اسلاندوز",20,163,0,2,194,359,0,359
"اردبیل","پارس_آباد","اسلاندوز",21,125,0,0,259,384,0,384
"اردبیل","پارس_آباد","اسلاندوز",22,274,3,0,231,508,0,508
"اردبیل","پارس_آباد","اسلاندوز",23,333,0,0,190,523,0,523
"اردبیل","پارس_آباد","اسلاندوز",24,154,0,0,149,303,0,303
"اردبیل","پارس_آباد","اسلاندوز",25,186,0,0,180,366,0,366
"اردبیل","پارس_آباد","اسلاندوز",26,265,1,1,248,515,0,515
"اردبیل","پارس_آباد","اسلاندوز",27,50,0,0,119,169,0,169
"اردبیل","پارس_آباد","اسلاندوز",28,143,0,1,388,532,5,537
"اردبیل","پارس_آباد","اسلاندوز",29,18,0,0,23,41,0,41
"اردبیل","پارس_آباد","اسلاندوز",30,16,0,0,19,35,0,35
"اردبیل","پارس_آباد","اسلاندوز",31,8,0,0,19,27,0,27
"اردبیل","پارس_آباد","اسلاندوز",32,13,0,0,37,50,0,50
"اردبیل","پارس_آباد","اسلاندوز",33,63,0,0,25,88,0,88
"اردبیل","پارس_آباد","اسلاندوز",34,43,0,0,30,73,0,73
"اردبیل","پارس_آباد","اسلاندوز",35,22,0,0,18,40,0,40
"اردبیل","پارس_آباد","تازه_کند",1,304,0,1,257,562,2,564
"اردبیل","پارس_آباد","تازه_کند",2,255,1,0,197,453,4,457
"اردبیل","پارس_آباد","تازه_کند",3,72,0,0,48,120,0,120
"اردبیل","پارس_آباد","تازه_کند",4,207,4,0,199,410,0,410
"اردبیل","پارس_آباد","تازه_کند",5,138,1,0,293,432,2,434
"اردبیل","پارس_آباد","تازه_کند",6,426,3,2,198,629,2,631
"اردبیل","پارس_آباد","تازه_کند",7,92,0,1,166,259,1,260
"اردبیل","پارس_آباد","تازه_کند",8,146,1,0,70,217,1,218
"اردبیل","پارس_آباد","تازه_کند",9,122,1,0,340,463,0,463
"اردبیل","پارس_آباد","تازه_کند",10,104,0,0,128,232,1,233
"اردبیل","پارس_آباد","تازه_کند",11,396,1,1,138,536,0,536
"اردبیل","پارس_آباد","تازه_کند",12,215,2,0,106,323,0,323
"اردبیل","پارس_آباد","تازه_کند",13,200,0,0,137,337,2,339
"اردبیل","پارس_آباد","تازه_کند",14,255,1,6,107,369,4,373
"اردبیل","پارس_آباد","تازه_کند",15,112,2,0,187,301,0,301
"اردبیل","پارس_آباد","تازه_کند",16,235,0,1,178,414,1,415
"اردبیل","پارس_آباد","تازه_کند",17,66,5,1,87,159,0,159
"اردبیل","پارس_آباد","تازه_کند",18,137,0,0,162,299,0,299
"اردبیل","پارس_آباد","تازه_کند",19,169,0,0,98,267,2,269
"اردبیل","پارس_آباد","تازه_کند",20,166,0,0,29,195,1,196
"اردبیل","پارس_آباد","تازه_کند",21,96,0,0,20,116,0,116
"اردبیل","خلخال","مرکزی",1,402,4,2,167,575,9,584
"اردبیل","خلخال","مرکزی",2,862,7,1,163,1033,10,1043
"اردبیل","خلخال","مرکزی",3,377,1,2,49,429,4,433
"اردبیل","خلخال","مرکزی",4,514,10,1,335,860,6,866
"اردبیل","خلخال","مرکزی",5,264,6,1,134,405,0,405
"اردبیل","خلخال","مرکزی",6,252,5,0,345,602,9,611
"اردبیل","خلخال","مرکزی",7,268,2,3,218,491,5,496
"اردبیل","خلخال","مرکزی",8,666,2,2,312,982,8,990
"اردبیل","خلخال","مرکزی",9,744,7,2,299,1052,13,1065
"اردبیل","خلخال","مرکزی",10,444,6,3,431,884,12,896
"اردبیل","خلخال","مرکزی",11,728,8,7,185,928,9,937
"اردبیل","خلخال","مرکزی",12,519,15,3,826,1363,9,1372
"اردبیل","خلخال","مرکزی",13,323,7,1,244,575,2,577
"اردبیل","خلخال","مرکزی",14,292,10,1,353,656,8,664
"اردبیل","خلخال","مرکزی",15,444,9,2,753,1208,12,1220
"اردبیل","خلخال","مرکزی",16,158,2,1,183,344,4,348
"اردبیل","خلخال","مرکزی",17,207,10,3,269,489,12,501
"اردبیل","خلخال","مرکزی",18,460,3,6,274,743,9,752
"اردبیل","خلخال","مرکزی",19,629,6,0,330,965,6,971
"اردبیل","خلخال","مرکزی",20,658,16,1,272,947,7,954
"اردبیل","خلخال","مرکزی",21,474,21,1,341,837,9,846
"اردبیل","خلخال","مرکزی",22,381,6,2,173,562,7,569
"اردبیل","خلخال","مرکزی",23,523,5,4,220,752,6,758
"اردبیل","خلخال","مرکزی",24,144,3,8,108,263,4,267
"اردبیل","خلخال","مرکزی",25,429,9,1,407,846,12,858
"اردبیل","خلخال","مرکزی",26,401,10,0,371,782,6,788
"اردبیل","خلخال","مرکزی",27,189,8,1,298,496,4,500
"اردبیل","خلخال","مرکزی",28,378,5,2,236,621,3,624
"اردبیل","خلخال","مرکزی",29,378,2,5,159,544,5,549
"اردبیل","خلخال","مرکزی",30,238,4,3,177,422,9,431
"اردبیل","خلخال","مرکزی",31,265,11,1,121,398,5,403
"اردبیل","خلخال","مرکزی",32,304,1,2,118,425,2,427
"اردبیل","خلخال","مرکزی",33,403,5,2,73,483,3,486
"اردبیل","خلخال","مرکزی",34,175,3,0,66,244,2,246
"اردبیل","خلخال","مرکزی",35,567,3,1,276,847,9,856
"اردبیل","خلخال","مرکزی",36,459,11,2,373,845,8,853
"اردبیل","خلخال","مرکزی",37,302,3,0,46,351,3,354
"اردبیل","خلخال","مرکزی",38,404,0,0,35,439,1,440
"اردبیل","خلخال","مرکزی",39,379,2,0,29,410,0,410
"اردبیل","خلخال","مرکزی",40,288,3,1,74,366,3,369
"اردبیل","خلخال","مرکزی",41,425,4,1,106,536,1,537
"اردبیل","خلخال","مرکزی",42,277,4,0,47,328,8,336
"اردبیل","خلخال","مرکزی",43,294,0,0,38,332,2,334
"اردبیل","خلخال","مرکزی",44,626,3,1,112,742,3,745
"اردبیل","خلخال","مرکزی",45,170,0,1,25,196,2,198
"اردبیل","خلخال","مرکزی",46,138,1,0,66,205,1,206
"اردبیل","خلخال","مرکزی",47,196,1,1,63,261,3,264
"اردبیل","خلخال","مرکزی",48,117,1,1,48,167,1,168
"اردبیل","خلخال","مرکزی",49,287,4,2,69,362,2,364
"اردبیل","خلخال","مرکزی",50,205,4,1,80,290,4,294
"اردبیل","خلخال","مرکزی",51,136,0,2,18,156,0,156
"اردبیل","خلخال","مرکزی",52,176,1,0,31,208,0,208
"اردبیل","خلخال","مرکزی",53,324,0,0,41,365,0,365
"اردبیل","خلخال","مرکزی",54,107,0,0,41,148,1,149
"اردبیل","خلخال","مرکزی",55,327,1,2,26,356,0,356
"اردبیل","خلخال","مرکزی",56,92,0,0,8,100,1,101
"اردبیل","خلخال","مرکزی",57,163,1,0,11,175,1,176
"اردبیل","خلخال","مرکزی",58,114,0,0,22,136,0,136
"اردبیل","خلخال","مرکزی",59,70,1,0,37,108,0,108
"اردبیل","خلخال","مرکزی",60,184,0,0,16,200,0,200
"اردبیل","خلخال","مرکزی",61,469,2,0,106,577,7,584
"اردبیل","خلخال","مرکزی",62,43,1,0,25,69,0,69
"اردبیل","خلخال","مرکزی",63,17,1,0,14,32,0,32
"اردبیل","خلخال","مرکزی",64,560,3,0,65,628,6,634
"اردبیل","خلخال","مرکزی",65,644,17,2,193,856,5,861
"اردبیل","خلخال","مرکزی",66,441,0,0,17,458,3,461
"اردبیل","خلخال","مرکزی",67,45,0,0,22,67,0,67
"اردبیل","خلخال","مرکزی",68,189,0,0,22,211,1,212
"اردبیل","خلخال","مرکزی",69,357,1,0,18,376,0,376
"اردبیل","خلخال","مرکزی",70,279,3,1,61,344,8,352
"اردبیل","خلخال","مرکزی",71,439,2,0,50,491,2,493
"اردبیل","خلخال","مرکزی",72,194,1,0,13,208,0,208
"اردبیل","خلخال","مرکزی",73,119,2,0,14,135,0,135
"اردبیل","خلخال","مرکزی",74,263,0,0,13,276,0,276
"اردبیل","خلخال","مرکزی",75,101,0,0,19,120,0,120
"اردبیل","خلخال","مرکزی",76,238,0,0,12,250,1,251
"اردبیل","خلخال","مرکزی",77,137,1,0,47,185,1,186
"اردبیل","خلخال","مرکزی",78,256,0,0,121,377,1,378
"اردبیل","خلخال","مرکزی",79,137,0,0,30,167,2,169
"اردبیل","خلخال","مرکزی",80,135,2,0,123,260,1,261
"اردبیل","خلخال","خورش_رستم",1,65,0,0,49,114,0,114
"اردبیل","خلخال","خورش_رستم",2,154,3,4,222,383,3,386
"اردبیل","خلخال","خورش_رستم",3,273,0,3,116,392,3,395
"اردبیل","خلخال","خورش_رستم",4,223,0,0,150,373,3,376
"اردبیل","خلخال","خورش_رستم",5,241,7,2,162,412,2,414
"اردبیل","خلخال","خورش_رستم",6,207,5,0,234,446,3,449
"اردبیل","خلخال","خورش_رستم",7,239,1,0,17,257,0,257
"اردبیل","خلخال","خورش_رستم",8,176,1,1,29,207,0,207
"اردبیل","خلخال","خورش_رستم",9,129,0,0,47,176,1,177
"اردبیل","خلخال","خورش_رستم",10,276,2,0,44,322,0,322
"اردبیل","خلخال","خورش_رستم",11,330,2,1,75,408,0,408
"اردبیل","خلخال","خورش_رستم",12,71,0,0,5,76,1,77
"اردبیل","خلخال","خورش_رستم",13,149,2,0,13,164,0,164
"اردبیل","خلخال","خورش_رستم",14,145,0,0,30,175,0,175
"اردبیل","خلخال","خورش_رستم",15,117,1,0,34,152,2,154
"اردبیل","خلخال","خورش_رستم",16,319,0,0,204,523,1,524
"اردبیل","خلخال","خورش_رستم",17,220,0,0,25,245,2,247
"اردبیل","خلخال","خورش_رستم",18,365,0,0,130,495,0,495
"اردبیل","خلخال","خورش_رستم",19,208,3,1,152,364,3,367
"اردبیل","خلخال","خورش_رستم",20,130,0,0,73,203,0,203
"اردبیل","خلخال","خورش_رستم",21,181,0,7,128,316,2,318
"اردبیل","خلخال","خورش_رستم",22,265,1,0,15,281,1,282
"اردبیل","خلخال","خورش_رستم",23,104,0,0,8,112,0,112
"اردبیل","خلخال","خورش_رستم",24,122,1,0,9,132,0,132
"اردبیل","خلخال","خورش_رستم",25,104,0,0,12,116,0,116
"اردبیل","خلخال","خورش_رستم",26,90,0,0,16,106,0,106
"اردبیل","خلخال","خورش_رستم",27,17,0,0,4,21,0,21
"اردبیل","خلخال","خورش_رستم",28,84,0,0,11,95,0,95
"اردبیل","خلخال","خورش_رستم",29,81,1,2,43,127,3,130
"اردبیل","خلخال","خورش_رستم",30,141,0,2,89,232,3,235
"اردبیل","خلخال","خورش_رستم",31,111,0,0,26,137,0,137
"اردبیل","خلخال","خورش_رستم",32,101,1,1,197,300,1,301
"اردبیل","خلخال","خورش_رستم",33,18,0,0,91,109,0,109
"اردبیل","خلخال","خورش_رستم",34,73,0,0,52,125,0,125
"اردبیل","خلخال","خورش_رستم",35,231,1,0,152,384,0,384
"اردبیل","خلخال","خورش_رستم",36,170,1,0,113,284,1,285
"اردبیل","خلخال","خورش_رستم",37,74,0,1,6,81,0,81
"اردبیل","خلخال","خورش_رستم",38,29,0,0,4,33,0,33
"اردبیل","خلخال","شاهرود",1,204,3,0,70,277,3,280
"اردبیل","خلخال","شاهرود",2,488,5,0,124,617,5,622
"اردبیل","خلخال","شاهرود",3,294,4,,162,460,6,466
"اردبیل","خلخال","شاهرود",4,256,2,0,46,304,2,306
"اردبیل","خلخال","شاهرود",5,376,0,0,30,406,1,407
"اردبیل","خلخال","شاهرود",6,280,1,1,28,310,0,310
"اردبیل","خلخال","شاهرود",7,343,0,0,59,402,3,405
"اردبیل","خلخال","شاهرود",8,149,0,1,7,157,0,157
"اردبیل","خلخال","شاهرود",9,317,2,0,80,399,0,399
"اردبیل","خلخال","شاهرود",10,221,5,0,94,320,6,326
"اردبیل","خلخال","شاهرود",11,246,5,0,62,313,4,317
"اردبیل","خلخال","شاهرود",12,227,0,0,17,244,0,244
"اردبیل","خلخال","شاهرود",13,363,1,0,68,432,0,432
"اردبیل","خلخال","شاهرود",14,193,1,0,26,220,0,220
"اردبیل","خلخال","شاهرود",15,136,1,0,18,155,1,156
"اردبیل","خلخال","شاهرود",16,463,4,0,89,556,4,560
"اردبیل","خلخال","شاهرود",17,577,2,0,62,641,2,643
"اردبیل","خلخال","شاهرود",18,244,1,0,30,275,0,275
"اردبیل","خلخال","شاهرود",19,394,2,0,14,410,2,412
"اردبیل","خلخال","شاهرود",20,154,0,0,8,162,0,162
"اردبیل","خلخال","شاهرود",21,155,0,1,8,164,0,164
"اردبیل","خلخال","شاهرود",22,221,0,0,22,243,0,243
"اردبیل","خلخال","شاهرود",23,119,0,0,10,129,0,129
"اردبیل","خلخال","شاهرود",24,147,0,0,4,151,1,152
"اردبیل","خلخال","شاهرود",25,60,0,0,16,76,9,85
"اردبیل","خلخال","شاهرود",26,78,0,0,11,89,0,89
"اردبیل","خلخال","شاهرود",27,51,0,0,10,61,0,61
"اردبیل","خلخال","شاهرود",28,184,0,0,29,213,2,215
"اردبیل","خلخال","شاهرود",29,54,0,1,29,84,0,84
"اردبیل","خلخال","شاهرود",30,48,0,2,4,54,1,55
"اردبیل","کوثر","مرکزی",1,252,6,4,380,642,10,652
"اردبیل","کوثر","مرکزی",2,194,2,11,274,481,5,486
"اردبیل","کوثر","مرکزی",3,271,8,7,342,628,3,631
"اردبیل","کوثر","مرکزی",4,145,4,9,266,424,2,426
"اردبیل","کوثر","مرکزی",5,111,2,7,152,272,5,277
"اردبیل","کوثر","مرکزی",6,296,4,8,230,538,3,541
"اردبیل","کوثر","مرکزی",7,323,0,7,143,473,1,474
"اردبیل","کوثر","مرکزی",8,255,3,3,89,350,0,350
"اردبیل","کوثر","مرکزی",9,106,1,3,94,204,3,207
"اردبیل","کوثر","مرکزی",10,162,2,1,25,190,0,190
"اردبیل","کوثر","مرکزی",11,369,1,1,63,434,2,436
"اردبیل","کوثر","مرکزی",12,108,0,1,29,138,0,138
"اردبیل","کوثر","مرکزی",13,241,2,0,31,274,0,274
"اردبیل","کوثر","مرکزی",14,302,0,0,83,385,0,385
"اردبیل","کوثر","مرکزی",15,227,0,0,30,257,0,257
"اردبیل","کوثر","مرکزی",16,247,1,0,27,275,2,277
"اردبیل","کوثر","مرکزی",17,93,0,0,46,139,0,139
"اردبیل","کوثر","مرکزی",18,194,0,1,34,229,0,229
"اردبیل","کوثر","مرکزی",19,139,1,0,47,187,0,187
"اردبیل","کوثر","مرکزی",20,134,0,0,84,218,0,218
"اردبیل","کوثر","مرکزی",21,109,0,0,23,132,0,132
"اردبیل","کوثر","مرکزی",22,137,0,0,34,171,2,173
"اردبیل","کوثر","مرکزی",23,269,0,0,36,305,2,307
"اردبیل","کوثر","مرکزی",24,227,1,0,33,261,3,264
"اردبیل","کوثر","مرکزی",25,263,1,3,13,280,2,282
"اردبیل","کوثر","مرکزی",26,128,0,0,31,159,1,160
"اردبیل","کوثر","مرکزی",27,121,0,0,17,138,0,138
"اردبیل","کوثر","مرکزی",28,294,0,0,82,376,0,376
"اردبیل","کوثر","مرکزی",29,119,2,0,122,243,0,243
"اردبیل","کوثر","مرکزی",30,152,4,0,98,254,0,254
"اردبیل","کوثر","مرکزی",31,120,1,2,68,191,1,192
"اردبیل","کوثر","مرکزی",32,88,2,2,87,179,2,181
"اردبیل","کوثر","مرکزی",33,131,0,4,14,149,0,149
"اردبیل","کوثر","مرکزی",34,129,0,0,36,165,1,166
"اردبیل","کوثر","مرکزی",35,124,0,0,20,144,0,144
"اردبیل","کوثر","مرکزی",36,313,2,0,76,391,1,392
"اردبیل","کوثر","مرکزی",37,188,1,0,26,215,0,215
"اردبیل","کوثر","مرکزی",38,166,0,0,62,228,0,228
"اردبیل","کوثر","مرکزی",39,265,0,1,47,313,1,314
"اردبیل","کوثر","مرکزی",40,103,1,2,94,200,2,202
"اردبیل","کوثر","مرکزی",41,144,0,0,20,164,0,164
"اردبیل","کوثر","مرکزی",42,264,0,0,31,295,0,295
"اردبیل","کوثر","مرکزی",43,110,0,0,57,167,0,167
"اردبیل","کوثر","مرکزی",44,68,1,0,12,81,0,81
"اردبیل","کوثر","مرکزی",45,54,0,0,9,63,0,63
"اردبیل","کوثر","مرکزی",46,178,0,0,71,249,2,251
"اردبیل","کوثر","فیروز",1,169,0,1,133,303,0,303
"اردبیل","کوثر","فیروز",2,203,1,2,125,331,0,331
"اردبیل","کوثر","فیروز",3,178,0,3,108,289,2,291
"اردبیل","کوثر","فیروز",4,132,0,0,49,181,0,181
"اردبیل","کوثر","فیروز",5,266,4,0,23,293,1,294
"اردبیل","کوثر","فیروز",6,81,0,0,43,124,0,124
"اردبیل","کوثر","فیروز",7,206,0,0,26,232,0,232
"اردبیل","کوثر","فیروز",8,151,1,1,24,177,0,177
"اردبیل","کوثر","فیروز",9,84,0,0,60,144,0,144
"اردبیل","کوثر","فیروز",10,97,2,0,16,115,0,115
"اردبیل","کوثر","فیروز",11,165,0,0,18,183,0,183
"اردبیل","کوثر","فیروز",12,237,0,0,30,267,1,268
"اردبیل","کوثر","فیروز",13,70,0,0,38,108,1,109
"اردبیل","کوثر","فیروز",14,131,0,0,30,161,0,161
"اردبیل","کوثر","فیروز",15,211,0,0,87,298,6,304
"اردبیل","کوثر","فیروز",16,53,0,0,25,78,0,78
"اردبیل","کوثر","فیروز",17,159,0,0,84,243,1,244
"اردبیل","کوثر","فیروز",18,83,1,0,75,159,1,160
"اردبیل","کوثر","فیروز",19,56,0,0,16,72,0,72
"اردبیل","کوثر","فیروز",20,60,0,0,38,98,1,99
"اردبیل","کوثر","فیروز",21,78,2,0,20,100,0,100
"اردبیل","کوثر","فیروز",22,67,0,0,47,114,0,114
"اردبیل","گرمی","مرکزی",1,291,15,1,914,1221,8,1229
"اردبیل","گرمی","مرکزی",2,263,5,4,823,1095,11,1106
"اردبیل","گرمی","مرکزی",3,134,4,3,202,343,4,347
"اردبیل","گرمی","مرکزی",4,120,6,68,529,723,2,725
"اردبیل","گرمی","مرکزی",5,250,10,1,659,920,6,926
"اردبیل","گرمی","مرکزی",6,238,3,3,491,735,1,736
"اردبیل","گرمی","مرکزی",7,192,9,3,700,904,7,911
"اردبیل","گرمی","مرکزی",8,387,15,4,531,937,0,937
"اردبیل","گرمی","مرکزی",9,263,7,3,940,1213,3,1216
"اردبیل","گرمی","مرکزی",10,275,5,2,688,970,0,970
"اردبیل","گرمی","مرکزی",11,139,10,3,400,552,0,552
"اردبیل","گرمی","مرکزی",12,147,4,0,285,436,3,439
"اردبیل","گرمی","مرکزی",13,127,3,0,245,375,3,378
"اردبیل","گرمی","مرکزی",14,106,10,5,334,455,3,458
"اردبیل","گرمی","مرکزی",15,194,4,0,475,673,9,682
"اردبیل","گرمی","مرکزی",16,240,17,1,709,967,7,974
"اردبیل","گرمی","مرکزی",17,207,6,6,536,755,0,755
"اردبیل","گرمی","مرکزی",18,114,2,4,320,440,0,440
"اردبیل","گرمی","مرکزی",19,258,9,2,861,1130,6,1136
"اردبیل","گرمی","مرکزی",20,123,2,0,445,570,2,572
"اردبیل","گرمی","مرکزی",21,161,4,0,286,451,8,459
"اردبیل","گرمی","مرکزی",22,91,3,2,98,194,1,195
"اردبیل","گرمی","مرکزی",23,216,3,0,242,461,1,462
"اردبیل","گرمی","مرکزی",24,120,0,0,185,305,0,305
"اردبیل","گرمی","مرکزی",25,110,1,1,107,219,0,219
"اردبیل","گرمی","مرکزی",26,197,2,1,199,399,1,400
"اردبیل","گرمی","مرکزی",27,276,2,1,219,498,0,498
"اردبیل","گرمی","مرکزی",28,275,0,0,187,462,0,462
"اردبیل","گرمی","مرکزی",29,332,4,4,150,490,1,491
"اردبیل","گرمی","مرکزی",30,217,0,3,136,356,0,356
"اردبیل","گرمی","مرکزی",31,126,0,0,107,233,0,233
"اردبیل","گرمی","مرکزی",32,88,2,0,26,116,1,117
"اردبیل","گرمی","مرکزی",33,129,0,0,98,227,2,229
"اردبیل","گرمی","مرکزی",34,141,1,1,138,281,0,281
"اردبیل","گرمی","مرکزی",35,129,1,2,75,207,0,207
"اردبیل","گرمی","مرکزی",36,161,3,0,110,274,0,274
"اردبیل","گرمی","مرکزی",37,61,0,0,116,177,1,178
"اردبیل","گرمی","مرکزی",38,316,2,1,90,409,1,410
"اردبیل","گرمی","مرکزی",39,256,6,1,197,460,0,460
"اردبیل","گرمی","مرکزی",40,105,0,0,44,149,0,149
"اردبیل","گرمی","مرکزی",41,150,0,0,171,321,0,321
"اردبیل","گرمی","مرکزی",42,258,0,2,105,365,0,365
"اردبیل","گرمی","مرکزی",43,117,3,5,207,332,0,332
"اردبیل","گرمی","مرکزی",44,85,1,1,112,199,0,199
"اردبیل","گرمی","مرکزی",45,246,2,0,197,445,0,445
"اردبیل","گرمی","مرکزی",46,252,1,0,104,357,2,359
"اردبیل","گرمی","مرکزی",47,151,3,0,230,384,0,384
"اردبیل","گرمی","مرکزی",48,97,0,1,153,251,3,254
"اردبیل","گرمی","مرکزی",49,163,1,2,223,389,1,390
"اردبیل","گرمی","مرکزی",50,179,3,0,171,353,0,353
"اردبیل","گرمی","مرکزی",51,138,0,0,156,294,1,295
"اردبیل","گرمی","انگوت",1,159,2,1,192,354,2,356
"اردبیل","گرمی","انگوت",2,157,2,0,185,344,0,344
"اردبیل","گرمی","انگوت",3,178,1,0,214,393,3,396
"اردبیل","گرمی","انگوت",4,129,1,7,26,163,0,163
"اردبیل","گرمی","انگوت",5,257,1,0,134,392,1,393
"اردبیل","گرمی","انگوت",6,177,,1,35,213,0,213
"اردبیل","گرمی","انگوت",7,197,0,9,26,232,1,233
"اردبیل","گرمی","انگوت",8,259,0,9,26,294,0,294
"اردبیل","گرمی","انگوت",9,119,0,3,69,191,0,191
"اردبیل","گرمی","انگوت",10,129,0,0,68,197,0,197
"اردبیل","گرمی","انگوت",11,90,1,0,43,134,1,135
"اردبیل","گرمی","انگوت",12,144,,3,69,216,0,216
"اردبیل","گرمی","انگوت",13,272,2,0,116,390,3,393
"اردبیل","گرمی","انگوت",14,209,1,2,108,320,1,321
"اردبیل","گرمی","انگوت",15,133,1,0,92,226,1,227
"اردبیل","گرمی","انگوت",16,36,0,0,97,133,0,133
"اردبیل","گرمی","انگوت",17,87,1,0,58,146,0,146
"اردبیل","گرمی","انگوت",18,116,1,0,18,135,0,135
"اردبیل","گرمی","انگوت",19,147,0,0,76,223,7,230
"اردبیل","گرمی","انگوت",20,72,1,0,36,109,0,109
"اردبیل","گرمی","انگوت",21,86,0,0,84,170,0,170
"اردبیل","گرمی","انگوت",22,214,0,0,123,337,2,339
"اردبیل","گرمی","انگوت",23,276,0,0,90,366,0,366
"اردبیل","گرمی","انگوت",24,209,1,0,101,311,1,312
"اردبیل","گرمی","انگوت",25,135,1,0,165,301,7,308
"اردبیل","گرمی","انگوت",26,178,1,0,173,352,1,353
"اردبیل","گرمی","انگوت",27,209,3,5,179,396,1,397
"اردبیل","گرمی","انگوت",28,143,0,1,73,217,1,218
"اردبیل","گرمی","انگوت",29,88,0,2,300,390,0,390
"اردبیل","گرمی","انگوت",30,141,1,0,134,276,0,276
"اردبیل","گرمی","انگوت",31,124,0,0,80,204,3,207
"اردبیل","گرمی","انگوت",32,58,1,0,349,408,3,411
"اردبیل","گرمی","انگوت",33,199,4,0,223,426,6,432
"اردبیل","گرمی","انگوت",34,258,3,2,309,572,0,572
"اردبیل","گرمی","انگوت",35,55,0,0,51,106,0,106
"اردبیل","گرمی","انگوت",36,249,1,1,195,446,0,446
"اردبیل","گرمی","انگوت",37,122,0,0,67,189,0,189
"اردبیل","گرمی","انگوت",38,57,0,0,96,153,0,153
"اردبیل","گرمی","انگوت",39,50,0,0,40,90,1,91
"اردبیل","گرمی","انگوت",40,134,2,0,142,278,0,278
"اردبیل","گرمی","انگوت",41,76,0,1,35,112,1,113
"اردبیل","گرمی","انگوت",42,106,1,0,91,198,0,198
"اردبیل","گرمی","انگوت",43,122,0,0,94,216,1,217
"اردبیل","گرمی","انگوت",44,84,0,0,57,141,0,141
"اردبیل","گرمی","انگوت",45,57,1,1,96,155,1,156
"اردبیل","گرمی","انگوت",46,128,0,0,157,285,4,289
"اردبیل","گرمی","انگوت",47,83,0,0,37,120,1,121
"اردبیل","گرمی","انگوت",48,61,1,0,41,103,3,106
"اردبیل","گرمی","انگوت",49,84,0,1,40,125,0,125
"اردبیل","گرمی","انگوت",50,143,0,0,86,229,0,229
"اردبیل","گرمی","انگوت",51,31,1,0,139,171,1,172
"اردبیل","گرمی","انگوت",52,212,3,0,131,346,2,348
"اردبیل","گرمی","انگوت",53,55,0,0,21,76,0,76
"اردبیل","گرمی","موران",1,125,2,0,137,264,2,266
"اردبیل","گرمی","موران",2,165,5,2,126,298,1,299
"اردبیل","گرمی","موران",3,129,3,0,180,312,0,312
"اردبیل","گرمی","موران",4,158,5,1,124,288,0,288
"اردبیل","گرمی","موران",5,252,4,1,184,441,0,441
"اردبیل","گرمی","موران",6,196,0,1,192,389,1,390
"اردبیل","گرمی","موران",7,136,0,0,175,311,1,312
"اردبیل","گرمی","موران",8,151,2,1,189,343,2,345
"اردبیل","گرمی","موران",9,171,0,1,50,222,1,223
"اردبیل","گرمی","موران",10,136,2,0,73,211,2,213
"اردبیل","گرمی","موران",11,150,2,0,66,218,0,218
"اردبیل","گرمی","موران",12,238,0,1,119,358,1,359
"اردبیل","گرمی","موران",13,222,1,1,151,375,0,375
"اردبیل","گرمی","موران",14,180,1,0,154,335,1,336
"اردبیل","گرمی","موران",15,51,1,0,32,84,1,85
"اردبیل","گرمی","موران",16,141,0,0,94,235,1,236
"اردبیل","گرمی","موران",17,83,7,7,165,262,1,263
"اردبیل","گرمی","موران",18,144,1,0,120,265,0,265
"اردبیل","گرمی","موران",19,140,0,0,142,282,0,282
"اردبیل","گرمی","موران",20,177,7,2,229,415,0,415
"اردبیل","گرمی","موران",21,170,2,0,77,249,2,251
"اردبیل","مشکین_شهر","مرکزی",1,475,20,2,1216,1713,14,1727
"اردبیل","مشکین_شهر","مرکزی",2,300,22,11,1175,1508,24,1532
"اردبیل","مشکین_شهر","مرکزی",3,414,10,7,960,1391,10,1401
"اردبیل","مشکین_شهر","مرکزی",4,302,11,3,902,1218,6,1224
"اردبیل","مشکین_شهر","مرکزی",5,516,10,12,1033,1571,14,1585
"اردبیل","مشکین_شهر","مرکزی",6,433,8,1,571,1013,4,1017
"اردبیل","مشکین_شهر","مرکزی",7,657,14,1,813,1485,18,1503
"اردبیل","مشکین_شهر","مرکزی",8,780,11,6,647,1444,11,1455
"اردبیل","مشکین_شهر","مرکزی",9,401,7,0,352,760,0,760
"اردبیل","مشکین_شهر","مرکزی",10,867,34,0,772,1673,16,1689
"اردبیل","مشکین_شهر","مرکزی",11,558,11,14,1167,1750,19,1769
"اردبیل","مشکین_شهر","مرکزی",12,294,9,5,684,992,9,1001
"اردبیل","مشکین_شهر","مرکزی",13,330,12,6,1256,1604,10,1614
"اردبیل","مشکین_شهر","مرکزی",14,207,15,4,684,910,8,918
"اردبیل","مشکین_شهر","مرکزی",15,158,9,5,667,839,7,846
"اردبیل","مشکین_شهر","مرکزی",16,260,12,8,1119,1399,13,1412
"اردبیل","مشکین_شهر","مرکزی",17,320,24,7,1071,1422,7,1429
"اردبیل","مشکین_شهر","مرکزی",18,313,12,6,762,1093,7,1100
"اردبیل","مشکین_شهر","مرکزی",19,597,14,2,743,1356,8,1364
"اردبیل","مشکین_شهر","مرکزی",20,598,13,4,914,1529,13,1542
"اردبیل","مشکین_شهر","مرکزی",21,475,7,4,700,1186,10,1196
"اردبیل","مشکین_شهر","مرکزی",22,276,17,7,433,733,14,747
"اردبیل","مشکین_شهر","مرکزی",23,228,15,11,1040,1294,12,1306
"اردبیل","مشکین_شهر","مرکزی",24,540,15,13,1182,1750,18,1768
"اردبیل","مشکین_شهر","مرکزی",25,198,11,5,569,783,3,786
"اردبیل","مشکین_شهر","مرکزی",26,309,5,0,319,633,3,636
"اردبیل","مشکین_شهر","مرکزی",27,165,10,3,530,708,3,711
"اردبیل","مشکین_شهر","مرکزی",28,268,4,2,282,556,4,560
"اردبیل","مشکین_شهر","مرکزی",29,249,4,2,217,472,0,472
"اردبیل","مشکین_شهر","مرکزی",30,114,1,0,315,430,2,432
"اردبیل","مشکین_شهر","مرکزی",31,140,3,0,154,297,3,300
"اردبیل","مشکین_شهر","مرکزی",32,140,0,0,106,246,2,248
"اردبیل","مشکین_شهر","مرکزی",33,114,2,1,167,284,5,289
"اردبیل","مشکین_شهر","مرکزی",34,383,25,1,356,765,7,772
"اردبیل","مشکین_شهر","مرکزی",35,614,33,1,522,1170,7,1177
"اردبیل","مشکین_شهر","مرکزی",36,541,4,0,156,701,3,704
"اردبیل","مشکین_شهر","مرکزی",37,380,5,4,404,793,7,800
"اردبیل","مشکین_شهر","مرکزی",38,239,2,2,810,1053,5,1058
"اردبیل","مشکین_شهر","مرکزی",39,704,2,0,211,917,3,920
"اردبیل","مشکین_شهر","مرکزی",40,184,1,0,266,451,1,452
"اردبیل","مشکین_شهر","مرکزی",41,159,3,1,241,404,4,408
"اردبیل","مشکین_شهر","مرکزی",42,155,0,0,476,631,2,633
"اردبیل","مشکین_شهر","مرکزی",43,60,0,0,23,83,0,83
"اردبیل","مشکین_شهر","مرکزی",44,89,0,3,61,153,1,154
"اردبیل","مشکین_شهر","مرکزی",45,288,1,0,137,426,0,426
"اردبیل","مشکین_شهر","مرکزی",46,144,3,1,64,212,1,213
"اردبیل","مشکین_شهر","مرکزی",47,99,2,0,85,186,1,187
"اردبیل","مشکین_شهر","مرکزی",48,165,3,0,117,285,1,286
"اردبیل","مشکین_شهر","مرکزی",49,182,1,2,102,287,0,287
"اردبیل","مشکین_شهر","مرکزی",50,134,0,0,41,175,0,175
"اردبیل","مشکین_شهر","مرکزی",51,686,3,0,155,844,6,850
"اردبیل","مشکین_شهر","مرکزی",52,359,12,1,443,815,5,820
"اردبیل","مشکین_شهر","مرکزی",53,219,1,2,220,442,1,443
"اردبیل","مشکین_شهر","مرکزی",54,243,0,0,81,324,0,324
"اردبیل","مشکین_شهر","مرکزی",55,207,5,0,244,456,0,456
"اردبیل","مشکین_شهر","مرکزی",56,696,1,3,158,858,3,861
"اردبیل","مشکین_شهر","مرکزی",57,408,2,1,128,539,3,542
"اردبیل","مشکین_شهر","مرکزی",58,548,8,3,167,726,1,727
"اردبیل","مشکین_شهر","مرکزی",59,702,2,5,130,839,7,846
"اردبیل","مشکین_شهر","مرکزی",60,433,6,1,158,598,2,600
"اردبیل","مشکین_شهر","مرکزی",61,402,6,2,240,650,4,654
"اردبیل","مشکین_شهر","مرکزی",62,229,1,0,103,333,1,334
"اردبیل","مشکین_شهر","مرکزی",63,200,4,0,165,369,1,370
"اردبیل","مشکین_شهر","مرکزی",64,166,0,1,23,190,1,191
"اردبیل","مشکین_شهر","مرکزی",65,592,2,3,103,700,6,706
"اردبیل","مشکین_شهر","مرکزی",66,524,10,1,260,795,5,800
"اردبیل","مشکین_شهر","مرکزی",67,809,3,0,236,1048,2,1050
"اردبیل","مشکین_شهر","مرکزی",68,608,3,1,260,872,5,877
"اردبیل","مشکین_شهر","مرکزی",69,441,4,1,175,621,4,625
"اردبیل","مشکین_شهر","مرکزی",70,510,3,1,207,721,7,728
"اردبیل","مشکین_شهر","مرکزی",71,323,0,0,39,362,0,362
"اردبیل","مشکین_شهر","مرکزی",72,505,9,1,354,869,7,876
"اردبیل","مشکین_شهر","مرکزی",73,249,5,0,178,432,3,435
"اردبیل","مشکین_شهر","مرکزی",74,127,1,0,110,238,0,238
"اردبیل","مشکین_شهر","مرکزی",75,105,0,0,31,136,0,136
"اردبیل","مشکین_شهر","مرکزی",76,340,0,0,59,399,1,400
"اردبیل","مشکین_شهر","مرکزی",77,149,1,0,29,179,0,179
"اردبیل","مشکین_شهر","مرکزی",78,88,1,1,132,222,0,222
"اردبیل","مشکین_شهر","مرکزی",79,48,1,0,44,93,0,93
"اردبیل","مشکین_شهر","مرکزی",80,55,0,0,48,103,0,103
"اردبیل","مشکین_شهر","مرکزی",81,39,0,0,112,151,0,151
"اردبیل","مشکین_شهر","مرکزی",82,112,0,0,131,243,6,249
"اردبیل","مشکین_شهر","مرکزی",83,74,1,0,78,153,0,153
"اردبیل","مشکین_شهر","ارشق",1,311,2,2,86,401,0,401
"اردبیل","مشکین_شهر","ارشق",2,388,5,3,237,633,6,639
"اردبیل","مشکین_شهر","ارشق",3,203,0,0,83,286,0,286
"اردبیل","مشکین_شهر","ارشق",4,142,0,0,43,185,1,186
"اردبیل","مشکین_شهر","ارشق",5,236,4,0,67,307,0,307
"اردبیل","مشکین_شهر","ارشق",6,102,0,0,43,145,0,145
"اردبیل","مشکین_شهر","ارشق",7,135,1,2,27,165,0,165
"اردبیل","مشکین_شهر","ارشق",8,299,1,0,73,373,3,376
"اردبیل","مشکین_شهر","ارشق",9,176,0,0,67,243,2,245
"اردبیل","مشکین_شهر","ارشق",10,252,1,1,36,290,0,290
"اردبیل","مشکین_شهر","ارشق",11,152,0,0,38,190,0,190
"اردبیل","مشکین_شهر","ارشق",12,128,3,0,18,149,0,149
"اردبیل","مشکین_شهر","ارشق",13,199,1,0,54,254,0,254
"اردبیل","مشکین_شهر","ارشق",14,323,7,1,64,395,1,396
"اردبیل","مشکین_شهر","ارشق",15,162,2,2,36,202,0,202
"اردبیل","مشکین_شهر","ارشق",16,256,1,0,26,283,3,286
"اردبیل","مشکین_شهر","ارشق",17,195,1,0,25,221,1,222
"اردبیل","مشکین_شهر","ارشق",18,169,0,0,38,207,0,207
"اردبیل","مشکین_شهر","ارشق",19,124,0,0,63,187,0,187
"اردبیل","مشکین_شهر","ارشق",20,183,1,1,37,222,0,222
"اردبیل","مشکین_شهر","ارشق",21,485,6,1,68,560,0,560
"اردبیل","مشکین_شهر","ارشق",22,299,0,0,27,326,2,328
"اردبیل","مشکین_شهر","ارشق",23,135,0,0,73,208,0,208
"اردبیل","مشکین_شهر","ارشق",24,282,3,0,89,374,3,377
"اردبیل","مشکین_شهر","مرادلو",1,106,1,0,107,214,0,214
"اردبیل","مشکین_شهر","مرادلو",2,120,0,0,90,210,0,210
"اردبیل","مشکین_شهر","مرادلو",3,131,1,0,44,176,0,176
"اردبیل","مشکین_شهر","مرادلو",4,202,0,0,25,227,0,227
"اردبیل","مشکین_شهر","مرادلو",5,232,2,0,42,276,1,277
"اردبیل","مشکین_شهر","مرادلو",6,235,1,0,56,292,0,292
"اردبیل","مشکین_شهر","مرادلو",7,361,0,2,95,458,3,461
"اردبیل","مشکین_شهر","مرادلو",8,332,1,0,41,374,1,375
"اردبیل","مشکین_شهر","مرادلو",9,193,0,0,54,247,0,247
"اردبیل","مشکین_شهر","مرادلو",10,56,2,0,6,64,0,64
"اردبیل","مشکین_شهر","مرادلو",11,173,2,1,153,329,0,329
"اردبیل","مشکین_شهر","مرادلو",12,133,0,0,77,210,1,211
"اردبیل","مشکین_شهر","مرادلو",13,253,0,1,104,358,4,362
"اردبیل","مشکین_شهر","مرادلو",14,30,0,0,76,106,0,106
"اردبیل","مشکین_شهر","مرادلو",15,30,0,0,54,84,0,84
"اردبیل","مشکین_شهر","مرادلو",16,28,0,0,36,64,0,64
"اردبیل","مشکین_شهر","مرادلو",17,160,0,0,102,262,3,265
"اردبیل","مشکین_شهر","مرادلو",18,128,0,1,151,280,3,283
"اردبیل","مشکین_شهر","مرادلو",19,226,1,1,77,305,0,305
"اردبیل","مشکین_شهر","مرادلو",20,161,0,0,88,249,1,250
"اردبیل","مشکین_شهر","مرادلو",21,148,1,0,86,235,3,238
"اردبیل","مشکین_شهر","مرادلو",22,181,0,0,38,219,2,221
"اردبیل","مشکین_شهر","مرادلو",23,186,1,0,82,269,0,269
"اردبیل","مشکین_شهر","مرادلو",24,120,5,1,28,154,2,156
"اردبیل","مشکین_شهر","مرادلو",25,307,1,1,91,400,2,402
"اردبیل","مشکین_شهر","مرادلو",26,106,2,0,87,195,1,196
"اردبیل","مشکین_شهر","مشکین_شرقی",1,211,0,0,121,332,7,339
"اردبیل","مشکین_شهر","مشکین_شرقی",2,306,1,2,226,535,2,537
"اردبیل","مشکین_شهر","مشکین_شرقی",3,286,2,0,75,363,0,363
"اردبیل","مشکین_شهر","مشکین_شرقی",4,218,6,1,251,476,5,481
"اردبیل","مشکین_شهر","مشکین_شرقی",5,394,6,1,106,507,4,511
"اردبیل","مشکین_شهر","مشکین_شرقی",6,405,2,1,77,485,3,488
"اردبیل","مشکین_شهر","مشکین_شرقی",7,311,2,1,190,504,8,512
"اردبیل","مشکین_شهر","مشکین_شرقی",8,173,6,2,245,426,7,433
"اردبیل","مشکین_شهر","مشکین_شرقی",9,337,0,0,90,427,0,427
"اردبیل","مشکین_شهر","مشکین_شرقی",10,252,1,0,52,305,0,305
"اردبیل","مشکین_شهر","مشکین_شرقی",11,230,1,3,279,513,2,515
"اردبیل","مشکین_شهر","مشکین_شرقی",12,260,3,0,136,399,3,402
"اردبیل","مشکین_شهر","مشکین_شرقی",13,188,3,0,136,327,0,327
"اردبیل","مشکین_شهر","مشکین_شرقی",14,294,2,0,66,362,0,362
"اردبیل","مشکین_شهر","مشکین_شرقی",15,433,0,0,63,496,3,499
"اردبیل","مشکین_شهر","مشکین_شرقی",16,119,4,1,115,239,5,244
"اردبیل","مشکین_شهر","مشکین_شرقی",17,271,0,0,46,317,0,317
"اردبیل","مشکین_شهر","مشکین_شرقی",18,176,2,0,11,189,1,190
"اردبیل","مشکین_شهر","مشکین_شرقی",19,401,8,1,162,572,6,578
"اردبیل","مشکین_شهر","مشکین_شرقی",20,275,10,0,142,427,5,432
"اردبیل","مشکین_شهر","مشکین_شرقی",21,391,1,0,53,445,2,447
"اردبیل","مشکین_شهر","مشکین_شرقی",22,267,4,0,201,472,6,478
"اردبیل","مشکین_شهر","مشکین_شرقی",23,244,0,0,155,399,0,399
"اردبیل","مشکین_شهر","مشکین_شرقی",24,118,0,0,31,149,6,155
"اردبیل","مشکین_شهر","مشکین_شرقی",25,86,1,0,24,111,1,112
"اردبیل","مشکین_شهر","مشکین_شرقی",26,100,1,0,14,115,0,115
"اردبیل","مشکین_شهر","مشکین_شرقی",27,153,1,1,53,208,0,208
"اردبیل","مشکین_شهر","مشکین_شرقی",28,81,0,0,40,121,1,122
"اردبیل","مشکین_شهر","مشکین_شرقی",29,87,0,0,113,200,1,201
"اردبیل","مشکین_شهر","مشکین_شرقی",30,81,0,0,64,145,0,145
"اردبیل","مشکین_شهر","مشکین_شرقی",31,62,0,0,52,114,1,115
"اردبیل","نمین","مرکزی",1,331,11,9,584,935,16,951
"اردبیل","نمین","مرکزی",2,520,16,7,788,1331,15,1346
"اردبیل","نمین","مرکزی",3,333,2,6,490,831,7,838
"اردبیل","نمین","مرکزی",4,196,1,2,319,518,3,521
"اردبیل","نمین","مرکزی",5,182,4,2,296,484,5,489
"اردبیل","نمین","مرکزی",6,319,8,7,504,838,8,846
"اردبیل","نمین","مرکزی",7,100,1,5,140,246,3,249
"اردبیل","نمین","مرکزی",8,337,6,2,304,649,3,652
"اردبیل","نمین","مرکزی",9,144,5,5,204,358,2,360
"اردبیل","نمین","مرکزی",10,133,3,2,172,310,1,311
"اردبیل","نمین","مرکزی",11,92,0,1,52,145,0,145
"اردبیل","نمین","مرکزی",12,180,5,0,98,283,1,284
"اردبیل","نمین","مرکزی",13,209,5,2,200,416,3,419
"اردبیل","نمین","مرکزی",14,238,9,3,212,462,6,468
"اردبیل","نمین","مرکزی",15,254,10,7,457,728,5,733
"اردبیل","نمین","مرکزی",16,426,7,1,203,637,1,638
"اردبیل","نمین","مرکزی",17,159,5,1,176,341,2,343
"اردبیل","نمین","مرکزی",18,287,1,6,79,373,1,374
"اردبیل","نمین","مرکزی",19,183,2,3,65,253,3,256
"اردبیل","نمین","مرکزی",20,294,5,3,150,452,1,453
"اردبیل","نمین","مرکزی",21,21,3,0,51,75,1,76
"اردبیل","نمین","مرکزی",22,178,3,0,103,284,2,286
"اردبیل","نمین","مرکزی",23,386,1,0,59,446,0,446
"اردبیل","نمین","مرکزی",24,221,3,0,39,263,0,263
"اردبیل","نمین","مرکزی",25,218,7,0,268,493,3,496
"اردبیل","نمین","مرکزی",26,361,8,0,117,486,3,489
"اردبیل","نمین","مرکزی",27,391,3,1,74,469,1,470
"اردبیل","نمین","مرکزی",28,396,5,1,131,533,9,542
"اردبیل","نمین","مرکزی",29,184,6,0,126,316,0,316
"اردبیل","نمین","مرکزی",30,180,2,0,102,284,1,285
"اردبیل","نمین","مرکزی",31,130,4,0,129,263,0,263
"اردبیل","نمین","مرکزی",32,171,2,1,95,269,3,272
"اردبیل","نمین","مرکزی",33,128,0,1,29,158,1,159
"اردبیل","نمین","مرکزی",34,80,0,0,22,102,0,102
"اردبیل","نمین","مرکزی",35,85,0,0,33,118,1,119
"اردبیل","نمین","مرکزی",36,104,0,1,54,159,0,159
"اردبیل","نمین","عنبران",1,607,0,27,402,1036,14,1050
"اردبیل","نمین","عنبران",2,480,1,11,220,712,9,721
"اردبیل","نمین","عنبران",3,334,0,8,99,441,4,445
"اردبیل","نمین","عنبران",4,156,4,3,167,330,3,333
"اردبیل","نمین","عنبران",5,337,3,0,151,491,4,495
"اردبیل","نمین","عنبران",6,80,1,0,50,131,0,131
"اردبیل","نمین","عنبران",7,328,2,2,59,391,0,391
"اردبیل","نمین","عنبران",8,347,0,0,66,413,2,415
"اردبیل","نمین","عنبران",9,435,5,2,68,510,3,513
"اردبیل","نمین","عنبران",10,175,1,3,55,234,0,234
"اردبیل","نمین","عنبران",11,159,2,18,114,293,1,294
"اردبیل","نمین","عنبران",12,234,0,7,115,356,8,364
"اردبیل","نمین","عنبران",13,123,0,0,32,155,0,155
"اردبیل","نمین","ویلکیج",1,455,14,5,425,899,13,912
"اردبیل","نمین","ویلکیج",2,588,2,1,285,876,2,878
"اردبیل","نمین","ویلکیج",3,282,5,5,249,541,6,547
"اردبیل","نمین","ویلکیج",4,237,3,3,242,485,1,486
"اردبیل","نمین","ویلکیج",5,380,3,0,163,546,0,546
"اردبیل","نمین","ویلکیج",6,540,3,0,111,654,0,654
"اردبیل","نمین","ویلکیج",7,414,6,0,201,621,6,627
"اردبیل","نمین","ویلکیج",8,415,1,1,134,551,2,553
"اردبیل","نمین","ویلکیج",9,404,4,2,484,894,6,900
"اردبیل","نمین","ویلکیج",10,421,1,0,300,722,3,725
"اردبیل","نمین","ویلکیج",11,764,4,2,200,970,2,972
"اردبیل","نمین","ویلکیج",12,869,1,1,135,1006,5,1011
"اردبیل","نمین","ویلکیج",13,357,4,1,182,544,6,550
"اردبیل","نمین","ویلکیج",14,295,1,0,220,516,5,521
"اردبیل","نمین","ویلکیج",15,396,6,3,116,521,2,523
"اردبیل","نمین","ویلکیج",16,425,0,0,69,494,1,495
"اردبیل","نمین","ویلکیج",17,469,2,1,82,554,0,554
"اردبیل","نمین","ویلکیج",18,300,0,0,92,392,1,393
"اردبیل","تیر","مرکزی",1,287,10,11,430,738,9,747
"اردبیل","تیر","مرکزی",2,105,4,6,168,283,1,284
"اردبیل","تیر","مرکزی",3,261,6,3,342,612,15,627
"اردبیل","تیر","مرکزی",4,110,1,7,104,222,3,225
"اردبیل","تیر","مرکزی",5,203,13,24,360,600,1,601
"اردبیل","تیر","مرکزی",6,325,9,7,478,819,14,833
"اردبیل","تیر","مرکزی",7,67,1,0,80,148,4,152
"اردبیل","تیر","مرکزی",8,139,0,4,98,241,7,248
"اردبیل","تیر","مرکزی",9,154,0,0,35,189,2,191
"اردبیل","تیر","مرکزی",10,149,0,2,89,240,3,243
"اردبیل","تیر","مرکزی",11,140,0,2,39,181,0,181
"اردبیل","تیر","مرکزی",12,117,0,3,62,182,1,183
"اردبیل","تیر","مرکزی",13,300,0,0,42,342,1,343
"اردبیل","تیر","مرکزی",14,164,2,2,43,211,0,211
"اردبیل","تیر","مرکزی",15,178,1,3,24,206,0,206
"اردبیل","تیر","مرکزی",16,270,1,1,44,316,0,316
"اردبیل","تیر","مرکزی",17,238,0,2,27,267,1,268
"اردبیل","تیر","مرکزی",18,209,2,3,76,290,3,293
"اردبیل","تیر","مرکزی",19,233,1,2,35,271,1,272
"اردبیل","تیر","مرکزی",20,128,0,0,25,153,1,154
"اردبیل","تیر","مرکزی",21,157,0,0,39,196,0,196
"اردبیل","تیر","مرکزی",22,310,1,1,35,347,1,348
"اردبیل","تیر","مرکزی",23,161,1,12,90,264,12,276
"اردبیل","تیر","مرکزی",24,429,0,1,52,482,4,486
"اردبیل","تیر","مرکزی",25,204,0,9,62,275,4,279
"اردبیل","تیر","مرکزی",26,160,0,0,93,253,4,257
"اردبیل","تیر","مرکزی",27,107,0,10,47,164,0,164
"اردبیل","تیر","مرکزی",28,196,0,1,23,220,0,220
"اردبیل","تیر","مرکزی",29,193,0,1,39,233,3,236
"اردبیل","تیر","مرکزی",30,334,0,3,61,398,2,400
"اردبیل","تیر","مرکزی",31,60,0,0,54,114,0,114
"اردبیل","تیر","مرکزی",32,142,0,3,53,198,0,198
"اردبیل","تیر","مرکزی",33,93,1,1,11,106,0,106
"اردبیل","تیر","مرکزی",34,145,4,1,71,221,0,221
"اردبیل","تیر","مرکزی",35,244,1,2,66,313,3,316
"اردبیل","تیر","مرکزی",36,108,2,1,74,185,1,186
"اردبیل","تیر","کورائیم",1,145,5,1,82,233,4,237
"اردبیل","تیر","کورائیم",2,189,1,2,36,228,1,229
"اردبیل","تیر","کورائیم",3,99,1,0,15,115,0,115
"اردبیل","تیر","کورائیم",4,49,0,0,19,68,0,68
"اردبیل","تیر","کورائیم",5,117,1,4,18,140,0,140
"اردبیل","تیر","کورائیم",6,76,0,2,12,90,0,90
"اردبیل","تیر","کورائیم",7,98,0,0,16,114,0,114
"اردبیل","تیر","کورائیم",8,309,10,1,89,409,2,411
"اردبیل","تیر","کورائیم",9,116,1,1,28,146,2,148
"اردبیل","تیر","کورائیم",10,89,1,0,12,102,0,102
"اردبیل","تیر","کورائیم",11,225,2,3,24,254,0,254
"اردبیل","تیر","کورائیم",12,90,0,0,34,124,5,129
"اردبیل","تیر","کورائیم",13,280,6,0,87,373,2,375
"اردبیل","تیر","کورائیم",14,223,0,1,37,261,0,261
"اردبیل","تیر","کورائیم",15,128,0,0,28,156,0,156
"اردبیل","تیر","کورائیم",16,82,1,0,13,96,0,96
"اردبیل","تیر","کورائیم",17,236,1,0,45,282,0,282
"اردبیل","تیر","کورائیم",18,131,1,5,23,160,0,160
"اردبیل","تیر","کورائیم",19,35,0,2,62,99,0,99
"اردبیل","تیر","کورائیم",20,177,0,4,24,205,0,205
"اردبیل","تیر","کورائیم",21,118,1,3,10,132,3,135
"اردبیل","تیر","کورائیم",22,30,0,0,36,66,0,66
"اردبیل","تیر","کورائیم",23,55,0,1,10,66,0,66
"اردبیل","تیر","کورائیم",24,76,0,1,20,97,0,97
"اردبیل","تیر","کورائیم",25,88,0,0,12,100,0,100
"اردبیل","تیر","کورائیم",26,46,0,0,16,62,0,62
"اصفهان","آران_و_بیدگل","مرکزی",1,341,11,5,239,596,13,609
"اصفهان","آران_و_بیدگل","مرکزی",2,626,21,9,428,1084,43,1127
"اصفهان","آران_و_بیدگل","مرکزی",3,630,20,1,194,845,25,870
"اصفهان","آران_و_بیدگل","مرکزی",4,614,17,4,562,1197,35,1232
"اصفهان","آران_و_بیدگل","مرکزی",5,527,11,4,285,827,36,863
"اصفهان","آران_و_بیدگل","مرکزی",6,1350,22,8,579,1959,41,2000
"اصفهان","آران_و_بیدگل","مرکزی",7,914,19,1,331,1265,47,1312
"اصفهان","آران_و_بیدگل","مرکزی",8,440,12,0,255,707,16,723
"اصفهان","آران_و_بیدگل","مرکزی",9,474,1,1,237,713,15,728
"اصفهان","آران_و_بیدگل","مرکزی",10,495,16,3,299,813,23,836
"اصفهان","آران_و_بیدگل","مرکزی",11,806,22,2,430,1260,34,1294
"اصفهان","آران_و_بیدگل","مرکزی",12,927,36,2,357,1322,47,1369
"اصفهان","آران_و_بیدگل","مرکزی",13,683,11,6,386,1086,35,1121
"اصفهان","آران_و_بیدگل","مرکزی",14,866,27,13,360,1266,32,1298
"اصفهان","آران_و_بیدگل","مرکزی",15,273,17,0,212,502,14,516
"اصفهان","آران_و_بیدگل","مرکزی",16,246,12,1,184,443,17,460
"اصفهان","آران_و_بیدگل","مرکزی",17,1142,13,7,277,1439,38,1477
"اصفهان","آران_و_بیدگل","مرکزی",18,977,11,6,193,1187,25,1212
"اصفهان","آران_و_بیدگل","مرکزی",19,770,11,15,125,921,25,946
"اصفهان","آران_و_بیدگل","مرکزی",20,309,7,8,124,448,12,460
"اصفهان","آران_و_بیدگل","مرکزی",21,510,7,7,216,740,20,760
"اصفهان","آران_و_بیدگل","مرکزی",22,352,3,2,126,483,9,492
"اصفهان","آران_و_بیدگل","مرکزی",23,468,17,8,153,646,16,662
"اصفهان","آران_و_بیدگل","مرکزی",24,968,22,7,395,1392,48,1440
"اصفهان","آران_و_بیدگل","مرکزی",25,606,8,5,160,779,15,794
"اصفهان","آران_و_بیدگل","مرکزی",26,770,6,0,221,997,20,1017
"اصفهان","آران_و_بیدگل","مرکزی",27,767,14,2,283,1066,22,1088
"اصفهان","آران_و_بیدگل","مرکزی",28,371,6,1,120,498,2,500
"اصفهان","آران_و_بیدگل","مرکزی",29,1262,29,8,556,1855,44,1899
"اصفهان","آران_و_بیدگل","مرکزی",30,626,29,2,161,818,15,833
"اصفهان","آران_و_بیدگل","مرکزی",31,634,38,5,311,988,37,1025
"اصفهان","آران_و_بیدگل","مرکزی",32,942,19,5,260,1226,26,1252
"اصفهان","آران_و_بیدگل","مرکزی",33,562,24,9,279,874,40,914
"اصفهان","آران_و_بیدگل","مرکزی",34,603,11,3,230,847,31,878
"اصفهان","آران_و_بیدگل","مرکزی",35,383,15,4,433,835,26,861
"اصفهان","آران_و_بیدگل","مرکزی",36,383,9,0,611,1003,20,1023
"اصفهان","آران_و_بیدگل","مرکزی",37,1000,18,5,471,1494,32,1526
"اصفهان","آران_و_بیدگل","مرکزی",38,350,12,2,696,1060,21,1081
"اصفهان","آران_و_بیدگل","مرکزی",39,343,12,58,548,961,27,988
"اصفهان","آران_و_بیدگل","مرکزی",40,242,16,1,344,603,13,616
"اصفهان","آران_و_بیدگل","مرکزی",41,544,12,2,317,875,10,885
"اصفهان","آران_و_بیدگل","مرکزی",42,397,12,2,209,620,18,638
"اصفهان","آران_و_بیدگل","مرکزی",43,395,5,5,148,553,11,564
"اصفهان","آران_و_بیدگل","مرکزی",44,461,6,0,228,695,9,704
"اصفهان","آران_و_بیدگل","مرکزی",45,401,5,0,416,822,15,837
"اصفهان","آران_و_بیدگل","مرکزی",46,399,5,0,191,595,12,607
"اصفهان","آران_و_بیدگل","مرکزی",47,321,10,1,273,605,19,624
"اصفهان","آران_و_بیدگل","مرکزی",48,183,2,2,197,384,8,392
"اصفهان","آران_و_بیدگل","مرکزی",49,592,7,1,306,906,11,917
"اصفهان","آران_و_بیدگل","مرکزی",50,500,10,0,169,679,16,695
"اصفهان","آران_و_بیدگل","مرکزی",51,167,2,5,45,219,1,220
"اصفهان","آران_و_بیدگل","مرکزی",52,378,1,1,160,540,9,549
"اصفهان","آران_و_بیدگل","مرکزی",53,180,2,0,151,333,13,346
"اصفهان","آران_و_بیدگل","کوبرات",54,1018,10,0,168,1196,6,1202
"اصفهان","آران_و_بیدگل","کوبرات",55,339,3,1,341,684,1,685
"اصفهان","آران_و_بیدگل","کوبرات",56,485,6,5,239,735,19,754
"اصفهان","آران_و_بیدگل","کوبرات",57,529,7,0,144,680,6,686
"اصفهان","آران_و_بیدگل","کوبرات",58,325,3,0,96,424,1,425
"اصفهان","آران_و_بیدگل","کوبرات",59,900,6,0,131,1037,7,1044
"اصفهان","آران_و_بیدگل","کوبرات",60,1019,16,2,152,1189,13,1202
"اصفهان","آران_و_بیدگل","کوبرات",61,1137,4,0,67,1208,1,1209
"اصفهان","آران_و_بیدگل","کوبرات",62,569,8,0,17,594,1,595
"اصفهان","آران_و_بیدگل","کوبرات",63,317,4,1,88,410,4,414
"اصفهان","آران_و_بیدگل","کوبرات",64,595,11,0,141,747,3,750
"اصفهان","اردستان","مرکزی",1,663,11,0,287,961,10,971
"اصفهان","اردستان","مرکزی",2,324,6,1,168,499,3,502
"اصفهان","اردستان","مرکزی",3,359,5,8,368,740,13,753
"اصفهان","اردستان","مرکزی",4,661,2,0,253,916,7,923
"اصفهان","اردستان","مرکزی",5,636,6,0,156,798,8,806
"اصفهان","اردستان","مرکزی",6,353,1,0,146,500,3,503
"اصفهان","اردستان","مرکزی",7,668,3,1,291,963,11,974
"اصفهان","اردستان","مرکزی",8,582,10,2,393,987,13,1000
"اصفهان","اردستان","مرکزی",9,473,5,2,159,639,10,649
"اصفهان","اردستان","مرکزی",10,703,6,4,181,894,16,910
"اصفهان","اردستان","مرکزی",11,449,8,1,197,655,10,665
"اصفهان","اردستان","مرکزی",12,438,18,0,199,655,1,656
"اصفهان","اردستان","مرکزی",13,641,2,0,104,747,6,753
"اصفهان","اردستان","مرکزی",14,367,1,0,32,400,1,401
"اصفهان","اردستان","مرکزی",15,311,2,0,56,369,2,371
"اصفهان","اردستان","مرکزی",16,688,1,0,79,768,3,771
"اصفهان","اردستان","مرکزی",17,303,3,0,79,385,2,387
"اصفهان","اردستان","مرکزی",18,583,0,0,109,692,7,699
"اصفهان","اردستان","مرکزی",19,624,4,2,129,759,4,763
"اصفهان","اردستان","مرکزی",20,468,0,0,76,544,0,544
"اصفهان","اردستان","مرکزی",21,467,0,0,111,578,2,580
"اصفهان","اردستان","مرکزی",22,357,2,1,43,403,4,407
"اصفهان","اردستان","مرکزی",23,326,1,0,85,412,0,412
"اصفهان","اردستان","مرکزی",24,176,1,0,64,241,0,241
"اصفهان","اردستان","مرکزی",25,351,1,0,57,409,2,411
"اصفهان","اردستان","مرکزی",26,840,9,2,419,1270,11,1281
"اصفهان","اردستان","مرکزی",27,486,2,1,292,781,6,787
"اصفهان","اردستان","مرکزی",28,291,6,0,154,451,4,455
"اصفهان","اردستان","مرکزی",29,352,0,0,13,365,0,365
"اصفهان","اردستان","مرکزی",30,599,8,0,101,708,3,711
"اصفهان","اردستان","مرکزی",31,736,12,1,150,899,6,905
"اصفهان","اردستان","مرکزی",32,345,1,0,48,394,2,396
"اصفهان","اردستان","مرکزی",33,600,3,0,112,715,4,719
"اصفهان","اردستان","مرکزی",34,323,3,1,93,420,0,420
"اصفهان","اردستان","زواره",1,210,8,0,91,309,6,315
"اصفهان","اردستان","زواره",2,819,17,2,315,1153,36,1189
"اصفهان","اردستان","زواره",3,244,6,0,161,411,18,429
"اصفهان","اردستان","زواره",4,668,9,1,368,1046,33,1079
"اصفهان","اردستان","زواره",5,197,3,0,90,290,6,296
"اصفهان","اردستان","زواره",6,510,7,2,140,659,7,666
"اصفهان","اردستان","زواره",7,273,8,0,52,333,3,336
"اصفهان","اردستان","زواره",8,373,8,0,112,493,15,508
"اصفهان","اردستان","زواره",9,307,6,0,146,459,13,472
"اصفهان","اردستان","زواره",10,198,3,1,126,328,1,329
"اصفهان","اردستان","زواره",11,273,3,0,190,466,4,470
"اصفهان","اردستان","زواره",12,333,7,0,181,521,2,523
"اصفهان","اردستان","زواره",13,349,3,0,37,389,2,391
"اصفهان","اردستان","زواره",14,514,0,1,79,594,4,598
"اصفهان","اردستان","زواره",15,239,1,1,43,284,1,285
"اصفهان","اردستان","زواره",16,111,2,0,44,157,2,159
"اصفهان","اردستان","زواره",17,284,1,1,48,334,5,339
"اصفهان","اردستان","زواره",18,227,1,0,30,258,0,258
"اصفهان","اردستان","زواره",19,165,1,0,47,213,2,215
"اصفهان","اردستان","زواره",20,228,7,0,54,289,2,291
"اصفهان","اصفهان","مرکزی",1,739,56,31,1285,2111,28,2139
"اصفهان","اصفهان","مرکزی",2,798,70,31,958,1857,22,1879
"اصفهان","اصفهان","مرکزی",3,534,66,22,1469,2091,19,2110
"اصفهان","اصفهان","مرکزی",4,448,68,19,1925,2460,18,2478
"اصفهان","اصفهان","مرکزی",5,718,52,15,640,1425,10,1435
"اصفهان","اصفهان","مرکزی",6,666,42,8,363,1079,19,1098
"اصفهان","اصفهان","مرکزی",7,811,54,9,751,1625,30,1655
"اصفهان","اصفهان","مرکزی",8,922,54,16,739,1731,22,1753
"اصفهان","اصفهان","مرکزی",9,935,36,8,559,1538,18,1556
"اصفهان","اصفهان","مرکزی",10,1001,66,25,1089,2181,19,2200
"اصفهان","اصفهان","مرکزی",11,1250,59,12,1089,2410,22,2432
"اصفهان","اصفهان","مرکزی",12,631,71,34,2497,3233,20,3253
"اصفهان","اصفهان","مرکزی",13,816,66,28,1079,1989,25,2014
"اصفهان","اصفهان","مرکزی",14,934,65,20,970,1989,24,2013
"اصفهان","اصفهان","مرکزی",15,1020,51,7,717,1795,28,1823
"اصفهان","اصفهان","مرکزی",16,1156,63,15,920,2154,20,2174
"اصفهان","اصفهان","مرکزی",17,1072,65,20,1279,2436,22,2458
"اصفهان","اصفهان","مرکزی",18,843,47,10,576,1476,22,1498
"اصفهان","اصفهان","مرکزی",19,1272,65,10,801,2148,28,2176
"اصفهان","اصفهان","مرکزی",20,936,53,9,496,1494,5,1499
"اصفهان","اصفهان","مرکزی",21,1213,67,15,717,2012,29,2041
"اصفهان","اصفهان","مرکزی",22,702,42,14,729,1487,25,1512
"اصفهان","اصفهان","مرکزی",23,649,47,7,322,1025,9,1034
"اصفهان","اصفهان","مرکزی",24,1034,61,3,434,1532,19,1551
"اصفهان","اصفهان","مرکزی",25,897,57,8,773,1735,22,1757
"اصفهان","اصفهان","مرکزی",26,747,28,7,306,1088,13,1101
"اصفهان","اصفهان","مرکزی",27,840,70,14,1069,1993,25,2018
"اصفهان","اصفهان","مرکزی",28,671,49,9,704,1433,22,1455
"اصفهان","اصفهان","مرکزی",29,624,39,11,357,1031,10,1041
"اصفهان","اصفهان","مرکزی",30,1039,49,8,736,1832,21,1853
"اصفهان","اصفهان","مرکزی",31,854,44,10,553,1461,20,1481
"اصفهان","اصفهان","مرکزی",32,499,29,12,526,1066,16,1082
"اصفهان","اصفهان","مرکزی",33,875,51,19,1041,1986,30,2016
"اصفهان","اصفهان","مرکزی",34,1394,64,14,673,2145,27,2172
"اصفهان","اصفهان","مرکزی",35,802,40,4,440,1286,14,1300
"اصفهان","اصفهان","مرکزی",36,1446,26,0,266,1738,10,1748
"اصفهان","اصفهان","مرکزی",37,1341,66,14,873,2294,34,2328
"اصفهان","اصفهان","مرکزی",38,1133,19,2,226,1380,10,1390
"اصفهان","اصفهان","مرکزی",39,430,3,4,117,554,4,558
"اصفهان","اصفهان","مرکزی",40,652,20,2,228,902,14,916
"اصفهان","اصفهان","مرکزی",41,259,9,0,154,422,11,433
"اصفهان","اصفهان","مرکزی",42,1193,39,13,309,1554,15,1569
"اصفهان","اصفهان","مرکزی",43,1487,46,5,517,2055,17,2072
"اصفهان","اصفهان","مرکزی",44,1310,27,10,610,1957,19,1976
"اصفهان","اصفهان","مرکزی",45,2016,27,6,470,2519,14,2533
"اصفهان","اصفهان","مرکزی",46,1353,39,10,752,2154,14,2168
"اصفهان","اصفهان","مرکزی",47,1991,30,2,295,2318,15,2333
"اصفهان","اصفهان","مرکزی",48,2069,29,8,489,2595,27,2622
"اصفهان","اصفهان","مرکزی",49,834,11,3,155,1003,9,1012
"اصفهان","اصفهان","مرکزی",50,717,13,6,808,1544,15,1559
"اصفهان","اصفهان","مرکزی",51,1148,20,6,605,1779,17,1796
"اصفهان","اصفهان","مرکزی",52,444,11,1,136,592,5,597
"اصفهان","اصفهان","مرکزی",53,716,15,8,367,1106,0,1106
"اصفهان","اصفهان","مرکزی",54,571,55,4,654,1284,13,1297
"اصفهان","اصفهان","مرکزی",55,745,38,6,395,1184,16,1200
"اصفهان","اصفهان","مرکزی",56,885,42,5,457,1389,0,1389
"اصفهان","اصفهان","مرکزی",57,670,42,1,281,994,18,1012
"اصفهان","اصفهان","مرکزی",58,717,15,1,183,916,19,935
"اصفهان","اصفهان","مرکزی",59,1078,30,4,355,1467,29,1496
"اصفهان","اصفهان","مرکزی",60,1019,39,3,436,1497,13,1510
"اصفهان","اصفهان","مرکزی",61,957,27,8,648,1640,24,1664
"اصفهان","اصفهان","مرکزی",62,449,74,23,2238,2784,16,2800
"اصفهان","اصفهان","مرکزی",63,1054,102,34,1412,2602,0,2602
"اصفهان","اصفهان","مرکزی",64,732,101,19,1110,1962,36,1998
"اصفهان","اصفهان","مرکزی",65,843,34,1,426,1304,16,1320
"اصفهان","اصفهان","مرکزی",66,1720,73,4,407,2204,20,2224
"اصفهان","اصفهان","مرکزی",67,1177,56,4,496,1733,26,1759
"اصفهان","اصفهان","مرکزی",68,947,41,9,410,1407,12,1419
"اصفهان","اصفهان","مرکزی",69,1305,35,4,434,1778,21,1799
"اصفهان","اصفهان","مرکزی",70,1076,24,1,352,1453,19,1472
"اصفهان","اصفهان","مرکزی",71,1364,32,9,309,1714,17,1731
"اصفهان","اصفهان","مرکزی",72,753,15,2,239,1009,9,1018
"اصفهان","اصفهان","مرکزی",73,1474,54,3,632,2163,34,2197
"اصفهان","اصفهان","مرکزی",74,1428,58,4,564,2054,16,2070
"اصفهان","اصفهان","مرکزی",75,755,59,32,1216,2062,21,2083
"اصفهان","اصفهان","مرکزی",76,779,47,7,801,1634,22,1656
"اصفهان","اصفهان","مرکزی",77,1298,82,10,1087,2477,17,2494
"اصفهان","اصفهان","مرکزی",78,758,62,25,1306,2151,18,2169
"اصفهان","اصفهان","مرکزی",79,1197,55,14,771,2037,25,2062
"اصفهان","اصفهان","مرکزی",80,944,52,4,605,1605,20,1625
"اصفهان","اصفهان","مرکزی",81,766,61,10,746,1583,27,1610
"اصفهان","اصفهان","مرکزی",82,869,52,8,850,1779,31,1810
"اصفهان","اصفهان","مرکزی",83,792,46,3,451,1292,9,1301
"اصفهان","اصفهان","مرکزی",84,845,75,25,1391,2336,18,2354
"اصفهان","اصفهان","مرکزی",85,1146,41,11,604,1802,29,1831
"اصفهان","اصفهان","مرکزی",86,949,104,30,1859,2942,24,2966
"اصفهان","اصفهان","مرکزی",87,942,56,11,713,1722,34,1756
"اصفهان","اصفهان","مرکزی",88,951,71,13,1092,2127,32,2159
"اصفهان","اصفهان","مرکزی",89,881,64,6,639,1590,27,1617
"اصفهان","اصفهان","مرکزی",90,1239,62,13,662,1976,24,2000
"اصفهان","اصفهان","مرکزی",91,2350,95,18,1371,3834,46,3880
"اصفهان","اصفهان","مرکزی",92,816,49,18,914,1797,26,1823
"اصفهان","اصفهان","مرکزی",93,492,40,20,908,1460,12,1472
"اصفهان","اصفهان","مرکزی",94,1094,67,9,831,2001,34,2035
"اصفهان","اصفهان","مرکزی",95,929,55,12,782,1778,22,1800
"اصفهان","اصفهان","مرکزی",96,1242,95,9,1031,2377,26,2403
"اصفهان","اصفهان","مرکزی",97,1258,39,15,766,2078,26,2104
"اصفهان","اصفهان","مرکزی",98,726,44,13,1160,1943,28,1971
"اصفهان","اصفهان","مرکزی",99,952,56,15,1271,2294,25,2319
"اصفهان","اصفهان","مرکزی",100,915,62,29,1036,2042,32,2074
"اصفهان","اصفهان","مرکزی",101,1732,75,16,798,2621,29,2650
"اصفهان","اصفهان","مرکزی",102,1048,33,9,886,1976,30,2006
"اصفهان","اصفهان","مرکزی",103,1885,44,13,957,2899,30,2929
"اصفهان","اصفهان","مرکزی",104,869,57,4,861,1791,15,1806
"اصفهان","اصفهان","مرکزی",105,1513,57,15,676,2261,31,2292
"اصفهان","اصفهان","مرکزی",106,1348,57,12,1007,2424,26,2450
"اصفهان","اصفهان","مرکزی",107,1217,59,11,1032,2319,18,2337
"اصفهان","اصفهان","مرکزی",108,673,30,5,485,1193,12,1205
"اصفهان","اصفهان","مرکزی",109,902,85,13,1061,2061,16,2077
"اصفهان","اصفهان","مرکزی",110,1273,75,24,1182,2554,27,2581
"اصفهان","اصفهان","مرکزی",111,1024,39,7,796,1866,21,1887
"اصفهان","اصفهان","مرکزی",112,1049,48,11,809,1917,29,1946
"اصفهان","اصفهان","مرکزی",113,799,52,17,1342,2210,23,2233
"اصفهان","اصفهان","مرکزی",114,1164,77,16,1430,2687,24,2711
"اصفهان","اصفهان","مرکزی",115,654,66,29,1678,2427,14,2441
"اصفهان","اصفهان","مرکزی",116,663,63,15,1221,1962,17,1979
"اصفهان","اصفهان","مرکزی",117,1682,41,12,594,2329,29,2358
"اصفهان","اصفهان","مرکزی",118,1789,28,8,501,2326,13,2339
"اصفهان","اصفهان","مرکزی",119,2211,27,3,404,2645,18,2663
"اصفهان","اصفهان","مرکزی",120,433,58,18,1441,1950,15,1965
"اصفهان","اصفهان","مرکزی",121,1167,43,17,1042,2269,15,2284
"اصفهان","اصفهان","مرکزی",122,1273,28,3,325,1629,12,1641
"اصفهان","اصفهان","مرکزی",123,894,35,11,650,1590,12,1602
"اصفهان","اصفهان","مرکزی",124,947,35,10,590,1582,49,1631
"اصفهان","اصفهان","مرکزی",125,1041,66,29,986,2122,30,2152
"اصفهان","اصفهان","مرکزی",126,583,29,20,1147,1779,17,1796
"اصفهان","اصفهان","مرکزی",127,954,92,29,2201,3276,29,3305
"اصفهان","اصفهان","مرکزی",128,737,64,18,1145,1964,35,1999
"اصفهان","اصفهان","مرکزی",129,1126,54,18,896,2094,32,2126
"اصفهان","اصفهان","مرکزی",130,2108,51,19,681,2859,34,2893
"اصفهان","اصفهان","مرکزی",131,1047,32,23,410,1512,18,1530
"اصفهان","اصفهان","مرکزی",132,636,31,12,387,1066,11,1077
"اصفهان","اصفهان","مرکزی",133,1765,36,11,685,2497,24,2521
"اصفهان","اصفهان","مرکزی",134,1156,50,14,1188,2408,26,2434
"اصفهان","اصفهان","مرکزی",135,1150,51,21,756,1978,19,1997
"اصفهان","اصفهان","مرکزی",136,1546,40,7,282,1875,11,1886
"اصفهان","اصفهان","مرکزی",137,1574,36,7,405,2022,14,2036
"اصفهان","اصفهان","مرکزی",138,1618,39,10,620,2287,19,2306
"اصفهان","اصفهان","مرکزی",139,819,34,15,1040,1908,14,1922
"اصفهان","اصفهان","مرکزی",140,891,49,20,753,1713,22,1735
"اصفهان","اصفهان","مرکزی",141,844,42,16,489,1391,8,1399
"اصفهان","اصفهان","مرکزی",142,866,41,13,852,1772,11,1783
"اصفهان","اصفهان","مرکزی",143,1040,84,25,1327,2476,13,2489
"اصفهان","اصفهان","مرکزی",144,886,84,26,1522,2518,25,2543
"اصفهان","اصفهان","مرکزی",145,1200,78,24,1476,2778,18,2796
"اصفهان","اصفهان","مرکزی",146,766,88,21,993,1868,19,1887
"اصفهان","اصفهان","مرکزی",147,2662,91,5,460,3218,15,3233
"اصفهان","اصفهان","مرکزی",148,906,37,13,673,1629,17,1646
"اصفهان","اصفهان","مرکزی",149,2107,53,9,367,2536,13,2549
"اصفهان","اصفهان","مرکزی",150,792,61,27,1128,2008,9,2017
"اصفهان","اصفهان","مرکزی",151,903,63,27,1160,2153,0,2153
"اصفهان","اصفهان","مرکزی",152,693,33,9,919,1654,15,1669
"اصفهان","اصفهان","مرکزی",153,1363,77,29,1150,2619,19,2638
"اصفهان","اصفهان","مرکزی",154,1299,70,27,1131,2527,26,2553
"اصفهان","اصفهان","مرکزی",155,767,38,10,636,1451,15,1466
"اصفهان","اصفهان","مرکزی",156,1518,56,27,1478,3079,42,3121
"اصفهان","اصفهان","مرکزی",157,779,60,35,1784,2658,18,2676
"اصفهان","اصفهان","مرکزی",158,1284,44,42,810,2180,13,2193
"اصفهان","اصفهان","مرکزی",159,753,69,33,1807,2662,16,2678
"اصفهان","اصفهان","مرکزی",160,904,28,11,442,1385,14,1399
"اصفهان","اصفهان","مرکزی",161,803,71,32,1315,2221,24,2245
"اصفهان","اصفهان","مرکزی",162,168,22,33,2038,2261,26,2287
"اصفهان","اصفهان","مرکزی",163,809,61,33,1851,2754,26,2780
"اصفهان","اصفهان","مرکزی",164,387,30,23,1442,1882,8,1890
"اصفهان","اصفهان","مرکزی",165,464,44,25,1123,1656,17,1673
"اصفهان","اصفهان","مرکزی",166,251,24,34,1794,2103,8,2111
"اصفهان","اصفهان","مرکزی",167,669,58,27,1104,1858,19,1877
"اصفهان","اصفهان","مرکزی",168,534,38,22,929,1523,27,1550
"اصفهان","اصفهان","مرکزی",169,616,43,37,1584,2280,17,2297
"اصفهان","اصفهان","مرکزی",170,746,52,41,2194,3033,20,3053
"اصفهان","اصفهان","مرکزی",171,234,28,61,2445,2768,19,2787
"اصفهان","اصفهان","مرکزی",172,417,30,61,2335,2843,0,2843
"اصفهان","اصفهان","مرکزی",173,505,43,42,1543,2133,27,2160
"اصفهان","اصفهان","مرکزی",174,566,45,29,1301,1941,12,1953
"اصفهان","اصفهان","مرکزی",175,183,27,20,1245,1475,5,1480
"اصفهان","اصفهان","مرکزی",176,791,81,73,1067,2012,56,2068
"اصفهان","اصفهان","مرکزی",177,717,94,47,1622,2480,18,2498
"اصفهان","اصفهان","مرکزی",178,862,59,45,1305,2271,19,2290
"اصفهان","اصفهان","مرکزی",179,917,66,38,1949,2970,27,2997
"اصفهان","اصفهان","مرکزی",180,665,58,26,1918,2667,21,2688
"اصفهان","اصفهان","مرکزی",181,1123,51,18,1158,2350,19,2369
"اصفهان","اصفهان","مرکزی",182,1946,104,30,1500,3580,49,3629
"اصفهان","اصفهان","مرکزی",183,695,43,12,1241,1991,21,2012
"اصفهان","اصفهان","مرکزی",184,291,35,20,1121,1467,11,1478
"اصفهان","اصفهان","مرکزی",185,867,34,4,227,1132,12,1144
"اصفهان","اصفهان","مرکزی",186,863,50,26,876,1815,20,1835
"اصفهان","اصفهان","مرکزی",187,901,27,7,346,1281,19,1300
"اصفهان","اصفهان","مرکزی",188,728,34,22,1171,1955,20,1975
"اصفهان","اصفهان","مرکزی",189,1409,50,13,566,2038,21,2059
"اصفهان","اصفهان","مرکزی",190,876,43,6,660,1585,15,1600
"اصفهان","اصفهان","مرکزی",191,1288,46,2,305,1641,11,1652
"اصفهان","اصفهان","مرکزی",192,1102,37,3,215,1357,5,1362
"اصفهان","اصفهان","مرکزی",193,1011,55,10,684,1760,16,1776
"اصفهان","اصفهان","مرکزی",194,697,64,22,1920,2703,24,2727
"اصفهان","اصفهان","مرکزی",195,263,48,28,1929,2268,13,2281
"اصفهان","اصفهان","مرکزی",196,552,49,23,1639,2263,15,2278
"اصفهان","اصفهان","مرکزی",197,593,67,33,1744,2437,13,2450
"اصفهان","اصفهان","مرکزی",198,586,24,11,355,976,7,983
"اصفهان","اصفهان","مرکزی",199,1188,92,28,1231,2539,31,2570
"اصفهان","اصفهان","مرکزی",200,425,26,9,1078,1538,20,1558
"اصفهان","اصفهان","مرکزی",201,1339,31,8,314,1692,13,1705
"اصفهان","اصفهان","مرکزی",202,539,51,43,2161,2794,20,2814
"اصفهان","اصفهان","مرکزی",203,209,23,37,1934,2203,8,2211
"اصفهان","اصفهان","مرکزی",204,346,22,45,1580,1993,16,2009
"اصفهان","اصفهان","مرکزی",205,194,36,44,1724,1998,6,2004
"اصفهان","اصفهان","مرکزی",206,376,59,41,1186,1662,8,1670
"اصفهان","اصفهان","مرکزی",207,219,40,23,1613,1895,5,1900
"اصفهان","اصفهان","مرکزی",208,389,27,14,589,1019,13,1032
"اصفهان","اصفهان","مرکزی",209,797,60,19,793,1669,15,1684
"اصفهان","اصفهان","مرکزی",210,870,47,51,1352,2320,27,2347
"اصفهان","اصفهان","مرکزی",211,987,41,10,566,1604,25,1629
"اصفهان","اصفهان","مرکزی",212,1203,46,41,1025,2315,33,2348
"اصفهان","اصفهان","مرکزی",213,982,71,34,909,1996,38,2034
"اصفهان","اصفهان","مرکزی",214,634,48,29,1370,2081,19,2100
"اصفهان","اصفهان","مرکزی",215,541,22,5,334,902,9,911
"اصفهان","اصفهان","مرکزی",216,551,27,12,491,1081,12,1093
"اصفهان","اصفهان","مرکزی",217,226,22,55,2193,2496,16,2512
"اصفهان","اصفهان","مرکزی",218,510,640,42,1644,2836,20,2856
"اصفهان","اصفهان","مرکزی",219,396,44,21,1259,1720,13,1733
"اصفهان","اصفهان","مرکزی",220,829,51,29,1013,1922,18,1940
"اصفهان","اصفهان","مرکزی",221,270,15,3,505,793,3,796
"اصفهان","اصفهان","مرکزی",222,572,31,11,679,1293,9,1302
"اصفهان","اصفهان","مرکزی",223,544,44,26,1238,1852,28,1880
"اصفهان","اصفهان","مرکزی",224,599,65,27,1342,2033,18,2051
"اصفهان","اصفهان","مرکزی",225,583,47,23,1419,2072,17,2089
"اصفهان","اصفهان","مرکزی",226,231,39,26,2152,2448,13,2461
"اصفهان","اصفهان","مرکزی",227,618,51,25,1439,2133,21,2154
"اصفهان","اصفهان","مرکزی",228,1282,17,2,199,1500,12,1512
"اصفهان","اصفهان","مرکزی",229,970,18,14,404,1406,8,1414
"اصفهان","اصفهان","مرکزی",230,1373,46,7,542,1968,32,2000
"اصفهان","اصفهان","مرکزی",231,997,39,5,483,1524,32,1556
"اصفهان","اصفهان","مرکزی",232,1232,39,4,684,1959,20,1979
"اصفهان","اصفهان","مرکزی",233,1469,35,8,647,2159,27,2186
"اصفهان","اصفهان","مرکزی",234,1243,35,7,393,1678,20,1698
"اصفهان","اصفهان","مرکزی",235,1467,28,4,301,1800,29,1829
"اصفهان","اصفهان","مرکزی",236,1149,38,27,698,1912,22,1934
"اصفهان","اصفهان","مرکزی",237,1098,40,10,430,1578,12,1590
"اصفهان","اصفهان","مرکزی",238,1814,45,5,329,2193,18,2211
"اصفهان","اصفهان","مرکزی",239,927,34,5,620,1586,11,1597
"اصفهان","اصفهان","مرکزی",240,850,23,4,327,1204,19,1223
"اصفهان","اصفهان","مرکزی",241,1368,56,23,848,2295,21,2316
"اصفهان","اصفهان","مرکزی",242,1230,59,17,1132,2438,23,2461
"اصفهان","اصفهان","مرکزی",243,1914,76,18,997,3005,44,3049
"اصفهان","اصفهان","مرکزی",244,2121,63,23,980,3187,29,3216
"اصفهان","اصفهان","مرکزی",245,2078,86,45,1610,3819,35,3854
"اصفهان","اصفهان","مرکزی",246,1114,43,22,889,2068,19,2087
"اصفهان","اصفهان","مرکزی",247,1714,52,15,476,2257,12,2269
"اصفهان","اصفهان","مرکزی",248,852,42,8,564,1466,21,1487
"اصفهان","اصفهان","مرکزی",249,1940,42,6,384,2372,23,2395
"اصفهان","اصفهان","مرکزی",250,1432,43,6,407,1888,17,1905
"اصفهان","اصفهان","مرکزی",251,1281,26,4,406,1717,16,1733
"اصفهان","اصفهان","مرکزی",252,1648,25,5,444,2122,31,2153
"اصفهان","اصفهان","مرکزی",253,1567,19,11,417,2014,14,2028
"اصفهان","اصفهان","مرکزی",254,1598,26,11,360,1995,11,2006
"اصفهان","اصفهان","مرکزی",255,1192,19,18,412,1641,27,1668
"اصفهان","اصفهان","مرکزی",256,1357,15,1,271,1644,14,1658
"اصفهان","اصفهان","مرکزی",257,1827,19,3,151,2000,14,2014
"اصفهان","اصفهان","مرکزی",258,1914,21,3,150,2088,11,2099
"اصفهان","اصفهان","مرکزی",259,2122,22,8,310,2462,8,2470
"اصفهان","اصفهان","مرکزی",260,2060,17,9,254,2340,10,2350
"اصفهان","اصفهان","مرکزی",261,1923,76,1,294,2294,20,2314
"اصفهان","اصفهان","مرکزی",262,1858,16,4,363,2241,16,2257
"اصفهان","اصفهان","مرکزی",263,1697,24,13,128,1862,6,1868
"اصفهان","اصفهان","مرکزی",264,1489,58,9,237,1793,7,1800
"اصفهان","اصفهان","مرکزی",265,1547,24,24,394,1989,11,2000
"اصفهان","اصفهان","مرکزی",266,1499,39,8,435,1981,12,1993
"اصفهان","اصفهان","مرکزی",267,1544,33,7,554,2138,13,2151
"اصفهان","اصفهان","مرکزی",268,1701,40,1,267,2009,5,2014
"اصفهان","اصفهان","مرکزی",269,1455,42,43,282,1822,12,1834
"اصفهان","اصفهان","مرکزی",270,1857,29,0,160,2046,3,2049
"اصفهان","اصفهان","مرکزی",271,2063,47,9,382,2501,25,2526
"اصفهان","اصفهان","مرکزی",272,1596,22,9,249,1876,16,1892
"اصفهان","اصفهان","مرکزی",273,1488,16,9,217,1730,6,1736
"اصفهان","اصفهان","مرکزی",274,2383,14,2,264,2663,16,2679
"اصفهان","اصفهان","مرکزی",275,728,15,2,194,939,9,948
"اصفهان","اصفهان","مرکزی",276,1921,45,4,437,2407,30,2437
"اصفهان","اصفهان","مرکزی",277,1493,38,14,731,2276,27,2303
"اصفهان","اصفهان","مرکزی",278,1507,82,13,1104,2706,30,2736
"اصفهان","اصفهان","مرکزی",279,1413,55,27,1168,2663,31,2694
"اصفهان","اصفهان","مرکزی",280,1237,44,9,933,2223,28,2251
"اصفهان","اصفهان","مرکزی",281,1716,32,15,486,2249,18,2267
"اصفهان","اصفهان","مرکزی",282,1683,19,5,181,1888,12,1900
"اصفهان","اصفهان","مرکزی",283,1764,36,9,334,2143,21,2164
"اصفهان","اصفهان","مرکزی",284,1018,19,2,413,1452,13,1465
"اصفهان","اصفهان","مرکزی",285,1517,32,14,590,2153,29,2182
"اصفهان","اصفهان","مرکزی",286,1553,71,20,868,2512,38,2550
"اصفهان","اصفهان","مرکزی",287,1281,65,10,666,2022,25,2047
"اصفهان","اصفهان","مرکزی",288,1195,50,24,832,2101,22,2123
"اصفهان","اصفهان","مرکزی",289,1287,64,18,1081,2450,24,2474
"اصفهان","اصفهان","مرکزی",290,2019,68,13,880,2980,25,3005
"اصفهان","اصفهان","مرکزی",291,1031,66,59,2043,3199,28,3227
"اصفهان","اصفهان","مرکزی",292,1440,72,19,943,2474,31,2505
"اصفهان","اصفهان","مرکزی",293,875,64,17,1335,2291,17,2308
"اصفهان","اصفهان","مرکزی",294,1340,82,30,1694,3146,25,3171
"اصفهان","اصفهان","مرکزی",295,1658,91,16,881,2646,29,2675
"اصفهان","اصفهان","مرکزی",296,1475,22,16,455,1968,18,1986
"اصفهان","اصفهان","مرکزی",297,1847,87,29,1325,3288,28,3316
"اصفهان","اصفهان","مرکزی",298,1191,61,21,780,2053,26,2079
"اصفهان","اصفهان","مرکزی",299,1578,40,13,595,2226,18,2244
"اصفهان","اصفهان","مرکزی",300,1587,54,13,892,2546,28,2574
"اصفهان","اصفهان","مرکزی",301,2429,54,16,855,3354,27,3381
"اصفهان","اصفهان","مرکزی",302,1382,85,24,1672,3163,37,3200
"اصفهان","اصفهان","مرکزی",303,1196,59,15,908,2178,22,2200
"اصفهان","اصفهان","مرکزی",304,1592,25,11,358,1986,14,2000
"اصفهان","اصفهان","مرکزی",305,1938,38,1,316,2293,10,2303
"اصفهان","اصفهان","مرکزی",306,1802,32,13,759,2606,17,2623
"اصفهان","اصفهان","مرکزی",307,2436,52,6,689,3183,22,3205
"اصفهان","اصفهان","مرکزی",308,1607,26,5,411,2049,21,2070
"اصفهان","اصفهان","مرکزی",309,1617,33,18,700,2368,26,2394
"اصفهان","اصفهان","مرکزی",310,1491,27,6,473,1997,14,2011
"اصفهان","اصفهان","مرکزی",311,2024,74,25,1128,3251,15,3266
"اصفهان","اصفهان","مرکزی",312,2593,57,20,923,3593,35,3628
"اصفهان","اصفهان","مرکزی",313,2161,14,6,211,2392,5,2397
"اصفهان","اصفهان","مرکزی",314,1551,17,4,290,1862,7,1869
"اصفهان","اصفهان","مرکزی",315,2255,27,9,568,2859,24,2883
"اصفهان","اصفهان","مرکزی",316,1732,59,9,535,2335,9,2344
"اصفهان","اصفهان","مرکزی",317,984,32,19,813,1848,21,1869
"اصفهان","اصفهان","مرکزی",318,1084,19,12,735,1850,15,1865
"اصفهان","اصفهان","مرکزی",319,1499,37,11,500,2047,18,2065
"اصفهان","اصفهان","مرکزی",320,1136,56,11,934,2137,11,2148
"اصفهان","اصفهان","مرکزی",321,711,54,45,1826,2636,18,2654
"اصفهان","اصفهان","مرکزی",322,412,53,32,1506,2003,18,2021
"اصفهان","اصفهان","مرکزی",323,395,44,43,1760,2242,13,2255
"اصفهان","اصفهان","مرکزی",324,1330,99,50,1933,3412,32,3444
"اصفهان","اصفهان","مرکزی",325,385,43,28,1744,2200,12,2212
"اصفهان","اصفهان","مرکزی",326,1215,71,25,1483,2794,31,2825
"اصفهان","اصفهان","مرکزی",327,1050,56,19,760,1885,13,1898
"اصفهان","اصفهان","مرکزی",328,2820,5,1,128,2954,5,2959
"اصفهان","اصفهان","مرکزی",329,890,60,15,957,1922,19,1941
"اصفهان","اصفهان","مرکزی",330,1418,67,41,2289,3815,25,3840
"اصفهان","اصفهان","مرکزی",331,1753,61,15,1044,2873,21,2894
"اصفهان","اصفهان","مرکزی",332,1811,97,27,1436,3371,28,3399
"اصفهان","اصفهان","مرکزی",333,998,49,34,1700,2781,25,2806
"اصفهان","اصفهان","مرکزی",334,2125,83,34,1495,3737,36,3773
"اصفهان","اصفهان","مرکزی",335,1738,43,13,567,2361,12,2373
"اصفهان","اصفهان","مرکزی",336,2216,30,29,354,2629,11,2640
"اصفهان","اصفهان","مرکزی",337,1860,44,38,470,2412,11,2423
"اصفهان","اصفهان","مرکزی",338,870,49,8,930,1857,20,1877
"اصفهان","اصفهان","مرکزی",339,861,20,1,203,1085,9,1094
"اصفهان","اصفهان","مرکزی",340,1197,23,7,334,1561,15,1576
"اصفهان","اصفهان","مرکزی",341,2165,32,1,247,2445,16,2461
"اصفهان","اصفهان","مرکزی",342,685,8,2,255,950,10,960
"اصفهان","اصفهان","مرکزی",343,1192,32,10,434,1668,21,1689
"اصفهان","اصفهان","مرکزی",344,1485,29,1,294,1809,16,1825
"اصفهان","اصفهان","مرکزی",345,1026,27,0,116,1169,9,1178
"اصفهان","اصفهان","مرکزی",346,1634,10,4,146,1794,7,1801
"اصفهان","اصفهان","مرکزی",347,692,23,4,312,1031,18,1049
"اصفهان","اصفهان","مرکزی",348,1485,29,1,294,1809,16,1825
"اصفهان","اصفهان","مرکزی",349,890,49,4,519,1462,17,1479
"اصفهان","اصفهان","مرکزی",350,1152,36,13,660,1861,20,1881
"اصفهان","اصفهان","مرکزی",351,1653,29,2,284,1968,16,1984
"اصفهان","اصفهان","مرکزی",352,1196,36,5,557,1794,24,1818
"اصفهان","اصفهان","مرکزی",353,1309,28,4,384,1725,21,1746
"اصفهان","اصفهان","مرکزی",354,1669,16,6,272,1963,19,1982
"اصفهان","اصفهان","مرکزی",355,1335,38,7,678,2058,21,2079
"اصفهان","اصفهان","مرکزی",356,1538,26,9,548,2121,18,2139
"اصفهان","اصفهان","مرکزی",357,1281,15,7,634,1937,22,1959
"اصفهان","اصفهان","مرکزی",358,1185,33,4,433,1655,14,1669
"اصفهان","اصفهان","مرکزی",359,1769,32,4,368,2173,16,2189
"اصفهان","اصفهان","مرکزی",360,1507,32,4,436,1979,22,2001
"اصفهان","اصفهان","مرکزی",361,527,19,0,163,709,4,713
"اصفهان","اصفهان","مرکزی",362,643,20,9,291,963,0,963
"اصفهان","اصفهان","مرکزی",363,671,19,4,404,1098,11,1109
"اصفهان","اصفهان","مرکزی",364,952,39,17,750,1758,16,1774
"اصفهان","اصفهان","مرکزی",365,1558,24,4,359,1945,17,1962
"اصفهان","اصفهان","مرکزی",366,865,30,3,239,1137,8,1145
"اصفهان","اصفهان","مرکزی",367,1451,38,12,504,2005,25,2030
"اصفهان","اصفهان","مرکزی",368,2162,29,8,295,2494,24,2518
"اصفهان","اصفهان","مرکزی",369,1739,34,6,567,2346,18,2364
"اصفهان","اصفهان","مرکزی",370,1697,25,3,235,1960,16,1976
"اصفهان","اصفهان","مرکزی",371,1623,22,3,412,2060,25,2085
"اصفهان","اصفهان","مرکزی",372,1705,21,2,402,2130,23,2153
"اصفهان","اصفهان","مرکزی",373,1957,40,9,448,2454,25,2479
"اصفهان","اصفهان","مرکزی",374,1657,25,3,308,1993,21,2014
"اصفهان","اصفهان","مرکزی",375,1658,30,7,371,2066,14,2080
"اصفهان","اصفهان","مرکزی",376,1116,32,5,400,1553,24,1577
"اصفهان","اصفهان","مرکزی",377,2329,48,8,526,2911,29,2940
"اصفهان","اصفهان","مرکزی",378,2538,29,11,379,2957,29,2986
"اصفهان","اصفهان","مرکزی",379,1533,41,13,486,2073,26,2099
"اصفهان","اصفهان","مرکزی",380,1201,14,5,227,1447,16,1463
"اصفهان","اصفهان","مرکزی",381,1758,15,10,175,1958,9,1967
"اصفهان","اصفهان","مرکزی",382,1817,15,2,288,2122,6,2128
"اصفهان","اصفهان","مرکزی",383,1840,13,5,291,2149,11,2160
"اصفهان","اصفهان","مرکزی",384,1754,18,3,326,2101,12,2113
"اصفهان","اصفهان","مرکزی",385,967,69,2,507,1545,18,1563
"اصفهان","اصفهان","مرکزی",386,767,54,3,1052,1876,24,1900
"اصفهان","اصفهان","مرکزی",387,1305,28,10,681,2024,9,2033
"اصفهان","اصفهان","مرکزی",388,973,53,6,637,1669,24,1693
"اصفهان","اصفهان","مرکزی",389,1396,48,6,382,1832,15,1847
"اصفهان","اصفهان","مرکزی",390,1044,37,6,582,1669,30,1699
"اصفهان","اصفهان","مرکزی",391,1020,41,12,851,1924,21,1945
"اصفهان","اصفهان","مرکزی",392,1290,31,15,617,1953,21,1974
"اصفهان","اصفهان","مرکزی",393,2252,104,12,1164,3532,37,3569
"اصفهان","اصفهان","مرکزی",394,1355,47,5,590,1997,13,2010
"اصفهان","اصفهان","مرکزی",395,959,42,12,868,1881,12,1893
"اصفهان","اصفهان","مرکزی",396,1990,80,17,1229,3316,43,3359
"اصفهان","اصفهان","مرکزی",397,963,38,2,255,1258,42,1300
"اصفهان","اصفهان","مرکزی",398,1018,33,6,484,1541,24,1565
"اصفهان","اصفهان","مرکزی",399,1130,35,4,577,1746,21,1767
"اصفهان","اصفهان","مرکزی",400,1503,32,7,319,1861,14,1875
"اصفهان","اصفهان","مرکزی",401,1418,53,11,819,2301,38,2339
"اصفهان","اصفهان","مرکزی",402,1032,27,2,564,1625,15,1640
"اصفهان","اصفهان","مرکزی",403,844,62,23,859,1788,15,1803
"اصفهان","اصفهان","مرکزی",404,1174,61,2,733,1970,32,2002
"اصفهان","اصفهان","مرکزی",405,587,47,14,1114,1762,12,1774
"اصفهان","اصفهان","مرکزی",406,370,32,7,739,1148,8,1156
"اصفهان","اصفهان","مرکزی",407,957,52,8,627,1644,11,1655
"اصفهان","اصفهان","مرکزی",408,878,52,16,881,1827,19,1846
"اصفهان","اصفهان","مرکزی",409,2041,78,13,1023,3155,42,3197
"اصفهان","اصفهان","مرکزی",410,1590,84,22,878,2574,36,2610
"اصفهان","اصفهان","مرکزی",411,1041,58,8,856,1963,22,1985
"اصفهان","اصفهان","مرکزی",412,2057,12,3,183,2255,7,2262
"اصفهان","اصفهان","مرکزی",413,2000,23,7,705,2735,22,2757
"اصفهان","اصفهان","مرکزی",414,669,9,4,393,1075,9,1084
"اصفهان","اصفهان","مرکزی",415,1275,21,5,496,1797,17,1814
"اصفهان","اصفهان","مرکزی",416,721,13,1,435,1170,12,1182
"اصفهان","اصفهان","مرکزی",417,1501,30,20,1031,2582,25,2607
"اصفهان","اصفهان","مرکزی",418,1212,27,16,537,1792,17,1809
"اصفهان","اصفهان","مرکزی",419,1570,34,5,608,2217,14,2231
"اصفهان","اصفهان","مرکزی",420,1663,51,8,497,2219,17,2236
"اصفهان","اصفهان","مرکزی",421,757,15,2,338,1112,15,1127
"اصفهان","اصفهان","مرکزی",422,977,21,9,492,1499,4,1503
"اصفهان","اصفهان","مرکزی",423,1202,13,0,308,1523,14,1537
"اصفهان","اصفهان","مرکزی",424,819,13,1,332,1165,8,1173
"اصفهان","اصفهان","مرکزی",425,1474,37,8,595,2114,30,2144
"اصفهان","اصفهان","مرکزی",426,1393,16,9,318,1736,7,1743
"اصفهان","اصفهان","مرکزی",427,1414,31,6,894,2345,13,2358
"اصفهان","اصفهان","مرکزی",428,1034,34,5,617,1690,19,1709
"اصفهان","اصفهان","مرکزی",429,430,18,7,204,659,6,665
"اصفهان","اصفهان","مرکزی",430,613,25,1,232,871,17,888
"اصفهان","اصفهان","مرکزی",431,262,18,3,190,473,5,478
"اصفهان","اصفهان","مرکزی",432,816,23,1,164,1004,12,1016
"اصفهان","اصفهان","مرکزی",433,951,22,2,332,1307,18,1325
"اصفهان","اصفهان","مرکزی",434,369,11,1,91,472,2,474
"اصفهان","اصفهان","مرکزی",435,232,10,5,131,378,3,381
"اصفهان","اصفهان","مرکزی",436,482,18,3,242,745,11,756
"اصفهان","اصفهان","مرکزی",437,631,17,7,223,878,8,886
"اصفهان","اصفهان","مرکزی",438,427,13,9,171,620,3,623
"اصفهان","اصفهان","مرکزی",439,680,30,7,367,1084,15,1099
"اصفهان","اصفهان","مرکزی",440,807,18,7,133,965,6,971
"اصفهان","اصفهان","مرکزی",441,869,28,16,486,1399,17,1416
"اصفهان","اصفهان","مرکزی",442,882,18,6,432,1338,13,1351
"اصفهان","اصفهان","مرکزی",443,606,17,9,412,1044,6,1050
"اصفهان","اصفهان","مرکزی",444,1309,57,11,817,2194,19,2213
"اصفهان","اصفهان","مرکزی",445,1469,61,9,735,2274,28,2302
"اصفهان","اصفهان","مرکزی",446,1904,31,7,391,2333,34,2367
"اصفهان","اصفهان","مرکزی",447,1917,35,8,527,2487,18,2505
"اصفهان","اصفهان","مرکزی",448,1823,17,2,352,2194,12,2206
"اصفهان","اصفهان","مرکزی",449,2122,25,5,366,2518,16,2534
"اصفهان","اصفهان","مرکزی",450,857,34,3,462,1356,15,1371
"اصفهان","اصفهان","مرکزی",451,1730,28,1,349,2108,16,2124
"اصفهان","اصفهان","مرکزی",452,2071,22,1,222,2316,11,2327
"اصفهان","اصفهان","مرکزی",453,1468,4,2,127,1601,6,1607
"اصفهان","اصفهان","مرکزی",454,1461,35,3,437,1936,18,1954
"اصفهان","اصفهان","مرکزی",455,1705,22,1,306,2034,18,2052
"اصفهان","اصفهان","مرکزی",456,1443,15,3,278,1739,9,1748
"اصفهان","اصفهان","مرکزی",457,1879,28,5,521,2433,17,2450
"اصفهان","اصفهان","مرکزی",458,1555,27,1,300,1883,19,1902
"اصفهان","اصفهان","مرکزی",459,1365,17,2,174,1558,14,1572
"اصفهان","اصفهان","مرکزی",460,1761,9,3,201,1974,14,1988
"اصفهان","اصفهان","مرکزی",461,1387,21,3,479,1890,12,1902
"اصفهان","اصفهان","مرکزی",462,1383,5,2,169,1559,10,1569
"اصفهان","اصفهان","مرکزی",463,1790,31,5,377,2203,19,2222
"اصفهان","اصفهان","مرکزی",464,1318,12,1,124,1455,15,1470
"اصفهان","اصفهان","مرکزی",465,1613,30,4,370,2017,27,2044
"اصفهان","اصفهان","مرکزی",466,1129,22,11,570,1732,9,1741
"اصفهان","اصفهان","مرکزی",467,1398,17,4,356,1775,22,1797
"اصفهان","اصفهان","مرکزی",468,1335,19,0,229,1583,4,1587
"اصفهان","اصفهان","مرکزی",469,1071,13,0,168,1252,9,1261
"اصفهان","اصفهان","مرکزی",470,1191,12,3,185,1391,9,1400
"اصفهان","اصفهان","مرکزی",471,1166,11,0,197,1374,6,1380
"اصفهان","اصفهان","مرکزی",472,1110,2,0,75,1187,0,1187
"اصفهان","اصفهان","مرکزی",473,912,5,2,173,1092,4,1096
"اصفهان","اصفهان","مرکزی",474,849,11,0,157,1017,4,1021
"اصفهان","اصفهان","مرکزی",475,1385,42,17,479,1923,41,1964
"اصفهان","اصفهان","مرکزی",476,831,58,14,329,1232,31,1263
"اصفهان","اصفهان","مرکزی",477,1239,39,10,468,1756,15,1771
"اصفهان","اصفهان","مرکزی",478,754,24,7,349,1134,10,1144
"اصفهان","اصفهان","مرکزی",479,1236,7,1,176,1420,6,1426
"اصفهان","اصفهان","مرکزی",480,1042,12,1,219,1274,11,1285
"اصفهان","اصفهان","مرکزی",481,1148,13,0,315,1476,14,1490
"اصفهان","اصفهان","مرکزی",482,836,3,1,156,996,7,1003
"اصفهان","اصفهان","مرکزی",483,827,1,1,44,873,4,877
"اصفهان","اصفهان","مرکزی",484,600,2,0,130,732,8,740
"اصفهان","اصفهان","مرکزی",485,1520,4,0,116,1640,6,1646
"اصفهان","اصفهان","مرکزی",486,1011,91,32,1422,2556,21,2577
"اصفهان","اصفهان","مرکزی",487,1212,71,26,1163,2472,12,2484
"اصفهان","اصفهان","مرکزی",488,1019,50,23,889,1981,27,2008
"اصفهان","اصفهان","مرکزی",489,818,50,20,952,1840,28,1868
"اصفهان","اصفهان","مرکزی",490,1303,95,39,1339,2776,18,2794
"اصفهان","اصفهان","مرکزی",491,891,65,25,880,1861,29,1890
"اصفهان","اصفهان","مرکزی",492,984,69,26,1070,2149,20,2169
"اصفهان","اصفهان","مرکزی",493,710,49,29,910,1698,11,1709
"اصفهان","اصفهان","مرکزی",494,1357,65,16,738,2176,32,2208
"اصفهان","اصفهان","مرکزی",495,1127,45,29,745,1946,9,1955
"اصفهان","اصفهان","مرکزی",496,1021,59,14,541,1635,13,1648
"اصفهان","اصفهان","مرکزی",497,1188,61,24,1127,2400,32,2432
"اصفهان","اصفهان","مرکزی",498,1473,6,0,155,1634,5,1639
"اصفهان","اصفهان","مرکزی",499,1088,5,0,116,1209,6,1215
"اصفهان","اصفهان","مرکزی",500,1403,15,0,154,1572,4,1576
"اصفهان","اصفهان","مرکزی",501,529,5,0,168,702,5,707
"اصفهان","اصفهان","مرکزی",502,613,2,0,49,664,2,666
"اصفهان","اصفهان","مرکزی",503,797,3,0,77,877,4,881
"اصفهان","اصفهان","مرکزی",504,1014,2,1,47,1064,3,1067
"اصفهان","اصفهان","مرکزی",505,862,4,0,62,928,5,933
"اصفهان","اصفهان","مرکزی",506,954,7,3,136,1100,3,1103
"اصفهان","اصفهان","مرکزی",507,959,10,0,83,1052,2,1054
"اصفهان","اصفهان","مرکزی",508,1329,5,0,221,1555,3,1558
"اصفهان","اصفهان","مرکزی",509,721,5,1,93,820,1,821
"اصفهان","اصفهان","مرکزی",510,1151,4,5,136,1296,4,1300
"اصفهان","اصفهان","مرکزی",511,949,5,0,116,1070,6,1076
"اصفهان","اصفهان","مرکزی",512,734,9,16,508,1267,7,1274
"اصفهان","اصفهان","مرکزی",513,890,4,0,67,961,7,968
"اصفهان","اصفهان","مرکزی",514,1068,11,0,94,1173,1,1174
"اصفهان","اصفهان","مرکزی",515,820,4,0,111,935,3,938
"اصفهان","اصفهان","مرکزی",516,1267,14,50,237,1568,11,1579
"اصفهان","اصفهان","مرکزی",517,1044,11,7,200,1262,9,1271
"اصفهان","اصفهان","مرکزی",518,781,50,16,778,1625,21,1646
"اصفهان","اصفهان","مرکزی",519,320,21,9,519,869,9,878
"اصفهان","اصفهان","مرکزی",520,1460,20,11,441,1932,16,1948
"اصفهان","اصفهان","مرکزی",521,1087,14,2,125,1228,4,1232
"اصفهان","اصفهان","مرکزی",522,733,28,2,505,1268,4,1272
"اصفهان","اصفهان","مرکزی",523,1606,27,8,445,2086,11,2097
"اصفهان","اصفهان","مرکزی",524,1297,12,3,257,1569,7,1576
"اصفهان","اصفهان","مرکزی",525,527,4,0,47,578,3,581
"اصفهان","اصفهان","مرکزی",526,224,2,0,67,293,2,295
"اصفهان","اصفهان","مرکزی",527,663,2,0,44,709,3,712
"اصفهان","اصفهان","مرکزی",528,472,1,0,64,537,3,540
"اصفهان","اصفهان","مرکزی",529,946,2,1,112,1061,5,1066
"اصفهان","اصفهان","مرکزی",530,904,11,8,172,1095,9,1104
"اصفهان","اصفهان","مرکزی",531,623,1,0,24,648,5,653
"اصفهان","اصفهان","مرکزی",532,521,1,0,50,572,0,572
"اصفهان","اصفهان","بن_رود",1,971,22,1,366,1360,0,1360
"اصفهان","اصفهان","بن_رود",2,651,9,3,724,1387,0,1387
"اصفهان","اصفهان","بن_رود",3,615,10,0,186,811,0,811
"اصفهان","اصفهان","بن_رود",4,871,22,0,501,1394,0,1394
"اصفهان","اصفهان","بن_رود",5,924,13,1,280,1218,0,1218
"اصفهان","اصفهان","بن_رود",6,430,11,5,233,679,1,680
"اصفهان","اصفهان","بن_رود",7,710,8,2,138,858,0,858
"اصفهان","اصفهان","بن_رود",8,556,6,0,150,712,0,712
"اصفهان","اصفهان","بن_رود",9,626,5,0,109,740,0,740
"اصفهان","اصفهان","بن_رود",10,445,2,0,12,459,0,459
"اصفهان","اصفهان","بن_رود",11,694,2,0,45,741,0,741
"اصفهان","اصفهان","بن_رود",12,845,5,1,28,879,0,879
"اصفهان","اصفهان","بن_رود",13,566,11,1,72,650,0,650
"اصفهان","اصفهان","بن_رود",14,611,2,1,36,650,0,650
"اصفهان","اصفهان","بن_رود",15,577,0,0,14,591,0,591
"اصفهان","اصفهان","بن_رود",16,560,2,0,16,578,0,578
"اصفهان","اصفهان","بن_رود",17,800,1,0,15,816,0,816
"اصفهان","اصفهان","بن_رود",18,723,2,0,24,749,0,749
"اصفهان","اصفهان","بن_رود",19,788,19,1,228,1036,0,1036
"اصفهان","اصفهان","بن_رود",20,537,3,0,24,564,0,564
"اصفهان","اصفهان","جلگه",21,689,11,1,186,887,0,887
"اصفهان","اصفهان","جلگه",22,472,9,1,69,551,0,551
"اصفهان","اصفهان","جلگه",23,597,4,0,201,802,0,802
"اصفهان","اصفهان","جلگه",24,778,7,3,242,1030,0,1030
"اصفهان","اصفهان","جلگه",25,404,3,0,109,516,0,516
"اصفهان","اصفهان","جلگه",26,440,2,0,144,586,0,586
"اصفهان","اصفهان","جلگه",27,495,11,1,291,798,0,798
"اصفهان","اصفهان","جلگه",28,672,10,1,311,994,0,994
"اصفهان","اصفهان","جلگه",29,572,4,0,220,796,0,796
"اصفهان","اصفهان","جلگه",30,757,4,0,42,803,0,803
"اصفهان","اصفهان","جلگه",31,776,6,1,35,818,0,818
"اصفهان","اصفهان","جلگه",32,851,5,0,116,972,0,972
"اصفهان","اصفهان","جلگه",33,941,0,0,32,973,0,973
"اصفهان","اصفهان","جلگه",34,545,0,0,24,569,0,569
"اصفهان","اصفهان","جلگه",35,377,6,0,28,411,0,411
"اصفهان","اصفهان","جلگه",36,446,1,0,20,467,0,467
"اصفهان","اصفهان","جلگه",37,306,1,1,19,327,0,327
"اصفهان","اصفهان","جلگه",38,452,1,0,38,491,0,491
"اصفهان","اصفهان","جلگه",39,383,6,0,46,435,0,435
"اصفهان","اصفهان","جلگه",40,216,3,0,22,241,0,241
"اصفهان","اصفهان","جرقوبه_سفلی",1,342,8,1,474,825,0,825
"اصفهان","اصفهان","جرقوبه_سفلی",2,456,10,1,255,722,0,722
"اصفهان","اصفهان","جرقوبه_سفلی",3,397,10,1,889,1297,0,1297
"اصفهان","اصفهان","جرقوبه_سفلی",4,963,16,1,197,1177,0,1177
"اصفهان","اصفهان","جرقوبه_سفلی",5,791,19,2,104,916,0,916
"اصفهان","اصفهان","جرقوبه_سفلی",6,436,12,0,90,538,0,538
"اصفهان","اصفهان","جرقوبه_سفلی",7,681,7,3,130,821,0,821
"اصفهان","اصفهان","جرقوبه_سفلی",8,763,7,0,70,840,0,840
"اصفهان","اصفهان","جرقوبه_سفلی",9,581,9,1,281,872,0,872
"اصفهان","اصفهان","جرقوبه_سفلی",10,1033,10,7,130,1180,0,1180
"اصفهان","اصفهان","جرقوبه_سفلی",11,926,4,3,45,978,0,978
"اصفهان","اصفهان","جرقوبه_سفلی",12,579,8,2,233,822,0,822
"اصفهان","اصفهان","جرقوبه_سفلی",13,587,7,1,77,672,0,672
"اصفهان","اصفهان","جرقوبه_سفلی",14,411,3,0,76,490,0,490
"اصفهان","اصفهان","جرقوبه_سفلی",15,766,5,0,52,823,0,823
"اصفهان","اصفهان","جرقوبه_سفلی",16,254,4,1,23,282,0,282
"اصفهان","اصفهان","جرقوبه_سفلی",17,29,1,0,20,50,0,50
"اصفهان","اصفهان","جرقوبه_علیا",1,543,3,0,144,690,0,690
"اصفهان","اصفهان","جرقوبه_علیا",2,476,3,0,202,681,0,681
"اصفهان","اصفهان","جرقوبه_علیا",3,281,6,1,113,401,0,401
"اصفهان","اصفهان","جرقوبه_علیا",4,344,5,2,209,560,0,560
"اصفهان","اصفهان","جرقوبه_علیا",5,352,7,0,192,551,0,551
"اصفهان","اصفهان","جرقوبه_علیا",6,143,3,0,79,225,0,225
"اصفهان","اصفهان","جرقوبه_علیا",7,591,11,1,51,654,0,654
"اصفهان","اصفهان","جرقوبه_علیا",8,563,8,0,39,610,0,610
"اصفهان","اصفهان","جرقوبه_علیا",9,775,6,1,63,845,0,845
"اصفهان","اصفهان","جرقوبه_علیا",10,236,3,0,15,254,0,254
"اصفهان","اصفهان","جرقوبه_علیا",11,620,1,0,43,664,0,664
"اصفهان","اصفهان","جرقوبه_علیا",12,670,2,3,44,719,0,719
"اصفهان","اصفهان","جرقوبه_علیا",13,803,8,2,402,1215,0,1215
"اصفهان","اصفهان","جرقوبه_علیا",14,482,4,2,217,705,0,705
"اصفهان","اصفهان","جرقوبه_علیا",15,484,3,0,53,540,0,540
"اصفهان","اصفهان","جرقوبه_علیا",16,356,1,1,25,383,0,383
"اصفهان","اصفهان","جرقوبه_علیا",17,636,2,0,66,704,0,704
"اصفهان","اصفهان","جرقوبه_علیا",18,52,0,0,8,60,0,60
"اصفهان","اصفهان","کوهپایه",1,913,11,6,129,1059,0,1059
"اصفهان","اصفهان","کوهپایه",2,953,4,2,88,1047,0,1047
"اصفهان","اصفهان","کوهپایه",3,897,3,0,85,985,0,985
"اصفهان","اصفهان","کوهپایه",4,499,3,0,34,536,0,536
"اصفهان","اصفهان","کوهپایه",5,710,2,0,36,748,0,748
"اصفهان","اصفهان","کوهپایه",6,952,4,1,149,1106,0,1106
"اصفهان","اصفهان","کوهپایه",7,545,3,0,53,601,0,601
"اصفهان","اصفهان","کوهپایه",8,768,15,2,273,1058,0,1058
"اصفهان","اصفهان","کوهپایه",9,783,26,2,362,1173,0,1173
"اصفهان","اصفهان","کوهپایه",10,275,6,1,44,326,0,326
"اصفهان","اصفهان","کوهپایه",11,460,14,0,147,621,0,621
"اصفهان","اصفهان","کوهپایه",12,747,4,0,138,889,0,889
"اصفهان","اصفهان","کوهپایه",13,480,1,0,110,591,0,591
"اصفهان","اصفهان","کوهپایه",14,642,11,0,112,765,0,765
"اصفهان","اصفهان","کوهپایه",15,646,4,1,114,765,0,765
"اصفهان","اصفهان","کوهپایه",16,548,7,0,207,762,0,762
"اصفهان","اصفهان","کوهپایه",17,591,5,0,135,731,0,731
"اصفهان","اصفهان","کوهپایه",18,706,7,1,250,964,0,964
"اصفهان","اصفهان","کوهپایه",19,592,17,0,134,743,0,743
"اصفهان","اصفهان","کوهپایه",20,559,7,0,52,618,0,618
"اصفهان","اصفهان","کوهپایه",21,495,18,4,244,761,0,761
"اصفهان","اصفهان","کوهپایه",22,282,5,3,84,374,0,374
"اصفهان","اصفهان","کوهپایه",23,702,3,0,156,861,0,861
"اصفهان","برخوار","مرکزی",1,779,13,1,165,958,24,982
"اصفهان","برخوار","مرکزی",2,1167,4,2,61,1234,12,1246
"اصفهان","برخوار","مرکزی",3,739,2,0,81,822,3,825
"اصفهان","برخوار","مرکزی",4,1029,2,1,134,1166,12,1178
"اصفهان","برخوار","مرکزی",5,301,0,1,35,337,2,339
"اصفهان","برخوار","مرکزی",6,768,4,1,104,877,3,880
"اصفهان","برخوار","مرکزی",7,287,3,0,31,321,4,325
"اصفهان","برخوار","مرکزی",8,1149,12,9,349,1519,17,1536
"اصفهان","برخوار","مرکزی",9,487,1,0,91,579,1,580
"اصفهان","برخوار","مرکزی",10,819,15,0,260,1094,8,1102
"اصفهان","برخوار","مرکزی",11,1156,7,5,176,1344,11,1355
"اصفهان","برخوار","مرکزی",12,1060,9,2,90,1161,17,1178
"اصفهان","برخوار","مرکزی",13,960,6,2,100,1068,13,1081
"اصفهان","برخوار","مرکزی",14,792,6,3,101,902,9,911
"اصفهان","برخوار","مرکزی",15,840,15,2,251,1108,19,1127
"اصفهان","برخوار","مرکزی",16,1094,9,2,201,1306,5,1311
"اصفهان","برخوار","مرکزی",17,695,12,0,160,867,4,871
"اصفهان","برخوار","مرکزی",18,819,15,3,459,1296,19,1315
"اصفهان","برخوار","مرکزی",19,1069,12,2,233,1316,7,1323
"اصفهان","برخوار","مرکزی",20,1151,12,3,133,1299,11,1310
"اصفهان","برخوار","مرکزی",21,787,7,0,55,849,2,851
"اصفهان","برخوار","مرکزی",22,1024,10,1,234,1269,8,1277
"اصفهان","برخوار","مرکزی",23,1272,12,0,115,1399,10,1409
"اصفهان","برخوار","مرکزی",24,1373,16,4,192,1585,8,1593
"اصفهان","برخوار","مرکزی",25,1230,5,2,134,1371,5,1376
"اصفهان","برخوار","مرکزی",26,1111,8,3,118,1240,5,1245
"اصفهان","برخوار","مرکزی",27,1506,18,5,189,1718,8,1726
"اصفهان","برخوار","مرکزی",28,449,3,0,88,540,4,544
"اصفهان","برخوار","مرکزی",29,1609,13,0,95,1717,5,1722
"اصفهان","برخوار","مرکزی",30,1268,3,1,60,1332,4,1336
"اصفهان","برخوار","مرکزی",31,1517,9,0,78,1604,6,1610
"اصفهان","برخوار","مرکزی",32,1137,12,4,250,1403,13,1416
"اصفهان","برخوار","مرکزی",33,1814,22,11,431,2278,21,2299
"اصفهان","برخوار","مرکزی",34,1293,28,13,253,1587,13,1600
"اصفهان","برخوار","مرکزی",35,966,5,8,154,1133,12,1145
"اصفهان","برخوار","مرکزی",36,871,6,0,118,995,7,1002
"اصفهان","برخوار","مرکزی",37,947,11,4,225,1187,11,1198
"اصفهان","برخوار","مرکزی",38,689,20,2,282,993,10,1003
"اصفهان","برخوار","مرکزی",39,1108,16,4,118,1246,8,1254
"اصفهان","برخوار","مرکزی",40,208,0,1,38,247,4,251
"اصفهان","برخوار","حبیب_آباد",1,1068,19,0,252,1339,10,1349
"اصفهان","برخوار","حبیب_آباد",2,856,11,2,101,970,6,976
"اصفهان","برخوار","حبیب_آباد",3,898,11,0,120,1029,4,1033
"اصفهان","برخوار","حبیب_آباد",4,288,7,0,111,406,7,413
"اصفهان","برخوار","حبیب_آباد",5,505,5,0,87,597,2,599
"اصفهان","برخوار","حبیب_آباد",6,605,5,1,192,803,11,814
"اصفهان","برخوار","حبیب_آباد",7,948,9,0,119,1076,4,1080
"اصفهان","برخوار","حبیب_آباد",8,725,0,0,43,768,1,769
"اصفهان","برخوار","حبیب_آباد",9,1311,24,7,170,1512,5,1517
"اصفهان","برخوار","حبیب_آباد",10,1145,29,5,265,1444,18,1462
"اصفهان","برخوار","حبیب_آباد",11,1264,3,1,57,1325,5,1330
"اصفهان","برخوار","حبیب_آباد",12,1145,8,3,83,1239,9,1248
"اصفهان","برخوار","حبیب_آباد",13,694,1,0,30,725,5,730
"اصفهان","برخوار","حبیب_آباد",14,537,1,0,27,565,5,570
"اصفهان","تیران_و_کرون","مرکزی",1,1100,32,5,491,1628,22,1650
"اصفهان","تیران_و_کرون","مرکزی",2,801,16,3,545,1365,15,1380
"اصفهان","تیران_و_کرون","مرکزی",3,602,11,4,295,912,8,920
"اصفهان","تیران_و_کرون","مرکزی",4,636,26,2,317,981,24,1005
"اصفهان","تیران_و_کرون","مرکزی",5,766,4,2,278,1050,5,1055
"اصفهان","تیران_و_کرون","مرکزی",6,847,11,4,174,1036,11,1047
"اصفهان","تیران_و_کرون","مرکزی",7,660,11,2,231,904,8,912
"اصفهان","تیران_و_کرون","مرکزی",8,782,24,5,350,1161,16,1177
"اصفهان","تیران_و_کرون","مرکزی",9,762,10,2,321,1095,5,1100
"اصفهان","تیران_و_کرون","مرکزی",10,531,2,0,71,604,4,608
"اصفهان","تیران_و_کرون","مرکزی",11,485,1,0,36,522,2,524
"اصفهان","تیران_و_کرون","مرکزی",12,394,0,19,322,735,3,738
"اصفهان","تیران_و_کرون","مرکزی",13,585,15,2,260,862,4,866
"اصفهان","تیران_و_کرون","مرکزی",14,917,8,4,181,1110,7,1117
"اصفهان","تیران_و_کرون","مرکزی",15,212,12,0,96,320,2,322
"اصفهان","تیران_و_کرون","مرکزی",16,145,3,0,33,181,4,185
"اصفهان","تیران_و_کرون","مرکزی",17,858,3,2,91,954,8,962
"اصفهان","تیران_و_کرون","مرکزی",18,569,5,1,92,667,5,672
"اصفهان","تیران_و_کرون","مرکزی",19,195,4,0,62,261,3,264
"اصفهان","تیران_و_کرون","مرکزی",20,1049,8,0,123,1180,12,1192
"اصفهان","تیران_و_کرون","مرکزی",21,875,5,0,58,938,12,950
"اصفهان","تیران_و_کرون","مرکزی",22,758,22,0,106,886,10,896
"اصفهان","تیران_و_کرون","مرکزی",23,422,2,0,26,450,1,451
"اصفهان","تیران_و_کرون","مرکزی",24,482,0,2,55,539,4,543
"اصفهان","تیران_و_کرون","مرکزی",25,892,7,3,73,975,4,979
"اصفهان","تیران_و_کرون","مرکزی",26,1030,1,0,65,1096,3,1099
"اصفهان","تیران_و_کرون","مرکزی",27,595,1,0,33,629,1,630
"اصفهان","تیران_و_کرون","مرکزی",28,217,1,0,34,252,8,260
"اصفهان","تیران_و_کرون","مرکزی",29,247,3,0,58,308,2,310
"اصفهان","تیران_و_کرون","مرکزی",30,266,0,3,24,293,1,294
"اصفهان","تیران_و_کرون","کرون",1,743,3,0,85,831,5,836
"اصفهان","تیران_و_کرون","کرون",2,948,6,1,75,1030,3,1033
"اصفهان","تیران_و_کرون","کرون",3,864,1,1,88,954,3,957
"اصفهان","تیران_و_کرون","کرون",4,523,2,0,23,548,4,552
"اصفهان","تیران_و_کرون","کرون",5,986,4,1,88,1079,6,1085
"اصفهان","تیران_و_کرون","کرون",6,541,12,0,97,650,11,661
"اصفهان","تیران_و_کرون","کرون",7,958,1,0,30,989,2,991
"اصفهان","تیران_و_کرون","کرون",8,239,0,0,17,256,0,256
"اصفهان","تیران_و_کرون","کرون",9,532,0,1,33,566,0,566
"اصفهان","تیران_و_کرون","کرون",10,437,9,0,44,490,3,493
"اصفهان","تیران_و_کرون","کرون",11,905,3,1,42,951,1,952
"اصفهان","تیران_و_کرون","کرون",12,710,0,1,50,761,4,765
"اصفهان","تیران_و_کرون","کرون",13,809,2,3,27,841,5,846
"اصفهان","تیران_و_کرون","کرون",14,500,2,0,25,527,2,529
"اصفهان","تیران_و_کرون","کرون",15,735,4,2,95,836,8,844
"اصفهان","تیران_و_کرون","کرون",16,455,6,0,33,494,6,500
"اصفهان","تیران_و_کرون","کرون",17,567,5,0,65,637,6,643
"اصفهان","تیران_و_کرون","کرون",18,531,0,1,30,562,0,562
"اصفهان","تیران_و_کرون","کرون",19,668,1,0,22,691,2,693
"اصفهان","تیران_و_کرون","کرون",20,661,7,0,201,869,3,872
"اصفهان","تیران_و_کرون","کرون",21,1137,6,0,72,1215,1,1216
"اصفهان","تیران_و_کرون","کرون",22,486,2,0,77,565,1,566
"اصفهان","تیران_و_کرون","کرون",23,487,3,2,79,571,0,571
"اصفهان","تیران_و_کرون","کرون",24,250,2,1,24,277,2,279
"اصفهان","تیران_و_کرون","کرون",25,628,0,0,63,691,2,693
"اصفهان","تیران_و_کرون","کرون",26,920,5,0,37,962,2,964
"اصفهان","تیران_و_کرون","کرون",27,835,1,0,49,885,5,890
"اصفهان","تیران_و_کرون","کرون",28,628,3,0,25,656,2,658
"اصفهان","تیران_و_کرون","کرون",29,715,0,0,41,756,1,757
"اصفهان","تیران_و_کرون","کرون",30,756,9,1,50,816,1,817
"اصفهان","تیران_و_کرون","کرون",31,520,2,1,40,563,4,567
"اصفهان","تیران_و_کرون","کرون",32,279,5,0,47,331,7,338
"اصفهان","چادگان","چادگان",1,997,8,12,535,1552,12,1564
"اصفهان","چادگان","چادگان",2,976,37,7,530,1550,7,1557
"اصفهان","چادگان","چادگان",3,574,4,4,282,864,3,867
"اصفهان","چادگان","چادگان",4,469,3,1,90,563,2,565
"اصفهان","چادگان","چادگان",5,664,2,0,140,806,0,806
"اصفهان","چادگان","چادگان",6,529,9,3,502,1043,5,1048
"اصفهان","چادگان","چادگان",7,175,3,0,47,225,3,228
"اصفهان","چادگان","چادگان",8,183,1,0,45,229,3,232
"اصفهان","چادگان","چادگان",9,728,33,11,720,1492,18,1510
"اصفهان","چادگان","چادگان",10,706,2,0,80,788,1,789
"اصفهان","چادگان","چادگان",11,396,2,0,50,448,3,451
"اصفهان","چادگان","چادگان",12,808,4,1,115,928,2,930
"اصفهان","چادگان","چادگان",13,619,3,1,66,689,1,690
"اصفهان","چادگان","چادگان",14,287,1,0,23,311,1,312
"اصفهان","چادگان","چادگان",15,490,2,1,10,503,0,503
"اصفهان","چادگان","چادگان",16,1158,2,2,37,1199,1,1200
"اصفهان","چادگان","چادگان",17,502,4,1,80,587,2,589
"اصفهان","چادگان","چادگان",18,229,0,0,23,252,2,254
"اصفهان","چادگان","چادگان",19,626,2,0,17,645,1,646
"اصفهان","چادگان","چادگان",20,533,1,0,52,586,1,587
"اصفهان","چادگان","چادگان",21,229,1,0,53,283,2,285
"اصفهان","چادگان","چادگان",22,344,1,4,104,453,3,456
"اصفهان","چادگان","چادگان",23,218,2,0,84,304,2,306
"اصفهان","چادگان","چادگان",24,392,0,0,22,414,4,418
"اصفهان","چادگان","چادگان",25,363,1,0,6,370,1,371
"اصفهان","چادگان","چادگان",26,782,0,0,54,836,2,838
"اصفهان","چادگان","چادگان",27,407,0,1,28,436,0,436
"اصفهان","چادگان","چادگان",28,495,1,0,98,594,1,595
"اصفهان","چادگان","چادگان",29,243,0,0,3,246,0,246
"اصفهان","چادگان","چادگان",30,849,5,0,214,1068,4,1072
"اصفهان","چادگان","چادگان",31,620,3,0,46,669,0,669
"اصفهان","چادگان","چنارود",32,342,12,2,11,367,1,368
"اصفهان","چادگان","چنارود",33,200,17,1,8,226,0,226
"اصفهان","چادگان","چنارود",34,255,6,0,48,309,0,309
"اصفهان","چادگان","چنارود",35,186,17,1,8,212,1,213
"اصفهان","چادگان","چنارود",36,235,11,0,29,275,0,275
"اصفهان","چادگان","چنارود",37,477,3,3,185,668,1,669
"اصفهان","چادگان","چنارود",38,271,11,5,30,317,3,320
"اصفهان","چادگان","چنارود",39,137,6,2,14,159,0,159
"اصفهان","چادگان","چنارود",40,249,30,0,28,307,0,307
"اصفهان","چادگان","چنارود",41,263,8,1,10,282,1,283
"اصفهان","چادگان","چنارود",42,537,42,3,90,672,3,675
"اصفهان","چادگان","چنارود",43,240,38,21,19,318,2,320
"اصفهان","چادگان","چنارود",44,400,26,9,18,453,1,454
"اصفهان","چادگان","چنارود",45,304,7,1,3,315,1,316
"اصفهان","چادگان","چنارود",46,252,15,9,6,282,1,283
"اصفهان","خمینی_شهر","مرکزی",1,797,25,6,343,1171,9,1180
"اصفهان","خمینی_شهر","مرکزی",2,358,4,1,225,588,5,593
"اصفهان","خمینی_شهر","مرکزی",3,608,11,4,263,886,8,894
"اصفهان","خمینی_شهر","مرکزی",4,407,24,3,285,719,17,736
"اصفهان","خمینی_شهر","مرکزی",5,564,21,2,263,850,12,862
"اصفهان","خمینی_شهر","مرکزی",6,729,14,1,247,991,9,1000
"اصفهان","خمینی_شهر","مرکزی",7,485,9,3,163,660,11,671
"اصفهان","خمینی_شهر","مرکزی",8,507,25,2,480,1014,18,1032
"اصفهان","خمینی_شهر","مرکزی",9,534,9,3,225,771,10,781
"اصفهان","خمینی_شهر","مرکزی",10,536,11,3,254,804,6,810
"اصفهان","خمینی_شهر","مرکزی",11,607,24,2,558,1191,16,1207
"اصفهان","خمینی_شهر","مرکزی",12,883,19,5,472,1379,19,1398
"اصفهان","خمینی_شهر","مرکزی",13,643,30,3,326,1002,8,1010
"اصفهان","خمینی_شهر","مرکزی",14,1201,35,6,392,1634,30,1664
"اصفهان","خمینی_شهر","مرکزی",15,774,25,10,404,1213,9,1222
"اصفهان","خمینی_شهر","مرکزی",16,1031,35,23,369,1458,14,1472
"اصفهان","خمینی_شهر","مرکزی",17,790,20,14,213,1037,18,1055
"اصفهان","خمینی_شهر","مرکزی",18,970,143,65,237,1415,21,1436
"اصفهان","خمینی_شهر","مرکزی",19,739,31,7,353,1130,11,1141
"اصفهان","خمینی_شهر","مرکزی",20,1274,45,7,585,1911,19,1930
"اصفهان","خمینی_شهر","مرکزی",21,1313,30,14,377,1734,26,1760
"اصفهان","خمینی_شهر","مرکزی",22,1071,72,23,538,1704,16,1720
"اصفهان","خمینی_شهر","مرکزی",23,552,12,23,167,754,11,765
"اصفهان","خمینی_شهر","مرکزی",24,312,11,5,148,476,7,483
"اصفهان","خمینی_شهر","مرکزی",25,789,38,16,342,1185,13,1198
"اصفهان","خمینی_شهر","مرکزی",26,523,18,5,367,913,22,935
"اصفهان","خمینی_شهر","مرکزی",27,869,38,2,586,1495,24,1519
"اصفهان","خمینی_شهر","مرکزی",28,1033,56,10,874,1973,25,1998
"اصفهان","خمینی_شهر","مرکزی",29,602,21,1,534,1158,17,1175
"اصفهان","خمینی_شهر","مرکزی",30,552,96,101,796,1545,23,1568
"اصفهان","خمینی_شهر","مرکزی",31,352,79,143,1050,1624,20,1644
"اصفهان","خمینی_شهر","مرکزی",32,834,22,8,228,1092,9,1101
"اصفهان","خمینی_شهر","مرکزی",33,727,4,3,115,849,10,859
"اصفهان","خمینی_شهر","مرکزی",34,776,15,3,209,1003,21,1024
"اصفهان","خمینی_شهر","مرکزی",35,370,6,1,125,502,8,510
"اصفهان","خمینی_شهر","مرکزی",36,1175,22,4,232,1433,20,1453
"اصفهان","خمینی_شهر","مرکزی",37,1111,11,0,161,1283,17,1300
"اصفهان","خمینی_شهر","مرکزی",38,1009,24,4,173,1210,10,1220
"اصفهان","خمینی_شهر","مرکزی",39,654,8,0,127,789,14,803
"اصفهان","خمینی_شهر","مرکزی",40,1185,46,1,541,1773,26,1799
"اصفهان","خمینی_شهر","مرکزی",41,926,20,3,290,1239,13,1252
"اصفهان","خمینی_شهر","مرکزی",42,1151,17,1,162,1331,18,1349
"اصفهان","خمینی_شهر","مرکزی",43,503,4,0,112,619,12,631
"اصفهان","خمینی_شهر","مرکزی",44,449,12,2,99,562,9,571
"اصفهان","خمینی_شهر","مرکزی",45,942,9,2,231,1184,14,1198
"اصفهان","خمینی_شهر","مرکزی",46,1183,12,2,158,1355,9,1364
"اصفهان","خمینی_شهر","مرکزی",47,1182,10,1,247,1440,19,1459
"اصفهان","خمینی_شهر","مرکزی",48,1165,12,5,70,1252,10,1262
"اصفهان","خمینی_شهر","مرکزی",49,1196,21,1,183,1401,14,1415
"اصفهان","خمینی_شهر","مرکزی",50,1166,12,0,41,1219,9,1228
"اصفهان","خمینی_شهر","مرکزی",51,1257,7,1,69,1334,13,1347
"اصفهان","خمینی_شهر","مرکزی",52,1088,24,1,104,1217,7,1224
"اصفهان","خمینی_شهر","مرکزی",53,586,6,2,127,721,11,732
"اصفهان","خمینی_شهر","مرکزی",54,1314,13,0,82,1409,9,1418
"اصفهان","خمینی_شهر","مرکزی",55,861,16,3,126,1006,5,1011
"اصفهان","خمینی_شهر","مرکزی",56,1216,25,1,168,1410,6,1416
"اصفهان","خمینی_شهر","مرکزی",57,863,9,1,330,1203,15,1218
"اصفهان","خمینی_شهر","مرکزی",58,862,11,3,202,1078,10,1088
"اصفهان","خمینی_شهر","مرکزی",59,692,9,1,200,902,6,908
"اصفهان","خمینی_شهر","مرکزی",60,1081,9,1,362,1453,6,1459
"اصفهان","خمینی_شهر","مرکزی",61,1276,22,3,334,1635,9,1644
"اصفهان","خمینی_شهر","مرکزی",62,936,9,0,202,1147,14,1161
"اصفهان","خمینی_شهر","مرکزی",63,1175,23,4,466,1668,22,1690
"اصفهان","خمینی_شهر","مرکزی",64,1443,12,11,220,1686,11,1697
"اصفهان","خمینی_شهر","مرکزی",65,722,14,2,251,989,10,999
"اصفهان","خمینی_شهر","مرکزی",66,975,22,3,260,1260,11,1271
"اصفهان","خمینی_شهر","مرکزی",67,908,10,5,300,1223,11,1234
"اصفهان","خمینی_شهر","مرکزی",68,744,24,12,679,1459,24,1483
"اصفهان","خمینی_شهر","مرکزی",69,1210,21,7,435,1673,26,1699
"اصفهان","خمینی_شهر","مرکزی",70,924,2,0,118,1044,9,1053
"اصفهان","خمینی_شهر","مرکزی",71,1237,31,7,648,1923,26,1949
"اصفهان","خمینی_شهر","مرکزی",72,931,22,0,149,1102,12,1114
"اصفهان","خمینی_شهر","مرکزی",73,970,11,0,117,1098,5,1103
"اصفهان","خمینی_شهر","مرکزی",74,1210,6,2,178,1396,8,1404
"اصفهان","خمینی_شهر","مرکزی",75,1443,15,3,110,1571,10,1581
"اصفهان","خمینی_شهر","مرکزی",76,1649,8,1,150,1808,5,1813
"اصفهان","خمینی_شهر","مرکزی",77,1318,96,15,213,1642,8,1650
"اصفهان","خمینی_شهر","مرکزی",78,1014,112,23,163,1312,7,1319
"اصفهان","خمینی_شهر","مرکزی",79,1327,142,10,135,1614,6,1620
"اصفهان","خمینی_شهر","مرکزی",80,843,131,25,126,1125,6,1131
"اصفهان","خمینی_شهر","مرکزی",81,640,9,14,273,936,7,943
"اصفهان","خمینی_شهر","مرکزی",82,782,16,1,284,1083,12,1095
"اصفهان","خمینی_شهر","مرکزی",83,1050,46,32,232,1360,7,1367
"اصفهان","خمینی_شهر","مرکزی",84,1041,42,7,374,1464,15,1479
"اصفهان","خمینی_شهر","مرکزی",85,1120,118,20,238,1496,9,1505
"اصفهان","خمینی_شهر","مرکزی",86,1073,131,15,146,1365,6,1371
"اصفهان","خمینی_شهر","مرکزی",87,1146,87,23,173,1429,7,1436
"اصفهان","خمینی_شهر","مرکزی",88,1126,117,25,170,1438,7,1445
"اصفهان","خمینی_شهر","مرکزی",89,1143,99,17,92,1351,4,1355
"اصفهان","خمینی_شهر","مرکزی",90,1576,25,4,229,1834,15,1849
"اصفهان","خمینی_شهر","مرکزی",91,1354,22,13,182,1571,10,1581
"اصفهان","خمینی_شهر","مرکزی",92,1118,23,1,273,1415,2,1417
"اصفهان","خمینی_شهر","مرکزی",93,553,6,2,87,648,6,654
"اصفهان","خمینی_شهر","مرکزی",94,490,56,15,310,871,8,879
"اصفهان","خمینی_شهر","مرکزی",95,279,6,1,102,388,3,391
"اصفهان","خمینی_شهر","مرکزی",96,294,5,3,79,381,7,388
"اصفهان","خمینی_شهر","مرکزی",97,149,4,2,30,185,1,186
"اصفهان","خمینی_شهر","مرکزی",98,297,11,3,119,430,1,431
"اصفهان","خمینی_شهر","مرکزی",99,90,2,1,45,138,1,139
"اصفهان","خمینی_شهر","مرکزی",100,1953,17,7,373,2350,13,2363
"اصفهان","خمینی_شهر","مرکزی",101,908,7,1,112,1028,11,1039
"اصفهان","خمینی_شهر","مرکزی",102,1527,31,3,281,1842,21,1863
"اصفهان","خمینی_شهر","مرکزی",103,1076,18,2,226,1322,15,1337
"اصفهان","خمینی_شهر","مرکزی",104,771,6,3,110,890,6,896
"اصفهان","خمینی_شهر","مرکزی",105,874,16,1,177,1068,9,1077
"اصفهان","خمینی_شهر","مرکزی",106,845,2,4,168,1019,7,1026
"اصفهان","خمینی_شهر","مرکزی",107,558,8,4,175,745,5,750
"اصفهان","خمینی_شهر","مرکزی",108,1409,12,7,353,1781,13,1794
"اصفهان","خمینی_شهر","مرکزی",109,1553,22,3,364,1942,20,1962
"اصفهان","خمینی_شهر","مرکزی",110,959,13,3,186,1161,11,1172
"اصفهان","خمینی_شهر","مرکزی",111,1067,12,3,117,1199,16,1215
"اصفهان","خمینی_شهر","مرکزی",112,1614,10,1,236,1861,16,1877
"اصفهان","خمینی_شهر","مرکزی",113,1429,7,0,42,1478,9,1487
"اصفهان","خمینی_شهر","مرکزی",114,1178,17,1,322,1518,11,1529
"اصفهان","خمینی_شهر","مرکزی",115,601,4,1,92,698,4,702
"اصفهان","خمینی_شهر","مرکزی",116,1040,7,4,274,1325,16,1341
"اصفهان","خمینی_شهر","مرکزی",117,963,23,3,323,1312,7,1319
"اصفهان","خمینی_شهر","مرکزی",118,145,3,0,19,167,2,169
"اصفهان","خمینی_شهر","مرکزی",119,1061,12,0,184,1257,19,1276
"اصفهان","خمینی_شهر","مرکزی",120,946,6,3,96,1051,13,1064
"اصفهان","خمینی_شهر","مرکزی",121,1180,20,3,315,1518,27,1545
"اصفهان","خمینی_شهر","مرکزی",122,1451,22,5,238,1716,17,1733
"اصفهان","خمینی_شهر","مرکزی",123,615,3,0,36,654,8,662
"اصفهان","خمینی_شهر","مرکزی",124,726,7,3,75,811,11,822
"اصفهان","خمینی_شهر","مرکزی",125,1226,18,13,221,1478,11,1489
"اصفهان","خمینی_شهر","مرکزی",126,1005,14,8,164,1191,7,1198
"اصفهان","خمینی_شهر","مرکزی",127,997,23,8,251,1279,16,1295
"اصفهان","خمینی_شهر","مرکزی",128,883,4,0,66,953,3,956
"اصفهان","خمینی_شهر","مرکزی",129,790,7,3,132,932,3,935
"اصفهان","خمینی_شهر","مرکزی",130,946,14,1,129,1090,14,1104
"اصفهان","خوانسار","مرکزی",1,273,5,1,96,375,3,378
"اصفهان","خوانسار","مرکزی",2,1170,24,3,416,1613,21,1634
"اصفهان","خوانسار","مرکزی",3,428,12,4,303,747,14,761
"اصفهان","خوانسار","مرکزی",4,323,11,1,135,470,6,476
"اصفهان","خوانسار","مرکزی",5,231,10,1,127,369,6,375
"اصفهان","خوانسار","مرکزی",6,996,4,1,145,1146,15,1161
"اصفهان","خوانسار","مرکزی",7,747,6,4,272,1029,18,1047
"اصفهان","خوانسار","مرکزی",8,274,2,2,112,390,7,397
"اصفهان","خوانسار","مرکزی",9,316,18,4,82,420,9,429
"اصفهان","خوانسار","مرکزی",10,416,4,2,162,584,14,598
"اصفهان","خوانسار","مرکزی",11,499,26,7,380,912,15,927
"اصفهان","خوانسار","مرکزی",12,297,17,2,93,409,2,411
"اصفهان","خوانسار","مرکزی",13,152,3,1,28,184,3,187
"اصفهان","خوانسار","مرکزی",14,420,4,0,121,545,6,551
"اصفهان","خوانسار","مرکزی",15,505,6,0,174,685,4,689
"اصفهان","خوانسار","مرکزی",16,282,5,4,113,404,9,413
"اصفهان","خوانسار","مرکزی",17,337,7,3,166,513,3,516
"اصفهان","خوانسار","مرکزی",18,380,4,2,51,437,6,443
"اصفهان","خوانسار","مرکزی",19,421,3,2,159,585,12,597
"اصفهان","خوانسار","مرکزی",20,496,8,2,118,624,10,634
"اصفهان","خوانسار","مرکزی",21,435,2,1,63,501,3,504
"اصفهان","خوانسار","مرکزی",22,135,0,1,34,170,4,174
"اصفهان","خوانسار","مرکزی",23,375,1,2,69,447,6,453
"اصفهان","خوانسار","مرکزی",24,570,7,2,99,678,4,682
"اصفهان","خوانسار","مرکزی",25,221,4,1,41,267,8,275
"اصفهان","خوانسار","مرکزی",26,444,4,1,97,546,7,553
"اصفهان","خوانسار","مرکزی",27,334,0,1,64,399,1,400
"اصفهان","خوانسار","مرکزی",28,122,2,2,15,141,0,141
"اصفهان","خوانسار","مرکزی",29,335,0,1,47,383,0,383
"اصفهان","خوانسار","مرکزی",30,960,11,6,51,1028,1,1029
"اصفهان","خوانسار","مرکزی",31,701,6,1,92,800,4,804
"اصفهان","خوانسار","مرکزی",32,189,0,0,1,190,1,191
"اصفهان","خوانسار","مرکزی",33,739,2,0,20,761,2,763
"اصفهان","خوانسار","مرکزی",34,358,0,1,46,405,3,408
"اصفهان","خوانسار","مرکزی",35,1036,3,9,158,1206,16,1222
"اصفهان","خوانسار","مرکزی",36,304,3,0,107,414,5,419
"اصفهان","خوانسار","مرکزی",37,144,0,2,22,168,0,168
"اصفهان","خوانسار","مرکزی",38,464,6,0,32,502,0,502
"اصفهان","خوانسار","مرکزی",39,155,0,0,7,162,0,162
"اصفهان","خوانسار","مرکزی",40,847,6,2,43,898,1,899
"اصفهان","دهاقان","مرکزی",1,672,12,5,300,989,19,1008
"اصفهان","دهاقان","مرکزی",2,640,12,4,153,809,2,811
"اصفهان","دهاقان","مرکزی",3,596,4,3,230,833,8,841
"اصفهان","دهاقان","مرکزی",4,496,1,0,146,643,10,653
"اصفهان","دهاقان","مرکزی",5,627,9,2,244,882,5,887
"اصفهان","دهاقان","مرکزی",6,802,6,2,283,1093,6,1099
"اصفهان","دهاقان","مرکزی",7,480,4,2,126,612,9,621
"اصفهان","دهاقان","مرکزی",8,496,5,0,166,667,6,673
"اصفهان","دهاقان","مرکزی",9,429,3,5,46,483,3,486
"اصفهان","دهاقان","مرکزی",10,812,5,1,125,943,16,959
"اصفهان","دهاقان","مرکزی",11,507,7,2,69,585,6,591
"اصفهان","دهاقان","مرکزی",12,713,8,1,180,902,9,911
"اصفهان","دهاقان","مرکزی",13,464,17,2,248,731,8,739
"اصفهان","دهاقان","مرکزی",14,241,4,2,169,416,4,420
"اصفهان","دهاقان","مرکزی",15,245,1,0,36,282,1,283
"اصفهان","دهاقان","مرکزی",16,148,6,0,57,211,5,216
"اصفهان","دهاقان","مرکزی",17,153,0,0,14,167,0,167
"اصفهان","دهاقان","مرکزی",18,935,4,1,42,982,1,983
"اصفهان","دهاقان","مرکزی",19,780,2,3,153,938,12,950
"اصفهان","دهاقان","مرکزی",20,553,0,0,24,577,2,579
"اصفهان","دهاقان","مرکزی",21,645,1,3,32,681,2,683
"اصفهان","دهاقان","مرکزی",22,424,14,11,110,559,3,562
"اصفهان","دهاقان","مرکزی",23,958,16,4,122,1100,11,1111
"اصفهان","دهاقان","مرکزی",24,688,17,6,81,792,8,800
"اصفهان","دهاقان","مرکزی",25,226,0,3,15,244,5,249
"اصفهان","دهاقان","مرکزی",26,146,2,0,9,157,2,159
"اصفهان","دهاقان","مرکزی",27,265,1,1,44,311,4,315
"اصفهان","دهاقان","مرکزی",28,501,0,0,19,520,5,525
"اصفهان","دهاقان","مرکزی",29,270,4,1,48,323,2,325
"اصفهان","دهاقان","مرکزی",30,187,0,0,22,209,0,209
"اصفهان","دهاقان","مرکزی",31,717,4,1,138,860,7,867
"اصفهان","دهاقان","مرکزی",32,372,4,0,82,458,4,462
"اصفهان","دهاقان","مرکزی",33,123,1,1,40,165,0,165
"اصفهان","دهاقان","مرکزی",34,69,0,0,5,74,0,74
"اصفهان","دهاقان","مرکزی",35,794,5,1,63,863,5,868
"اصفهان","دهاقان","مرکزی",36,879,9,0,116,1004,8,1012
"اصفهان","دهاقان","مرکزی",37,359,4,1,41,405,4,409
"اصفهان","دهاقان","مرکزی",38,828,4,1,65,898,2,900
"اصفهان","سمیرم","مرکزی",1,107,0,0,115,222,5,227
"اصفهان","سمیرم","مرکزی",2,553,6,2,292,853,11,864
"اصفهان","سمیرم","مرکزی",3,442,5,3,410,860,15,875
"اصفهان","سمیرم","مرکزی",4,195,13,1,236,445,11,456
"اصفهان","سمیرم","مرکزی",5,781,27,9,604,1421,34,1455
"اصفهان","سمیرم","مرکزی",6,954,13,10,625,1602,15,1617
"اصفهان","سمیرم","مرکزی",7,285,6,3,296,590,12,602
"اصفهان","سمیرم","مرکزی",8,595,16,4,491,1106,10,1116
"اصفهان","سمیرم","مرکزی",9,308,8,6,135,457,8,465
"اصفهان","سمیرم","مرکزی",10,125,3,2,140,270,6,276
"اصفهان","سمیرم","مرکزی",11,486,22,3,365,876,10,886
"اصفهان","سمیرم","مرکزی",12,240,4,3,145,392,7,399
"اصفهان","سمیرم","مرکزی",13,277,2,7,275,561,12,573
"اصفهان","سمیرم","مرکزی",14,487,5,1,185,678,1,679
"اصفهان","سمیرم","مرکزی",15,610,13,7,493,1123,14,1137
"اصفهان","سمیرم","مرکزی",16,662,5,4,374,1045,10,1055
"اصفهان","سمیرم","مرکزی",17,552,10,6,431,999,7,1006
"اصفهان","سمیرم","مرکزی",18,276,10,1,154,441,3,444
"اصفهان","سمیرم","مرکزی",19,481,1,1,57,540,3,543
"اصفهان","سمیرم","مرکزی",20,657,5,2,110,774,5,779
"اصفهان","سمیرم","مرکزی",21,434,0,2,143,579,1,580
"اصفهان","سمیرم","مرکزی",22,554,0,0,87,641,4,645
"اصفهان","سمیرم","مرکزی",23,548,0,0,56,604,3,607
"اصفهان","سمیرم","مرکزی",24,382,1,1,59,443,0,443
"اصفهان","سمیرم","مرکزی",25,671,6,0,242,919,4,923
"اصفهان","سمیرم","مرکزی",26,332,1,0,105,438,2,440
"اصفهان","سمیرم","مرکزی",27,447,1,0,30,478,5,483
"اصفهان","سمیرم","مرکزی",28,463,8,0,164,635,11,646
"اصفهان","سمیرم","مرکزی",29,516,1,0,118,635,6,641
"اصفهان","سمیرم","مرکزی",30,740,5,0,196,941,7,948
"اصفهان","سمیرم","مرکزی",31,522,1,0,105,628,8,636
"اصفهان","سمیرم","مرکزی",32,645,0,0,95,740,8,748
"اصفهان","سمیرم","مرکزی",33,484,1,1,28,514,0,514
"اصفهان","سمیرم","مرکزی",34,221,5,2,104,332,3,335
"اصفهان","سمیرم","مرکزی",35,972,3,3,59,1037,0,1037
"اصفهان","سمیرم","مرکزی",36,622,2,4,85,713,7,720
"اصفهان","سمیرم","مرکزی",37,410,1,3,97,511,2,513
"اصفهان","سمیرم","مرکزی",38,1329,4,4,266,1603,10,1613
"اصفهان","سمیرم","مرکزی",39,812,2,1,68,883,6,889
"اصفهان","سمیرم","پادنا",1,428,7,1,123,559,9,568
"اصفهان","سمیرم","پادنا",2,600,10,2,119,731,0,731
"اصفهان","سمیرم","پادنا",3,847,9,1,78,935,3,938
"اصفهان","سمیرم","پادنا",4,331,5,1,59,396,4,400
"اصفهان","سمیرم","پادنا",5,312,1,2,181,496,1,497
"اصفهان","سمیرم","پادنا",6,623,3,7,165,798,4,802
"اصفهان","سمیرم","پادنا",7,693,4,2,46,745,4,749
"اصفهان","سمیرم","پادنا",8,286,1,1,7,295,1,296
"اصفهان","سمیرم","پادنا",9,906,10,2,52,970,0,970
"اصفهان","سمیرم","پادنا",10,566,4,0,49,619,2,621
"اصفهان","سمیرم","پادنا",11,777,5,3,110,895,5,900
"اصفهان","سمیرم","پادنا",12,310,4,1,46,361,1,362
"اصفهان","سمیرم","پادنا",13,721,3,2,55,781,2,783
"اصفهان","سمیرم","پادنا",14,677,7,3,189,876,6,882
"اصفهان","سمیرم","پادنا",15,574,2,4,84,664,1,665
"اصفهان","سمیرم","پادنا",16,526,0,0,139,665,5,670
"اصفهان","سمیرم","پادنا",17,416,4,29,163,612,4,616
"اصفهان","سمیرم","پادنا",18,263,1,1,265,530,2,532
"اصفهان","سمیرم","پادنا",19,415,11,3,259,688,1,689
"اصفهان","سمیرم","پادنا",20,453,2,3,107,565,7,572
"اصفهان","سمیرم","پادنا",21,483,13,1,258,755,0,755
"اصفهان","سمیرم","پادنا",22,437,7,0,177,621,1,622
"اصفهان","سمیرم","پادنا",23,501,2,0,77,580,3,583
"اصفهان","سمیرم","پادنا",24,268,0,1,23,292,0,292
"اصفهان","سمیرم","پادنا",25,288,0,1,75,364,1,365
"اصفهان","سمیرم","پادنا",26,195,0,2,97,294,2,296
"اصفهان","شاهین_شهر_و_میمه","میمه",1,1101,8,4,294,1407,15,1422
"اصفهان","شاهین_شهر_و_میمه","میمه",2,937,29,3,475,1444,11,1455
"اصفهان","شاهین_شهر_و_میمه","میمه",3,531,3,3,239,776,6,782
"اصفهان","شاهین_شهر_و_میمه","میمه",4,214,2,0,82,298,7,305
"اصفهان","شاهین_شهر_و_میمه","میمه",5,908,8,0,118,1034,6,1040
"اصفهان","شاهین_شهر_و_میمه","میمه",6,944,7,0,159,1110,7,1117
"اصفهان","شاهین_شهر_و_میمه","میمه",7,600,10,3,181,794,3,797
"اصفهان","شاهین_شهر_و_میمه","میمه",8,814,4,0,77,895,5,900
"اصفهان","شاهین_شهر_و_میمه","میمه",9,755,8,1,93,857,10,867
"اصفهان","شاهین_شهر_و_میمه","میمه",10,829,3,0,62,894,6,900
"اصفهان","شاهین_شهر_و_میمه","میمه",11,691,2,1,175,869,1,870
"اصفهان","شاهین_شهر_و_میمه","میمه",12,634,2,0,32,668,2,670
"اصفهان","شاهین_شهر_و_میمه","میمه",13,214,2,1,32,249,1,250
"اصفهان","شاهین_شهر_و_میمه","میمه",14,344,3,1,100,448,6,454
"اصفهان","شاهین_شهر_و_میمه","میمه",15,460,1,0,54,515,1,516
"اصفهان","شاهین_شهر_و_میمه","میمه",16,655,4,1,77,737,3,740
"اصفهان","شاهین_شهر_و_میمه","میمه",17,253,2,0,45,300,0,300
"اصفهان","شاهین_شهر_و_میمه","میمه",18,152,2,1,40,195,0,195
"اصفهان","شاهین_شهر_و_میمه","میمه",19,350,24,3,365,742,8,750
"اصفهان","شاهین_شهر_و_میمه","میمه",20,231,17,15,199,462,6,468
"اصفهان","شاهین_شهر_و_میمه","میمه",21,561,47,13,807,1428,17,1445
"اصفهان","شاهین_شهر_و_میمه","میمه",22,678,49,25,1074,1826,29,1855
"اصفهان","شاهین_شهر_و_میمه","میمه",23,376,21,11,510,918,12,930
"اصفهان","شاهین_شهر_و_میمه","میمه",24,585,39,26,1001,1651,13,1664
"اصفهان","شاهین_شهر_و_میمه","میمه",25,310,29,26,704,1069,18,1087
"اصفهان","شاهین_شهر_و_میمه","میمه",26,287,19,17,519,842,8,850
"اصفهان","شاهین_شهر_و_میمه","میمه",27,354,23,30,485,892,8,900
"اصفهان","شاهین_شهر_و_میمه","میمه",28,220,27,12,457,716,5,721
"اصفهان","شاهین_شهر_و_میمه","میمه",29,633,45,28,1078,1784,18,1802
"اصفهان","شاهین_شهر_و_میمه","میمه",30,330,19,13,605,967,7,974
"اصفهان","شاهین_شهر_و_میمه","میمه",31,869,63,16,730,1678,22,1700
"اصفهان","شاهین_شهر_و_میمه","میمه",32,169,19,8,404,600,5,605
"اصفهان","شاهین_شهر_و_میمه","میمه",33,775,64,29,815,1683,17,1700
"اصفهان","شاهین_شهر_و_میمه","میمه",34,610,89,33,543,1275,22,1297
"اصفهان","شاهین_شهر_و_میمه","میمه",35,445,32,7,408,892,8,900
"اصفهان","شاهین_شهر_و_میمه","میمه",36,1352,98,38,743,2231,21,2252
"اصفهان","شاهین_شهر_و_میمه","میمه",37,633,47,14,598,1292,7,1299
"اصفهان","شاهین_شهر_و_میمه","میمه",38,729,26,17,423,1195,5,1200
"اصفهان","شاهین_شهر_و_میمه","میمه",39,870,29,8,303,1210,9,1219
"اصفهان","شاهین_شهر_و_میمه","میمه",40,222,24,9,411,666,8,674
"اصفهان","شاهین_شهر_و_میمه","میمه",41,466,33,12,503,1014,4,1018
"اصفهان","شاهین_شهر_و_میمه","میمه",42,613,44,15,712,1384,18,1402
"اصفهان","شاهین_شهر_و_میمه","میمه",43,648,38,15,845,1546,18,1564
"اصفهان","شاهین_شهر_و_میمه","میمه",44,648,52,20,923,1643,21,1664
"اصفهان","شاهین_شهر_و_میمه","میمه",45,632,66,37,927,1662,21,1683
"اصفهان","شاهین_شهر_و_میمه","میمه",46,784,44,14,694,1536,13,1549
"اصفهان","شاهین_شهر_و_میمه","میمه",47,579,13,10,231,833,3,836
"اصفهان","شاهین_شهر_و_میمه","میمه",48,527,23,5,337,892,8,900
"اصفهان","شاهین_شهر_و_میمه","میمه",49,456,46,8,422,932,4,936
"اصفهان","شاهین_شهر_و_میمه","میمه",50,1282,10,6,147,1445,4,1449
"اصفهان","شاهین_شهر_و_میمه","میمه",51,861,58,17,642,1578,22,1600
"اصفهان","شاهین_شهر_و_میمه","میمه",52,666,42,21,836,1565,12,1577
"اصفهان","شاهین_شهر_و_میمه","میمه",53,485,29,6,471,991,9,1000
"اصفهان","شاهین_شهر_و_میمه","میمه",54,434,26,18,503,981,4,985
"اصفهان","شاهین_شهر_و_میمه","میمه",55,766,59,28,945,1798,8,1806
"اصفهان","شاهین_شهر_و_میمه","میمه",56,480,44,25,951,1500,20,1520
"اصفهان","شاهین_شهر_و_میمه","میمه",57,561,33,44,1052,1690,10,1700
"اصفهان","شاهین_شهر_و_میمه","میمه",58,1317,73,23,814,2227,20,2247
"اصفهان","شاهین_شهر_و_میمه","میمه",59,468,34,17,540,1059,13,1072
"اصفهان","شاهین_شهر_و_میمه","میمه",60,667,36,24,865,1592,23,1615
"اصفهان","شاهین_شهر_و_میمه","میمه",61,633,35,28,665,1361,15,1376
"اصفهان","شاهین_شهر_و_میمه","میمه",62,382,42,25,1008,1457,7,1464
"اصفهان","شاهین_شهر_و_میمه","میمه",63,737,41,15,646,1439,11,1450
"اصفهان","شاهین_شهر_و_میمه","میمه",64,306,17,3,267,593,7,600
"اصفهان","شاهین_شهر_و_میمه","میمه",65,794,39,20,292,1145,,1145
"اصفهان","شاهین_شهر_و_میمه","میمه",66,467,37,6,304,814,12,826
"اصفهان","شاهین_شهر_و_میمه","میمه",67,714,38,10,411,1173,11,1184
"اصفهان","شاهین_شهر_و_میمه","میمه",68,853,31,15,460,1359,15,1374
"اصفهان","شاهین_شهر_و_میمه","میمه",69,771,15,10,297,1093,25,1118
"اصفهان","شاهین_شهر_و_میمه","میمه",70,850,22,3,257,1132,18,1150
"اصفهان","شاهین_شهر_و_میمه","میمه",71,556,37,20,452,1065,10,1075
"اصفهان","شاهین_شهر_و_میمه","میمه",72,918,43,16,654,1631,16,1647
"اصفهان","شاهین_شهر_و_میمه","میمه",73,485,32,4,576,1097,7,1104
"اصفهان","شاهین_شهر_و_میمه","میمه",74,239,12,3,189,443,15,458
"اصفهان","شاهین_شهر_و_میمه","میمه",75,113,4,0,67,184,2,186
"اصفهان","شاهین_شهر_و_میمه","میمه",76,1285,15,6,281,1587,7,1594
"اصفهان","شاهین_شهر_و_میمه","میمه",77,650,12,2,212,876,5,881
"اصفهان","شاهین_شهر_و_میمه","میمه",78,686,20,2,442,1150,11,1161
"اصفهان","شاهین_شهر_و_میمه","میمه",79,675,15,7,241,938,10,948
"اصفهان","شاهین_شهر_و_میمه","میمه",80,949,10,0,232,1191,9,1200
"اصفهان","شاهین_شهر_و_میمه","میمه",81,899,13,4,322,1238,12,1250
"اصفهان","شاهین_شهر_و_میمه","میمه",82,578,1,2,168,749,1,750
"اصفهان","شاهین_شهر_و_میمه","میمه",83,1010,10,3,414,1437,13,1450
"اصفهان","شاهین_شهر_و_میمه","میمه",84,817,12,2,311,1142,7,1149
"اصفهان","شاهین_شهر_و_میمه","میمه",85,283,4,3,157,447,2,449
"اصفهان","شاهین_شهر_و_میمه","میمه",86,141,2,1,55,199,1,200
"اصفهان","شاهین_شهر_و_میمه","میمه",87,1423,12,4,102,1541,9,1550
"اصفهان","شاهین_شهر_و_میمه","میمه",88,1364,9,1,69,1443,9,1452
"اصفهان","شاهین_شهر_و_میمه","میمه",89,1070,26,5,421,1522,6,1528
"اصفهان","شاهین_شهر_و_میمه","میمه",90,758,15,0,311,1084,3,1087
"اصفهان","شاهین_شهر_و_میمه","میمه",91,315,2,0,81,398,4,402
"اصفهان","شاهین_شهر_و_میمه","میمه",92,292,4,0,126,422,3,425
"اصفهان","شاهین_شهر_و_میمه","میمه",93,107,0,0,20,127,0,127
"اصفهان","شهرضا","مرکزی",1,1357,19,3,302,1681,24,1705
"اصفهان","شهرضا","مرکزی",2,491,14,2,192,699,7,706
"اصفهان","شهرضا","مرکزی",3,372,6,1,147,526,7,533
"اصفهان","شهرضا","مرکزی",4,369,18,3,259,649,19,668
"اصفهان","شهرضا","مرکزی",5,387,22,7,289,705,16,721
"اصفهان","شهرضا","مرکزی",6,763,31,24,594,1412,40,1452
"اصفهان","شهرضا","مرکزی",7,571,28,4,432,1035,37,1072
"اصفهان","شهرضا","مرکزی",8,644,36,20,747,1447,33,1480
"اصفهان","شهرضا","مرکزی",9,532,13,2,193,740,16,756
"اصفهان","شهرضا","مرکزی",10,581,32,12,503,1128,23,1151
"اصفهان","شهرضا","مرکزی",11,971,48,15,428,1462,37,1499
"اصفهان","شهرضا","مرکزی",12,734,13,6,428,1181,14,1195
"اصفهان","شهرضا","مرکزی",13,1180,12,0,214,1406,4,1410
"اصفهان","شهرضا","مرکزی",14,755,47,13,575,1390,32,1422
"اصفهان","شهرضا","مرکزی",15,542,26,16,309,893,20,913
"اصفهان","شهرضا","مرکزی",16,317,9,7,227,560,8,568
"اصفهان","شهرضا","مرکزی",17,318,26,8,350,702,12,714
"اصفهان","شهرضا","مرکزی",18,501,18,10,273,802,21,823
"اصفهان","شهرضا","مرکزی",19,682,16,19,585,1302,24,1326
"اصفهان","شهرضا","مرکزی",20,243,8,0,47,298,4,302
"اصفهان","شهرضا","مرکزی",21,613,13,4,346,976,9,985
"اصفهان","شهرضا","مرکزی",22,625,18,3,302,948,6,954
"اصفهان","شهرضا","مرکزی",23,546,4,4,230,784,5,789
"اصفهان","شهرضا","مرکزی",24,718,9,6,350,1083,16,1099
"اصفهان","شهرضا","مرکزی",25,640,20,7,473,1140,41,1181
"اصفهان","شهرضا","مرکزی",26,288,8,2,150,448,9,457
"اصفهان","شهرضا","مرکزی",27,832,27,5,486,1350,24,1374
"اصفهان","شهرضا","مرکزی",28,1496,7,3,263,1769,11,1780
"اصفهان","شهرضا","مرکزی",29,803,24,8,360,1195,21,1216
"اصفهان","شهرضا","مرکزی",30,607,23,7,339,976,17,993
"اصفهان","شهرضا","مرکزی",31,416,10,0,138,564,11,575
"اصفهان","شهرضا","مرکزی",32,418,9,5,164,596,16,612
"اصفهان","شهرضا","مرکزی",33,347,10,4,213,574,12,586
"اصفهان","شهرضا","مرکزی",34,527,9,5,133,674,11,685
"اصفهان","شهرضا","مرکزی",35,844,11,24,293,1172,22,1194
"اصفهان","شهرضا","مرکزی",36,764,22,18,525,1329,28,1357
"اصفهان","شهرضا","مرکزی",37,589,8,7,319,923,25,948
"اصفهان","شهرضا","مرکزی",38,1432,45,30,748,2255,42,2297
"اصفهان","شهرضا","مرکزی",39,714,28,9,439,1190,25,1215
"اصفهان","شهرضا","مرکزی",40,923,32,6,483,1444,28,1472
"اصفهان","شهرضا","مرکزی",41,568,32,5,291,896,20,916
"اصفهان","شهرضا","مرکزی",42,761,15,3,308,1087,9,1096
"اصفهان","شهرضا","مرکزی",43,1008,20,6,279,1313,13,1326
"اصفهان","شهرضا","مرکزی",44,973,23,14,611,1621,36,1657
"اصفهان","شهرضا","مرکزی",45,467,2,7,113,589,5,594
"اصفهان","شهرضا","مرکزی",46,522,19,19,521,1081,16,1097
"اصفهان","شهرضا","مرکزی",47,999,34,29,386,1448,18,1466
"اصفهان","شهرضا","مرکزی",48,1061,26,8,350,1445,25,1470
"اصفهان","شهرضا","مرکزی",49,392,4,0,45,441,4,445
"اصفهان","شهرضا","مرکزی",50,324,10,5,119,458,6,464
"اصفهان","شهرضا","مرکزی",51,431,5,1,144,581,6,587
"اصفهان","شهرضا","مرکزی",52,1039,18,19,376,1452,21,1473
"اصفهان","شهرضا","مرکزی",53,939,20,4,412,1375,30,1405
"اصفهان","شهرضا","مرکزی",54,529,2,0,117,648,4,652
"اصفهان","شهرضا","مرکزی",55,664,2,1,134,801,10,811
"اصفهان","شهرضا","مرکزی",56,1055,2,1,233,1291,7,1298
"اصفهان","شهرضا","مرکزی",57,991,11,3,165,1170,21,1191
"اصفهان","شهرضا","مرکزی",58,346,5,1,84,436,3,439
"اصفهان","شهرضا","مرکزی",59,929,11,12,168,1120,8,1128
"اصفهان","شهرضا","مرکزی",60,646,7,4,51,708,2,710
"اصفهان","شهرضا","مرکزی",61,842,7,4,156,1009,7,1016
"اصفهان","شهرضا","مرکزی",62,1073,12,0,157,1242,8,1250
"اصفهان","شهرضا","مرکزی",63,206,1,1,95,303,7,310
"اصفهان","شهرضا","مرکزی",64,319,11,1,61,392,8,400
"اصفهان","شهرضا","مرکزی",65,87,2,0,35,124,4,128
"اصفهان","شهرضا","مرکزی",66,876,9,0,96,981,12,993
"اصفهان","شهرضا","مرکزی",67,628,20,3,214,865,13,878
"اصفهان","شهرضا","مرکزی",68,357,9,1,169,536,8,544
"اصفهان","شهرضا","مرکزی",69,469,3,2,99,573,3,576
"اصفهان","شهرضا","مرکزی",70,272,4,0,62,338,11,349
"اصفهان","شهرضا","مرکزی",71,887,2,1,179,1069,3,1072
"اصفهان","شهرضا","مرکزی",72,553,6,5,138,702,4,706
"اصفهان","شهرضا","مرکزی",73,198,0,1,42,241,2,243
"اصفهان","شهرضا","مرکزی",74,1015,4,0,38,1057,4,1061
"اصفهان","شهرضا","مرکزی",75,825,23,1,181,1030,9,1039
"اصفهان","شهرضا","مرکزی",76,593,28,5,180,806,10,816
"اصفهان","شهرضا","مرکزی",77,874,6,1,53,934,6,940
"اصفهان","شهرضا","مرکزی",78,657,8,2,72,739,4,743
"اصفهان","شهرضا","مرکزی",79,213,0,3,21,237,8,245
"اصفهان","شهرضا","مرکزی",80,432,2,0,25,459,5,464
"اصفهان","شهرضا","مرکزی",81,248,0,1,45,294,5,299
"اصفهان","شهرضا","مرکزی",82,333,0,0,16,349,4,353
"اصفهان","شهرضا","مرکزی",83,191,2,16,40,249,6,255
"اصفهان","شهرضا","مرکزی",84,212,4,1,45,262,6,268
"اصفهان","شهرضا","مرکزی",85,391,6,2,118,517,3,520
"اصفهان","شهرضا","مرکزی",86,192,2,1,69,264,2,266
"اصفهان","شهرضا","مرکزی",87,659,5,1,202,867,3,870
"اصفهان","شهرضا","مرکزی",88,988,9,3,255,1255,13,1268
"اصفهان","شهرضا","مرکزی",89,671,5,1,169,846,6,852
"اصفهان","شهرضا","مرکزی",90,804,4,1,129,938,4,942
"اصفهان","شهرضا","مرکزی",91,1076,8,0,107,1191,10,1201
"اصفهان","شهرضا","مرکزی",92,108,0,0,23,131,4,135
"اصفهان","شهرضا","مرکزی",93,260,0,0,15,275,2,277
"اصفهان","فریدن","مرکزی",1,754,10,15,228,1007,3,1010
"اصفهان","فریدن","مرکزی",2,441,16,3,242,702,11,713
"اصفهان","فریدن","مرکزی",3,336,17,7,155,515,0,515
"اصفهان","فریدن","مرکزی",4,430,5,6,190,631,4,635
"اصفهان","فریدن","مرکزی",5,510,14,4,388,916,6,922
"اصفهان","فریدن","مرکزی",6,333,3,5,120,461,1,462
"اصفهان","فریدن","مرکزی",7,360,5,6,140,511,1,512
"اصفهان","فریدن","مرکزی",8,848,8,3,206,1065,1,1066
"اصفهان","فریدن","مرکزی",9,546,18,4,203,771,4,775
"اصفهان","فریدن","مرکزی",10,746,4,3,233,986,4,990
"اصفهان","فریدن","مرکزی",11,383,8,6,190,587,8,595
"اصفهان","فریدن","مرکزی",12,1056,28,5,391,1480,15,1495
"اصفهان","فریدن","مرکزی",13,518,10,18,258,804,5,809
"اصفهان","فریدن","مرکزی",14,597,6,3,185,791,5,796
"اصفهان","فریدن","مرکزی",15,225,49,3,50,327,2,329
"اصفهان","فریدن","مرکزی",16,196,3,0,98,297,6,303
"اصفهان","فریدن","مرکزی",17,791,10,2,146,949,3,952
"اصفهان","فریدن","مرکزی",18,814,7,2,183,1006,7,1013
"اصفهان","فریدن","مرکزی",19,590,9,2,166,767,2,769
"اصفهان","فریدن","مرکزی",20,702,1,1,64,768,2,770
"اصفهان","فریدن","مرکزی",21,821,2,0,49,872,1,873
"اصفهان","فریدن","مرکزی",22,526,0,0,47,573,1,574
"اصفهان","فریدن","مرکزی",23,1045,10,0,144,1199,4,1203
"اصفهان","فریدن","مرکزی",24,454,3,0,76,533,2,535
"اصفهان","فریدن","مرکزی",25,681,1,1,57,740,1,741
"اصفهان","فریدن","مرکزی",26,665,0,3,81,749,5,754
"اصفهان","فریدن","مرکزی",27,681,3,4,84,772,0,772
"اصفهان","فریدن","مرکزی",28,286,2,0,56,344,2,346
"اصفهان","فریدن","مرکزی",29,1059,1,1,47,1108,3,1111
"اصفهان","فریدن","مرکزی",30,551,2,0,34,587,1,588
"اصفهان","فریدن","مرکزی",31,283,0,2,40,325,1,326
"اصفهان","فریدن","مرکزی",32,830,2,0,44,876,3,879
"اصفهان","فریدن","مرکزی",33,770,6,2,33,811,2,813
"اصفهان","فریدن","مرکزی",34,526,4,2,46,578,0,578
"اصفهان","فریدن","مرکزی",35,448,0,1,50,499,1,500
"اصفهان","فریدن","مرکزی",36,574,3,0,121,698,6,704
"اصفهان","فریدن","مرکزی",37,517,7,0,95,619,2,621
"اصفهان","فریدن","مرکزی",38,717,2,0,80,799,0,799
"اصفهان","فریدن","مرکزی",39,309,3,0,30,342,0,342
"اصفهان","فریدن","مرکزی",40,618,2,1,112,733,0,733
"اصفهان","فریدن","مرکزی",41,575,1,1,73,650,2,652
"اصفهان","فریدن","مرکزی",42,338,0,0,14,352,0,352
"اصفهان","فریدن","مرکزی",43,599,0,0,19,618,2,620
"اصفهان","فریدن","مرکزی",44,433,0,0,68,501,4,505
"اصفهان","فریدن","مرکزی",45,414,9,2,251,676,2,678
"اصفهان","فریدن","مرکزی",46,295,2,1,96,394,2,396
"اصفهان","فریدن","مرکزی",47,686,2,0,70,758,1,759
"اصفهان","فریدن","مرکزی",48,593,0,1,90,684,0,684
"اصفهان","فریدن","مرکزی",49,698,5,0,66,769,0,769
"اصفهان","فریدن","مرکزی",50,457,2,0,40,499,0,499
"اصفهان","فریدن","بوئین_میاندشت",1,430,10,3,340,783,3,786
"اصفهان","فریدن","بوئین_میاندشت",2,864,20,4,482,1370,5,1375
"اصفهان","فریدن","بوئین_میاندشت",3,729,16,4,451,1200,4,1204
"اصفهان","فریدن","بوئین_میاندشت",4,543,18,1,301,863,10,873
"اصفهان","فریدن","بوئین_میاندشت",5,302,12,0,164,478,3,481
"اصفهان","فریدن","بوئین_میاندشت",6,427,4,2,139,572,2,574
"اصفهان","فریدن","بوئین_میاندشت",7,458,16,1,227,702,2,704
"اصفهان","فریدن","بوئین_میاندشت",8,115,2,0,82,199,1,200
"اصفهان","فریدن","بوئین_میاندشت",9,603,6,4,394,1007,4,1011
"اصفهان","فریدن","بوئین_میاندشت",10,591,7,1,252,851,7,858
"اصفهان","فریدن","بوئین_میاندشت",11,751,9,2,178,940,10,950
"اصفهان","فریدن","بوئین_میاندشت",12,362,2,0,57,421,0,421
"اصفهان","فریدن","بوئین_میاندشت",13,439,0,1,35,475,1,476
"اصفهان","فریدن","بوئین_میاندشت",14,374,1,2,29,406,3,409
"اصفهان","فریدن","بوئین_میاندشت",15,305,2,0,39,346,1,347
"اصفهان","فریدن","بوئین_میاندشت",16,206,0,2,13,221,2,223
"اصفهان","فریدن","بوئین_میاندشت",17,246,0,0,20,266,1,267
"اصفهان","فریدن","بوئین_میاندشت",18,478,1,0,16,495,1,496
"اصفهان","فریدن","بوئین_میاندشت",19,341,2,1,42,386,2,388
"اصفهان","فریدن","بوئین_میاندشت",20,333,0,1,86,420,1,421
"اصفهان","فریدن","بوئین_میاندشت",21,215,0,0,26,241,0,241
"اصفهان","فریدن","بوئین_میاندشت",22,215,1,1,13,230,4,234
"اصفهان","فریدن","بوئین_میاندشت",23,463,1,4,29,497,1,498
"اصفهان","فریدن","بوئین_میاندشت",24,236,0,0,32,268,0,268
"اصفهان","فریدن","بوئین_میاندشت",25,111,3,3,72,189,0,189
"اصفهان","فریدن","بوئین_میاندشت",26,189,1,2,36,228,0,228
"اصفهان","فریدن","بوئین_میاندشت",27,285,0,0,31,316,1,317
"اصفهان","فریدن","بوئین_میاندشت",28,547,1,0,125,673,2,675
"اصفهان","فریدن","بوئین_میاندشت",29,347,5,2,29,383,2,385
"اصفهان","فریدن","بوئین_میاندشت",30,170,1,0,43,214,0,214
"اصفهان","فریدن","بوئین_میاندشت",31,568,1,0,139,708,0,708
"اصفهان","فریدن","بوئین_میاندشت",32,287,2,1,26,316,1,317
"اصفهان","فریدن","بوئین_میاندشت",33,591,2,1,85,679,2,681
"اصفهان","فریدن","بوئین_میاندشت",34,75,8,1,15,99,3,102
"اصفهان","فریدونشهر","مرکزی",1,634,39,5,426,1104,16,1120
"اصفهان","فریدونشهر","مرکزی",2,665,26,3,351,1045,19,1064
"اصفهان","فریدونشهر","مرکزی",3,634,21,3,549,1207,12,1219
"اصفهان","فریدونشهر","مرکزی",4,816,25,7,627,1475,17,1492
"اصفهان","فریدونشهر","مرکزی",5,644,45,6,517,1212,12,1224
"اصفهان","فریدونشهر","مرکزی",6,879,9,11,392,1291,8,1299
"اصفهان","فریدونشهر","مرکزی",7,499,6,12,164,681,9,690
"اصفهان","فریدونشهر","مرکزی",8,267,11,0,92,370,3,373
"اصفهان","فریدونشهر","مرکزی",9,310,8,2,128,448,4,452
"اصفهان","فریدونشهر","مرکزی",10,129,6,0,2,137,0,137
"اصفهان","فریدونشهر","مرکزی",11,674,2,2,54,732,2,734
"اصفهان","فریدونشهر","مرکزی",12,477,6,3,187,673,3,676
"اصفهان","فریدونشهر","مرکزی",13,1096,10,0,184,1290,4,1294
"اصفهان","فریدونشهر","مرکزی",14,683,11,5,407,1106,8,1114
"اصفهان","فریدونشهر","مرکزی",15,739,12,2,135,888,4,892
"اصفهان","فریدونشهر","مرکزی",16,732,9,0,65,806,4,810
"اصفهان","فریدونشهر","مرکزی",17,799,7,2,37,845,6,851
"اصفهان","فریدونشهر","مرکزی",18,879,4,2,29,914,5,919
"اصفهان","فریدونشهر","مرکزی",19,684,8,1,58,751,5,756
"اصفهان","فریدونشهر","مرکزی",20,844,8,0,183,1035,12,1047
"اصفهان","فریدونشهر","مرکزی",21,561,4,0,23,588,0,588
"اصفهان","فریدونشهر","مرکزی",22,330,7,0,56,393,2,395
"اصفهان","فریدونشهر","مرکزی",23,333,25,0,65,423,1,424
"اصفهان","فریدونشهر","مرکزی",24,545,74,30,53,702,0,702
"اصفهان","فریدونشهر","مرکزی",25,392,17,2,12,423,2,425
"اصفهان","فریدونشهر","مرکزی",26,439,11,2,101,553,4,557
"اصفهان","فریدونشهر","مرکزی",27,185,22,2,17,226,0,226
"اصفهان","فریدونشهر","مرکزی",28,170,2,5,29,206,0,206
"اصفهان","فریدونشهر","مرکزی",29,233,5,7,39,284,0,284
"اصفهان","فریدونشهر","مرکزی",30,195,1,2,26,224,0,224
"اصفهان","فریدونشهر","مرکزی",31,294,20,11,19,344,0,344
"اصفهان","فریدونشهر","مرکزی",32,280,28,53,30,391,0,391
"اصفهان","فریدونشهر","مرکزی",33,174,5,29,17,225,2,227
"اصفهان","فریدونشهر","مرکزی",34,353,15,4,15,387,2,389
"اصفهان","فریدونشهر","مرکزی",35,187,4,3,19,213,0,213
"اصفهان","فریدونشهر","مرکزی",36,343,9,1,14,367,0,367
"اصفهان","فریدونشهر","مرکزی",37,295,15,0,16,326,3,329
"اصفهان","فریدونشهر","مرکزی",38,365,36,6,26,433,1,434
"اصفهان","فریدونشهر","مرکزی",39,152,37,1,11,201,0,201
"اصفهان","فریدونشهر","مرکزی",40,620,15,0,8,643,0,643
"اصفهان","فریدونشهر","مرکزی",41,288,18,0,6,312,1,313
"اصفهان","فریدونشهر","مرکزی",42,20,0,0,4,24,0,24
"اصفهان","فریدونشهر","مرکزی",43,251,10,0,14,275,2,277
"اصفهان","فریدونشهر","مرکزی",44,172,95,0,13,280,0,280
"اصفهان","فلاورجان","مرکزی",1,1002,42,6,266,1316,14,1330
"اصفهان","فلاورجان","مرکزی",2,812,32,0,353,1197,3,1200
"اصفهان","فلاورجان","مرکزی",3,694,22,1,151,868,5,873
"اصفهان","فلاورجان","مرکزی",4,916,316,27,229,1488,12,1500
"اصفهان","فلاورجان","مرکزی",5,1034,22,5,153,1214,16,1230
"اصفهان","فلاورجان","مرکزی",6,1075,150,15,246,1486,14,1500
"اصفهان","فلاورجان","مرکزی",7,826,15,2,112,955,7,962
"اصفهان","فلاورجان","مرکزی",8,682,26,7,170,885,2,887
"اصفهان","فلاورجان","مرکزی",9,861,29,3,140,1033,8,1041
"اصفهان","فلاورجان","مرکزی",10,375,5,8,86,474,3,477
"اصفهان","فلاورجان","مرکزی",11,840,5,4,118,967,6,973
"اصفهان","فلاورجان","مرکزی",12,736,28,5,125,894,6,900
"اصفهان","فلاورجان","مرکزی",13,252,47,0,39,338,2,340
"اصفهان","فلاورجان","مرکزی",14,567,201,2,134,904,6,910
"اصفهان","فلاورجان","مرکزی",15,954,157,48,125,1284,13,1297
"اصفهان","فلاورجان","مرکزی",16,628,94,2,79,803,6,809
"اصفهان","فلاورجان","مرکزی",17,610,36,5,244,895,4,899
"اصفهان","فلاورجان","مرکزی",18,387,12,1,95,495,4,499
"اصفهان","فلاورجان","مرکزی",19,1209,18,3,145,1375,1,1376
"اصفهان","فلاورجان","مرکزی",20,1065,9,0,107,1181,9,1190
"اصفهان","فلاورجان","مرکزی",21,1007,17,1,161,1186,8,1194
"اصفهان","فلاورجان","مرکزی",22,1114,5,4,321,1444,19,1463
"اصفهان","فلاورجان","مرکزی",23,954,8,4,128,1094,6,1100
"اصفهان","فلاورجان","مرکزی",24,1006,8,4,354,1372,9,1381
"اصفهان","فلاورجان","مرکزی",25,1265,9,1,307,1582,6,1588
"اصفهان","فلاورجان","مرکزی",26,696,5,1,190,892,9,901
"اصفهان","فلاورجان","مرکزی",27,986,7,2,100,1095,5,1100
"اصفهان","فلاورجان","مرکزی",28,1762,7,0,161,1930,1,1931
"اصفهان","فلاورجان","مرکزی",29,382,3,0,111,496,3,499
"اصفهان","فلاورجان","مرکزی",30,699,7,0,84,790,9,799
"اصفهان","فلاورجان","مرکزی",31,1360,5,1,46,1412,4,1416
"اصفهان","فلاورجان","مرکزی",32,867,6,0,170,1043,7,1050
"اصفهان","فلاورجان","مرکزی",33,947,4,3,138,1092,4,1096
"اصفهان","فلاورجان","مرکزی",34,608,6,1,170,785,13,798
"اصفهان","فلاورجان","مرکزی",35,1676,28,5,231,1940,7,1947
"اصفهان","فلاورجان","مرکزی",36,1097,14,0,177,1288,19,1307
"اصفهان","فلاورجان","مرکزی",37,1210,14,1,161,1386,14,1400
"اصفهان","فلاورجان","مرکزی",38,664,6,0,117,787,4,791
"اصفهان","فلاورجان","مرکزی",39,1026,20,0,145,1191,8,1199
"اصفهان","فلاورجان","مرکزی",40,1583,29,1,176,1789,8,1797
"اصفهان","فلاورجان","مرکزی",41,940,11,3,141,1095,5,1100
"اصفهان","فلاورجان","مرکزی",42,1345,23,0,277,1645,10,1655
"اصفهان","فلاورجان","مرکزی",43,1186,103,3,145,1437,7,1444
"اصفهان","فلاورجان","مرکزی",44,1069,21,5,212,1307,12,1319
"اصفهان","فلاورجان","مرکزی",45,1022,23,6,337,1388,10,1398
"اصفهان","فلاورجان","مرکزی",46,892,16,6,175,1089,11,1100
"اصفهان","فلاورجان","مرکزی",47,991,19,0,179,1189,10,1199
"اصفهان","فلاورجان","مرکزی",48,985,9,2,225,1221,5,1226
"اصفهان","فلاورجان","مرکزی",49,849,6,0,84,939,6,945
"اصفهان","فلاورجان","مرکزی",50,1110,15,3,163,1291,9,1300
"اصفهان","فلاورجان","مرکزی",51,936,15,15,282,1248,7,1255
"اصفهان","فلاورجان","مرکزی",52,823,18,7,247,1095,5,1100
"اصفهان","فلاورجان","مرکزی",53,976,33,4,160,1173,5,1178
"اصفهان","فلاورجان","مرکزی",54,1257,14,0,124,1395,4,1399
"اصفهان","فلاورجان","مرکزی",55,903,45,3,185,1136,8,1144
"اصفهان","فلاورجان","مرکزی",56,722,126,9,137,994,6,1000
"اصفهان","فلاورجان","مرکزی",57,1235,14,0,274,1523,10,1533
"اصفهان","فلاورجان","مرکزی",58,1095,16,1,205,1317,3,1320
"اصفهان","فلاورجان","مرکزی",59,716,1,0,137,854,3,857
"اصفهان","فلاورجان","مرکزی",60,374,13,1,108,496,4,500
"اصفهان","فلاورجان","مرکزی",61,1338,15,3,135,1491,8,1499
"اصفهان","فلاورجان","مرکزی",62,1227,5,6,74,1312,11,1323
"اصفهان","فلاورجان","مرکزی",63,819,20,2,204,1045,12,1057
"اصفهان","فلاورجان","مرکزی",64,814,11,10,139,974,4,978
"اصفهان","فلاورجان","مرکزی",65,1034,40,2,123,1199,10,1209
"اصفهان","فلاورجان","مرکزی",66,1149,72,7,127,1355,12,1367
"اصفهان","فلاورجان","مرکزی",67,731,4,1,70,806,9,815
"اصفهان","فلاورجان","مرکزی",68,870,35,5,84,994,5,999
"اصفهان","فلاورجان","مرکزی",69,780,8,2,113,903,16,919
"اصفهان","فلاورجان","مرکزی",70,561,18,0,18,597,3,600
"اصفهان","فلاورجان","مرکزی",71,1364,8,3,160,1535,9,1544
"اصفهان","فلاورجان","مرکزی",72,1388,9,0,98,1495,4,1499
"اصفهان","فلاورجان","مرکزی",73,1099,6,0,85,1190,4,1194
"اصفهان","فلاورجان","مرکزی",74,639,3,2,52,696,2,698
"اصفهان","فلاورجان","مرکزی",75,966,3,1,43,1013,1,1014
"اصفهان","فلاورجان","مرکزی",76,529,4,0,92,625,2,627
"اصفهان","فلاورجان","مرکزی",77,409,3,0,77,489,3,492
"اصفهان","فلاورجان","مرکزی",78,686,3,4,137,830,3,833
"اصفهان","فلاورجان","مرکزی",79,599,5,4,85,693,1,694
"اصفهان","فلاورجان","مرکزی",80,566,36,1,88,691,9,700
"اصفهان","فلاورجان","مرکزی",81,1015,1,2,79,1097,3,1100
"اصفهان","فلاورجان","مرکزی",82,1035,11,0,143,1189,10,1199
"اصفهان","فلاورجان","مرکزی",83,1116,7,3,139,1265,8,1273
"اصفهان","فلاورجان","مرکزی",84,912,5,2,73,992,0,992
"اصفهان","فلاورجان","مرکزی",85,503,11,0,202,716,3,719
"اصفهان","فلاورجان","مرکزی",86,863,9,0,304,1176,7,1183
"اصفهان","فلاورجان","مرکزی",87,982,11,0,251,1244,14,1258
"اصفهان","فلاورجان","مرکزی",88,932,9,0,129,1070,7,1077
"اصفهان","فلاورجان","مرکزی",89,983,19,2,226,1230,17,1247
"اصفهان","فلاورجان","مرکزی",90,1224,8,1,157,1390,9,1399
"اصفهان","فلاورجان","مرکزی",91,1244,69,5,171,1489,3,1492
"اصفهان","فلاورجان","مرکزی",92,818,18,7,57,900,0,900
"اصفهان","فلاورجان","پیربکران",1,1148,15,6,368,1537,13,1550
"اصفهان","فلاورجان","پیربکران",2,510,8,1,173,692,7,699
"اصفهان","فلاورجان","پیربکران",3,1156,5,0,129,1290,10,1300
"اصفهان","فلاورجان","پیربکران",4,934,5,2,150,1091,9,1100
"اصفهان","فلاورجان","پیربکران",5,778,3,0,87,868,7,875
"اصفهان","فلاورجان","پیربکران",6,870,5,0,58,933,6,939
"اصفهان","فلاورجان","پیربکران",7,614,3,0,180,797,3,800
"اصفهان","فلاورجان","پیربکران",8,1356,6,0,176,1538,11,1549
"اصفهان","فلاورجان","پیربکران",9,1138,14,0,188,1340,10,1350
"اصفهان","فلاورجان","پیربکران",10,1157,1,0,85,1243,7,1250
"اصفهان","فلاورجان","پیربکران",11,981,1,0,76,1058,4,1062
"اصفهان","فلاورجان","پیربکران",12,499,2,0,31,532,3,535
"اصفهان","فلاورجان","پیربکران",13,1047,2,2,93,1144,6,1150
"اصفهان","فلاورجان","پیربکران",14,691,3,0,53,747,3,750
"اصفهان","فلاورجان","پیربکران",15,691,5,0,93,789,5,794
"اصفهان","فلاورجان","پیربکران",16,688,3,0,27,718,1,719
"اصفهان","فلاورجان","پیربکران",17,377,0,0,46,423,3,426
"اصفهان","فلاورجان","پیربکران",18,608,3,1,65,677,8,685
"اصفهان","فلاورجان","پیربکران",19,514,0,0,17,531,2,533
"اصفهان","فلاورجان","پیربکران",20,406,0,0,24,430,1,431
"اصفهان","فلاورجان","پیربکران",21,867,2,0,72,941,8,949
"اصفهان","فلاورجان","پیربکران",22,764,1,0,81,846,4,850
"اصفهان","فلاورجان","پیربکران",23,541,5,4,61,611,4,615
"اصفهان","فلاورجان","پیربکران",24,1139,1,0,71,1211,4,1215
"اصفهان","فلاورجان","پیربکران",25,529,0,0,67,596,4,600
"اصفهان","فلاورجان","پیربکران",26,732,10,0,193,935,15,950
"اصفهان","فلاورجان","پیربکران",27,930,10,3,289,1232,18,1250
"اصفهان","فلاورجان","پیربکران",28,1238,3,3,126,1370,6,1376
"اصفهان","فلاورجان","پیربکران",29,1091,7,3,95,1196,3,1199
"اصفهان","فلاورجان","پیربکران",30,803,3,0,94,900,0,900
"اصفهان","فلاورجان","پیربکران",31,697,7,0,96,800,0,800
"اصفهان","فلاورجان","پیربکران",32,536,1,0,60,597,3,600
"اصفهان","فلاورجان","پیربکران",33,1024,3,0,58,1085,11,1096
"اصفهان","فلاورجان","پیربکران",34,649,1,0,73,723,6,729
"اصفهان","فلاورجان","پیربکران",35,270,5,5,60,340,2,342
"اصفهان","کاشان","مرکزی",1,468,23,1,249,741,8,749
"اصفهان","کاشان","مرکزی",2,1113,30,6,336,1485,14,1499
"اصفهان","کاشان","مرکزی",3,892,24,20,367,1303,25,1328
"اصفهان","کاشان","مرکزی",4,494,4,4,92,594,3,597
"اصفهان","کاشان","مرکزی",5,579,20,6,452,1057,19,1076
"اصفهان","کاشان","مرکزی",6,467,23,12,338,840,24,864
"اصفهان","کاشان","مرکزی",7,565,25,5,330,925,22,947
"اصفهان","کاشان","مرکزی",8,1362,30,1,296,1689,21,1710
"اصفهان","کاشان","مرکزی",9,1066,25,3,247,1341,29,1370
"اصفهان","کاشان","مرکزی",10,1090,14,0,203,1307,10,1317
"اصفهان","کاشان","مرکزی",11,157,7,0,163,327,5,332
"اصفهان","کاشان","مرکزی",12,450,16,11,222,699,15,714
"اصفهان","کاشان","مرکزی",13,1595,49,12,832,2488,45,2533
"اصفهان","کاشان","مرکزی",14,685,15,6,502,1208,23,1231
"اصفهان","کاشان","مرکزی",15,809,17,1,226,1053,9,1062
"اصفهان","کاشان","مرکزی",16,379,12,2,101,494,13,507
"اصفهان","کاشان","مرکزی",17,1348,35,3,430,1816,32,1848
"اصفهان","کاشان","مرکزی",18,518,35,7,432,992,14,1006
"اصفهان","کاشان","مرکزی",19,292,16,5,209,522,5,527
"اصفهان","کاشان","مرکزی",20,566,5,12,115,698,12,710
"اصفهان","کاشان","مرکزی",21,660,13,0,197,870,15,885
"اصفهان","کاشان","مرکزی",22,730,22,4,389,1145,18,1163
"اصفهان","کاشان","مرکزی",23,735,8,2,181,926,21,947
"اصفهان","کاشان","مرکزی",24,359,11,2,126,498,8,506
"اصفهان","کاشان","مرکزی",25,635,7,1,108,751,8,759
"اصفهان","کاشان","مرکزی",26,586,4,0,104,694,17,711
"اصفهان","کاشان","مرکزی",27,340,5,3,56,404,11,415
"اصفهان","کاشان","مرکزی",28,1165,14,10,207,1396,31,1427
"اصفهان","کاشان","مرکزی",29,1142,11,1,121,1275,14,1289
"اصفهان","کاشان","مرکزی",30,790,14,2,115,921,14,935
"اصفهان","کاشان","مرکزی",31,950,15,1,239,1205,9,1214
"اصفهان","کاشان","مرکزی",32,706,10,2,97,815,9,824
"اصفهان","کاشان","مرکزی",33,990,17,3,221,1231,19,1250
"اصفهان","کاشان","مرکزی",34,856,21,3,267,1147,25,1172
"اصفهان","کاشان","مرکزی",35,1369,22,3,232,1626,15,1641
"اصفهان","کاشان","مرکزی",36,1646,11,12,192,1861,20,1881
"اصفهان","کاشان","مرکزی",37,1180,16,3,150,1349,24,1373
"اصفهان","کاشان","مرکزی",38,1613,37,2,335,1987,24,2011
"اصفهان","کاشان","مرکزی",39,422,7,4,130,563,22,585
"اصفهان","کاشان","مرکزی",40,695,31,1,168,895,12,907
"اصفهان","کاشان","مرکزی",41,1180,24,1,253,1458,24,1482
"اصفهان","کاشان","مرکزی",42,989,26,4,294,1313,28,1341
"اصفهان","کاشان","مرکزی",43,788,23,0,291,1102,15,1117
"اصفهان","کاشان","مرکزی",44,721,28,0,365,1114,29,1143
"اصفهان","کاشان","مرکزی",45,338,20,3,166,527,13,540
"اصفهان","کاشان","مرکزی",46,233,12,0,155,400,12,412
"اصفهان","کاشان","مرکزی",47,462,29,4,298,793,25,818
"اصفهان","کاشان","مرکزی",48,278,14,0,202,494,18,512
"اصفهان","کاشان","مرکزی",49,233,17,8,183,441,14,455
"اصفهان","کاشان","مرکزی",50,338,23,7,440,808,25,833
"اصفهان","کاشان","مرکزی",51,619,26,4,673,1322,16,1338
"اصفهان","کاشان","مرکزی",52,515,26,1,387,929,18,947
"اصفهان","کاشان","مرکزی",53,467,19,6,259,751,17,768
"اصفهان","کاشان","مرکزی",54,834,16,5,480,1335,41,1376
"اصفهان","کاشان","مرکزی",55,1248,23,2,406,1679,21,1700
"اصفهان","کاشان","مرکزی",56,949,18,1,218,1186,23,1209
"اصفهان","کاشان","مرکزی",57,674,25,0,354,1053,18,1071
"اصفهان","کاشان","مرکزی",58,216,5,0,82,303,10,313
"اصفهان","کاشان","مرکزی",59,925,36,10,591,1562,27,1589
"اصفهان","کاشان","مرکزی",60,426,12,2,154,594,12,606
"اصفهان","کاشان","مرکزی",61,693,39,5,484,1221,31,1252
"اصفهان","کاشان","مرکزی",62,542,17,2,296,857,16,873
"اصفهان","کاشان","مرکزی",63,383,9,2,138,532,9,541
"اصفهان","کاشان","مرکزی",64,908,17,2,167,1094,10,1104
"اصفهان","کاشان","مرکزی",65,297,6,0,129,432,11,443
"اصفهان","کاشان","مرکزی",66,705,12,5,336,1058,18,1076
"اصفهان","کاشان","مرکزی",67,681,38,5,534,1258,36,1294
"اصفهان","کاشان","مرکزی",68,306,18,0,371,695,17,712
"اصفهان","کاشان","مرکزی",69,707,50,14,973,1744,34,1778
"اصفهان","کاشان","مرکزی",70,503,33,3,631,1170,22,1192
"اصفهان","کاشان","مرکزی",71,570,40,8,971,1589,28,1617
"اصفهان","کاشان","مرکزی",72,689,36,4,598,1327,30,1357
"اصفهان","کاشان","مرکزی",73,675,12,1,324,1012,21,1033
"اصفهان","کاشان","مرکزی",74,618,39,9,479,1145,21,1166
"اصفهان","کاشان","مرکزی",75,870,17,2,275,1164,25,1189
"اصفهان","کاشان","مرکزی",76,527,21,7,342,897,11,908
"اصفهان","کاشان","مرکزی",77,761,27,2,555,1345,28,1373
"اصفهان","کاشان","مرکزی",78,477,28,17,605,1127,24,1151
"اصفهان","کاشان","مرکزی",79,429,24,5,448,906,18,924
"اصفهان","کاشان","مرکزی",80,998,31,13,567,1609,37,1646
"اصفهان","کاشان","مرکزی",81,1025,26,5,293,1349,28,1377
"اصفهان","کاشان","مرکزی",82,994,20,36,226,1276,13,1289
"اصفهان","کاشان","مرکزی",83,1140,21,40,369,1570,30,1600
"اصفهان","کاشان","مرکزی",84,880,26,3,373,1282,22,1304
"اصفهان","کاشان","مرکزی",85,472,7,5,231,715,7,722
"اصفهان","کاشان","مرکزی",86,1123,28,4,519,1674,20,1694
"اصفهان","کاشان","مرکزی",87,465,11,4,303,783,15,798
"اصفهان","کاشان","مرکزی",88,809,26,9,366,1210,21,1231
"اصفهان","کاشان","مرکزی",89,933,17,2,212,1164,11,1175
"اصفهان","کاشان","مرکزی",90,561,21,5,315,902,13,915
"اصفهان","کاشان","مرکزی",91,436,15,3,159,613,17,630
"اصفهان","کاشان","مرکزی",92,724,23,5,332,1084,29,1113
"اصفهان","کاشان","مرکزی",93,1320,38,13,612,1983,35,2018
"اصفهان","کاشان","مرکزی",94,837,37,7,609,1490,17,1507
"اصفهان","کاشان","مرکزی",95,841,31,2,334,1208,29,1237
"اصفهان","کاشان","مرکزی",96,452,13,1,128,594,18,612
"اصفهان","کاشان","مرکزی",97,373,26,5,348,752,14,766
"اصفهان","کاشان","مرکزی",98,130,2,2,118,252,3,255
"اصفهان","کاشان","مرکزی",99,623,38,11,638,1310,15,1325
"اصفهان","کاشان","مرکزی",100,773,41,3,618,1435,38,1473
"اصفهان","کاشان","مرکزی",101,813,47,7,795,1662,34,1696
"اصفهان","کاشان","مرکزی",102,216,15,1,250,482,4,486
"اصفهان","کاشان","مرکزی",103,741,18,2,425,1186,20,1206
"اصفهان","کاشان","مرکزی",104,651,16,6,277,950,19,969
"اصفهان","کاشان","مرکزی",105,701,19,3,210,933,16,949
"اصفهان","کاشان","مرکزی",106,375,20,3,384,782,17,799
"اصفهان","کاشان","مرکزی",107,532,4,1,69,606,5,611
"اصفهان","کاشان","مرکزی",108,1410,18,2,381,1811,25,1836
"اصفهان","کاشان","مرکزی",109,1002,15,5,231,1253,13,1266
"اصفهان","کاشان","مرکزی",110,515,5,5,118,643,12,655
"اصفهان","کاشان","مرکزی",111,829,4,1,106,940,9,949
"اصفهان","کاشان","مرکزی",112,1046,16,7,245,1314,15,1329
"اصفهان","کاشان","مرکزی",113,1043,10,0,203,1256,2,1258
"اصفهان","کاشان","مرکزی",114,759,3,0,84,846,4,850
"اصفهان","کاشان","مرکزی",115,957,4,1,126,1088,5,1093
"اصفهان","کاشان","مرکزی",116,594,22,312,8,936,27,963
"اصفهان","کاشان","مرکزی",117,675,49,14,359,1097,39,1136
"اصفهان","کاشان","مرکزی",118,994,34,13,366,1407,11,1418
"اصفهان","کاشان","مرکزی",119,1194,27,12,341,1574,17,1591
"اصفهان","کاشان","مرکزی",120,593,14,7,84,698,7,705
"اصفهان","کاشان","مرکزی",121,908,38,8,293,1247,19,1266
"اصفهان","کاشان","مرکزی",122,979,26,2,335,1342,36,1378
"اصفهان","کاشان","مرکزی",123,767,15,8,191,981,9,990
"اصفهان","کاشان","مرکزی",124,479,8,1,67,555,3,558
"اصفهان","کاشان","مرکزی",125,750,19,0,344,1113,20,1133
"اصفهان","کاشان","مرکزی",126,578,20,1,405,1004,27,1031
"اصفهان","کاشان","مرکزی",127,718,8,0,185,911,15,926
"اصفهان","کاشان","مرکزی",128,208,6,0,110,324,7,331
"اصفهان","کاشان","مرکزی",129,111,1,0,49,161,2,163
"اصفهان","کاشان","مرکزی",130,321,1,1,105,428,5,433
"اصفهان","کاشان","مرکزی",131,322,19,11,170,522,10,532
"اصفهان","کاشان","مرکزی",132,1258,5,5,258,1526,15,1541
"اصفهان","کاشان","مرکزی",133,741,4,3,307,1055,9,1064
"اصفهان","کاشان","مرکزی",134,651,2,0,40,693,5,698
"اصفهان","کاشان","مرکزی",135,1040,8,1,129,1178,11,1189
"اصفهان","کاشان","مرکزی",136,627,4,0,63,694,3,697
"اصفهان","کاشان","مرکزی",137,1030,7,0,113,1150,7,1157
"اصفهان","کاشان","مرکزی",138,784,28,1,292,1105,5,1110
"اصفهان","کاشان","مرکزی",139,470,7,0,137,614,5,619
"اصفهان","کاشان","مرکزی",140,237,2,4,93,336,0,336
"اصفهان","کاشان","مرکزی",141,712,2,4,106,824,8,832
"اصفهان","کاشان","مرکزی",142,272,5,0,54,331,6,337
"اصفهان","کاشان","مرکزی",143,163,4,3,81,251,8,259
"اصفهان","کاشان","مرکزی",144,382,3,0,34,419,2,421
"اصفهان","کاشان","قمصر",1,1004,31,6,530,1571,29,1600
"اصفهان","کاشان","قمصر",2,983,37,14,568,1602,25,1627
"اصفهان","کاشان","قمصر",3,717,15,0,246,978,11,989
"اصفهان","کاشان","قمصر",4,887,11,0,106,1004,6,1010
"اصفهان","کاشان","قمصر",5,532,2,1,105,640,6,646
"اصفهان","کاشان","قمصر",6,1003,2,1,228,1234,4,1238
"اصفهان","کاشان","قمصر",7,717,7,0,151,875,2,877
"اصفهان","کاشان","قمصر",8,511,1,0,114,626,2,628
"اصفهان","کاشان","قمصر",9,1039,3,0,283,1325,7,1332
"اصفهان","کاشان","قمصر",10,475,0,0,66,541,2,543
"اصفهان","کاشان","قمصر",11,442,11,6,251,710,9,719
"اصفهان","کاشان","نیاسر",12,725,18,2,305,1050,14,1064
"اصفهان","کاشان","نیاسر",13,534,5,0,205,744,9,753
"اصفهان","کاشان","نیاسر",14,760,10,6,197,973,19,992
"اصفهان","کاشان","نیاسر",15,439,2,1,69,511,4,515
"اصفهان","کاشان","نیاسر",16,846,17,4,241,1108,4,1112
"اصفهان","کاشان","نیاسر",17,664,6,1,121,792,1,793
"اصفهان","کاشان","نیاسر",18,865,9,2,242,1118,20,1138
"اصفهان","کاشان","نیاسر",19,818,9,1,231,1059,7,1066
"اصفهان","کاشان","نیاسر",20,475,9,1,105,590,3,593
"اصفهان","کاشان","نیاسر",21,1144,18,1,203,1366,9,1375
"اصفهان","کاشان","نیاسر",22,984,23,2,203,1212,12,1224
"اصفهان","کاشان","نیاسر",23,527,13,1,124,665,1,666
"اصفهان","کاشان","برزک",1,944,7,11,186,1148,7,1155
"اصفهان","کاشان","برزک",2,872,9,9,187,1077,14,1091
"اصفهان","کاشان","برزک",3,551,6,2,144,703,9,712
"اصفهان","کاشان","برزک",4,623,8,1,101,733,5,738
"اصفهان","کاشان","برزک",5,586,7,3,101,697,1,698
"اصفهان","کاشان","برزک",6,1002,1,0,61,1064,6,1070
"اصفهان","کاشان","برزک",7,682,6,0,86,774,5,779
"اصفهان","کاشان","برزک",8,775,4,2,45,826,7,833
"اصفهان","کاشان","برزک",9,1229,3,0,89,1321,8,1329
"اصفهان","کاشان","برزک",10,490,5,0,136,631,6,637
"اصفهان","کاشان","برزک",11,631,1,0,28,660,0,660
"اصفهان","گلپایگان","مرکزی",1,456,5,7,318,786,13,799
"اصفهان","گلپایگان","مرکزی",2,586,12,7,328,933,14,947
"اصفهان","گلپایگان","مرکزی",3,519,13,8,408,948,12,960
"اصفهان","گلپایگان","مرکزی",4,657,20,5,303,985,11,996
"اصفهان","گلپایگان","مرکزی",5,659,25,12,563,1259,16,1275
"اصفهان","گلپایگان","مرکزی",6,576,22,6,448,1052,10,1062
"اصفهان","گلپایگان","مرکزی",7,420,12,4,214,650,8,658
"اصفهان","گلپایگان","مرکزی",8,874,22,9,622,1527,23,1550
"اصفهان","گلپایگان","مرکزی",9,777,12,5,409,1203,11,1214
"اصفهان","گلپایگان","مرکزی",10,627,9,7,374,1017,20,1037
"اصفهان","گلپایگان","مرکزی",11,545,16,5,276,842,11,853
"اصفهان","گلپایگان","مرکزی",12,612,7,5,230,854,14,868
"اصفهان","گلپایگان","مرکزی",13,712,13,3,247,975,13,988
"اصفهان","گلپایگان","مرکزی",14,760,17,9,407,1193,20,1213
"اصفهان","گلپایگان","مرکزی",15,718,14,2,353,1087,16,1103
"اصفهان","گلپایگان","مرکزی",16,785,15,3,310,1113,18,1131
"اصفهان","گلپایگان","مرکزی",17,618,8,1,343,970,16,986
"اصفهان","گلپایگان","مرکزی",18,718,15,3,225,961,8,969
"اصفهان","گلپایگان","مرکزی",19,623,1,1,102,727,8,735
"اصفهان","گلپایگان","مرکزی",20,856,15,6,453,1330,16,1346
"اصفهان","گلپایگان","مرکزی",21,796,32,4,260,1092,17,1109
"اصفهان","گلپایگان","مرکزی",22,840,14,17,249,1120,9,1129
"اصفهان","گلپایگان","مرکزی",23,1024,12,4,213,1253,14,1267
"اصفهان","گلپایگان","مرکزی",24,668,5,7,148,828,6,834
"اصفهان","گلپایگان","مرکزی",25,467,7,8,207,689,18,707
"اصفهان","گلپایگان","مرکزی",26,397,10,2,169,578,7,585
"اصفهان","گلپایگان","مرکزی",27,508,2,1,151,662,6,668
"اصفهان","گلپایگان","مرکزی",28,333,0,3,114,450,2,452
"اصفهان","گلپایگان","مرکزی",29,375,13,1,235,624,6,630
"اصفهان","گلپایگان","مرکزی",30,325,8,9,174,516,4,520
"اصفهان","گلپایگان","مرکزی",31,299,3,2,62,366,3,369
"اصفهان","گلپایگان","مرکزی",32,550,9,2,208,769,5,774
"اصفهان","گلپایگان","مرکزی",33,494,13,3,256,766,9,775
"اصفهان","گلپایگان","مرکزی",34,542,15,1,181,739,4,743
"اصفهان","گلپایگان","مرکزی",35,598,8,3,221,830,7,837
"اصفهان","گلپایگان","مرکزی",36,725,10,2,227,964,7,971
"اصفهان","گلپایگان","مرکزی",37,462,6,1,99,568,4,572
"اصفهان","گلپایگان","مرکزی",38,969,6,2,156,1133,6,1139
"اصفهان","گلپایگان","مرکزی",39,286,4,1,85,376,2,378
"اصفهان","گلپایگان","مرکزی",40,1083,11,2,173,1269,3,1272
"اصفهان","گلپایگان","مرکزی",41,677,3,6,234,920,2,922
"اصفهان","گلپایگان","مرکزی",42,879,4,1,114,998,2,1000
"اصفهان","گلپایگان","مرکزی",43,495,6,1,117,619,5,624
"اصفهان","گلپایگان","مرکزی",44,567,2,0,75,644,0,644
"اصفهان","گلپایگان","مرکزی",45,588,9,0,137,734,5,739
"اصفهان","گلپایگان","مرکزی",46,380,5,0,50,435,0,435
"اصفهان","گلپایگان","مرکزی",47,364,3,0,40,407,1,408
"اصفهان","گلپایگان","مرکزی",48,248,4,2,62,316,5,321
"اصفهان","گلپایگان","مرکزی",49,448,6,0,72,526,3,529
"اصفهان","گلپایگان","مرکزی",50,356,1,1,45,403,1,404
"اصفهان","گلپایگان","مرکزی",51,328,1,0,38,367,1,368
"اصفهان","گلپایگان","مرکزی",52,507,9,0,63,579,4,583
"اصفهان","گلپایگان","مرکزی",53,626,3,0,93,722,3,725
"اصفهان","گلپایگان","مرکزی",54,737,6,1,144,888,4,892
"اصفهان","گلپایگان","مرکزی",55,317,5,0,100,422,2,424
"اصفهان","گلپایگان","مرکزی",56,634,2,0,89,725,2,727
"اصفهان","گلپایگان","مرکزی",57,351,1,1,51,404,1,405
"اصفهان","گلپایگان","مرکزی",58,592,4,0,49,645,0,645
"اصفهان","گلپایگان","مرکزی",59,486,10,9,127,632,5,637
"اصفهان","گلپایگان","مرکزی",60,518,11,4,105,638,4,642
"اصفهان","گلپایگان","مرکزی",61,267,0,0,48,315,1,316
"اصفهان","گلپایگان","مرکزی",62,247,4,2,99,352,1,353
"اصفهان","گلپایگان","مرکزی",63,170,2,0,39,211,1,212
"اصفهان","گلپایگان","مرکزی",64,241,1,2,81,325,5,330
"اصفهان","گلپایگان","مرکزی",65,254,4,0,33,291,2,293
"اصفهان","گلپایگان","مرکزی",66,955,2,5,53,1015,5,1020
"اصفهان","گلپایگان","مرکزی",67,622,14,0,130,766,10,776
"اصفهان","گلپایگان","مرکزی",68,253,0,5,21,279,3,282
"اصفهان","گلپایگان","مرکزی",69,301,7,1,78,387,6,393
"اصفهان","گلپایگان","مرکزی",70,327,4,4,30,365,0,365
"اصفهان","لنجان","مرکزی",1,1161,118,5,196,1480,15,1495
"اصفهان","لنجان","مرکزی",2,708,40,2,93,843,10,853
"اصفهان","لنجان","مرکزی",3,692,86,3,268,1049,13,1062
"اصفهان","لنجان","مرکزی",4,1154,60,2,409,1625,25,1650
"اصفهان","لنجان","مرکزی",5,1300,27,6,276,1609,9,1618
"اصفهان","لنجان","مرکزی",6,992,26,6,334,1358,14,1372
"اصفهان","لنجان","مرکزی",7,805,4,1,233,1043,15,1058
"اصفهان","لنجان","مرکزی",8,781,5,1,106,893,13,906
"اصفهان","لنجان","مرکزی",9,1259,20,0,282,1561,20,1581
"اصفهان","لنجان","مرکزی",10,637,16,5,232,890,7,897
"اصفهان","لنجان","مرکزی",11,461,4,2,288,755,7,762
"اصفهان","لنجان","مرکزی",12,869,36,4,210,1119,14,1133
"اصفهان","لنجان","مرکزی",13,925,24,0,287,1236,11,1247
"اصفهان","لنجان","مرکزی",14,1112,28,7,227,1374,13,1387
"اصفهان","لنجان","مرکزی",15,1095,25,2,378,1500,24,1524
"اصفهان","لنجان","مرکزی",16,588,24,0,220,832,10,842
"اصفهان","لنجان","مرکزی",17,771,9,7,355,1142,21,1163
"اصفهان","لنجان","مرکزی",18,936,19,5,572,1532,21,1553
"اصفهان","لنجان","مرکزی",19,806,12,1,255,1074,17,1091
"اصفهان","لنجان","مرکزی",20,1448,45,3,432,1928,20,1948
"اصفهان","لنجان","مرکزی",21,1133,71,2,493,1699,15,1714
"اصفهان","لنجان","مرکزی",22,1040,49,2,489,1580,24,1604
"اصفهان","لنجان","مرکزی",23,893,55,6,437,1391,16,1407
"اصفهان","لنجان","مرکزی",24,526,14,5,204,749,18,767
"اصفهان","لنجان","مرکزی",25,412,8,0,172,592,3,595
"اصفهان","لنجان","مرکزی",26,1095,10,0,140,1245,8,1253
"اصفهان","لنجان","مرکزی",27,388,10,1,73,472,4,476
"اصفهان","لنجان","مرکزی",28,1085,177,30,474,1766,8,1774
"اصفهان","لنجان","مرکزی",29,657,81,24,466,1228,13,1241
"اصفهان","لنجان","مرکزی",30,657,67,48,586,1358,18,1376
"اصفهان","لنجان","مرکزی",31,807,136,30,916,1889,19,1908
"اصفهان","لنجان","مرکزی",32,980,124,32,947,2083,16,2099
"اصفهان","لنجان","مرکزی",33,988,137,20,803,1948,19,1967
"اصفهان","لنجان","مرکزی",34,445,64,18,313,840,9,849
"اصفهان","لنجان","مرکزی",35,903,138,10,509,1560,20,1580
"اصفهان","لنجان","مرکزی",36,640,85,11,399,1135,15,1150
"اصفهان","لنجان","مرکزی",37,1260,138,31,1080,2509,28,2537
"اصفهان","لنجان","مرکزی",38,1215,113,23,509,1860,33,1893
"اصفهان","لنجان","مرکزی",39,753,124,13,624,1514,19,1533
"اصفهان","لنجان","مرکزی",40,648,109,17,556,1330,15,1345
"اصفهان","لنجان","مرکزی",41,631,158,11,438,1238,17,1255
"اصفهان","لنجان","مرکزی",42,877,203,18,384,1482,18,1500
"اصفهان","لنجان","مرکزی",43,498,73,10,382,963,11,974
"اصفهان","لنجان","مرکزی",44,829,126,37,496,1488,0,1488
"اصفهان","لنجان","مرکزی",45,775,145,10,540,1470,8,1478
"اصفهان","لنجان","مرکزی",46,699,87,16,423,1225,8,1233
"اصفهان","لنجان","مرکزی",47,370,76,9,313,768,2,770
"اصفهان","لنجان","مرکزی",48,587,128,24,378,1117,14,1131
"اصفهان","لنجان","مرکزی",49,498,148,16,282,944,8,952
"اصفهان","لنجان","مرکزی",50,442,56,10,360,868,11,879
"اصفهان","لنجان","مرکزی",51,1170,18,6,267,1461,10,1471
"اصفهان","لنجان","مرکزی",52,1504,37,3,223,1767,21,1788
"اصفهان","لنجان","مرکزی",53,965,40,0,182,1187,5,1192
"اصفهان","لنجان","مرکزی",54,1327,129,4,282,1742,16,1758
"اصفهان","لنجان","مرکزی",55,694,9,2,117,822,1,823
"اصفهان","لنجان","مرکزی",56,889,12,1,91,993,7,1000
"اصفهان","لنجان","مرکزی",57,710,35,2,205,952,8,960
"اصفهان","لنجان","مرکزی",58,1514,155,3,288,1960,22,1982
"اصفهان","لنجان","مرکزی",59,1303,33,15,303,1654,13,1667
"اصفهان","لنجان","مرکزی",60,1237,69,5,312,1623,7,1630
"اصفهان","لنجان","مرکزی",61,1706,52,8,288,2054,6,2060
"اصفهان","لنجان","مرکزی",62,1178,47,5,341,1571,19,1590
"اصفهان","لنجان","مرکزی",63,1060,91,8,234,1393,13,1406
"اصفهان","لنجان","مرکزی",64,1075,269,1,243,1588,9,1597
"اصفهان","لنجان","مرکزی",65,1420,75,12,240,1747,15,1762
"اصفهان","لنجان","مرکزی",66,850,417,10,221,1498,12,1510
"اصفهان","لنجان","مرکزی",67,1218,58,2,200,1478,12,1490
"اصفهان","لنجان","مرکزی",68,1197,97,1,317,1612,7,1619
"اصفهان","لنجان","مرکزی",69,440,35,0,171,646,8,654
"اصفهان","لنجان","مرکزی",70,1123,10,3,252,1388,12,1400
"اصفهان","لنجان","مرکزی",71,890,10,1,296,1197,3,1200
"اصفهان","لنجان","مرکزی",72,1528,18,3,296,1845,18,1863
"اصفهان","لنجان","مرکزی",73,958,2,1,125,1086,4,1090
"اصفهان","لنجان","مرکزی",74,754,5,6,90,855,2,857
"اصفهان","لنجان","مرکزی",75,988,8,0,105,1101,3,1104
"اصفهان","لنجان","مرکزی",76,1030,11,4,215,1260,4,1264
"اصفهان","لنجان","مرکزی",77,575,2,1,245,823,8,831
"اصفهان","لنجان","مرکزی",78,212,4,0,107,323,1,324
"اصفهان","لنجان","مرکزی",79,542,10,0,252,804,5,809
"اصفهان","لنجان","مرکزی",80,536,7,2,104,649,5,654
"اصفهان","لنجان","مرکزی",81,1074,48,4,170,1296,6,1302
"اصفهان","لنجان","مرکزی",82,616,34,4,122,776,7,783
"اصفهان","لنجان","مرکزی",83,118,3,2,25,148,4,152
"اصفهان","لنجان","باغبهادران",1,903,22,4,759,1688,22,1710
"اصفهان","لنجان","باغبهادران",2,557,6,5,319,887,13,900
"اصفهان","لنجان","باغبهادران",3,719,8,6,435,1168,8,1176
"اصفهان","لنجان","باغبهادران",4,652,6,29,253,940,9,949
"اصفهان","لنجان","باغبهادران",5,933,2,6,296,1237,3,1240
"اصفهان","لنجان","باغبهادران",6,859,7,57,155,1078,7,1085
"اصفهان","لنجان","باغبهادران",7,1246,15,82,173,1516,12,1528
"اصفهان","لنجان","باغبهادران",8,1336,8,59,134,1537,10,1547
"اصفهان","لنجان","باغبهادران",9,930,14,144,217,1305,11,1316
"اصفهان","لنجان","باغبهادران",10,527,8,45,138,718,2,720
"اصفهان","لنجان","باغبهادران",11,433,5,3,97,538,7,545
"اصفهان","لنجان","باغبهادران",12,669,4,3,105,781,8,789
"اصفهان","لنجان","باغبهادران",13,934,3,4,67,1008,2,1010
"اصفهان","لنجان","باغبهادران",14,1295,12,1,157,1465,15,1480
"اصفهان","لنجان","باغبهادران",15,936,3,3,78,1020,7,1027
"اصفهان","لنجان","باغبهادران",16,896,6,0,133,1035,8,1043
"اصفهان","لنجان","باغبهادران",17,258,1,0,87,346,4,350
"اصفهان","لنجان","باغبهادران",18,1176,3,8,147,1334,3,1337
"اصفهان","لنجان","باغبهادران",19,315,1,0,43,359,1,360
"اصفهان","لنجان","باغبهادران",20,1139,3,9,219,1370,6,1376
"اصفهان","لنجان","باغبهادران",21,623,7,2,52,684,2,686
"اصفهان","لنجان","باغبهادران",22,375,4,0,88,467,5,472
"اصفهان","لنجان","باغبهادران",23,386,1,0,84,471,2,473
"اصفهان","لنجان","باغبهادران",24,420,0,2,79,501,0,501
"اصفهان","لنجان","باغبهادران",25,347,1,1,31,380,4,384
"اصفهان","لنجان","باغبهادران",26,1011,5,2,92,1110,5,1115
"اصفهان","لنجان","باغبهادران",27,899,3,0,39,941,0,941
"اصفهان","لنجان","باغبهادران",28,1130,1,3,93,1227,5,1232
"اصفهان","لنجان","باغبهادران",29,235,4,0,44,283,0,283
"اصفهان","لنجان","باغبهادران",30,186,1,1,59,247,1,248
"اصفهان","لنجان","باغبهادران",31,293,1,0,28,322,0,322
"اصفهان","مبارکه","مرکزی",1,1216,26,8,620,1870,20,1890
"اصفهان","مبارکه","مرکزی",2,780,16,8,382,1186,13,1199
"اصفهان","مبارکه","مرکزی",3,829,15,8,379,1231,16,1247
"اصفهان","مبارکه","مرکزی",4,954,21,2,521,1498,24,1522
"اصفهان","مبارکه","مرکزی",5,1397,14,4,447,1862,15,1877
"اصفهان","مبارکه","مرکزی",6,1352,17,2,443,1814,19,1833
"اصفهان","مبارکه","مرکزی",7,1486,19,6,429,1940,16,1956
"اصفهان","مبارکه","مرکزی",8,1038,27,4,414,1483,19,1502
"اصفهان","مبارکه","مرکزی",9,1426,35,7,468,1936,28,1964
"اصفهان","مبارکه","مرکزی",10,1077,31,2,346,1456,17,1473
"اصفهان","مبارکه","مرکزی",11,1335,30,1,236,1602,6,1608
"اصفهان","مبارکه","مرکزی",12,817,10,3,178,1008,7,1015
"اصفهان","مبارکه","مرکزی",13,921,22,2,186,1131,10,1141
"اصفهان","مبارکه","مرکزی",14,944,11,2,220,1177,13,1190
"اصفهان","مبارکه","مرکزی",15,1284,12,0,159,1455,6,1461
"اصفهان","مبارکه","مرکزی",16,1189,6,0,120,1315,11,1326
"اصفهان","مبارکه","مرکزی",17,1313,8,1,198,1520,10,1530
"اصفهان","مبارکه","مرکزی",18,942,21,7,196,1166,9,1175
"اصفهان","مبارکه","مرکزی",19,1381,19,3,336,1739,11,1750
"اصفهان","مبارکه","مرکزی",20,1032,7,4,227,1270,9,1279
"اصفهان","مبارکه","مرکزی",21,1035,7,1,159,1202,7,1209
"اصفهان","مبارکه","مرکزی",22,1044,36,13,450,1543,9,1552
"اصفهان","مبارکه","مرکزی",23,1079,60,35,673,1847,27,1874
"اصفهان","مبارکه","مرکزی",24,1463,16,6,254,1739,10,1749
"اصفهان","مبارکه","مرکزی",25,967,16,7,219,1209,13,1222
"اصفهان","مبارکه","مرکزی",26,492,3,1,34,530,4,534
"اصفهان","مبارکه","مرکزی",27,672,19,0,142,833,5,838
"اصفهان","مبارکه","مرکزی",28,1383,10,0,136,1529,2,1531
"اصفهان","مبارکه","مرکزی",29,1689,14,3,94,1800,14,1814
"اصفهان","مبارکه","مرکزی",30,986,7,2,99,1094,6,1100
"اصفهان","مبارکه","مرکزی",31,1131,4,6,144,1285,11,1296
"اصفهان","مبارکه","مرکزی",32,1310,9,1,128,1448,8,1456
"اصفهان","مبارکه","مرکزی",33,1110,73,4,458,1645,24,1669
"اصفهان","مبارکه","مرکزی",34,362,0,0,34,396,1,397
"اصفهان","مبارکه","مرکزی",35,537,2,0,45,584,4,588
"اصفهان","مبارکه","مرکزی",36,633,2,3,89,727,3,730
"اصفهان","مبارکه","مرکزی",37,515,14,5,134,668,6,674
"اصفهان","مبارکه","مرکزی",38,1259,20,2,287,1568,9,1577
"اصفهان","مبارکه","مرکزی",39,1481,15,12,315,1823,14,1837
"اصفهان","مبارکه","مرکزی",40,1371,14,2,342,1729,8,1737
"اصفهان","مبارکه","مرکزی",41,621,9,0,125,755,3,758
"اصفهان","مبارکه","مرکزی",42,1509,8,7,186,1710,7,1717
"اصفهان","مبارکه","مرکزی",43,1581,3,3,277,1864,8,1872
"اصفهان","مبارکه","مرکزی",44,809,5,1,95,910,0,910
"اصفهان","مبارکه","مرکزی",45,702,0,3,94,799,2,801
"اصفهان","مبارکه","گرکن_جنوبی",1,782,12,1,172,967,10,977
"اصفهان","مبارکه","گرکن_جنوبی",2,1015,21,8,228,1272,3,1275
"اصفهان","مبارکه","گرکن_جنوبی",3,839,9,0,162,1010,5,1015
"اصفهان","مبارکه","گرکن_جنوبی",4,1217,7,1,92,1317,5,1322
"اصفهان","مبارکه","گرکن_جنوبی",5,1033,15,5,392,1445,12,1457
"اصفهان","مبارکه","گرکن_جنوبی",6,876,1,4,220,1101,6,1107
"اصفهان","مبارکه","گرکن_جنوبی",7,995,4,0,144,1143,6,1149
"اصفهان","مبارکه","گرکن_جنوبی",8,559,0,0,81,640,5,645
"اصفهان","مبارکه","گرکن_جنوبی",9,607,0,0,176,783,2,785
"اصفهان","مبارکه","گرکن_جنوبی",10,1054,1,0,95,1150,6,1156
"اصفهان","مبارکه","گرکن_جنوبی",11,958,4,1,75,1038,0,1038
"اصفهان","مبارکه","گرکن_جنوبی",12,793,3,1,113,910,7,917
"اصفهان","مبارکه","گرکن_جنوبی",13,1175,3,0,135,1313,6,1319
"اصفهان","مبارکه","گرکن_جنوبی",14,646,3,0,87,736,5,741
"اصفهان","مبارکه","گرکن_جنوبی",15,1057,11,5,162,1235,5,1240
"اصفهان","مبارکه","گرکن_جنوبی",16,761,1,0,67,829,9,838
"اصفهان","مبارکه","گرکن_جنوبی",17,506,1,0,101,608,4,612
"اصفهان","مبارکه","گرکن_جنوبی",18,210,7,2,56,275,2,277
"اصفهان","مبارکه","گرکن_جنوبی",19,91,4,1,42,138,2,140
"اصفهان","نایین","مرکزی",1,1091,23,8,422,1544,19,1563
"اصفهان","نایین","مرکزی",2,1005,16,5,462,1488,18,1506
"اصفهان","نایین","مرکزی",3,962,33,4,685,1684,21,1705
"اصفهان","نایین","مرکزی",4,1022,34,4,568,1628,36,1664
"اصفهان","نایین","مرکزی",5,858,13,2,367,1240,11,1251
"اصفهان","نایین","مرکزی",6,998,19,2,447,1466,29,1495
"اصفهان","نایین","مرکزی",7,770,28,10,524,1332,18,1350
"اصفهان","نایین","مرکزی",8,796,17,0,291,1104,12,1116
"اصفهان","نایین","مرکزی",9,723,7,4,226,960,18,978
"اصفهان","نایین","مرکزی",10,537,15,3,471,1026,17,1043
"اصفهان","نایین","مرکزی",11,445,7,1,118,571,8,579
"اصفهان","نایین","مرکزی",12,637,3,0,62,702,12,714
"اصفهان","نایین","مرکزی",13,701,3,0,165,869,2,871
"اصفهان","نایین","مرکزی",14,578,7,1,291,877,5,882
"اصفهان","نایین","مرکزی",15,404,11,0,127,542,1,543
"اصفهان","نایین","مرکزی",16,461,11,1,75,548,3,551
"اصفهان","نایین","مرکزی",17,314,1,0,64,379,4,383
"اصفهان","نایین","مرکزی",18,387,2,1,58,448,1,449
"اصفهان","نایین","مرکزی",19,208,0,0,27,235,2,237
"اصفهان","نایین","مرکزی",20,238,0,0,49,287,1,288
"اصفهان","نایین","مرکزی",21,290,6,1,83,380,2,382
"اصفهان","نایین","مرکزی",22,214,1,0,49,264,3,267
"اصفهان","نایین","مرکزی",23,407,3,2,188,600,4,604
"اصفهان","نایین","مرکزی",24,338,5,1,132,476,3,479
"اصفهان","نایین","مرکزی",25,267,6,0,169,442,2,444
"اصفهان","نایین","مرکزی",26,441,7,0,109,557,1,558
"اصفهان","نایین","مرکزی",27,315,2,0,43,360,0,360
"اصفهان","نایین","مرکزی",28,511,4,2,94,611,4,615
"اصفهان","نایین","انارک",29,801,7,0,228,1036,12,1048
"اصفهان","نایین","انارک",30,59,0,0,25,84,1,85
"اصفهان","نایین","انارک",31,660,13,2,284,959,11,970
"اصفهان","نایین","خوروبیابانک",32,620,10,1,173,804,4,808
"اصفهان","نایین","خوروبیابانک",33,754,21,1,277,1053,18,1071
"اصفهان","نایین","خوروبیابانک",34,794,6,0,178,978,6,984
"اصفهان","نایین","خوروبیابانک",35,773,8,2,193,976,11,987
"اصفهان","نایین","خوروبیابانک",36,802,35,22,110,969,24,993
"اصفهان","نایین","خوروبیابانک",37,799,29,9,70,907,14,921
"اصفهان","نایین","خوروبیابانک",38,549,6,3,82,640,5,645
"اصفهان","نایین","خوروبیابانک",39,686,5,0,86,777,2,779
"اصفهان","نایین","خوروبیابانک",40,363,6,0,71,440,2,442
"اصفهان","نایین","خوروبیابانک",41,484,8,0,83,575,2,577
"اصفهان","نایین","خوروبیابانک",42,254,1,0,105,360,2,362
"اصفهان","نایین","خوروبیابانک",43,183,1,0,65,249,0,249
"اصفهان","نایین","خوروبیابانک",44,127,2,0,46,175,0,175
"اصفهان","نایین","خوروبیابانک",45,334,6,0,101,441,2,443
"اصفهان","نایین","خوروبیابانک",46,121,2,0,84,207,0,207
"اصفهان","نایین","خوروبیابانک",47,234,1,0,53,288,1,289
"اصفهان","نایین","خوروبیابانک",48,320,2,0,47,369,2,371
"اصفهان","نایین","خوروبیابانک",49,264,7,3,11,285,2,287
"اصفهان","نجف_آباد","مرکزی",1,1127,47,11,742,1927,37,1964
"اصفهان","نجف_آباد","مرکزی",2,388,20,6,342,756,13,769
"اصفهان","نجف_آباد","مرکزی",3,1098,32,12,824,1966,41,2007
"اصفهان","نجف_آباد","مرکزی",4,475,14,6,425,920,22,942
"اصفهان","نجف_آباد","مرکزی",5,1049,15,7,872,1943,34,1977
"اصفهان","نجف_آباد","مرکزی",6,779,22,3,510,1314,20,1334
"اصفهان","نجف_آباد","مرکزی",7,594,21,10,578,1203,23,1226
"اصفهان","نجف_آباد","مرکزی",8,807,29,15,755,1606,34,1640
"اصفهان","نجف_آباد","مرکزی",9,547,24,9,617,1197,14,1211
"اصفهان","نجف_آباد","مرکزی",10,560,21,3,460,1044,18,1062
"اصفهان","نجف_آباد","مرکزی",11,1028,30,7,544,1609,31,1640
"اصفهان","نجف_آباد","مرکزی",12,821,27,7,728,1583,18,1601
"اصفهان","نجف_آباد","مرکزی",13,354,9,1,265,629,12,641
"اصفهان","نجف_آباد","مرکزی",14,384,9,0,107,500,5,505
"اصفهان","نجف_آباد","مرکزی",15,934,26,13,625,1598,25,1623
"اصفهان","نجف_آباد","مرکزی",16,752,22,1,452,1227,15,1242
"اصفهان","نجف_آباد","مرکزی",17,731,37,8,713,1489,34,1523
"اصفهان","نجف_آباد","مرکزی",18,673,32,8,615,1328,23,1351
"اصفهان","نجف_آباد","مرکزی",19,416,25,7,361,809,9,818
"اصفهان","نجف_آباد","مرکزی",20,99,3,3,69,174,3,177
"اصفهان","نجف_آباد","مرکزی",21,849,26,5,802,1682,24,1706
"اصفهان","نجف_آباد","مرکزی",22,815,27,5,574,1421,23,1444
"اصفهان","نجف_آباد","مرکزی",23,822,18,5,626,1471,30,1501
"اصفهان","نجف_آباد","مرکزی",24,1233,25,5,695,1958,26,1984
"اصفهان","نجف_آباد","مرکزی",25,528,11,1,449,989,18,1007
"اصفهان","نجف_آباد","مرکزی",26,1008,27,18,809,1862,27,1889
"اصفهان","نجف_آباد","مرکزی",27,1230,42,11,803,2086,38,2124
"اصفهان","نجف_آباد","مرکزی",28,1046,19,14,449,1528,20,1548
"اصفهان","نجف_آباد","مرکزی",29,740,25,4,597,1366,27,1393
"اصفهان","نجف_آباد","مرکزی",30,890,14,14,502,1420,28,1448
"اصفهان","نجف_آباد","مرکزی",31,727,8,2,172,909,15,924
"اصفهان","نجف_آباد","مرکزی",32,1177,14,6,400,1597,18,1615
"اصفهان","نجف_آباد","مرکزی",33,843,16,2,395,1256,25,1281
"اصفهان","نجف_آباد","مرکزی",34,752,18,5,599,1374,22,1396
"اصفهان","نجف_آباد","مرکزی",35,655,17,1,388,1061,23,1084
"اصفهان","نجف_آباد","مرکزی",36,803,23,0,639,1465,42,1507
"اصفهان","نجف_آباد","مرکزی",37,698,15,3,633,1349,33,1382
"اصفهان","نجف_آباد","مرکزی",38,684,21,5,530,1240,25,1265
"اصفهان","نجف_آباد","مرکزی",39,560,14,2,347,923,17,940
"اصفهان","نجف_آباد","مرکزی",40,470,13,4,313,800,10,810
"اصفهان","نجف_آباد","مرکزی",41,617,23,4,624,1268,18,1286
"اصفهان","نجف_آباد","مرکزی",42,280,3,2,320,605,10,615
"اصفهان","نجف_آباد","مرکزی",43,884,24,9,781,1698,41,1739
"اصفهان","نجف_آباد","مرکزی",44,772,16,4,469,1261,29,1290
"اصفهان","نجف_آباد","مرکزی",45,542,9,1,411,963,17,980
"اصفهان","نجف_آباد","مرکزی",46,970,25,15,790,1800,23,1823
"اصفهان","نجف_آباد","مرکزی",47,1104,23,9,790,1926,35,1961
"اصفهان","نجف_آباد","مرکزی",48,1278,44,10,320,1652,12,1664
"اصفهان","نجف_آباد","مرکزی",49,924,49,10,226,1209,15,1224
"اصفهان","نجف_آباد","مرکزی",50,879,30,2,233,1144,14,1158
"اصفهان","نجف_آباد","مرکزی",51,1373,38,2,317,1730,12,1742
"اصفهان","نجف_آباد","مرکزی",52,1290,28,6,343,1667,28,1695
"اصفهان","نجف_آباد","مرکزی",53,1293,51,11,318,1673,11,1684
"اصفهان","نجف_آباد","مرکزی",54,834,23,7,197,1061,13,1074
"اصفهان","نجف_آباد","مرکزی",55,1340,57,12,355,1764,25,1789
"اصفهان","نجف_آباد","مرکزی",56,1135,58,10,424,1627,20,1647
"اصفهان","نجف_آباد","مرکزی",57,1544,52,4,181,1781,10,1791
"اصفهان","نجف_آباد","مرکزی",58,783,19,5,157,964,11,975
"اصفهان","نجف_آباد","مرکزی",59,681,35,9,241,966,9,975
"اصفهان","نجف_آباد","مرکزی",60,1090,44,7,226,1367,8,1375
"اصفهان","نجف_آباد","مرکزی",61,1067,104,25,222,1418,10,1428
"اصفهان","نجف_آباد","مرکزی",62,1042,125,17,310,1494,16,1510
"اصفهان","نجف_آباد","مرکزی",63,1026,46,12,161,1245,10,1255
"اصفهان","نجف_آباد","مرکزی",64,1006,135,29,435,1605,18,1623
"اصفهان","نجف_آباد","مرکزی",65,1076,167,29,341,1613,16,1629
"اصفهان","نجف_آباد","مرکزی",66,1148,178,10,220,1556,14,1570
"اصفهان","نجف_آباد","مرکزی",67,734,247,15,161,1157,5,1162
"اصفهان","نجف_آباد","مرکزی",68,856,245,14,135,1250,15,1265
"اصفهان","نجف_آباد","مرکزی",69,918,160,12,170,1260,9,1269
"اصفهان","نجف_آباد","مرکزی",70,1070,112,10,364,1556,10,1566
"اصفهان","نجف_آباد","مرکزی",71,675,58,5,207,945,3,948
"اصفهان","نجف_آباد","مرکزی",72,1005,132,13,197,1347,8,1355
"اصفهان","نجف_آباد","مرکزی",73,565,40,6,106,717,3,720
"اصفهان","نجف_آباد","مرکزی",74,483,92,7,148,730,4,734
"اصفهان","نجف_آباد","مرکزی",75,1210,130,19,174,1533,8,1541
"اصفهان","نجف_آباد","مرکزی",76,1239,19,3,242,1503,13,1516
"اصفهان","نجف_آباد","مرکزی",77,1317,22,9,311,1659,19,1678
"اصفهان","نجف_آباد","مرکزی",78,412,20,1,102,535,8,543
"اصفهان","نجف_آباد","مرکزی",79,1348,38,2,251,1639,26,1665
"اصفهان","نجف_آباد","مرکزی",80,1235,8,1,216,1460,8,1468
"اصفهان","نجف_آباد","مرکزی",81,608,15,0,72,695,1,696
"اصفهان","نجف_آباد","مرکزی",82,1257,106,16,669,2048,25,2073
"اصفهان","نجف_آباد","مرکزی",83,808,117,32,1155,2112,21,2133
"اصفهان","نجف_آباد","مرکزی",84,1088,112,26,826,2052,25,2077
"اصفهان","نجف_آباد","مرکزی",85,849,59,19,701,1628,19,1647
"اصفهان","نجف_آباد","مرکزی",86,1412,19,6,365,1802,18,1820
"اصفهان","نجف_آباد","مرکزی",87,882,19,7,191,1099,8,1107
"اصفهان","نجف_آباد","مرکزی",88,1356,52,36,138,1582,3,1585
"اصفهان","نجف_آباد","مرکزی",89,1676,33,5,254,1968,19,1987
"اصفهان","نجف_آباد","مرکزی",90,1326,60,32,406,1824,17,1841
"اصفهان","نجف_آباد","مرکزی",91,993,34,6,339,1372,13,1385
"اصفهان","نجف_آباد","مرکزی",92,1179,23,2,211,1415,19,1434
"اصفهان","نجف_آباد","مرکزی",93,1062,14,7,182,1265,14,1279
"اصفهان","نجف_آباد","مرکزی",94,1128,23,8,225,1384,4,1388
"اصفهان","نجف_آباد","مرکزی",95,1227,19,9,114,1369,11,1380
"اصفهان","نجف_آباد","مرکزی",96,999,8,6,126,1139,19,1158
"اصفهان","نجف_آباد","مرکزی",97,1124,14,8,141,1287,11,1298
"اصفهان","نجف_آباد","مرکزی",98,853,5,0,80,938,4,942
"اصفهان","نجف_آباد","مرکزی",99,1461,7,0,129,1597,9,1606
"اصفهان","نجف_آباد","مرکزی",100,671,6,3,50,730,2,732
"اصفهان","نجف_آباد","مرکزی",101,818,5,0,49,872,10,882
"اصفهان","نجف_آباد","مرکزی",102,508,2,0,32,542,2,544
"اصفهان","نجف_آباد","مرکزی",103,1013,31,1,45,1090,2,1092
"اصفهان","نجف_آباد","مهردشت",1,673,13,7,240,933,9,942
"اصفهان","نجف_آباد","مهردشت",2,930,13,5,335,1283,26,1309
"اصفهان","نجف_آباد","مهردشت",3,804,8,3,228,1043,7,1050
"اصفهان","نجف_آباد","مهردشت",4,428,12,0,136,576,10,586
"اصفهان","نجف_آباد","مهردشت",5,465,4,0,112,581,15,596
"اصفهان","نجف_آباد","مهردشت",6,394,6,4,149,553,3,556
"اصفهان","نجف_آباد","مهردشت",7,907,17,0,316,1240,14,1254
"اصفهان","نجف_آباد","مهردشت",8,688,13,10,231,942,5,947
"اصفهان","نجف_آباد","مهردشت",9,552,7,5,216,780,5,785
"اصفهان","نجف_آباد","مهردشت",10,672,25,3,323,1023,12,1035
"اصفهان","نجف_آباد","مهردشت",11,442,2,1,91,536,2,538
"اصفهان","نجف_آباد","مهردشت",12,1173,3,0,226,1402,9,1411
"اصفهان","نجف_آباد","مهردشت",13,259,0,0,30,289,3,292
"اصفهان","نجف_آباد","مهردشت",14,860,2,0,92,954,2,956
"اصفهان","نجف_آباد","مهردشت",15,219,1,0,28,248,1,249
"اصفهان","نجف_آباد","مهردشت",16,466,1,0,53,520,1,521
"اصفهان","نجف_آباد","مهردشت",17,515,2,3,139,659,9,668
"اصفهان","نجف_آباد","مهردشت",18,1017,5,0,65,1087,8,1095
"اصفهان","نجف_آباد","مهردشت",19,451,3,0,17,471,1,472
"اصفهان","نجف_آباد","مهردشت",20,610,3,2,53,668,1,669
"اصفهان","نجف_آباد","مهردشت",21,61,4,0,38,103,0,103
"اصفهان","نطنز","مرکزی",1,308,11,12,201,532,4,536
"اصفهان","نطنز","مرکزی",2,284,3,0,100,387,4,391
"اصفهان","نطنز","مرکزی",3,428,13,4,215,660,8,668
"اصفهان","نطنز","مرکزی",4,503,4,2,216,725,6,731
"اصفهان","نطنز","مرکزی",5,280,1,3,97,381,2,383
"اصفهان","نطنز","مرکزی",6,288,7,2,200,497,6,503
"اصفهان","نطنز","مرکزی",7,279,6,1,137,423,5,428
"اصفهان","نطنز","مرکزی",8,245,6,2,75,328,4,332
"اصفهان","نطنز","مرکزی",9,294,8,3,68,373,3,376
"اصفهان","نطنز","مرکزی",10,867,18,14,376,1275,8,1283
"اصفهان","نطنز","مرکزی",11,252,8,1,192,453,6,459
"اصفهان","نطنز","مرکزی",12,327,2,0,151,480,5,485
"اصفهان","نطنز","مرکزی",13,412,11,0,128,551,3,554
"اصفهان","نطنز","مرکزی",14,320,8,0,124,452,3,455
"اصفهان","نطنز","مرکزی",15,193,1,1,54,249,2,251
"اصفهان","نطنز","مرکزی",16,184,3,1,93,281,2,283
"اصفهان","نطنز","مرکزی",17,358,5,0,101,464,3,467
"اصفهان","نطنز","مرکزی",18,114,0,0,9,123,0,123
"اصفهان","نطنز","مرکزی",19,292,5,0,180,477,5,482
"اصفهان","نطنز","مرکزی",20,138,2,0,88,228,2,230
"اصفهان","نطنز","مرکزی",21,277,0,0,78,355,3,358
"اصفهان","نطنز","مرکزی",22,136,1,0,12,149,0,149
"اصفهان","نطنز","مرکزی",23,338,5,2,44,389,3,392
"اصفهان","نطنز","مرکزی",24,263,1,1,87,352,4,356
"اصفهان","نطنز","مرکزی",25,419,9,2,180,610,7,617
"اصفهان","نطنز","مرکزی",26,180,3,1,60,244,2,246
"اصفهان","نطنز","مرکزی",27,270,6,0,79,355,2,357
"اصفهان","نطنز","مرکزی",28,380,6,0,80,466,5,471
"اصفهان","نطنز","مرکزی",29,284,5,1,129,419,2,421
"اصفهان","نطنز","مرکزی",30,197,2,3,78,280,1,281
"اصفهان","نطنز","مرکزی",31,267,3,1,107,378,3,381
"اصفهان","نطنز","مرکزی",32,286,2,2,170,460,3,463
"اصفهان","نطنز","مرکزی",33,326,7,1,58,392,3,395
"اصفهان","نطنز","امامزاده",1,217,10,0,296,523,6,529
"اصفهان","نطنز","امامزاده",2,420,4,1,504,929,2,931
"اصفهان","نطنز","امامزاده",3,672,6,1,268,947,8,955
"اصفهان","نطنز","امامزاده",4,426,5,2,418,851,5,856
"اصفهان","نطنز","امامزاده",5,356,7,0,264,627,2,629
"اصفهان","نطنز","امامزاده",6,236,7,0,249,492,10,502
"اصفهان","نطنز","امامزاده",7,345,8,1,491,845,7,852
"اصفهان","نطنز","امامزاده",8,276,3,0,218,497,0,497
"اصفهان","نطنز","امامزاده",9,326,7,2,269,604,3,607
"اصفهان","نطنز","امامزاده",10,377,1,0,295,673,6,679
"اصفهان","نطنز","امامزاده",11,151,6,0,226,383,8,391
"اصفهان","نطنز","امامزاده",12,236,3,3,220,462,2,464
"اصفهان","نطنز","امامزاده",13,622,4,0,181,807,11,818
"اصفهان","نطنز","امامزاده",14,325,1,0,46,372,0,372
"اصفهان","نطنز","امامزاده",15,679,1,0,51,731,0,731
"اصفهان","نطنز","امامزاده",16,480,5,1,170,656,3,659
"اصفهان","نطنز","امامزاده",17,477,4,0,132,613,5,618
"اصفهان","نطنز","امامزاده",18,531,4,0,93,628,3,631
"اصفهان","نطنز","امامزاده",19,452,9,0,118,579,3,582
"اصفهان","نطنز","امامزاده",20,591,0,0,57,648,1,649
"اصفهان","نطنز","امامزاده",21,393,3,0,3,399,0,399
"اصفهان","نطنز","امامزاده",22,214,1,0,108,323,1,324
"اصفهان","نطنز","امامزاده",23,72,0,0,126,198,6,204
"اصفهان","نطنز","امامزاده",24,826,17,2,202,1047,6,1053
"ایلام","آبدانان","مرکزی",1,359,13,70,386,828,18,846
"ایلام","آبدانان","مرکزی",2,422,12,45,320,799,11,810
"ایلام","آبدانان","مرکزی",3,259,3,35,292,589,7,596
"ایلام","آبدانان","مرکزی",4,160,5,15,131,311,8,319
"ایلام","آبدانان","مرکزی",5,231,16,47,267,561,15,576
"ایلام","آبدانان","مرکزی",6,326,9,32,200,567,10,577
"ایلام","آبدانان","مرکزی",7,282,12,50,162,506,5,511
"ایلام","آبدانان","مرکزی",8,83,8,48,126,265,3,268
"ایلام","آبدانان","مرکزی",9,107,2,36,151,296,4,300
"ایلام","آبدانان","مرکزی",10,229,8,29,202,468,10,478
"ایلام","آبدانان","مرکزی",11,240,11,25,142,418,5,423
"ایلام","آبدانان","مرکزی",12,722,6,17,114,859,10,869
"ایلام","آبدانان","مرکزی",13,403,9,14,104,530,11,541
"ایلام","آبدانان","مرکزی",14,311,12,22,343,688,10,698
"ایلام","آبدانان","مرکزی",15,494,15,14,207,730,9,739
"ایلام","آبدانان","مرکزی",16,358,4,26,200,588,3,591
"ایلام","آبدانان","مرکزی",17,263,8,35,267,573,12,585
"ایلام","آبدانان","مرکزی",18,445,9,47,380,881,18,899
"ایلام","آبدانان","مرکزی",19,493,13,94,387,987,21,1008
"ایلام","آبدانان","مرکزی",20,221,9,16,196,442,9,451
"ایلام","آبدانان","مرکزی",21,159,11,9,208,387,6,393
"ایلام","آبدانان","مرکزی",22,213,7,30,177,427,5,432
"ایلام","آبدانان","مرکزی",23,298,5,150,261,714,14,728
"ایلام","آبدانان","مرکزی",24,322,5,39,135,501,0,501
"ایلام","آبدانان","مرکزی",25,470,2,32,61,565,3,568
"ایلام","آبدانان","مرکزی",26,231,6,53,147,437,7,444
"ایلام","آبدانان","مرکزی",27,414,4,50,137,605,8,613
"ایلام","آبدانان","مرکزی",28,443,20,14,248,725,4,729
"ایلام","آبدانان","مرکزی",29,367,7,19,120,513,6,519
"ایلام","آبدانان","مرکزی",30,848,12,19,132,1011,9,1020
"ایلام","آبدانان","مرکزی",31,865,11,25,167,1068,12,1080
"ایلام","آبدانان","مرکزی",32,199,5,7,23,234,0,234
"ایلام","آبدانان","مرکزی",33,100,0,6,30,136,1,137
"ایلام","آبدانان","مرکزی",34,22,0,1,9,32,0,32
"ایلام","آبدانان","مرکزی",35,43,1,1,6,51,0,51
"ایلام","آبدانان","مرکزی",36,71,1,0,18,90,2,92
"ایلام","آبدانان","سراباغ",1,255,8,3,43,309,0,309
"ایلام","آبدانان","سراباغ",2,696,6,7,148,857,6,863
"ایلام","آبدانان","سراباغ",3,237,8,5,63,313,3,316
"ایلام","آبدانان","سراباغ",4,290,6,124,35,455,8,463
"ایلام","آبدانان","سراباغ",5,360,0,6,86,452,3,455
"ایلام","آبدانان","سراباغ",6,106,1,0,7,114,1,115
"ایلام","آبدانان","سراباغ",7,51,3,0,16,70,0,70
"ایلام","آبدانان","سراباغ",8,381,0,5,92,478,3,481
"ایلام","آبدانان","سراباغ",9,66,0,2,45,113,0,113
"ایلام","آبدانان","سراباغ",10,51,0,1,7,59,1,60
"ایلام","آبدانان","سراباغ",11,141,9,7,19,176,0,176
"ایلام","آبدانان","سراباغ",12,221,0,8,48,277,3,280
"ایلام","آبدانان","کلات",1,380,5,42,109,536,11,547
"ایلام","آبدانان","کلات",2,233,11,77,125,446,11,457
"ایلام","آبدانان","کلات",3,313,5,50,132,500,9,509
"ایلام","آبدانان","کلات",4,233,6,144,100,483,3,486
"ایلام","آبدانان","کلات",5,398,5,6,113,522,4,526
"ایلام","آبدانان","کلات",6,60,1,88,29,178,1,179
"ایلام","آبدانان","کلات",7,126,8,42,123,299,2,301
"ایلام","آبدانان","کلات",8,34,1,9,11,55,0,55
"ایلام","آبدانان","کلات",9,123,2,5,18,148,2,150
"ایلام","آبدانان","کلات",10,230,7,32,102,371,5,376
"ایلام","ایوان","مرکزی",1,705,17,20,378,1120,17,1137
"ایلام","ایوان","مرکزی",2,465,5,7,340,817,12,829
"ایلام","ایوان","مرکزی",3,674,10,27,490,1201,21,1222
"ایلام","ایوان","مرکزی",4,745,5,8,280,1038,17,1055
"ایلام","ایوان","مرکزی",5,372,16,12,481,881,19,900
"ایلام","ایوان","مرکزی",6,644,20,11,411,1086,15,1101
"ایلام","ایوان","مرکزی",7,661,21,7,408,1097,23,1120
"ایلام","ایوان","مرکزی",8,418,5,5,320,748,16,764
"ایلام","ایوان","مرکزی",9,769,14,3,288,1074,12,1086
"ایلام","ایوان","مرکزی",10,729,9,11,409,1158,4,1162
"ایلام","ایوان","مرکزی",11,503,16,7,272,798,11,809
"ایلام","ایوان","مرکزی",12,328,2,1,245,576,5,581
"ایلام","ایوان","مرکزی",13,238,8,2,334,582,3,585
"ایلام","ایوان","مرکزی",14,260,5,4,170,439,9,448
"ایلام","ایوان","مرکزی",15,404,7,2,282,695,11,706
"ایلام","ایوان","مرکزی",16,131,3,2,105,241,3,244
"ایلام","ایوان","مرکزی",17,436,13,1,279,729,14,743
"ایلام","ایوان","مرکزی",18,314,11,3,328,656,9,665
"ایلام","ایوان","مرکزی",19,489,9,13,345,856,15,871
"ایلام","ایوان","مرکزی",20,239,8,4,111,362,1,363
"ایلام","ایوان","مرکزی",21,481,2,25,440,948,8,956
"ایلام","ایوان","مرکزی",22,608,9,4,135,756,7,763
"ایلام","ایوان","مرکزی",23,129,2,1,41,173,1,174
"ایلام","ایوان","مرکزی",24,288,3,1,95,387,3,390
"ایلام","ایوان","مرکزی",25,146,2,0,88,236,2,238
"ایلام","ایوان","مرکزی",26,340,1,0,113,454,2,456
"ایلام","ایوان","مرکزی",27,298,5,1,40,344,3,347
"ایلام","ایوان","مرکزی",28,528,5,0,165,698,2,700
"ایلام","ایوان","مرکزی",29,266,0,0,22,288,4,292
"ایلام","ایوان","مرکزی",30,390,1,2,28,421,0,421
"ایلام","ایوان","مرکزی",31,314,19,1,151,485,13,498
"ایلام","ایوان","مرکزی",32,373,3,3,50,429,1,430
"ایلام","ایوان","زرنه",33,385,3,1,235,624,8,632
"ایلام","ایوان","زرنه",34,251,1,1,164,417,4,421
"ایلام","ایوان","زرنه",35,174,1,1,196,372,4,376
"ایلام","ایوان","زرنه",36,221,0,0,106,327,2,329
"ایلام","ایوان","زرنه",37,114,0,0,55,169,0,169
"ایلام","ایوان","زرنه",38,601,12,2,121,736,6,742
"ایلام","ایوان","زرنه",39,434,2,2,126,564,2,566
"ایلام","ایوان","زرنه",40,371,5,4,67,447,0,447
"ایلام","ایوان","زرنه",41,326,7,1,128,462,3,465
"ایلام","ایوان","زرنه",42,560,3,5,113,681,2,683
"ایلام","ایوان","زرنه",43,57,1,0,15,73,1,74
"ایلام","ایوان","زرنه",44,452,3,2,120,577,7,584
"ایلام","ایوان","زرنه",45,253,2,1,124,380,5,385
"ایلام","ایوان","زرنه",46,30,0,1,29,60,0,60
"ایلام","ایلام","مرکزی",1,693,26,23,757,1499,16,1515
"ایلام","ایلام","مرکزی",2,453,23,9,362,847,15,862
"ایلام","ایلام","مرکزی",3,754,22,10,499,1285,12,1297
"ایلام","ایلام","مرکزی",4,827,23,16,486,1352,20,1372
"ایلام","ایلام","مرکزی",5,411,14,12,266,703,8,711
"ایلام","ایلام","مرکزی",6,458,26,10,376,870,9,879
"ایلام","ایلام","مرکزی",7,676,11,4,155,846,11,857
"ایلام","ایلام","مرکزی",8,156,16,5,314,491,5,496
"ایلام","ایلام","مرکزی",9,552,42,52,854,1500,23,1523
"ایلام","ایلام","مرکزی",10,226,12,6,337,581,7,588
"ایلام","ایلام","مرکزی",11,1055,30,17,700,1802,30,1832
"ایلام","ایلام","مرکزی",12,547,33,16,626,1222,29,1251
"ایلام","ایلام","مرکزی",13,170,7,9,201,387,9,396
"ایلام","ایلام","مرکزی",14,357,14,24,546,941,14,955
"ایلام","ایلام","مرکزی",15,435,21,12,499,967,14,981
"ایلام","ایلام","مرکزی",16,280,5,7,252,544,8,552
"ایلام","ایلام","مرکزی",17,401,12,25,615,1053,17,1070
"ایلام","ایلام","مرکزی",18,285,15,21,386,707,10,717
"ایلام","ایلام","مرکزی",19,484,20,24,654,1182,18,1200
"ایلام","ایلام","مرکزی",20,321,5,22,477,825,11,836
"ایلام","ایلام","مرکزی",21,251,15,21,533,820,12,832
"ایلام","ایلام","مرکزی",22,567,14,9,368,958,20,978
"ایلام","ایلام","مرکزی",23,826,23,15,537,1401,24,1425
"ایلام","ایلام","مرکزی",24,890,13,16,269,1188,12,1200
"ایلام","ایلام","مرکزی",25,694,8,3,199,904,13,917
"ایلام","ایلام","مرکزی",26,492,5,2,54,553,3,556
"ایلام","ایلام","مرکزی",27,408,12,4,99,523,7,530
"ایلام","ایلام","مرکزی",28,1096,14,1,230,1341,15,1356
"ایلام","ایلام","مرکزی",29,742,10,2,78,832,7,839
"ایلام","ایلام","مرکزی",30,1021,15,9,222,1267,9,1276
"ایلام","ایلام","مرکزی",31,1107,22,13,333,1475,16,1491
"ایلام","ایلام","مرکزی",32,323,9,3,177,512,13,525
"ایلام","ایلام","مرکزی",33,479,21,5,592,1097,18,1115
"ایلام","ایلام","مرکزی",34,561,19,6,520,1106,14,1120
"ایلام","ایلام","مرکزی",35,794,22,18,567,1401,26,1427
"ایلام","ایلام","مرکزی",36,510,26,8,335,879,9,888
"ایلام","ایلام","مرکزی",37,992,12,8,329,1341,17,1358
"ایلام","ایلام","مرکزی",38,972,25,6,323,1326,16,1342
"ایلام","ایلام","مرکزی",39,652,12,6,221,891,14,905
"ایلام","ایلام","مرکزی",40,458,22,8,277,765,7,772
"ایلام","ایلام","مرکزی",41,905,12,20,251,1188,12,1200
"ایلام","ایلام","مرکزی",42,649,12,6,389,1056,13,1069
"ایلام","ایلام","مرکزی",43,264,3,4,65,336,3,339
"ایلام","ایلام","مرکزی",44,740,13,22,469,1244,13,1257
"ایلام","ایلام","مرکزی",45,496,11,7,273,787,15,802
"ایلام","ایلام","مرکزی",46,326,18,4,311,659,12,671
"ایلام","ایلام","مرکزی",47,801,34,30,566,1431,24,1455
"ایلام","ایلام","مرکزی",48,298,13,5,204,520,12,532
"ایلام","ایلام","مرکزی",49,874,16,21,414,1325,19,1344
"ایلام","ایلام","مرکزی",50,275,11,4,167,457,10,467
"ایلام","ایلام","مرکزی",51,750,36,35,292,1113,11,1124
"ایلام","ایلام","مرکزی",52,264,20,5,196,485,4,489
"ایلام","ایلام","مرکزی",53,975,33,15,573,1596,13,1609
"ایلام","ایلام","مرکزی",54,261,15,5,316,597,8,605
"ایلام","ایلام","مرکزی",55,749,31,24,482,1286,13,1299
"ایلام","ایلام","مرکزی",56,619,22,7,300,948,11,959
"ایلام","ایلام","مرکزی",57,695,20,4,250,969,4,973
"ایلام","ایلام","مرکزی",58,707,16,11,505,1239,23,1262
"ایلام","ایلام","مرکزی",59,448,25,12,412,897,8,905
"ایلام","ایلام","مرکزی",60,732,31,28,557,1348,18,1366
"ایلام","ایلام","مرکزی",61,919,18,19,374,1330,12,1342
"ایلام","ایلام","مرکزی",62,500,26,13,467,1006,12,1018
"ایلام","ایلام","مرکزی",63,298,14,14,275,601,15,616
"ایلام","ایلام","مرکزی",64,462,34,20,706,1222,17,1239
"ایلام","ایلام","مرکزی",65,396,28,17,477,918,4,922
"ایلام","ایلام","مرکزی",66,674,31,14,383,1102,23,1125
"ایلام","ایلام","مرکزی",67,427,41,21,807,1296,26,1322
"ایلام","ایلام","مرکزی",68,368,22,12,438,840,16,856
"ایلام","ایلام","مرکزی",69,298,31,33,480,842,18,860
"ایلام","ایلام","مرکزی",70,237,16,52,367,672,9,681
"ایلام","ایلام","مرکزی",71,333,15,3,211,562,1,563
"ایلام","ایلام","مرکزی",72,903,24,16,461,1404,19,1423
"ایلام","ایلام","مرکزی",73,129,6,1,143,279,5,284
"ایلام","ایلام","مرکزی",74,304,24,9,458,795,21,816
"ایلام","ایلام","مرکزی",75,825,81,19,830,1755,27,1782
"ایلام","ایلام","مرکزی",76,430,37,31,486,984,19,1003
"ایلام","ایلام","مرکزی",77,585,39,11,548,1183,6,1189
"ایلام","ایلام","مرکزی",78,769,56,25,612,1462,32,1494
"ایلام","ایلام","مرکزی",79,177,9,3,115,304,0,304
"ایلام","ایلام","مرکزی",80,611,28,33,613,1285,14,1299
"ایلام","ایلام","مرکزی",81,567,32,31,531,1161,11,1172
"ایلام","ایلام","مرکزی",82,830,23,33,399,1285,14,1299
"ایلام","ایلام","مرکزی",83,1018,46,32,450,1546,18,1564
"ایلام","ایلام","مرکزی",84,522,54,26,637,1239,19,1258
"ایلام","ایلام","مرکزی",85,710,60,20,637,1427,29,1456
"ایلام","ایلام","مرکزی",86,895,47,20,625,1587,24,1611
"ایلام","ایلام","مرکزی",87,1152,30,11,376,1569,15,1584
"ایلام","ایلام","مرکزی",88,566,35,13,612,1226,5,1231
"ایلام","ایلام","مرکزی",89,295,11,6,170,482,9,491
"ایلام","ایلام","مرکزی",90,317,31,6,106,460,3,463
"ایلام","ایلام","مرکزی",91,447,36,56,389,928,48,976
"ایلام","ایلام","مرکزی",92,658,9,7,259,933,10,943
"ایلام","ایلام","مرکزی",93,531,16,8,209,764,6,770
"ایلام","ایلام","مرکزی",94,653,20,8,122,803,5,808
"ایلام","ایلام","مرکزی",95,993,24,8,339,1364,14,1378
"ایلام","ایلام","مرکزی",96,791,37,2,196,1026,6,1032
"ایلام","ایلام","مرکزی",97,809,20,1,104,934,2,936
"ایلام","ایلام","مرکزی",98,883,5,10,181,1079,5,1084
"ایلام","ایلام","مرکزی",99,919,5,3,126,1053,3,1056
"ایلام","ایلام","مرکزی",100,812,9,1,71,893,14,907
"ایلام","ایلام","مرکزی",101,447,7,3,125,582,4,586
"ایلام","ایلام","مرکزی",102,138,4,1,33,176,1,177
"ایلام","ایلام","مرکزی",103,286,1,0,18,305,5,310
"ایلام","ایلام","مرکزی",104,676,7,4,59,746,6,752
"ایلام","ایلام","مرکزی",105,1032,14,4,180,1230,13,1243
"ایلام","ایلام","مرکزی",106,973,15,2,81,1071,9,1080
"ایلام","ایلام","مرکزی",107,689,5,4,89,787,4,791
"ایلام","ایلام","مرکزی",108,605,3,4,86,698,1,699
"ایلام","ایلام","مرکزی",109,282,4,1,39,326,2,328
"ایلام","ایلام","چوار",1,582,19,4,140,745,7,752
"ایلام","ایلام","چوار",2,656,36,14,208,914,7,921
"ایلام","ایلام","چوار",3,430,78,23,160,691,5,696
"ایلام","ایلام","چوار",4,337,37,2,157,533,7,540
"ایلام","ایلام","چوار",5,501,11,3,156,671,3,674
"ایلام","ایلام","چوار",6,210,2,3,84,299,2,301
"ایلام","ایلام","چوار",7,297,9,2,148,456,3,459
"ایلام","ایلام","چوار",8,522,11,3,219,755,6,761
"ایلام","ایلام","چوار",9,169,5,1,57,232,3,235
"ایلام","ایلام","چوار",10,262,0,1,45,308,5,313
"ایلام","ایلام","چوار",11,188,10,4,69,271,5,276
"ایلام","ایلام","چوار",12,279,0,4,36,319,2,321
"ایلام","ایلام","چوار",13,68,1,0,22,91,1,92
"ایلام","ایلام","چوار",14,99,0,0,42,141,0,141
"ایلام","ایلام","چوار",15,94,0,0,14,108,1,109
"ایلام","ایلام","چوار",16,123,4,1,34,162,2,164
"ایلام","ایلام","چوار",17,237,7,4,58,306,2,308
"ایلام","ایلام","چوار",18,167,3,1,21,192,3,195
"ایلام","ایلام","چوار",19,93,1,1,17,112,0,112
"ایلام","ایلام","چوار",20,44,1,1,23,69,4,73
"ایلام","ایلام","چوار",21,139,1,2,18,160,0,160
"ایلام","دره_شهر","مرکزی",1,524,13,69,437,1043,17,1060
"ایلام","دره_شهر","مرکزی",2,343,17,42,425,827,11,838
"ایلام","دره_شهر","مرکزی",3,210,11,28,135,384,1,385
"ایلام","دره_شهر","مرکزی",4,377,7,25,322,731,9,740
"ایلام","دره_شهر","مرکزی",5,399,14,29,334,776,13,789
"ایلام","دره_شهر","مرکزی",6,573,29,26,507,1135,5,1140
"ایلام","دره_شهر","مرکزی",7,323,10,15,222,570,7,577
"ایلام","دره_شهر","مرکزی",8,239,17,29,172,457,7,464
"ایلام","دره_شهر","مرکزی",9,572,20,22,307,921,8,929
"ایلام","دره_شهر","مرکزی",10,634,39,49,302,1024,2,1026
"ایلام","دره_شهر","مرکزی",11,380,20,22,207,629,1,630
"ایلام","دره_شهر","مرکزی",12,394,12,28,240,674,6,680
"ایلام","دره_شهر","مرکزی",13,461,22,32,244,759,8,767
"ایلام","دره_شهر","مرکزی",14,234,15,24,202,475,5,480
"ایلام","دره_شهر","مرکزی",15,332,31,41,337,741,10,751
"ایلام","دره_شهر","مرکزی",16,258,7,31,222,518,5,523
"ایلام","دره_شهر","مرکزی",17,434,8,13,150,605,6,611
"ایلام","دره_شهر","مرکزی",18,665,15,36,117,833,3,836
"ایلام","دره_شهر","مرکزی",19,247,6,13,56,322,7,329
"ایلام","دره_شهر","مرکزی",20,573,7,30,174,784,6,790
"ایلام","دره_شهر","مرکزی",21,464,3,27,116,610,3,613
"ایلام","دره_شهر","مرکزی",22,510,11,27,169,717,6,723
"ایلام","دره_شهر","مرکزی",23,445,2,11,100,558,6,564
"ایلام","دره_شهر","مرکزی",24,320,3,7,123,453,5,458
"ایلام","دره_شهر","مرکزی",25,455,4,37,114,610,4,614
"ایلام","دره_شهر","مرکزی",26,429,6,12,200,647,8,655
"ایلام","دره_شهر","مرکزی",27,575,5,8,126,714,3,717
"ایلام","دره_شهر","مرکزی",28,606,9,13,135,763,3,766
"ایلام","دره_شهر","مرکزی",29,442,3,31,64,540,6,546
"ایلام","دره_شهر","مرکزی",30,464,15,91,205,775,5,780
"ایلام","دره_شهر","مرکزی",31,384,21,72,190,667,5,672
"ایلام","دره_شهر","مرکزی",32,507,10,32,118,667,9,676
"ایلام","دره_شهر","بدره",33,302,18,11,214,545,1,546
"ایلام","دره_شهر","بدره",34,725,12,23,359,1119,17,1136
"ایلام","دره_شهر","بدره",35,536,11,5,240,792,8,800
"ایلام","دره_شهر","بدره",36,455,2,0,74,531,4,535
"ایلام","دره_شهر","بدره",37,706,6,5,171,888,2,890
"ایلام","دره_شهر","بدره",38,195,2,0,23,220,3,223
"ایلام","دره_شهر","بدره",39,388,0,2,49,439,0,439
"ایلام","دره_شهر","بدره",40,197,1,4,34,236,3,239
"ایلام","دره_شهر","بدره",41,386,4,21,204,615,8,623
"ایلام","دره_شهر","بدره",42,400,4,6,138,548,10,558
"ایلام","دره_شهر","بدره",43,460,4,2,81,547,4,551
"ایلام","دره_شهر","بدره",44,596,7,1,188,792,7,799
"ایلام","دره_شهر","بدره",45,606,2,6,236,850,3,853
"ایلام","دره_شهر","بدره",46,619,4,3,96,722,12,734
"ایلام","دره_شهر","بدره",47,559,13,60,241,873,12,885
"ایلام","دره_شهر","ماژین",48,539,25,35,192,791,6,797
"ایلام","دره_شهر","ماژین",49,154,9,14,73,250,1,251
"ایلام","دره_شهر","ماژین",50,320,3,5,73,401,5,406
"ایلام","دره_شهر","ماژین",51,90,1,2,28,121,1,122
"ایلام","دره_شهر","ماژین",52,520,9,12,80,621,2,623
"ایلام","دره_شهر","ماژین",53,227,3,1,92,323,1,324
"ایلام","دره_شهر","ماژین",54,160,2,5,23,190,2,192
"ایلام","دهلران","مرکزی",1,810,36,65,543,1454,20,1474
"ایلام","دهلران","مرکزی",2,631,20,35,447,1133,16,1149
"ایلام","دهلران","مرکزی",3,326,17,45,463,851,10,861
"ایلام","دهلران","مرکزی",4,555,31,46,426,1058,19,1077
"ایلام","دهلران","مرکزی",5,585,50,61,745,1441,21,1462
"ایلام","دهلران","مرکزی",6,640,24,69,626,1359,12,1371
"ایلام","دهلران","مرکزی",7,683,37,33,471,1224,15,1239
"ایلام","دهلران","مرکزی",8,640,30,55,516,1241,15,1256
"ایلام","دهلران","مرکزی",9,330,23,62,372,787,17,804
"ایلام","دهلران","مرکزی",10,365,25,52,450,892,13,905
"ایلام","دهلران","مرکزی",11,648,19,29,300,996,15,1011
"ایلام","دهلران","مرکزی",12,654,40,27,254,975,7,982
"ایلام","دهلران","مرکزی",13,523,15,39,257,834,10,844
"ایلام","دهلران","مرکزی",14,244,13,30,236,523,5,528
"ایلام","دهلران","مرکزی",15,624,20,27,359,1030,15,1045
"ایلام","دهلران","مرکزی",16,661,27,54,535,1277,18,1295
"ایلام","دهلران","مرکزی",17,338,16,32,239,625,11,636
"ایلام","دهلران","مرکزی",18,375,9,63,315,762,13,775
"ایلام","دهلران","مرکزی",19,42,3,4,57,106,0,106
"ایلام","دهلران","مرکزی",20,244,1,26,67,338,7,345
"ایلام","دهلران","مرکزی",21,701,5,42,187,935,10,945
"ایلام","دهلران","مرکزی",22,35,7,3,31,76,9,85
"ایلام","دهلران","مرکزی",23,58,0,0,9,67,2,69
"ایلام","دهلران","مرکزی",24,552,6,12,131,701,4,705
"ایلام","دهلران","مرکزی",25,383,3,8,35,429,1,430
"ایلام","دهلران","مرکزی",26,51,4,0,10,65,1,66
"ایلام","دهلران","مرکزی",27,285,2,12,32,331,1,332
"ایلام","دهلران","زرین_آیاد",1,397,9,18,144,568,5,573
"ایلام","دهلران","زرین_آیاد",2,680,7,29,287,1003,12,1015
"ایلام","دهلران","زرین_آیاد",3,333,4,17,195,549,6,555
"ایلام","دهلران","زرین_آیاد",4,239,1,12,62,314,3,317
"ایلام","دهلران","زرین_آیاد",5,133,0,1,33,167,0,167
"ایلام","دهلران","زرین_آیاد",6,189,1,6,129,325,0,325
"ایلام","دهلران","زرین_آیاد",7,420,4,9,93,526,4,530
"ایلام","دهلران","زرین_آیاد",8,107,2,1,33,143,2,145
"ایلام","دهلران","زرین_آیاد",9,356,3,2,28,389,2,391
"ایلام","دهلران","زرین_آیاد",10,131,0,0,37,168,0,168
"ایلام","دهلران","زرین_آیاد",11,111,1,1,19,132,0,132
"ایلام","دهلران","زرین_آیاد",12,168,3,3,81,255,4,259
"ایلام","دهلران","زرین_آیاد",13,323,8,10,163,504,2,506
"ایلام","دهلران","زرین_آیاد",14,419,8,3,89,519,11,530
"ایلام","دهلران","موسیان",1,351,21,51,212,635,17,652
"ایلام","دهلران","موسیان",2,303,15,23,216,557,14,571
"ایلام","دهلران","موسیان",3,175,12,15,110,312,9,321
"ایلام","دهلران","موسیان",4,246,12,4,187,449,6,455
"ایلام","دهلران","موسیان",5,367,9,5,128,509,4,513
"ایلام","دهلران","موسیان",6,555,10,8,111,684,13,697
"ایلام","دهلران","موسیان",7,521,11,5,60,597,3,600
"ایلام","دهلران","موسیان",8,696,2,6,97,801,2,803
"ایلام","دهلران","موسیان",9,209,7,11,142,369,3,372
"ایلام","دهلران","موسیان",10,608,10,3,78,699,3,702
"ایلام","دهلران","موسیان",11,328,0,5,16,349,2,351
"ایلام","دهلران","موسیان",12,629,1,16,64,710,6,716
"ایلام","دهلران","موسیان",13,267,19,8,105,399,2,401
"ایلام","دهلران","موسیان",14,149,4,4,39,196,0,196
"ایلام","دهلران","موسیان",15,76,2,2,54,134,4,138
"ایلام","دهلران","موسیان",16,61,2,4,47,114,3,117
"ایلام","شیروان_چرداول","مرکزی",1,631,14,5,128,778,8,786
"ایلام","شیروان_چرداول","مرکزی",2,842,20,15,179,1056,11,1067
"ایلام","شیروان_چرداول","مرکزی",3,217,7,17,148,389,12,401
"ایلام","شیروان_چرداول","مرکزی",4,402,7,8,232,649,8,657
"ایلام","شیروان_چرداول","مرکزی",5,183,4,11,44,242,9,251
"ایلام","شیروان_چرداول","مرکزی",6,324,7,12,274,617,1,618
"ایلام","شیروان_چرداول","مرکزی",7,291,8,24,297,620,5,625
"ایلام","شیروان_چرداول","مرکزی",8,557,10,52,266,885,11,896
"ایلام","شیروان_چرداول","مرکزی",9,308,0,8,100,416,2,418
"ایلام","شیروان_چرداول","مرکزی",10,412,12,11,319,754,9,763
"ایلام","شیروان_چرداول","مرکزی",11,303,14,29,116,462,8,470
"ایلام","شیروان_چرداول","مرکزی",12,260,8,14,179,461,4,465
"ایلام","شیروان_چرداول","مرکزی",13,344,4,3,84,435,2,437
"ایلام","شیروان_چرداول","مرکزی",14,452,13,30,468,963,16,979
"ایلام","شیروان_چرداول","مرکزی",15,466,13,58,524,1061,4,1065
"ایلام","شیروان_چرداول","مرکزی",16,203,13,21,216,453,5,458
"ایلام","شیروان_چرداول","مرکزی",17,198,11,23,237,469,7,476
"ایلام","شیروان_چرداول","مرکزی",18,240,14,67,431,752,10,762
"ایلام","شیروان_چرداول","مرکزی",19,140,5,7,94,246,3,249
"ایلام","شیروان_چرداول","مرکزی",20,158,5,36,195,394,2,396
"ایلام","شیروان_چرداول","مرکزی",21,293,7,6,201,507,2,509
"ایلام","شیروان_چرداول","مرکزی",22,255,5,35,227,522,7,529
"ایلام","شیروان_چرداول","مرکزی",23,218,12,25,298,553,4,557
"ایلام","شیروان_چرداول","مرکزی",24,598,13,9,239,859,8,867
"ایلام","شیروان_چرداول","مرکزی",25,600,9,3,234,846,3,849
"ایلام","شیروان_چرداول","مرکزی",26,385,8,5,149,547,9,556
"ایلام","شیروان_چرداول","مرکزی",27,290,4,11,79,384,0,384
"ایلام","شیروان_چرداول","مرکزی",28,798,7,15,220,1040,7,1047
"ایلام","شیروان_چرداول","مرکزی",29,248,5,14,179,446,10,456
"ایلام","شیروان_چرداول","مرکزی",30,277,4,7,107,395,4,399
"ایلام","شیروان_چرداول","مرکزی",31,271,7,4,162,444,3,447
"ایلام","شیروان_چرداول","مرکزی",32,170,4,17,82,273,0,273
"ایلام","شیروان_چرداول","مرکزی",33,291,3,7,194,495,4,499
"ایلام","شیروان_چرداول","مرکزی",34,351,1,17,204,573,0,573
"ایلام","شیروان_چرداول","مرکزی",35,150,1,8,103,262,12,274
"ایلام","شیروان_چرداول","مرکزی",36,146,0,11,77,234,0,234
"ایلام","شیروان_چرداول","مرکزی",37,427,4,18,76,525,2,527
"ایلام","شیروان_چرداول","مرکزی",38,350,5,8,201,564,3,567
"ایلام","شیروان_چرداول","مرکزی",39,161,1,5,232,399,2,401
"ایلام","شیروان_چرداول","مرکزی",40,146,2,15,66,229,0,229
"ایلام","شیروان_چرداول","مرکزی",41,402,5,20,132,559,1,560
"ایلام","شیروان_چرداول","مرکزی",42,352,3,4,79,438,3,441
"ایلام","شیروان_چرداول","مرکزی",43,581,4,10,178,773,2,775
"ایلام","شیروان_چرداول","مرکزی",44,288,1,13,52,354,1,355
"ایلام","شیروان_چرداول","بخش_شیروان",45,289,8,41,288,626,4,630
"ایلام","شیروان_چرداول","بخش_شیروان",46,409,34,28,298,769,5,774
"ایلام","شیروان_چرداول","بخش_شیروان",47,453,4,24,115,596,4,600
"ایلام","شیروان_چرداول","بخش_شیروان",48,350,9,1,94,454,1,455
"ایلام","شیروان_چرداول","بخش_شیروان",49,233,1,0,31,265,1,266
"ایلام","شیروان_چرداول","بخش_شیروان",50,220,2,0,51,273,2,275
"ایلام","شیروان_چرداول","بخش_شیروان",51,477,3,6,80,566,2,568
"ایلام","شیروان_چرداول","بخش_شیروان",52,358,3,18,120,499,3,502
"ایلام","شیروان_چرداول","بخش_شیروان",53,319,2,4,146,471,1,472
"ایلام","شیروان_چرداول","بخش_شیروان",54,419,2,3,57,481,5,486
"ایلام","شیروان_چرداول","بخش_شیروان",55,337,1,6,63,407,0,407
"ایلام","شیروان_چرداول","بخش_شیروان",56,355,3,2,90,450,5,455
"ایلام","شیروان_چرداول","بخش_شیروان",57,326,2,3,102,433,4,437
"ایلام","شیروان_چرداول","بخش_شیروان",58,359,2,3,90,454,1,455
"ایلام","شیروان_چرداول","بخش_شیروان",59,296,1,4,75,376,1,377
"ایلام","شیروان_چرداول","بخش_شیروان",60,314,1,2,80,397,5,402
"ایلام","شیروان_چرداول","بخش_شیروان",61,222,1,0,42,265,3,268
"ایلام","شیروان_چرداول","بخش_شیروان",62,388,5,25,160,578,2,580
"ایلام","شیروان_چرداول","بخش_شیروان",63,598,12,4,270,884,6,890
"ایلام","شیروان_چرداول","بخش_شیروان",64,226,4,3,107,340,7,347
"ایلام","شیروان_چرداول","بخش_شیروان",65,259,11,12,278,560,5,565
"ایلام","شیروان_چرداول","بخش_شیروان",66,273,11,7,183,474,4,478
"ایلام","شیروان_چرداول","بخش_شیروان",67,379,11,14,133,537,6,543
"ایلام","شیروان_چرداول","بخش_شیروان",68,428,9,10,186,633,2,635
"ایلام","شیروان_چرداول","بخش_شیروان",69,368,6,12,180,566,2,568
"ایلام","شیروان_چرداول","بخش_شیروان",70,278,5,13,109,405,2,407
"ایلام","شیروان_چرداول","بخش_شیروان",71,330,4,7,197,538,3,541
"ایلام","شیروان_چرداول","بخش_شیروان",72,364,0,0,43,407,1,408
"ایلام","شیروان_چرداول","بخش_شیروان",73,356,1,3,42,402,1,403
"ایلام","شیروان_چرداول","بخش_شیروان",74,319,0,0,17,336,1,337
"ایلام","شیروان_چرداول","بخش_شیروان",75,336,1,6,31,374,2,376
"ایلام","شیروان_چرداول","بخش_شیروان",76,218,0,1,23,242,0,242
"ایلام","شیروان_چرداول","بخش_شیروان",77,470,2,12,152,636,1,637
"ایلام","شیروان_چرداول","بخش_شیروان",78,253,6,10,140,409,0,409
"ایلام","شیروان_چرداول","بخش_شیروان",79,214,0,3,153,370,0,370
"ایلام","شیروان_چرداول","بخش_شیروان",80,384,4,97,197,682,12,694
"ایلام","شیروان_چرداول","بخش_شیروان",81,280,6,70,131,487,1,488
"ایلام","شیروان_چرداول","بخش_شیروان",82,160,6,40,69,275,2,277
"ایلام","ملکشاهی","مرکزی",1,604,12,7,166,789,13,802
"ایلام","ملکشاهی","مرکزی",2,508,6,10,114,638,5,643
"ایلام","ملکشاهی","مرکزی",3,386,2,1,87,476,4,480
"ایلام","ملکشاهی","مرکزی",4,543,5,6,64,618,4,622
"ایلام","ملکشاهی","مرکزی",5,683,8,14,144,849,5,854
"ایلام","ملکشاهی","مرکزی",6,357,5,1,61,424,1,425
"ایلام","ملکشاهی","مرکزی",7,384,1,2,62,449,2,451
"ایلام","ملکشاهی","مرکزی",8,546,2,7,94,649,6,655
"ایلام","ملکشاهی","مرکزی",9,445,4,0,42,491,3,494
"ایلام","ملکشاهی","مرکزی",10,737,20,8,89,854,6,860
"ایلام","ملکشاهی","مرکزی",11,626,4,2,156,788,2,790
"ایلام","ملکشاهی","مرکزی",12,319,3,0,12,334,1,335
"ایلام","ملکشاهی","مرکزی",13,359,1,4,10,374,2,376
"ایلام","ملکشاهی","مرکزی",14,713,1,9,87,810,9,819
"ایلام","ملکشاهی","مرکزی",15,252,4,3,17,276,1,277
"ایلام","ملکشاهی","مرکزی",16,305,1,1,19,326,0,326
"ایلام","ملکشاهی","گچی",1,515,1,2,65,583,2,585
"ایلام","ملکشاهی","گچی",2,573,1,10,63,647,0,647
"ایلام","ملکشاهی","گچی",3,431,0,3,50,484,0,484
"ایلام","ملکشاهی","گچی",4,301,2,0,17,320,0,320
"ایلام","ملکشاهی","گچی",5,717,4,0,48,769,1,770
"ایلام","ملکشاهی","گچی",6,361,0,3,8,372,0,372
"ایلام","ملکشاهی","گچی",7,633,3,9,49,694,4,698
"ایلام","مهران","مرکزی",1,894,12,11,280,1197,17,1214
"ایلام","مهران","مرکزی",2,706,11,10,249,976,17,993
"ایلام","مهران","مرکزی",3,557,15,6,165,743,14,757
"ایلام","مهران","مرکزی",4,675,12,15,257,959,10,969
"ایلام","مهران","مرکزی",5,692,15,22,254,983,8,991
"ایلام","مهران","مرکزی",6,422,8,5,199,634,12,646
"ایلام","مهران","مرکزی",7,748,23,9,255,1035,19,1054
"ایلام","مهران","مرکزی",8,453,16,18,220,707,5,712
"ایلام","مهران","مرکزی",9,515,8,5,210,738,9,747
"ایلام","مهران","مرکزی",10,381,10,6,166,563,9,572
"ایلام","مهران","مرکزی",11,54,2,0,66,122,1,123
"ایلام","مهران","مرکزی",12,138,5,4,38,185,3,188
"ایلام","مهران","مرکزی",13,639,4,19,95,757,2,759
"ایلام","مهران","مرکزی",14,593,3,1,63,660,8,668
"ایلام","مهران","مرکزی",15,609,0,0,32,641,0,641
"ایلام","مهران","مرکزی",16,474,1,5,43,523,7,530
"ایلام","مهران","مرکزی",17,799,12,19,105,935,3,938
"ایلام","مهران","مرکزی",18,717,13,9,187,926,20,946
"ایلام","مهران","صالح_آباد",1,540,14,8,117,679,5,684
"ایلام","مهران","صالح_آباد",2,464,12,2,117,595,11,606
"ایلام","مهران","صالح_آباد",3,230,6,0,57,293,3,296
"ایلام","مهران","صالح_آباد",4,87,2,1,25,115,1,116
"ایلام","مهران","صالح_آباد",5,119,1,1,34,155,1,156
"ایلام","مهران","صالح_آباد",6,128,1,2,46,177,1,178
"ایلام","مهران","صالح_آباد",7,117,3,2,65,187,5,192
"ایلام","مهران","صالح_آباد",8,352,10,1,164,527,9,536
"بوشهر","بوشهر","مرکزی",1,437,20,22,525,1004,18,1022
"بوشهر","بوشهر","مرکزی",2,436,28,15,509,988,8,996
"بوشهر","بوشهر","مرکزی",3,239,7,8,396,650,6,656
"بوشهر","بوشهر","مرکزی",4,565,75,28,566,1234,14,1248
"بوشهر","بوشهر","مرکزی",5,577,21,8,766,1372,13,1385
"بوشهر","بوشهر","مرکزی",6,451,44,24,803,1322,18,1340
"بوشهر","بوشهر","مرکزی",7,506,30,24,427,987,13,1000
"بوشهر","بوشهر","مرکزی",8,340,19,22,693,1074,12,1086
"بوشهر","بوشهر","مرکزی",9,391,20,6,576,993,7,1000
"بوشهر","بوشهر","مرکزی",10,365,16,7,401,789,9,798
"بوشهر","بوشهر","مرکزی",11,428,15,5,395,843,7,850
"بوشهر","بوشهر","مرکزی",12,426,22,5,346,799,10,809
"بوشهر","بوشهر","مرکزی",13,651,9,13,356,1029,18,1047
"بوشهر","بوشهر","مرکزی",14,354,10,11,355,730,5,735
"بوشهر","بوشهر","مرکزی",15,1040,19,5,489,1553,24,1577
"بوشهر","بوشهر","مرکزی",16,672,31,15,567,1285,15,1300
"بوشهر","بوشهر","مرکزی",17,1156,41,20,954,2171,20,2191
"بوشهر","بوشهر","مرکزی",18,311,12,16,318,657,7,664
"بوشهر","بوشهر","مرکزی",19,616,38,33,1173,1860,27,1887
"بوشهر","بوشهر","مرکزی",20,489,33,17,571,1110,14,1124
"بوشهر","بوشهر","مرکزی",21,379,34,45,1408,1866,15,1881
"بوشهر","بوشهر","مرکزی",22,587,15,19,440,1061,7,1068
"بوشهر","بوشهر","مرکزی",23,486,22,9,525,1042,11,1053
"بوشهر","بوشهر","مرکزی",24,459,14,3,421,897,8,905
"بوشهر","بوشهر","مرکزی",25,647,9,19,596,1271,21,1292
"بوشهر","بوشهر","مرکزی",26,595,28,12,541,1176,6,1182
"بوشهر","بوشهر","مرکزی",27,673,29,17,824,1543,20,1563
"بوشهر","بوشهر","مرکزی",28,758,28,22,732,1540,15,1555
"بوشهر","بوشهر","مرکزی",29,459,20,7,499,985,7,992
"بوشهر","بوشهر","مرکزی",30,370,4,2,301,677,5,682
"بوشهر","بوشهر","مرکزی",31,1025,50,27,841,1943,10,1953
"بوشهر","بوشهر","مرکزی",32,326,8,4,382,720,2,722
"بوشهر","بوشهر","مرکزی",33,542,27,27,569,1165,19,1184
"بوشهر","بوشهر","مرکزی",34,584,18,9,566,1177,22,1199
"بوشهر","بوشهر","مرکزی",35,561,30,20,1178,1789,11,1800
"بوشهر","بوشهر","مرکزی",36,499,14,10,527,1050,11,1061
"بوشهر","بوشهر","مرکزی",37,702,22,19,737,1480,16,1496
"بوشهر","بوشهر","مرکزی",38,519,37,28,885,1469,21,1490
"بوشهر","بوشهر","مرکزی",39,691,44,34,966,1735,38,1773
"بوشهر","بوشهر","مرکزی",40,384,39,18,790,1231,14,1245
"بوشهر","بوشهر","مرکزی",41,396,44,25,903,1368,19,1387
"بوشهر","بوشهر","مرکزی",42,443,31,42,1363,1879,19,1898
"بوشهر","بوشهر","مرکزی",43,415,40,23,1003,1481,18,1499
"بوشهر","بوشهر","مرکزی",44,520,45,22,957,1544,18,1562
"بوشهر","بوشهر","مرکزی",45,574,25,8,661,1268,13,1281
"بوشهر","بوشهر","مرکزی",46,611,15,12,403,1041,8,1049
"بوشهر","بوشهر","مرکزی",47,469,8,9,431,917,12,929
"بوشهر","بوشهر","مرکزی",48,620,24,31,952,1627,22,1649
"بوشهر","بوشهر","مرکزی",49,1167,55,6,629,1857,25,1882
"بوشهر","بوشهر","مرکزی",50,1118,29,8,501,1656,11,1667
"بوشهر","بوشهر","مرکزی",51,661,17,13,448,1139,13,1152
"بوشهر","بوشهر","مرکزی",52,192,2,2,112,308,9,317
"بوشهر","بوشهر","مرکزی",53,1218,27,9,635,1889,11,1900
"بوشهر","بوشهر","مرکزی",54,599,15,11,373,998,7,1005
"بوشهر","بوشهر","مرکزی",55,257,10,4,237,508,6,514
"بوشهر","بوشهر","مرکزی",56,911,42,30,994,1977,12,1989
"بوشهر","بوشهر","مرکزی",57,476,49,28,938,1491,9,1500
"بوشهر","بوشهر","مرکزی",58,819,40,26,558,1443,17,1460
"بوشهر","بوشهر","مرکزی",59,944,49,13,927,1933,14,1947
"بوشهر","بوشهر","مرکزی",60,913,45,34,832,1824,21,1845
"بوشهر","بوشهر","مرکزی",61,517,31,18,513,1079,19,1098
"بوشهر","بوشهر","مرکزی",62,823,31,14,957,1825,15,1840
"بوشهر","بوشهر","مرکزی",63,775,19,3,618,1415,13,1428
"بوشهر","بوشهر","مرکزی",64,428,13,6,430,877,11,888
"بوشهر","بوشهر","مرکزی",65,968,41,36,736,1781,19,1800
"بوشهر","بوشهر","مرکزی",66,556,24,13,468,1061,10,1071
"بوشهر","بوشهر","مرکزی",67,778,29,22,457,1286,12,1298
"بوشهر","بوشهر","مرکزی",68,496,16,18,462,992,8,1000
"بوشهر","بوشهر","مرکزی",69,820,65,13,496,1394,6,1400
"بوشهر","بوشهر","مرکزی",70,599,16,11,307,933,13,946
"بوشهر","بوشهر","مرکزی",71,467,11,5,285,768,13,781
"بوشهر","بوشهر","مرکزی",72,366,19,3,208,596,5,601
"بوشهر","بوشهر","مرکزی",73,500,27,2,263,792,8,800
"بوشهر","بوشهر","مرکزی",74,228,12,4,118,362,10,372
"بوشهر","بوشهر","مرکزی",75,297,15,1,151,464,4,468
"بوشهر","بوشهر","مرکزی",76,151,6,7,68,232,6,238
"بوشهر","بوشهر","مرکزی",77,178,10,1,108,297,3,300
"بوشهر","بوشهر","مرکزی",78,442,13,5,186,646,19,665
"بوشهر","بوشهر","مرکزی",79,570,18,7,358,953,4,957
"بوشهر","بوشهر","مرکزی",80,1004,25,5,174,1208,5,1213
"بوشهر","بوشهر","مرکزی",81,336,37,22,474,869,13,882
"بوشهر","بوشهر","مرکزی",82,536,22,17,273,848,20,868
"بوشهر","بوشهر","مرکزی",83,840,4,2,46,892,9,901
"بوشهر","بوشهر","مرکزی",84,127,3,0,206,336,2,338
"بوشهر","بوشهر","مرکزی",85,913,27,33,596,1569,22,1591
"بوشهر","بوشهر","مرکزی",86,603,20,11,367,1001,6,1007
"بوشهر","بوشهر","مرکزی",87,501,18,12,359,890,11,901
"بوشهر","بوشهر","مرکزی",88,1069,24,5,347,1445,7,1452
"بوشهر","بوشهر","مرکزی",89,1212,10,4,316,1542,7,1549
"بوشهر","بوشهر","مرکزی",90,1249,7,4,332,1592,8,1600
"بوشهر","بوشهر","مرکزی",91,968,29,5,367,1369,12,1381
"بوشهر","بوشهر","مرکزی",92,1005,12,6,373,1396,6,1402
"بوشهر","بوشهر","مرکزی",93,203,4,1,59,267,1,268
"بوشهر","بوشهر","مرکزی",94,448,6,1,193,648,5,653
"بوشهر","بوشهر","مرکزی",95,836,10,2,200,1048,5,1053
"بوشهر","بوشهر","مرکزی",96,823,3,1,100,927,11,938
"بوشهر","بوشهر","مرکزی",97,288,4,1,82,375,0,375
"بوشهر","بوشهر","مرکزی",98,316,1,3,169,489,5,494
"بوشهر","بوشهر","مرکزی",99,833,3,7,254,1097,12,1109
"بوشهر","بوشهر","مرکزی",100,828,1,0,120,949,8,957
"بوشهر","بوشهر","مرکزی",101,368,2,0,113,483,5,488
"بوشهر","بوشهر","مرکزی",102,108,2,1,59,170,0,170
"بوشهر","بوشهر","مرکزی",103,192,1,0,18,211,1,212
"بوشهر","بوشهر","مرکزی",104,667,4,0,173,844,7,851
"بوشهر","بوشهر","مرکزی",105,156,3,0,53,212,1,213
"بوشهر","بوشهر","مرکزی",106,223,2,0,39,264,2,266
"بوشهر","بوشهر","خارگ",1,945,51,8,494,1498,11,1509
"بوشهر","بوشهر","خارگ",2,1018,72,13,712,1815,15,1830
"بوشهر","بوشهر","خارگ",3,208,6,2,80,296,6,302
"بوشهر","بوشهر","خارگ",4,193,7,0,56,256,5,261
"بوشهر","بوشهر","خارگ",5,675,29,3,583,1290,22,1312
"بوشهر","بوشهر","خارگ",6,283,16,4,297,600,5,605
"بوشهر","بوشهر","خارگ",7,326,10,2,143,481,7,488
"بوشهر","بوشهر","خارگ",8,116,13,0,122,251,6,257
"بوشهر","بوشهر","خارگ",9,173,11,2,86,272,2,274
"بوشهر","بوشهر","خارگ",10,118,9,0,124,251,3,254
"بوشهر","بوشهر","خارگ",11,157,17,4,118,296,4,300
"بوشهر","تنگستان","مرکزی",1,416,5,0,187,608,7,615
"بوشهر","تنگستان","مرکزی",2,539,4,1,180,724,14,738
"بوشهر","تنگستان","مرکزی",3,603,8,6,268,885,19,904
"بوشهر","تنگستان","مرکزی",4,784,9,8,397,1198,15,1213
"بوشهر","تنگستان","مرکزی",5,789,7,5,338,1139,18,1157
"بوشهر","تنگستان","مرکزی",6,535,8,4,234,781,15,796
"بوشهر","تنگستان","مرکزی",7,519,6,1,219,745,11,756
"بوشهر","تنگستان","مرکزی",8,300,1,23,120,444,2,446
"بوشهر","تنگستان","مرکزی",9,347,3,4,158,512,8,520
"بوشهر","تنگستان","مرکزی",10,26,0,0,5,31,1,32
"بوشهر","تنگستان","مرکزی",11,140,0,0,76,216,0,216
"بوشهر","تنگستان","مرکزی",12,145,0,0,111,256,2,258
"بوشهر","تنگستان","مرکزی",13,831,4,0,302,1137,14,1151
"بوشهر","تنگستان","مرکزی",14,328,0,1,148,477,3,480
"بوشهر","تنگستان","مرکزی",15,850,7,2,147,1006,4,1010
"بوشهر","تنگستان","مرکزی",16,524,9,2,96,631,3,634
"بوشهر","تنگستان","مرکزی",17,265,7,1,105,378,0,378
"بوشهر","تنگستان","مرکزی",18,768,2,2,56,828,5,833
"بوشهر","تنگستان","مرکزی",19,561,6,4,69,640,9,649
"بوشهر","تنگستان","مرکزی",20,420,3,4,99,526,5,531
"بوشهر","تنگستان","مرکزی",21,463,2,0,56,521,2,523
"بوشهر","تنگستان","مرکزی",22,756,6,1,54,817,4,821
"بوشهر","تنگستان","مرکزی",23,340,2,1,106,449,1,450
"بوشهر","تنگستان","مرکزی",24,299,8,1,53,361,1,362
"بوشهر","تنگستان","مرکزی",25,266,0,0,18,284,3,287
"بوشهر","تنگستان","مرکزی",26,331,2,0,41,374,0,374
"بوشهر","تنگستان","مرکزی",27,733,4,1,60,798,7,805
"بوشهر","تنگستان","مرکزی",28,301,1,1,52,355,2,357
"بوشهر","تنگستان","مرکزی",29,185,6,0,55,246,3,249
"بوشهر","تنگستان","مرکزی",30,469,7,7,186,669,15,684
"بوشهر","تنگستان","مرکزی",31,358,2,1,94,455,6,461
"بوشهر","تنگستان","مرکزی",32,401,4,1,151,557,5,562
"بوشهر","تنگستان","مرکزی",33,430,4,1,147,582,3,585
"بوشهر","تنگستان","مرکزی",34,577,7,7,321,912,7,919
"بوشهر","تنگستان","مرکزی",35,463,6,2,134,605,5,610
"بوشهر","تنگستان","مرکزی",36,439,9,0,125,573,7,580
"بوشهر","تنگستان","دلوار",1,513,6,4,164,687,9,696
"بوشهر","تنگستان","دلوار",2,851,10,1,236,1098,5,1103
"بوشهر","تنگستان","دلوار",3,776,6,2,199,983,9,992
"بوشهر","تنگستان","دلوار",4,1011,7,0,147,1165,9,1174
"بوشهر","تنگستان","دلوار",5,867,10,2,118,997,4,1001
"بوشهر","تنگستان","دلوار",6,736,7,2,133,878,6,884
"بوشهر","تنگستان","دلوار",7,580,2,0,56,638,2,640
"بوشهر","تنگستان","دلوار",8,691,6,0,82,779,6,785
"بوشهر","تنگستان","دلوار",9,551,3,0,54,608,4,612
"بوشهر","تنگستان","دلوار",10,804,10,3,251,1068,9,1077
"بوشهر","تنگستان","دلوار",11,581,18,0,199,798,9,807
"بوشهر","تنگستان","دلوار",12,568,6,1,176,751,7,758
"بوشهر","تنگستان","دلوار",13,411,4,1,112,528,5,533
"بوشهر","تنگستان","دلوار",14,427,5,1,152,585,5,590
"بوشهر","تنگستان","دلوار",15,815,10,1,306,1132,7,1139
"بوشهر","تنگستان","دلوار",16,750,13,1,359,1123,12,1135
"بوشهر","تنگستان","دلوار",17,697,17,1,401,1116,19,1135
"بوشهر","تنگستان","دلوار",18,725,13,2,290,1030,9,1039
"بوشهر","تنگستان","دلوار",19,790,31,0,144,965,5,970
"بوشهر","تنگستان","دلوار",20,385,7,0,52,444,6,450
"بوشهر","جم","مرکزی",1,581,36,19,699,1335,8,1343
"بوشهر","جم","مرکزی",2,498,20,18,776,1312,14,1326
"بوشهر","جم","مرکزی",3,540,14,22,480,1056,10,1066
"بوشهر","جم","مرکزی",4,480,11,4,409,904,10,914
"بوشهر","جم","مرکزی",5,545,39,9,920,1513,9,1522
"بوشهر","جم","مرکزی",6,368,59,28,867,1322,13,1335
"بوشهر","جم","مرکزی",7,399,12,5,383,799,11,810
"بوشهر","جم","مرکزی",8,664,4,0,303,971,2,973
"بوشهر","جم","مرکزی",9,510,9,3,264,786,2,788
"بوشهر","جم","مرکزی",10,519,16,5,299,839,7,846
"بوشهر","جم","مرکزی",11,168,3,0,87,258,4,262
"بوشهر","جم","مرکزی",12,380,7,0,147,534,1,535
"بوشهر","جم","مرکزی",13,354,26,10,320,710,4,714
"بوشهر","جم","مرکزی",14,285,7,1,230,523,3,526
"بوشهر","جم","مرکزی",15,412,4,7,255,678,7,685
"بوشهر","جم","مرکزی",16,204,8,1,153,366,1,367
"بوشهر","جم","مرکزی",17,462,9,3,263,737,7,744
"بوشهر","جم","مرکزی",18,381,4,7,109,501,6,507
"بوشهر","جم","مرکزی",19,409,5,3,148,565,4,569
"بوشهر","جم","مرکزی",20,507,6,3,85,601,4,605
"بوشهر","جم","مرکزی",21,487,10,2,75,574,3,577
"بوشهر","جم","مرکزی",22,411,4,0,174,589,1,590
"بوشهر","جم","مرکزی",23,357,6,0,289,652,6,658
"بوشهر","جم","ریز",1,438,5,1,166,610,5,615
"بوشهر","جم","ریز",2,158,0,1,103,262,1,263
"بوشهر","جم","ریز",3,244,6,1,85,336,2,338
"بوشهر","جم","ریز",4,478,3,2,126,609,2,611
"بوشهر","جم","ریز",5,508,5,0,223,736,9,745
"بوشهر","جم","ریز",6,362,7,0,147,516,3,519
"بوشهر","جم","ریز",7,378,6,0,308,692,4,696
"بوشهر","جم","ریز",8,248,8,0,86,342,8,350
"بوشهر","جم","ریز",9,396,6,1,270,673,3,676
"بوشهر","جم","ریز",10,154,2,2,87,245,2,247
"بوشهر","جم","ریز",11,319,7,1,263,590,5,595
"بوشهر","جم","ریز",12,233,5,1,35,274,2,276
"بوشهر","دشتستان","مرکزی",1,358,2,1,269,630,16,646
"بوشهر","دشتستان","مرکزی",2,611,22,3,476,1112,18,1130
"بوشهر","دشتستان","مرکزی",3,465,17,5,540,1027,30,1057
"بوشهر","دشتستان","مرکزی",4,717,16,10,670,1413,38,1451
"بوشهر","دشتستان","مرکزی",5,502,12,6,465,985,31,1016
"بوشهر","دشتستان","مرکزی",6,476,15,4,664,1159,18,1177
"بوشهر","دشتستان","مرکزی",7,784,35,12,768,1599,27,1626
"بوشهر","دشتستان","مرکزی",8,572,12,11,596,1191,30,1221
"بوشهر","دشتستان","مرکزی",9,604,13,8,465,1090,28,1118
"بوشهر","دشتستان","مرکزی",10,440,8,4,424,876,41,917
"بوشهر","دشتستان","مرکزی",11,375,9,2,282,668,17,685
"بوشهر","دشتستان","مرکزی",12,721,14,1,255,991,30,1021
"بوشهر","دشتستان","مرکزی",13,612,6,6,284,908,34,942
"بوشهر","دشتستان","مرکزی",14,625,5,5,389,1024,0,1024
"بوشهر","دشتستان","مرکزی",15,480,8,3,383,874,20,894
"بوشهر","دشتستان","مرکزی",16,423,8,3,420,854,21,875
"بوشهر","دشتستان","مرکزی",17,474,7,9,417,907,23,930
"بوشهر","دشتستان","مرکزی",18,693,20,9,488,1210,24,1234
"بوشهر","دشتستان","مرکزی",19,587,15,6,513,1121,43,1164
"بوشهر","دشتستان","مرکزی",20,595,8,9,322,934,16,950
"بوشهر","دشتستان","مرکزی",21,662,16,16,705,1399,27,1426
"بوشهر","دشتستان","مرکزی",22,524,15,8,536,1083,20,1103
"بوشهر","دشتستان","مرکزی",23,576,19,9,539,1143,25,1168
"بوشهر","دشتستان","مرکزی",24,590,22,11,687,1310,30,1340
"بوشهر","دشتستان","مرکزی",25,593,15,4,332,944,25,969
"بوشهر","دشتستان","مرکزی",26,987,15,9,476,1487,20,1507
"بوشهر","دشتستان","مرکزی",27,718,17,8,342,1085,26,1111
"بوشهر","دشتستان","مرکزی",28,612,12,8,282,914,13,927
"بوشهر","دشتستان","مرکزی",29,615,10,5,379,1009,19,1028
"بوشهر","دشتستان","مرکزی",30,667,10,3,381,1061,21,1082
"بوشهر","دشتستان","مرکزی",31,529,9,0,266,804,21,825
"بوشهر","دشتستان","مرکزی",32,744,10,6,567,1327,31,1358
"بوشهر","دشتستان","مرکزی",33,594,9,1,388,992,21,1013
"بوشهر","دشتستان","مرکزی",34,482,11,5,255,753,11,764
"بوشهر","دشتستان","مرکزی",35,843,5,1,281,1130,16,1146
"بوشهر","دشتستان","مرکزی",36,629,6,4,138,777,14,791
"بوشهر","دشتستان","مرکزی",37,837,9,12,350,1208,16,1224
"بوشهر","دشتستان","مرکزی",38,575,7,2,247,831,17,848
"بوشهر","دشتستان","مرکزی",39,489,4,6,141,640,13,653
"بوشهر","دشتستان","مرکزی",40,799,11,2,260,1072,27,1099
"بوشهر","دشتستان","مرکزی",41,628,14,4,222,868,20,888
"بوشهر","دشتستان","مرکزی",42,870,11,5,169,1055,15,1070
"بوشهر","دشتستان","مرکزی",43,675,3,4,176,858,21,879
"بوشهر","دشتستان","مرکزی",44,224,9,8,198,439,13,452
"بوشهر","دشتستان","مرکزی",45,102,4,3,95,204,7,211
"بوشهر","دشتستان","مرکزی",46,719,4,0,251,974,21,995
"بوشهر","دشتستان","مرکزی",47,570,5,1,337,913,22,935
"بوشهر","دشتستان","مرکزی",48,524,8,0,204,736,0,736
"بوشهر","دشتستان","مرکزی",49,659,4,9,269,941,28,969
"بوشهر","دشتستان","مرکزی",50,518,2,0,165,685,22,707
"بوشهر","دشتستان","مرکزی",51,724,3,0,148,875,16,891
"بوشهر","دشتستان","مرکزی",52,379,5,1,76,461,15,476
"بوشهر","دشتستان","مرکزی",53,746,3,0,143,892,28,920
"بوشهر","دشتستان","مرکزی",54,1035,13,1,190,1239,30,1269
"بوشهر","دشتستان","مرکزی",55,872,5,5,233,1115,20,1135
"بوشهر","دشتستان","مرکزی",56,377,1,2,171,551,7,558
"بوشهر","دشتستان","مرکزی",57,546,4,8,279,837,35,872
"بوشهر","دشتستان","مرکزی",58,390,9,2,282,683,15,698
"بوشهر","دشتستان","مرکزی",59,258,3,0,134,395,5,400
"بوشهر","دشتستان","مرکزی",60,581,7,5,249,842,23,865
"بوشهر","دشتستان","مرکزی",61,290,1,1,111,403,19,422
"بوشهر","دشتستان","مرکزی",62,661,2,0,201,864,17,881
"بوشهر","دشتستان","مرکزی",63,460,4,0,159,623,20,643
"بوشهر","دشتستان","مرکزی",64,248,3,2,141,394,5,399
"بوشهر","دشتستان","مرکزی",65,597,4,4,174,779,19,798
"بوشهر","دشتستان","مرکزی",66,699,3,2,315,1019,10,1029
"بوشهر","دشتستان","مرکزی",67,350,7,2,214,573,18,591
"بوشهر","دشتستان","ارم",1,350,7,3,282,642,18,660
"بوشهر","دشتستان","ارم",2,397,2,1,173,573,19,592
"بوشهر","دشتستان","ارم",3,360,4,6,118,488,10,498
"بوشهر","دشتستان","ارم",4,313,0,0,161,474,10,484
"بوشهر","دشتستان","ارم",5,387,3,1,152,543,24,567
"بوشهر","دشتستان","ارم",6,284,6,1,146,437,13,450
"بوشهر","دشتستان","ارم",7,284,7,1,192,484,12,496
"بوشهر","دشتستان","ارم",8,232,0,0,173,405,20,425
"بوشهر","دشتستان","ارم",9,363,1,0,110,474,14,488
"بوشهر","دشتستان","ارم",10,168,0,1,66,235,4,239
"بوشهر","دشتستان","ارم",11,194,1,0,96,291,6,297
"بوشهر","دشتستان","ارم",12,111,0,0,15,126,3,129
"بوشهر","دشتستان","ارم",13,101,0,0,10,111,3,114
"بوشهر","دشتستان","ارم",14,87,0,0,101,188,14,202
"بوشهر","دشتستان","ارم",15,86,0,0,18,104,1,105
"بوشهر","دشتستان","ارم",16,435,1,1,197,634,21,655
"بوشهر","دشتستان","ارم",17,184,1,0,70,255,2,257
"بوشهر","دشتستان","ارم",18,36,1,0,25,62,0,62
"بوشهر","دشتستان","بوشکان",1,281,5,11,273,570,17,587
"بوشهر","دشتستان","بوشکان",2,348,4,3,306,661,16,677
"بوشهر","دشتستان","بوشکان",3,433,4,0,291,728,23,751
"بوشهر","دشتستان","بوشکان",4,474,5,1,200,680,19,699
"بوشهر","دشتستان","بوشکان",5,530,2,2,176,710,24,734
"بوشهر","دشتستان","بوشکان",6,419,3,2,162,586,13,599
"بوشهر","دشتستان","بوشکان",7,275,1,5,158,439,15,454
"بوشهر","دشتستان","بوشکان",8,462,1,0,167,630,5,635
"بوشهر","دشتستان","بوشکان",9,359,1,0,177,537,23,560
"بوشهر","دشتستان","بوشکان",10,140,0,1,95,236,3,239
"بوشهر","دشتستان","بوشکان",11,262,6,1,144,413,12,425
"بوشهر","دشتستان","بوشکان",12,51,0,1,65,117,1,118
"بوشهر","دشتستان","بوشکان",13,97,0,0,44,141,8,149
"بوشهر","دشتستان","بوشکان",14,37,0,0,47,84,1,85
"بوشهر","دشتستان","بوشکان",15,320,1,0,69,390,8,398
"بوشهر","دشتستان","بوشکان",16,177,0,3,114,294,11,305
"بوشهر","دشتستان","سعدآباد",1,578,6,9,301,894,33,927
"بوشهر","دشتستان","سعدآباد",2,466,3,6,198,673,12,685
"بوشهر","دشتستان","سعدآباد",3,445,10,7,249,711,20,731
"بوشهر","دشتستان","سعدآباد",4,243,1,4,268,516,16,532
"بوشهر","دشتستان","سعدآباد",5,261,11,3,318,593,22,615
"بوشهر","دشتستان","سعدآباد",6,278,4,1,237,520,12,532
"بوشهر","دشتستان","سعدآباد",7,720,4,3,90,817,10,827
"بوشهر","دشتستان","سعدآباد",8,466,3,0,129,598,9,607
"بوشهر","دشتستان","سعدآباد",9,583,3,1,119,706,15,721
"بوشهر","دشتستان","سعدآباد",10,407,1,4,358,770,16,786
"بوشهر","دشتستان","سعدآباد",11,486,6,0,181,673,22,695
"بوشهر","دشتستان","سعدآباد",12,397,4,0,88,489,8,497
"بوشهر","دشتستان","سعدآباد",13,683,6,2,111,802,0,802
"بوشهر","دشتستان","سعدآباد",14,597,3,1,126,727,17,744
"بوشهر","دشتستان","سعدآباد",15,509,4,3,114,630,22,652
"بوشهر","دشتستان","سعدآباد",16,292,1,2,69,364,29,393
"بوشهر","دشتستان","سعدآباد",17,370,4,0,76,450,0,450
"بوشهر","دشتستان","سعدآباد",18,608,16,0,294,918,22,940
"بوشهر","دشتستان","سعدآباد",19,420,5,3,287,715,17,732
"بوشهر","دشتستان","سعدآباد",20,538,6,12,308,864,21,885
"بوشهر","دشتستان","سعدآباد",21,434,22,0,312,768,22,790
"بوشهر","دشتستان","سعدآباد",22,558,10,5,216,789,10,799
"بوشهر","دشتستان","سعدآباد",23,466,8,3,214,691,12,703
"بوشهر","دشتستان","سعدآباد",24,480,9,3,203,695,17,712
"بوشهر","دشتستان","سعدآباد",25,375,2,0,203,580,9,589
"بوشهر","دشتستان","سعدآباد",26,333,10,7,191,541,16,557
"بوشهر","دشتستان","سعدآباد",27,201,3,1,73,278,10,288
"بوشهر","دشتستان","سعدآباد",28,163,1,4,46,214,0,214
"بوشهر","دشتستان","شبانکاره",1,398,14,12,460,884,21,905
"بوشهر","دشتستان","شبانکاره",2,261,5,20,356,642,17,659
"بوشهر","دشتستان","شبانکاره",3,385,26,13,406,830,28,858
"بوشهر","دشتستان","شبانکاره",4,272,9,14,276,571,21,592
"بوشهر","دشتستان","شبانکاره",5,198,1,2,287,488,14,502
"بوشهر","دشتستان","شبانکاره",6,623,11,9,266,909,13,922
"بوشهر","دشتستان","شبانکاره",7,693,10,13,552,1268,28,1296
"بوشهر","دشتستان","شبانکاره",8,708,65,9,282,1064,19,1083
"بوشهر","دشتستان","شبانکاره",9,479,17,10,313,819,11,830
"بوشهر","دشتستان","شبانکاره",10,821,7,2,117,947,25,972
"بوشهر","دشتستان","شبانکاره",11,954,13,3,197,1167,31,1198
"بوشهر","دشتستان","شبانکاره",12,641,13,7,331,992,31,1023
"بوشهر","دشتستان","شبانکاره",13,383,6,2,276,667,16,683
"بوشهر","دشتستان","شبانکاره",14,508,10,11,196,725,21,746
"بوشهر","دشتستان","شبانکاره",15,472,11,0,100,583,9,592
"بوشهر","دشتستان","شبانکاره",16,520,1,0,66,587,23,610
"بوشهر","دشتستان","شبانکاره",17,108,2,1,50,161,3,164
"بوشهر","دشتستان","شبانکاره",18,552,4,0,90,646,11,657
"بوشهر","دشتستان","شبانکاره",19,622,13,119,181,935,15,950
"بوشهر","دشتستان","شبانکاره",20,305,13,2,157,477,21,498
"بوشهر","دشتستان","شبانکاره",21,426,5,9,260,700,16,716
"بوشهر","دشتستان","شبانکاره",22,459,12,3,342,816,21,837
"بوشهر","دشتستان","شبانکاره",23,380,3,7,486,876,21,897
"بوشهر","دشتستان","شبانکاره",24,515,9,5,118,647,10,657
"بوشهر","دشتستان","شبانکاره",25,316,7,5,340,668,17,685
"بوشهر","دشتستان","شبانکاره",26,509,19,2,369,899,30,929
"بوشهر","دشتستان","شبانکاره",27,397,1,1,105,504,13,517
"بوشهر","دشتستان","شبانکاره",28,389,2,9,206,606,4,610
"بوشهر","دشتستان","شبانکاره",29,7,0,0,6,13,0,13
"بوشهر","دشتی","مرکزی",1,655,9,1,243,908,13,921
"بوشهر","دشتی","مرکزی",2,598,11,6,369,984,13,997
"بوشهر","دشتی","مرکزی",3,656,10,2,272,940,17,957
"بوشهر","دشتی","مرکزی",4,715,12,4,433,1164,11,1175
"بوشهر","دشتی","مرکزی",5,424,6,3,170,603,0,603
"بوشهر","دشتی","مرکزی",6,516,3,2,200,721,7,728
"بوشهر","دشتی","مرکزی",7,761,10,14,420,1205,19,1224
"بوشهر","دشتی","مرکزی",8,402,5,1,311,719,5,724
"بوشهر","دشتی","مرکزی",9,660,8,4,229,901,10,911
"بوشهر","دشتی","مرکزی",10,454,4,0,178,636,8,644
"بوشهر","دشتی","مرکزی",11,303,2,1,120,426,3,429
"بوشهر","دشتی","مرکزی",12,509,5,1,201,716,9,725
"بوشهر","دشتی","مرکزی",13,334,17,5,258,614,9,623
"بوشهر","دشتی","مرکزی",14,471,10,6,321,808,17,825
"بوشهر","دشتی","مرکزی",15,803,9,4,339,1155,10,1165
"بوشهر","دشتی","مرکزی",16,604,10,5,354,973,7,980
"بوشهر","دشتی","مرکزی",17,643,6,3,218,870,9,879
"بوشهر","دشتی","مرکزی",18,596,12,2,322,932,5,937
"بوشهر","دشتی","مرکزی",19,404,4,1,216,625,6,631
"بوشهر","دشتی","مرکزی",20,205,4,4,75,288,3,291
"بوشهر","دشتی","مرکزی",21,403,10,1,209,623,7,630
"بوشهر","دشتی","مرکزی",22,564,5,1,159,729,3,732
"بوشهر","دشتی","مرکزی",23,432,6,3,204,645,8,653
"بوشهر","دشتی","مرکزی",24,464,3,0,122,589,6,595
"بوشهر","دشتی","مرکزی",25,413,16,21,296,746,8,754
"بوشهر","دشتی","مرکزی",26,674,2,2,72,750,6,756
"بوشهر","دشتی","مرکزی",27,587,8,2,100,697,3,700
"بوشهر","دشتی","مرکزی",28,423,1,3,121,548,1,549
"بوشهر","دشتی","مرکزی",29,524,6,1,176,707,3,710
"بوشهر","دشتی","مرکزی",30,641,7,0,99,747,7,754
"بوشهر","دشتی","مرکزی",31,234,1,0,20,255,0,255
"بوشهر","دشتی","مرکزی",32,237,6,0,74,317,1,318
"بوشهر","دشتی","مرکزی",33,817,6,0,147,970,10,980
"بوشهر","دشتی","مرکزی",34,552,7,1,81,641,1,642
"بوشهر","دشتی","مرکزی",35,254,1,0,94,349,2,351
"بوشهر","دشتی","مرکزی",36,445,0,4,110,559,3,562
"بوشهر","دشتی","شنبه_و_طسوج",1,492,4,0,83,579,1,580
"بوشهر","دشتی","شنبه_و_طسوج",2,475,4,4,92,575,2,577
"بوشهر","دشتی","شنبه_و_طسوج",3,353,0,1,92,446,2,448
"بوشهر","دشتی","شنبه_و_طسوج",4,614,2,2,163,781,2,783
"بوشهر","دشتی","شنبه_و_طسوج",5,209,5,6,88,308,1,309
"بوشهر","دشتی","شنبه_و_طسوج",6,430,4,0,56,490,1,491
"بوشهر","دشتی","شنبه_و_طسوج",7,540,3,1,103,647,0,647
"بوشهر","دشتی","شنبه_و_طسوج",8,139,0,0,13,152,0,152
"بوشهر","دشتی","شنبه_و_طسوج",9,174,3,0,72,249,0,249
"بوشهر","دشتی","شنبه_و_طسوج",10,273,0,1,51,325,6,331
"بوشهر","دشتی","کاکی",1,263,2,1,298,564,8,572
"بوشهر","دشتی","کاکی",2,268,8,2,258,536,4,540
"بوشهر","دشتی","کاکی",3,575,9,1,343,928,10,938
"بوشهر","دشتی","کاکی",4,490,5,5,319,819,4,823
"بوشهر","دشتی","کاکی",5,320,2,0,214,536,4,540
"بوشهر","دشتی","کاکی",6,329,14,3,473,819,3,822
"بوشهر","دشتی","کاکی",7,259,4,0,139,402,4,406
"بوشهر","دشتی","کاکی",8,416,7,3,203,629,3,632
"بوشهر","دشتی","کاکی",9,484,15,1,207,707,2,709
"بوشهر","دشتی","کاکی",10,275,1,0,95,371,3,374
"بوشهر","دشتی","کاکی",11,461,8,2,99,570,5,575
"بوشهر","دشتی","کاکی",12,295,3,1,183,482,2,484
"بوشهر","دشتی","کاکی",13,313,5,1,138,457,1,458
"بوشهر","دشتی","کاکی",14,469,2,0,58,529,2,531
"بوشهر","دشتی","کاکی",15,738,11,1,157,907,3,910
"بوشهر","دشتی","کاکی",16,450,5,0,136,591,1,592
"بوشهر","دشتی","کاکی",17,251,1,0,38,290,0,290
"بوشهر","دشتی","کاکی",18,503,6,6,101,616,2,618
"بوشهر","دشتی","کاکی",19,127,3,0,48,178,0,178
"بوشهر","دشتی","کاکی",20,312,1,0,14,327,3,330
"بوشهر","دشتی","کاکی",21,232,1,0,41,274,1,275
"بوشهر","دشتی","کاکی",22,361,2,0,117,480,6,486
"بوشهر","دشتی","کاکی",23,550,10,1,70,631,2,633
"بوشهر","دشتی","کاکی",24,521,3,5,117,646,5,651
"بوشهر","دشتی","کاکی",25,527,4,1,91,623,3,626
"بوشهر","دیر","مرکزی",1,495,11,7,252,765,7,772
"بوشهر","دیر","مرکزی",2,911,20,4,423,1358,6,1364
"بوشهر","دیر","مرکزی",3,695,19,5,432,1151,5,1156
"بوشهر","دیر","مرکزی",4,666,19,9,305,999,11,1010
"بوشهر","دیر","مرکزی",5,1003,33,7,304,1347,11,1358
"بوشهر","دیر","مرکزی",6,560,7,2,333,902,12,914
"بوشهر","دیر","مرکزی",7,660,13,14,306,993,7,1000
"بوشهر","دیر","مرکزی",8,614,17,7,415,1053,10,1063
"بوشهر","دیر","مرکزی",9,469,9,3,243,724,11,735
"بوشهر","دیر","مرکزی",10,534,7,2,170,713,3,716
"بوشهر","دیر","مرکزی",11,286,10,2,92,390,3,393
"بوشهر","دیر","مرکزی",12,329,15,4,154,502,6,508
"بوشهر","دیر","مرکزی",13,610,22,14,416,1062,4,1066
"بوشهر","دیر","مرکزی",14,576,12,6,299,893,8,901
"بوشهر","دیر","مرکزی",15,695,8,2,114,819,8,827
"بوشهر","دیر","مرکزی",16,689,28,5,193,915,5,920
"بوشهر","دیر","مرکزی",17,497,20,2,176,695,4,699
"بوشهر","دیر","مرکزی",18,626,41,8,203,878,0,878
"بوشهر","دیر","مرکزی",19,683,32,4,228,947,7,954
"بوشهر","دیر","مرکزی",20,854,11,3,199,1067,5,1072
"بوشهر","دیر","مرکزی",21,1065,18,0,198,1281,10,1291
"بوشهر","دیر","مرکزی",22,182,1,5,28,216,4,220
"بوشهر","دیر","مرکزی",23,487,9,0,80,576,2,578
"بوشهر","دیر","مرکزی",24,294,1,4,61,360,0,360
"بوشهر","دیر","مرکزی",25,380,4,1,111,496,3,499
"بوشهر","دیر","مرکزی",26,128,1,0,46,175,0,175
"بوشهر","دیر","مرکزی",27,716,8,2,144,870,5,875
"بوشهر","دیر","مرکزی",28,377,3,0,106,486,4,490
"بوشهر","دیر","بردخون",1,771,18,6,363,1158,20,1178
"بوشهر","دیر","بردخون",2,593,9,3,212,817,4,821
"بوشهر","دیر","بردخون",3,391,4,4,200,599,6,605
"بوشهر","دیر","بردخون",4,389,8,2,142,541,4,545
"بوشهر","دیر","بردخون",5,463,7,2,141,613,4,617
"بوشهر","دیر","بردخون",6,290,4,0,80,374,2,376
"بوشهر","دیر","بردخون",7,392,5,0,102,499,4,503
"بوشهر","دیر","بردخون",8,337,1,1,70,409,4,413
"بوشهر","دیر","بردخون",9,278,4,1,126,409,1,410
"بوشهر","دیلم","مرکزی",1,900,26,15,516,1457,25,1482
"بوشهر","دیلم","مرکزی",2,687,16,12,267,982,7,989
"بوشهر","دیلم","مرکزی",3,443,6,3,236,688,7,695
"بوشهر","دیلم","مرکزی",4,728,9,3,277,1017,16,1033
"بوشهر","دیلم","مرکزی",5,588,10,15,233,846,12,858
"بوشهر","دیلم","مرکزی",6,290,7,7,218,522,4,526
"بوشهر","دیلم","مرکزی",7,544,6,6,244,800,10,810
"بوشهر","دیلم","مرکزی",8,504,8,4,206,722,10,732
"بوشهر","دیلم","مرکزی",9,562,11,3,154,730,5,735
"بوشهر","دیلم","مرکزی",10,333,3,2,141,479,8,487
"بوشهر","دیلم","مرکزی",11,632,11,2,251,896,3,899
"بوشهر","دیلم","مرکزی",12,302,4,1,80,387,2,389
"بوشهر","دیلم","مرکزی",13,271,6,11,120,408,4,412
"بوشهر","دیلم","مرکزی",14,508,5,8,164,685,8,693
"بوشهر","دیلم","مرکزی",15,263,10,6,87,366,5,371
"بوشهر","دیلم","مرکزی",16,545,11,4,319,879,2,881
"بوشهر","دیلم","مرکزی",17,283,3,2,47,335,1,336
"بوشهر","دیلم","مرکزی",18,477,1,3,128,609,1,610
"بوشهر","دیلم","مرکزی",19,205,2,0,44,251,1,252
"بوشهر","دیلم","مرکزی",20,22,0,0,20,42,1,43
"بوشهر","دیلم","مرکزی",21,73,2,0,22,97,0,97
"بوشهر","دیلم","مرکزی",22,394,3,6,73,476,3,479
"بوشهر","دیلم","امام_حسن",1,674,15,4,192,885,9,894
"بوشهر","دیلم","امام_حسن",2,317,4,3,138,462,4,466
"بوشهر","دیلم","امام_حسن",3,402,3,1,146,552,5,557
"بوشهر","دیلم","امام_حسن",4,293,1,1,52,347,1,348
"بوشهر","دیلم","امام_حسن",5,198,2,0,35,235,2,237
"بوشهر","دیلم","امام_حسن",6,127,3,1,28,159,1,160
"بوشهر","دیلم","امام_حسن",7,126,15,1,231,373,4,377
"بوشهر","کنگان","مرکزی",1,363,6,1,506,876,2,878
"بوشهر","کنگان","مرکزی",2,485,14,4,315,818,11,829
"بوشهر","کنگان","مرکزی",3,507,42,9,369,927,9,936
"بوشهر","کنگان","مرکزی",4,650,42,10,420,1122,14,1136
"بوشهر","کنگان","مرکزی",5,600,39,8,657,1304,14,1318
"بوشهر","کنگان","مرکزی",6,611,23,12,786,1432,3,1435
"بوشهر","کنگان","مرکزی",7,573,17,10,683,1283,14,1297
"بوشهر","کنگان","مرکزی",8,685,15,8,697,1405,12,1417
"بوشهر","کنگان","مرکزی",9,972,24,18,676,1690,16,1706
"بوشهر","کنگان","مرکزی",10,471,11,3,223,708,5,713
"بوشهر","کنگان","مرکزی",11,382,16,2,393,793,9,802
"بوشهر","کنگان","مرکزی",12,485,17,5,479,986,5,991
"بوشهر","کنگان","مرکزی",13,819,11,0,188,1018,11,1029
"بوشهر","کنگان","مرکزی",14,332,10,5,170,517,11,528
"بوشهر","کنگان","مرکزی",15,503,5,7,178,693,6,699
"بوشهر","کنگان","مرکزی",16,879,12,3,302,1196,10,1206
"بوشهر","کنگان","مرکزی",17,568,17,3,244,832,10,842
"بوشهر","کنگان","مرکزی",18,600,9,2,140,751,4,755
"بوشهر","کنگان","مرکزی",19,468,12,2,161,643,2,645
"بوشهر","کنگان","مرکزی",20,640,6,0,134,780,0,780
"بوشهر","کنگان","مرکزی",21,126,4,4,152,286,3,289
"بوشهر","کنگان","مرکزی",22,367,15,9,171,562,3,565
"بوشهر","کنگان","مرکزی",23,368,0,3,147,518,1,519
"بوشهر","کنگان","مرکزی",24,475,7,3,229,714,5,719
"بوشهر","کنگان","مرکزی",25,489,5,5,492,991,15,1006
"بوشهر","کنگان","مرکزی",26,412,6,5,406,829,9,838
"بوشهر","کنگان","مرکزی",27,815,31,5,437,1288,14,1302
"بوشهر","کنگان","مرکزی",28,314,3,0,19,336,0,336
"بوشهر","کنگان","مرکزی",29,250,10,3,118,381,2,383
"بوشهر","کنگان","مرکزی",30,342,3,1,73,419,2,421
"بوشهر","کنگان","عسلویه",1,727,36,16,933,1712,14,1726
"بوشهر","کنگان","عسلویه",2,354,24,15,831,1224,10,1234
"بوشهر","کنگان","عسلویه",3,515,42,9,799,1365,17,1382
"بوشهر","کنگان","عسلویه",4,427,34,16,758,1235,20,1255
"بوشهر","کنگان","عسلویه",5,768,68,11,1319,2166,24,2190
"بوشهر","کنگان","عسلویه",6,395,23,7,781,1206,13,1219
"بوشهر","کنگان","عسلویه",7,908,68,21,1008,2005,11,2016
"بوشهر","کنگان","عسلویه",8,314,10,3,423,750,5,755
"بوشهر","کنگان","عسلویه",9,229,5,0,633,867,7,874
"بوشهر","کنگان","عسلویه",10,88,1,4,495,588,0,588
"بوشهر","کنگان","عسلویه",11,178,6,5,388,577,6,583
"بوشهر","کنگان","عسلویه",12,160,3,8,607,778,7,785
"بوشهر","کنگان","عسلویه",13,112,3,2,364,481,1,482
"بوشهر","کنگان","عسلویه",14,51,4,3,612,670,13,683
"بوشهر","کنگان","عسلویه",15,94,4,1,480,579,7,586
"بوشهر","کنگان","عسلویه",16,162,4,1,350,517,6,523
"بوشهر","کنگان","عسلویه",17,492,15,6,546,1059,7,1066
"بوشهر","کنگان","عسلویه",18,317,35,8,642,1002,18,1020
"بوشهر","کنگان","عسلویه",19,96,8,4,164,272,7,279
"بوشهر","کنگان","عسلویه",20,447,40,4,320,811,10,821
"بوشهر","کنگان","عسلویه",21,463,83,31,982,1559,16,1575
"بوشهر","کنگان","عسلویه",22,275,17,1,339,632,12,644
"بوشهر","کنگان","عسلویه",23,872,135,15,1146,2168,23,2191
"بوشهر","گناوه","مرکزی",1,355,5,10,258,628,7,635
"بوشهر","گناوه","مرکزی",2,179,5,5,128,317,3,320
"بوشهر","گناوه","مرکزی",3,813,47,17,723,1600,15,1615
"بوشهر","گناوه","مرکزی",4,437,15,11,406,869,5,874
"بوشهر","گناوه","مرکزی",5,496,21,11,474,1002,15,1017
"بوشهر","گناوه","مرکزی",6,579,11,5,591,1186,7,1193
"بوشهر","گناوه","مرکزی",7,302,10,3,289,604,7,611
"بوشهر","گناوه","مرکزی",8,572,16,12,401,1001,14,1015
"بوشهر","گناوه","مرکزی",9,431,12,10,211,664,16,680
"بوشهر","گناوه","مرکزی",10,326,8,3,198,535,6,541
"بوشهر","گناوه","مرکزی",11,387,12,9,378,786,12,798
"بوشهر","گناوه","مرکزی",12,564,17,14,483,1078,13,1091
"بوشهر","گناوه","مرکزی",13,273,9,2,149,433,3,436
"بوشهر","گناوه","مرکزی",14,700,10,11,200,921,12,933
"بوشهر","گناوه","مرکزی",15,409,4,6,202,621,8,629
"بوشهر","گناوه","مرکزی",16,728,24,14,352,1118,5,1123
"بوشهر","گناوه","مرکزی",17,157,2,5,96,260,4,264
"بوشهر","گناوه","مرکزی",18,795,14,8,434,1251,11,1262
"بوشهر","گناوه","مرکزی",19,434,8,11,216,669,16,685
"بوشهر","گناوه","مرکزی",20,387,11,7,333,738,13,751
"بوشهر","گناوه","مرکزی",21,186,7,4,226,423,1,424
"بوشهر","گناوه","مرکزی",22,532,8,17,563,1120,8,1128
"بوشهر","گناوه","مرکزی",23,575,17,23,587,1202,14,1216
"بوشهر","گناوه","مرکزی",24,309,13,9,277,608,8,616
"بوشهر","گناوه","مرکزی",25,906,21,13,438,1378,10,1388
"بوشهر","گناوه","مرکزی",26,648,8,2,135,793,0,793
"بوشهر","گناوه","مرکزی",27,512,8,2,139,661,4,665
"بوشهر","گناوه","مرکزی",28,1145,11,5,396,1557,9,1566
"بوشهر","گناوه","مرکزی",29,650,15,14,288,967,13,980
"بوشهر","گناوه","مرکزی",30,511,6,10,232,759,1,760
"بوشهر","گناوه","مرکزی",31,493,7,4,187,691,4,695
"بوشهر","گناوه","مرکزی",32,634,22,9,250,915,10,925
"بوشهر","گناوه","مرکزی",33,658,9,12,342,1021,13,1034
"بوشهر","گناوه","مرکزی",34,971,9,9,401,1390,10,1400
"بوشهر","گناوه","مرکزی",35,356,7,9,248,620,7,627
"بوشهر","گناوه","مرکزی",36,655,3,8,258,924,6,930
"بوشهر","گناوه","مرکزی",37,212,21,9,211,453,9,462
"بوشهر","گناوه","مرکزی",38,132,6,0,114,252,1,253
"بوشهر","گناوه","مرکزی",39,219,7,4,83,313,2,315
"بوشهر","گناوه","مرکزی",40,101,0,2,61,164,0,164
"بوشهر","گناوه","مرکزی",41,628,15,7,429,1079,8,1087
"بوشهر","گناوه","مرکزی",42,595,13,10,311,929,7,936
"بوشهر","گناوه","مرکزی",43,194,0,1,111,306,3,309
"بوشهر","گناوه","مرکزی",44,370,2,0,199,571,9,580
"بوشهر","گناوه","مرکزی",45,328,1,3,117,449,1,450
"بوشهر","گناوه","مرکزی",46,528,2,2,118,650,4,654
"بوشهر","گناوه","مرکزی",47,152,3,2,49,206,0,206
"بوشهر","گناوه","مرکزی",48,422,2,2,127,553,3,556
"بوشهر","گناوه","مرکزی",49,572,13,7,488,1080,3,1083
"بوشهر","گناوه","مرکزی",50,381,7,2,84,474,1,475
"بوشهر","گناوه","ریگ",1,382,9,3,328,722,11,733
"بوشهر","گناوه","ریگ",2,408,4,1,362,775,9,784
"بوشهر","گناوه","ریگ",3,377,7,7,408,799,5,804
"بوشهر","گناوه","ریگ",4,124,7,4,127,262,7,269
"بوشهر","گناوه","ریگ",5,140,4,3,176,323,6,329
"بوشهر","گناوه","ریگ",6,195,4,1,55,255,0,255
"بوشهر","گناوه","ریگ",7,287,6,2,253,548,6,554
"بوشهر","گناوه","ریگ",8,569,9,2,221,801,8,809
"بوشهر","گناوه","ریگ",9,327,1,0,88,416,0,416
"بوشهر","گناوه","ریگ",10,176,1,0,45,222,1,223
"بوشهر","گناوه","ریگ",11,362,2,2,130,496,4,500
"بوشهر","گناوه","ریگ",12,251,3,3,99,356,4,360
"بوشهر","گناوه","ریگ",13,473,0,1,89,563,3,566
"بوشهر","گناوه","ریگ",14,271,2,1,124,398,2,400
"بوشهر","گناوه","ریگ",15,295,0,1,94,390,3,393
"تهران","اسلامشهر","مركز",1,1024,19,2,338,1383,33,1416
"تهران","اسلامشهر","مركز",2,527,14,2,278,821,11,832
"تهران","اسلامشهر","مركز",3,600,22,1,379,1002,19,1021
"تهران","اسلامشهر","مركز",4,1039,11,5,428,1483,39,1522
"تهران","اسلامشهر","مركز",5,595,18,5,461,1079,12,1091
"تهران","اسلامشهر","مركز",6,840,10,4,451,1305,32,1337
"تهران","اسلامشهر","مركز",7,795,10,4,191,1000,19,1019
"تهران","اسلامشهر","مركز",8,608,10,3,314,935,20,955
"تهران","اسلامشهر","مركز",9,580,13,6,514,1113,25,1138
"تهران","اسلامشهر","مركز",10,466,8,3,307,784,19,803
"تهران","اسلامشهر","مركز",11,673,13,3,237,926,11,937
"تهران","اسلامشهر","مركز",12,741,17,2,177,937,25,962
"تهران","اسلامشهر","مركز",13,600,19,3,326,948,19,967
"تهران","اسلامشهر","مركز",14,704,9,1,339,1053,18,1071
"تهران","اسلامشهر","مركز",15,644,20,6,294,964,18,982
"تهران","اسلامشهر","مركز",16,633,14,3,235,885,15,900
"تهران","اسلامشهر","مركز",17,625,7,1,126,759,12,771
"تهران","اسلامشهر","مركز",18,972,18,5,378,1373,28,1401
"تهران","اسلامشهر","مركز",19,869,4,1,201,1075,17,1092
"تهران","اسلامشهر","مركز",20,794,7,4,225,1030,29,1059
"تهران","اسلامشهر","مركز",21,482,5,2,174,663,9,672
"تهران","اسلامشهر","مركز",22,871,15,3,279,1168,26,1194
"تهران","اسلامشهر","مركز",23,749,13,2,152,916,13,929
"تهران","اسلامشهر","مركز",24,464,8,1,241,714,35,749
"تهران","اسلامشهر","مركز",25,859,9,1,142,1011,27,1038
"تهران","اسلامشهر","مركز",26,799,8,0,167,974,15,989
"تهران","اسلامشهر","مركز",27,784,8,7,311,1110,21,1131
"تهران","اسلامشهر","مركز",28,1184,28,3,313,1528,21,1549
"تهران","اسلامشهر","مركز",29,561,21,6,492,1080,16,1096
"تهران","اسلامشهر","مركز",30,350,5,0,166,521,14,535
"تهران","اسلامشهر","مركز",31,498,12,0,211,721,8,729
"تهران","اسلامشهر","مركز",32,752,28,6,472,1258,19,1277
"تهران","اسلامشهر","مركز",33,601,26,6,336,969,21,990
"تهران","اسلامشهر","مركز",34,667,25,7,495,1194,28,1222
"تهران","اسلامشهر","مركز",35,936,22,5,393,1356,34,1390
"تهران","اسلامشهر","مركز",36,302,6,0,196,504,14,518
"تهران","اسلامشهر","مركز",37,732,27,7,555,1321,28,1349
"تهران","اسلامشهر","مركز",38,1032,20,1,315,1368,23,1391
"تهران","اسلامشهر","مركز",39,670,15,2,278,965,23,988
"تهران","اسلامشهر","مركز",40,745,14,2,184,945,29,974
"تهران","اسلامشهر","مركز",41,624,13,10,306,953,14,967
"تهران","اسلامشهر","مركز",42,759,16,6,436,1217,17,1234
"تهران","اسلامشهر","مركز",43,1057,26,5,274,1362,28,1390
"تهران","اسلامشهر","مركز",44,810,19,3,283,1115,23,1138
"تهران","اسلامشهر","مركز",45,526,19,8,379,932,30,962
"تهران","اسلامشهر","مركز",46,1219,16,3,348,1586,40,1626
"تهران","اسلامشهر","مركز",47,450,16,1,277,744,16,760
"تهران","اسلامشهر","مركز",48,879,17,2,325,1223,35,1258
"تهران","اسلامشهر","مركز",49,776,36,5,459,1276,24,1300
"تهران","اسلامشهر","مركز",50,834,11,2,261,1108,25,1133
"تهران","اسلامشهر","مركز",51,770,14,4,203,991,33,1024
"تهران","اسلامشهر","مركز",52,856,18,1,158,1033,24,1057
"تهران","اسلامشهر","مركز",53,824,32,3,314,1173,20,1193
"تهران","اسلامشهر","مركز",54,527,15,0,372,914,17,931
"تهران","اسلامشهر","مركز",55,1033,24,3,310,1370,37,1407
"تهران","اسلامشهر","مركز",56,1041,12,4,305,1362,20,1382
"تهران","اسلامشهر","مركز",57,547,10,1,236,794,20,814
"تهران","اسلامشهر","مركز",58,802,15,8,407,1232,27,1259
"تهران","اسلامشهر","مركز",59,826,5,0,245,1076,27,1103
"تهران","اسلامشهر","مركز",60,765,14,1,338,1118,29,1147
"تهران","اسلامشهر","مركز",61,728,9,2,245,984,18,1002
"تهران","اسلامشهر","مركز",62,1079,15,5,482,1581,42,1623
"تهران","اسلامشهر","مركز",63,1033,23,2,252,1310,10,1320
"تهران","اسلامشهر","مركز",64,979,17,2,366,1364,24,1388
"تهران","اسلامشهر","مركز",65,722,19,1,349,1091,35,1126
"تهران","اسلامشهر","مركز",66,652,24,5,368,1049,26,1075
"تهران","اسلامشهر","مركز",67,770,32,10,560,1372,17,1389
"تهران","اسلامشهر","مركز",68,800,13,3,301,1117,27,1144
"تهران","اسلامشهر","مركز",69,760,10,5,217,992,22,1014
"تهران","اسلامشهر","مركز",70,828,18,5,247,1098,11,1109
"تهران","اسلامشهر","مركز",71,168,3,3,368,542,3,545
"تهران","اسلامشهر","مركز",72,750,27,3,564,1344,26,1370
"تهران","اسلامشهر","مركز",73,730,39,15,620,1404,28,1432
"تهران","اسلامشهر","مركز",74,1106,22,5,703,1836,64,1900
"تهران","اسلامشهر","مركز",75,967,18,4,356,1345,17,1362
"تهران","اسلامشهر","مركز",76,665,11,7,467,1150,34,1184
"تهران","اسلامشهر","مركز",77,816,19,5,436,1276,17,1293
"تهران","اسلامشهر","مركز",78,671,21,7,454,1153,24,1177
"تهران","اسلامشهر","مركز",79,1039,17,0,355,1411,25,1436
"تهران","اسلامشهر","مركز",80,831,12,4,574,1421,19,1440
"تهران","اسلامشهر","مركز",81,627,18,2,286,933,20,953
"تهران","اسلامشهر","مركز",82,989,21,4,610,1624,22,1646
"تهران","اسلامشهر","مركز",83,856,19,4,461,1340,24,1364
"تهران","اسلامشهر","مركز",84,1394,20,1,365,1780,24,1804
"تهران","اسلامشهر","مركز",85,799,18,3,503,1323,27,1350
"تهران","اسلامشهر","مركز",86,792,18,5,486,1301,23,1324
"تهران","اسلامشهر","مركز",87,856,21,4,450,1331,29,1360
"تهران","اسلامشهر","مركز",88,949,14,3,275,1241,20,1261
"تهران","اسلامشهر","مركز",89,1143,21,4,506,1674,31,1705
"تهران","اسلامشهر","مركز",90,895,23,6,435,1359,26,1385
"تهران","اسلامشهر","مركز",91,950,16,5,484,1455,32,1487
"تهران","اسلامشهر","مركز",92,1083,23,0,482,1588,21,1609
"تهران","اسلامشهر","مركز",93,1246,26,0,503,1775,22,1797
"تهران","اسلامشهر","مركز",94,837,21,4,375,1237,17,1254
"تهران","اسلامشهر","مركز",95,832,15,1,282,1130,19,1149
"تهران","اسلامشهر","مركز",96,1011,19,3,370,1403,34,1437
"تهران","اسلامشهر","مركز",97,948,14,6,350,1318,26,1344
"تهران","اسلامشهر","مركز",98,1179,18,4,516,1717,19,1736
"تهران","اسلامشهر","مركز",99,875,22,11,555,1463,34,1497
"تهران","اسلامشهر","مركز",100,916,26,12,348,1302,19,1321
"تهران","اسلامشهر","مركز",101,1193,20,11,379,1603,35,1638
"تهران","اسلامشهر","مركز",102,1019,19,8,378,1424,22,1446
"تهران","اسلامشهر","مركز",103,862,17,6,409,1294,30,1324
"تهران","اسلامشهر","مركز",104,1232,11,9,376,1628,31,1659
"تهران","اسلامشهر","مركز",105,811,11,5,346,1173,20,1193
"تهران","اسلامشهر","مركز",106,767,16,4,304,1091,24,1115
"تهران","اسلامشهر","مركز",107,1058,13,3,425,1499,31,1530
"تهران","اسلامشهر","مركز",108,1027,16,3,267,1313,27,1340
"تهران","اسلامشهر","مركز",109,706,15,4,405,1130,22,1152
"تهران","اسلامشهر","مركز",110,928,13,3,303,1247,25,1272
"تهران","اسلامشهر","مركز",111,901,13,0,187,1101,29,1130
"تهران","اسلامشهر","مركز",112,657,7,2,309,975,24,999
"تهران","اسلامشهر","مركز",113,882,14,1,532,1429,26,1455
"تهران","اسلامشهر","مركز",114,947,6,5,467,1425,24,1449
"تهران","اسلامشهر","مركز",115,995,8,0,299,1302,25,1327
"تهران","اسلامشهر","مركز",116,692,3,1,367,1063,17,1080
"تهران","اسلامشهر","مركز",117,623,8,3,346,980,20,1000
"تهران","اسلامشهر","مركز",118,929,6,2,317,1254,14,1268
"تهران","اسلامشهر","مركز",119,712,13,1,396,1122,22,1144
"تهران","اسلامشهر","مركز",120,708,6,0,344,1058,19,1077
"تهران","اسلامشهر","مركز",121,480,6,2,277,765,22,787
"تهران","اسلامشهر","مركز",122,832,13,1,501,1347,26,1373
"تهران","اسلامشهر","مركز",123,581,6,0,323,910,17,927
"تهران","اسلامشهر","مركز",124,806,16,1,246,1069,23,1092
"تهران","اسلامشهر","مركز",125,740,12,1,408,1161,15,1176
"تهران","اسلامشهر","مركز",126,788,7,6,435,1236,27,1263
"تهران","اسلامشهر","مركز",127,892,11,5,373,1281,19,1300
"تهران","اسلامشهر","مركز",128,677,11,3,336,1027,25,1052
"تهران","اسلامشهر","مركز",129,646,10,5,388,1049,10,1059
"تهران","اسلامشهر","مركز",130,524,14,0,222,760,7,767
"تهران","اسلامشهر","مركز",131,609,21,1,524,1155,22,1177
"تهران","اسلامشهر","مركز",132,769,14,2,493,1278,13,1291
"تهران","اسلامشهر","مركز",133,714,12,1,549,1276,23,1299
"تهران","اسلامشهر","مركز",134,914,10,6,322,1252,21,1273
"تهران","اسلامشهر","مركز",135,716,19,5,393,1133,15,1148
"تهران","اسلامشهر","مركز",136,716,14,5,495,1230,30,1260
"تهران","اسلامشهر","مركز",137,917,19,4,351,1291,16,1307
"تهران","اسلامشهر","مركز",138,633,6,1,336,976,27,1003
"تهران","اسلامشهر","مركز",139,1026,19,2,587,1634,24,1658
"تهران","اسلامشهر","مركز",140,943,25,2,439,1409,24,1433
"تهران","اسلامشهر","مركز",141,913,13,0,347,1273,32,1305
"تهران","اسلامشهر","مركز",142,940,17,4,399,1360,27,1387
"تهران","اسلامشهر","مركز",143,851,8,4,304,1167,30,1197
"تهران","اسلامشهر","مركز",144,692,16,7,685,1400,31,1431
"تهران","اسلامشهر","مركز",145,704,9,5,428,1146,18,1164
"تهران","اسلامشهر","مركز",146,730,17,1,463,1211,15,1226
"تهران","اسلامشهر","مركز",147,1177,23,6,493,1699,34,1733
"تهران","اسلامشهر","مركز",148,904,21,6,474,1405,23,1428
"تهران","اسلامشهر","مركز",149,655,10,1,241,907,15,922
"تهران","اسلامشهر","مركز",150,575,7,1,119,702,16,718
"تهران","اسلامشهر","مركز",151,625,5,0,170,800,5,805
"تهران","اسلامشهر","مركز",152,858,13,2,269,1142,44,1186
"تهران","اسلامشهر","مركز",153,909,9,1,283,1202,20,1222
"تهران","اسلامشهر","مركز",154,774,5,0,238,1017,22,1039
"تهران","اسلامشهر","مركز",155,752,6,2,229,989,22,1011
"تهران","اسلامشهر","مركز",156,983,10,5,309,1307,25,1332
"تهران","اسلامشهر","مركز",157,808,7,1,318,1134,25,1159
"تهران","اسلامشهر","مركز",158,1020,12,2,450,1484,21,1505
"تهران","اسلامشهر","مركز",159,476,13,2,221,712,12,724
"تهران","اسلامشهر","مركز",160,233,3,3,63,302,6,308
"تهران","اسلامشهر","مركز",161,757,14,3,288,1062,12,1074
"تهران","اسلامشهر","مركز",162,779,10,1,223,1013,11,1024
"تهران","اسلامشهر","مركز",163,814,9,4,354,1181,19,1200
"تهران","اسلامشهر","مركز",164,811,12,5,262,1090,19,1109
"تهران","اسلامشهر","مركز",165,443,11,4,239,697,22,719
"تهران","اسلامشهر","مركز",166,516,7,1,113,637,6,643
"تهران","اسلامشهر","مركز",167,735,10,3,382,1130,15,1145
"تهران","اسلامشهر","مركز",168,775,3,0,197,975,11,986
"تهران","اسلامشهر","مركز",169,955,8,1,289,1253,23,1276
"تهران","اسلامشهر","مركز",170,581,3,2,195,781,16,797
"تهران","اسلامشهر","مركز",171,884,5,6,208,1103,15,1118
"تهران","اسلامشهر","مركز",172,818,3,5,186,1012,14,1026
"تهران","اسلامشهر","مركز",173,795,10,3,371,1179,24,1203
"تهران","اسلامشهر","مركز",174,978,27,5,420,1430,22,1452
"تهران","اسلامشهر","مركز",175,535,15,5,494,1049,18,1067
"تهران","اسلامشهر","مركز",176,1020,31,8,636,1695,30,1725
"تهران","اسلامشهر","مركز",177,883,21,4,370,1278,28,1306
"تهران","اسلامشهر","مركز",178,737,17,1,327,1082,24,1106
"تهران","اسلامشهر","مركز",179,742,12,8,421,1183,16,1199
"تهران","اسلامشهر","مركز",180,236,6,0,129,371,5,376
"تهران","اسلامشهر","مركز",181,262,3,3,164,432,6,438
"تهران","اسلامشهر","مركز",182,190,2,2,81,275,0,275
"تهران","اسلامشهر","مركز",183,379,11,3,225,618,9,627
"تهران","اسلامشهر","مركز",184,292,7,0,190,489,12,501
"تهران","اسلامشهر","مركز",185,403,10,3,164,580,8,588
"تهران","اسلامشهر","مركز",186,353,13,0,103,469,8,477
"تهران","اسلامشهر","چهاردانگه",1,861,13,7,287,1168,17,1185
"تهران","اسلامشهر","چهاردانگه",2,761,8,1,161,931,15,946
"تهران","اسلامشهر","چهاردانگه",3,536,17,6,188,747,6,753
"تهران","اسلامشهر","چهاردانگه",4,500,9,6,363,878,21,899
"تهران","اسلامشهر","چهاردانگه",5,573,12,8,227,820,10,830
"تهران","اسلامشهر","چهاردانگه",6,411,8,12,110,541,9,550
"تهران","اسلامشهر","چهاردانگه",7,652,13,6,295,966,15,981
"تهران","اسلامشهر","چهاردانگه",8,732,6,5,175,918,13,931
"تهران","اسلامشهر","چهاردانگه",9,487,16,6,428,937,9,946
"تهران","اسلامشهر","چهاردانگه",10,282,5,0,121,408,8,416
"تهران","اسلامشهر","چهاردانگه",11,271,6,1,79,357,10,367
"تهران","اسلامشهر","چهاردانگه",12,990,25,2,461,1478,34,1512
"تهران","اسلامشهر","چهاردانگه",13,684,9,8,371,1072,19,1091
"تهران","اسلامشهر","چهاردانگه",14,422,12,3,270,707,10,717
"تهران","اسلامشهر","چهاردانگه",15,567,14,5,220,806,11,817
"تهران","اسلامشهر","چهاردانگه",16,292,11,1,106,410,9,419
"تهران","اسلامشهر","چهاردانگه",17,238,7,0,46,291,6,297
"تهران","اسلامشهر","چهاردانگه",18,502,12,2,289,805,18,823
"تهران","اسلامشهر","چهاردانگه",19,968,17,8,442,1435,19,1454
"تهران","اسلامشهر","چهاردانگه",20,912,17,0,266,1195,24,1219
"تهران","اسلامشهر","چهاردانگه",21,916,9,17,249,1191,29,1220
"تهران","اسلامشهر","چهاردانگه",22,710,17,24,226,977,11,988
"تهران","اسلامشهر","چهاردانگه",23,387,15,0,176,578,8,586
"تهران","اسلامشهر","چهاردانگه",24,562,15,2,325,904,14,918
"تهران","اسلامشهر","چهاردانگه",25,532,19,0,164,715,8,723
"تهران","اسلامشهر","چهاردانگه",26,438,10,3,193,644,9,653
"تهران","اسلامشهر","چهاردانگه",27,430,2,1,124,557,12,569
"تهران","اسلامشهر","چهاردانگه",28,348,12,4,148,512,9,521
"تهران","اسلامشهر","چهاردانگه",29,343,4,0,92,439,7,446
"تهران","اسلامشهر","چهاردانگه",30,658,8,5,223,894,18,912
"تهران","اسلامشهر","چهاردانگه",31,514,12,5,201,732,7,739
"تهران","اسلامشهر","چهاردانگه",32,682,10,3,299,994,15,1009
"تهران","اسلامشهر","چهاردانگه",33,622,8,1,198,829,28,857
"تهران","اسلامشهر","چهاردانگه",34,488,5,2,214,709,17,726
"تهران","اسلامشهر","چهاردانگه",35,502,9,0,125,636,9,645
"تهران","اسلامشهر","چهاردانگه",36,603,8,1,240,852,22,874
"تهران","اسلامشهر","چهاردانگه",37,488,3,0,237,728,13,741
"تهران","اسلامشهر","چهاردانگه",38,726,10,3,397,1136,20,1156
"تهران","اسلامشهر","چهاردانگه",39,353,1,0,93,447,4,451
"تهران","اسلامشهر","چهاردانگه",40,359,11,2,117,489,1,490
"تهران","پاکدشت","مرکزی",1,889,16,8,382,1295,26,1321
"تهران","پاکدشت","مرکزی",2,1017,23,15,471,1526,29,1555
"تهران","پاکدشت","مرکزی",3,627,13,4,390,1034,14,1048
"تهران","پاکدشت","مرکزی",4,783,19,2,232,1036,16,1052
"تهران","پاکدشت","مرکزی",5,1040,14,16,505,1575,23,1598
"تهران","پاکدشت","مرکزی",6,636,12,3,256,907,20,927
"تهران","پاکدشت","مرکزی",7,1094,21,14,441,1570,29,1599
"تهران","پاکدشت","مرکزی",8,1233,11,28,304,1576,22,1598
"تهران","پاکدشت","مرکزی",9,1194,15,7,303,1519,26,1545
"تهران","پاکدشت","مرکزی",10,1100,24,17,511,1652,32,1684
"تهران","پاکدشت","مرکزی",11,1325,38,20,666,2049,42,2091
"تهران","پاکدشت","مرکزی",12,1521,18,9,287,1835,38,1873
"تهران","پاکدشت","مرکزی",13,1825,22,21,455,2323,46,2369
"تهران","پاکدشت","مرکزی",14,1345,11,21,303,1680,20,1700
"تهران","پاکدشت","مرکزی",15,1322,22,18,305,1667,33,1700
"تهران","پاکدشت","مرکزی",16,868,9,3,287,1167,29,1196
"تهران","پاکدشت","مرکزی",17,734,12,2,242,990,25,1015
"تهران","پاکدشت","مرکزی",18,753,6,4,183,946,12,958
"تهران","پاکدشت","مرکزی",19,704,28,8,367,1107,13,1120
"تهران","پاکدشت","مرکزی",20,662,32,2,325,1021,15,1036
"تهران","پاکدشت","مرکزی",21,908,33,8,354,1303,14,1317
"تهران","پاکدشت","مرکزی",22,725,27,6,287,1045,20,1065
"تهران","پاکدشت","مرکزی",23,1697,10,8,348,2063,35,2098
"تهران","پاکدشت","مرکزی",24,1405,13,2,304,1724,33,1757
"تهران","پاکدشت","مرکزی",25,901,11,11,304,1227,16,1243
"تهران","پاکدشت","مرکزی",26,1030,24,6,335,1395,27,1422
"تهران","پاکدشت","مرکزی",27,1251,23,12,340,1626,31,1657
"تهران","پاکدشت","مرکزی",28,1250,22,10,342,1624,32,1656
"تهران","پاکدشت","مرکزی",29,1240,8,6,172,1426,11,1437
"تهران","پاکدشت","مرکزی",30,1190,15,8,272,1485,19,1504
"تهران","پاکدشت","مرکزی",31,814,14,1,215,1044,20,1064
"تهران","پاکدشت","مرکزی",32,975,15,9,293,1292,14,1306
"تهران","پاکدشت","مرکزی",33,1181,10,1,274,1466,29,1495
"تهران","پاکدشت","مرکزی",34,664,6,1,184,855,22,877
"تهران","پاکدشت","مرکزی",35,893,11,3,307,1214,15,1229
"تهران","پاکدشت","مرکزی",36,836,7,1,278,1122,24,1146
"تهران","پاکدشت","مرکزی",37,602,13,0,478,1093,11,1104
"تهران","پاکدشت","مرکزی",38,837,13,5,345,1200,13,1213
"تهران","پاکدشت","مرکزی",39,667,8,3,214,892,5,897
"تهران","پاکدشت","مرکزی",40,962,15,5,392,1374,24,1398
"تهران","پاکدشت","مرکزی",41,1302,16,2,360,1680,27,1707
"تهران","پاکدشت","مرکزی",42,1503,8,4,354,1869,31,1900
"تهران","پاکدشت","مرکزی",43,1170,8,3,217,1398,15,1413
"تهران","پاکدشت","مرکزی",44,787,6,2,277,1072,18,1090
"تهران","پاکدشت","مرکزی",45,1092,5,5,515,1617,31,1648
"تهران","پاکدشت","مرکزی",46,1463,16,2,370,1851,30,1881
"تهران","پاکدشت","مرکزی",47,1406,18,1,385,1810,24,1834
"تهران","پاکدشت","مرکزی",48,705,8,0,362,1075,22,1097
"تهران","پاکدشت","مرکزی",49,1037,8,1,268,1314,28,1342
"تهران","پاکدشت","مرکزی",50,1083,14,3,437,1537,29,1566
"تهران","پاکدشت","مرکزی",51,1234,17,4,377,1632,24,1656
"تهران","پاکدشت","مرکزی",52,1082,7,7,248,1344,26,1370
"تهران","پاکدشت","مرکزی",53,762,3,0,208,973,25,998
"تهران","پاکدشت","مرکزی",54,885,5,0,183,1073,22,1095
"تهران","پاکدشت","مرکزی",55,952,9,0,296,1257,13,1270
"تهران","پاکدشت","مرکزی",56,668,17,5,201,891,13,904
"تهران","پاکدشت","مرکزی",57,705,22,4,238,969,18,987
"تهران","پاکدشت","مرکزی",58,567,3,1,96,667,9,676
"تهران","پاکدشت","مرکزی",59,848,2,1,128,979,10,989
"تهران","پاکدشت","مرکزی",60,237,1,0,64,302,8,310
"تهران","پاکدشت","مرکزی",61,787,34,2,198,1021,5,1026
"تهران","پاکدشت","مرکزی",62,1145,7,4,154,1310,10,1320
"تهران","پاکدشت","مرکزی",63,1072,4,0,71,1147,11,1158
"تهران","پاکدشت","مرکزی",64,587,5,5,64,661,14,675
"تهران","پاکدشت","مرکزی",65,620,3,1,101,725,9,734
"تهران","پاکدشت","مرکزی",66,524,10,0,81,615,0,615
"تهران","پاکدشت","مرکزی",67,917,10,1,93,1021,13,1034
"تهران","پاکدشت","مرکزی",68,926,2,0,113,1041,3,1044
"تهران","پاکدشت","مرکزی",69,260,2,1,26,289,5,294
"تهران","پاکدشت","مرکزی",70,314,4,1,85,404,5,409
"تهران","پاکدشت","مرکزی",71,272,1,1,37,311,3,314
"تهران","پاکدشت","مرکزی",72,231,1,0,18,250,4,254
"تهران","پاکدشت","مرکزی",73,663,5,0,143,811,12,823
"تهران","پاکدشت","مرکزی",74,1142,7,8,318,1475,24,1499
"تهران","پاکدشت","مرکزی",75,547,4,0,118,669,8,677
"تهران","پاکدشت","مرکزی",76,922,10,6,210,1148,0,1148
"تهران","پاکدشت","مرکزی",77,292,2,0,160,454,14,468
"تهران","پاکدشت","مرکزی",78,569,10,3,113,695,15,710
"تهران","پاکدشت","مرکزی",79,738,13,2,237,990,10,1000
"تهران","پاکدشت","مرکزی",80,610,9,63,187,869,11,880
"تهران","پاکدشت","مرکزی",81,223,5,0,110,338,4,342
"تهران","پاکدشت","مرکزی",82,229,4,2,182,417,13,430
"تهران","پاکدشت","مرکزی",83,213,5,2,118,338,7,345
"تهران","پاکدشت","شریف_آباد",84,522,3,5,229,759,15,774
"تهران","پاکدشت","شریف_آباد",85,543,11,7,128,689,11,700
"تهران","پاکدشت","شریف_آباد",86,298,5,5,64,372,7,379
"تهران","پاکدشت","شریف_آباد",87,550,11,9,230,800,12,812
"تهران","پاکدشت","شریف_آباد",88,401,4,1,88,494,2,496
"تهران","پاکدشت","شریف_آباد",89,831,12,4,228,1075,3,1078
"تهران","پاکدشت","شریف_آباد",90,438,8,1,166,613,6,619
"تهران","پاکدشت","شریف_آباد",91,526,11,2,178,717,13,730
"تهران","پاکدشت","شریف_آباد",92,634,5,3,93,735,2,737
"تهران","پاکدشت","شریف_آباد",93,440,3,0,109,552,5,557
"تهران","پاکدشت","شریف_آباد",94,302,1,2,43,348,1,349
"تهران","پاکدشت","شریف_آباد",95,172,0,0,46,218,2,220
"تهران","پاکدشت","شریف_آباد",96,654,6,2,147,809,6,815
"تهران","پاکدشت","شریف_آباد",97,228,7,0,37,272,2,274
"تهران","پاکدشت","شریف_آباد",98,175,2,0,43,220,2,222
"تهران","پاکدشت","شریف_آباد",99,115,2,1,17,135,0,135
"تهران","پاکدشت","شریف_آباد",100,255,1,0,58,314,0,314
"تهران","پاکدشت","شریف_آباد",101,319,6,0,14,339,2,341
"تهران","پاکدشت","شریف_آباد",102,403,6,0,50,459,6,465
"تهران","پاکدشت","شریف_آباد",103,539,1,0,64,604,4,608
"تهران","پاکدشت","شریف_آباد",104,882,3,2,125,1012,10,1022
"تهران","پاکدشت","شریف_آباد",105,560,9,2,54,625,3,628
"تهران","پاکدشت","شریف_آباد",106,617,9,1,155,782,18,800
"تهران","پاکدشت","شریف_آباد",107,607,7,1,108,723,9,732
"تهران","پاکدشت","شریف_آباد",108,134,2,0,19,155,5,160
"تهران","پاکدشت","شریف_آباد",109,190,0,1,24,215,3,218
"تهران","پاکدشت","شریف_آباد",110,544,4,2,189,739,6,745
"تهران","پاکدشت","شریف_آباد",111,143,0,0,38,181,3,184
"تهران","پاکدشت","شریف_آباد",112,212,15,4,106,337,4,341
"تهران","پاکدشت","شریف_آباد",113,115,0,0,27,142,0,142
"تهران","تهران","مرکز_شهرستان",1,668,65,35,1487,2255,31,2286
"تهران","تهران","مرکز_شهرستان",2,577,59,26,957,1619,17,1636
"تهران","تهران","مرکز_شهرستان",3,425,48,36,1748,2257,24,2281
"تهران","تهران","مرکز_شهرستان",4,722,52,13,1340,2127,38,2165
"تهران","تهران","مرکز_شهرستان",5,399,53,23,1171,1646,22,1668
"تهران","تهران","مرکز_شهرستان",6,483,67,47,1463,2060,30,2090
"تهران","تهران","مرکز_شهرستان",7,523,39,31,783,1376,22,1398
"تهران","تهران","مرکز_شهرستان",8,669,64,41,1010,1784,40,1824
"تهران","تهران","مرکز_شهرستان",9,752,71,61,674,1558,36,1594
"تهران","تهران","مرکز_شهرستان",10,611,57,42,461,1171,29,1200
"تهران","تهران","مرکز_شهرستان",11,747,71,31,1002,1851,61,1912
"تهران","تهران","مرکز_شهرستان",12,378,65,21,1075,1539,29,1568
"تهران","تهران","مرکز_شهرستان",13,492,52,26,1168,1738,23,1761
"تهران","تهران","مرکز_شهرستان",14,377,53,31,1318,1779,21,1800
"تهران","تهران","مرکز_شهرستان",15,529,63,13,1174,1779,20,1799
"تهران","تهران","مرکز_شهرستان",16,835,74,24,1083,2016,32,2048
"تهران","تهران","مرکز_شهرستان",17,581,59,41,847,1528,27,1555
"تهران","تهران","مرکز_شهرستان",18,590,77,37,1652,2356,21,2377
"تهران","تهران","مرکز_شهرستان",19,208,51,28,1510,1797,17,1814
"تهران","تهران","مرکز_شهرستان",20,287,42,25,1171,1525,25,1550
"تهران","تهران","مرکز_شهرستان",21,428,40,20,930,1418,21,1439
"تهران","تهران","مرکز_شهرستان",22,280,36,19,1053,1388,15,1403
"تهران","تهران","مرکز_شهرستان",23,612,56,9,952,1629,26,1655
"تهران","تهران","مرکز_شهرستان",24,622,55,10,1036,1723,29,1752
"تهران","تهران","مرکز_شهرستان",25,281,38,19,1192,1530,15,1545
"تهران","تهران","مرکز_شهرستان",26,314,31,34,1805,2184,15,2199
"تهران","تهران","مرکز_شهرستان",27,613,50,13,768,1444,24,1468
"تهران","تهران","مرکز_شهرستان",28,546,41,27,766,1380,25,1405
"تهران","تهران","مرکز_شهرستان",29,217,43,12,1193,1465,12,1477
"تهران","تهران","مرکز_شهرستان",30,288,37,19,1387,1731,19,1750
"تهران","تهران","مرکز_شهرستان",31,285,22,22,1316,1645,4,1649
"تهران","تهران","مرکز_شهرستان",32,246,38,50,1342,1676,22,1698
"تهران","تهران","مرکز_شهرستان",33,317,56,31,1455,1859,29,1888
"تهران","تهران","مرکز_شهرستان",34,400,36,18,854,1308,16,1324
"تهران","تهران","مرکز_شهرستان",35,424,38,11,934,1407,17,1424
"تهران","تهران","مرکز_شهرستان",36,317,23,32,1117,1489,15,1504
"تهران","تهران","مرکز_شهرستان",37,412,43,30,1446,1931,21,1952
"تهران","تهران","مرکز_شهرستان",38,608,35,26,766,1435,24,1459
"تهران","تهران","مرکز_شهرستان",39,569,34,11,656,1270,28,1298
"تهران","تهران","مرکز_شهرستان",40,599,52,28,1042,1721,17,1738
"تهران","تهران","مرکز_شهرستان",41,436,44,30,1127,1637,27,1664
"تهران","تهران","مرکز_شهرستان",42,304,47,28,1462,1841,18,1859
"تهران","تهران","مرکز_شهرستان",43,311,36,21,1097,1465,18,1483
"تهران","تهران","مرکز_شهرستان",44,327,37,29,1049,1442,26,1468
"تهران","تهران","مرکز_شهرستان",45,590,55,27,1218,1890,23,1913
"تهران","تهران","مرکز_شهرستان",46,475,41,24,968,1508,32,1540
"تهران","تهران","مرکز_شهرستان",47,599,51,33,1792,2475,22,2497
"تهران","تهران","مرکز_شهرستان",48,248,49,43,1650,1990,10,2000
"تهران","تهران","مرکز_شهرستان",49,331,31,16,1318,1696,12,1708
"تهران","تهران","مرکز_شهرستان",50,323,35,30,1751,2139,23,2162
"تهران","تهران","مرکز_شهرستان",51,188,23,46,1732,1989,11,2000
"تهران","تهران","مرکز_شهرستان",52,544,55,34,1185,1818,27,1845
"تهران","تهران","مرکز_شهرستان",53,574,70,14,1200,1858,20,1878
"تهران","تهران","مرکز_شهرستان",54,188,27,21,1238,1474,12,1486
"تهران","تهران","مرکز_شهرستان",55,270,46,23,1319,1658,19,1677
"تهران","تهران","مرکز_شهرستان",56,289,46,49,1702,2086,17,2103
"تهران","تهران","مرکز_شهرستان",57,294,38,41,1476,1849,16,1865
"تهران","تهران","مرکز_شهرستان",58,381,38,36,1409,1864,20,1884
"تهران","تهران","مرکز_شهرستان",59,824,52,34,1608,2518,32,2550
"تهران","تهران","مرکز_شهرستان",60,776,44,33,1553,2406,36,2442
"تهران","تهران","مرکز_شهرستان",61,400,49,27,1623,2099,24,2123
"تهران","تهران","مرکز_شهرستان",62,298,19,29,1296,1642,16,1658
"تهران","تهران","مرکز_شهرستان",63,387,46,20,1710,2163,37,2200
"تهران","تهران","مرکز_شهرستان",64,378,49,26,1269,1722,19,1741
"تهران","تهران","مرکز_شهرستان",65,327,31,26,943,1327,26,1353
"تهران","تهران","مرکز_شهرستان",66,431,49,28,2122,2630,29,2659
"تهران","تهران","مرکز_شهرستان",67,353,51,33,1580,2017,19,2036
"تهران","تهران","مرکز_شهرستان",68,467,50,42,1621,2180,17,2197
"تهران","تهران","مرکز_شهرستان",69,394,55,19,1217,1685,15,1700
"تهران","تهران","مرکز_شهرستان",70,435,64,34,1209,1742,19,1761
"تهران","تهران","مرکز_شهرستان",71,268,28,23,1165,1484,16,1500
"تهران","تهران","مرکز_شهرستان",72,728,57,30,2275,3090,25,3115
"تهران","تهران","مرکز_شهرستان",73,509,58,23,1523,2113,23,2136
"تهران","تهران","مرکز_شهرستان",74,394,38,27,1198,1657,21,1678
"تهران","تهران","مرکز_شهرستان",75,350,41,48,1829,2268,24,2292
"تهران","تهران","مرکز_شهرستان",76,310,57,25,1592,1984,16,2000
"تهران","تهران","مرکز_شهرستان",77,251,52,43,1493,1839,12,1851
"تهران","تهران","مرکز_شهرستان",78,568,62,33,1131,1794,22,1816
"تهران","تهران","مرکز_شهرستان",79,324,45,29,1335,1733,22,1755
"تهران","تهران","مرکز_شهرستان",80,376,24,33,1308,1741,15,1756
"تهران","تهران","مرکز_شهرستان",81,360,27,35,1392,1814,20,1834
"تهران","تهران","مرکز_شهرستان",82,416,55,45,1819,2335,19,2354
"تهران","تهران","مرکز_شهرستان",83,277,43,52,2256,2628,20,2648
"تهران","تهران","مرکز_شهرستان",84,366,54,55,1996,2471,14,2485
"تهران","تهران","مرکز_شهرستان",85,293,41,28,1635,1997,14,2011
"تهران","تهران","مرکز_شهرستان",86,559,21,44,2185,2809,26,2835
"تهران","تهران","مرکز_شهرستان",87,547,73,34,1709,2363,25,2388
"تهران","تهران","مرکز_شهرستان",88,253,52,43,1640,1988,20,2008
"تهران","تهران","مرکز_شهرستان",89,399,64,36,1723,2222,23,2245
"تهران","تهران","مرکز_شهرستان",90,372,40,22,1264,1698,2,1700
"تهران","تهران","مرکز_شهرستان",91,476,57,47,1472,2052,45,2097
"تهران","تهران","مرکز_شهرستان",92,446,42,38,1453,1979,15,1994
"تهران","تهران","مرکز_شهرستان",93,216,25,50,2110,2401,10,2411
"تهران","تهران","مرکز_شهرستان",94,256,37,84,2290,2667,16,2683
"تهران","تهران","مرکز_شهرستان",95,196,25,55,1831,2107,11,2118
"تهران","تهران","مرکز_شهرستان",96,235,41,41,2109,2426,8,2434
"تهران","تهران","مرکز_شهرستان",97,280,43,24,1040,1387,14,1401
"تهران","تهران","مرکز_شهرستان",98,140,36,38,1309,1523,3,1526
"تهران","تهران","مرکز_شهرستان",99,241,34,63,1724,2062,22,2084
"تهران","تهران","مرکز_شهرستان",100,367,45,56,1525,1993,17,2010
"تهران","تهران","مرکز_شهرستان",101,783,57,38,1543,2421,21,2442
"تهران","تهران","مرکز_شهرستان",102,616,60,24,1248,1948,15,1963
"تهران","تهران","مرکز_شهرستان",103,740,41,26,1415,2222,40,2262
"تهران","تهران","مرکز_شهرستان",104,439,47,21,1120,1627,23,1650
"تهران","تهران","مرکز_شهرستان",105,414,46,31,1734,2225,27,2252
"تهران","تهران","مرکز_شهرستان",106,319,38,38,1538,1933,7,1940
"تهران","تهران","مرکز_شهرستان",107,579,36,26,1519,2160,28,2188
"تهران","تهران","مرکز_شهرستان",108,524,54,33,1008,1619,18,1637
"تهران","تهران","مرکز_شهرستان",109,570,67,14,1362,2013,22,2035
"تهران","تهران","مرکز_شهرستان",110,525,11,1,155,692,13,705
"تهران","تهران","مرکز_شهرستان",111,296,45,39,1479,1859,14,1873
"تهران","تهران","مرکز_شهرستان",112,352,78,59,2072,2561,13,2574
"تهران","تهران","مرکز_شهرستان",113,427,73,44,1813,2357,23,2380
"تهران","تهران","مرکز_شهرستان",114,272,70,41,1619,2002,12,2014
"تهران","تهران","مرکز_شهرستان",115,374,56,61,1486,1977,25,2002
"تهران","تهران","مرکز_شهرستان",116,802,70,49,1697,2618,28,2646
"تهران","تهران","مرکز_شهرستان",117,312,43,33,1949,2337,17,2354
"تهران","تهران","مرکز_شهرستان",118,450,70,63,1892,2475,22,2497
"تهران","تهران","مرکز_شهرستان",119,409,49,40,1730,2228,21,2249
"تهران","تهران","مرکز_شهرستان",120,364,39,34,1787,2224,22,2246
"تهران","تهران","مرکز_شهرستان",121,339,49,26,1725,2139,10,2149
"تهران","تهران","مرکز_شهرستان",122,329,43,72,2418,2862,18,2880
"تهران","تهران","مرکز_شهرستان",123,377,42,77,2179,2675,25,2700
"تهران","تهران","مرکز_شهرستان",124,289,49,46,2439,2823,22,2845
"تهران","تهران","مرکز_شهرستان",125,373,36,51,1863,2323,18,2341
"تهران","تهران","مرکز_شهرستان",126,622,46,74,2119,2861,35,2896
"تهران","تهران","مرکز_شهرستان",127,365,54,33,1302,1754,14,1768
"تهران","تهران","مرکز_شهرستان",128,499,57,45,1675,2276,45,2321
"تهران","تهران","مرکز_شهرستان",129,443,27,25,986,1481,19,1500
"تهران","تهران","مرکز_شهرستان",130,256,41,28,1290,1615,16,1631
"تهران","تهران","مرکز_شهرستان",131,425,65,22,1347,1859,15,1874
"تهران","تهران","مرکز_شهرستان",132,672,61,35,980,1748,15,1763
"تهران","تهران","مرکز_شهرستان",133,968,93,37,1101,2199,16,2215
"تهران","تهران","مرکز_شهرستان",134,174,40,40,1596,1850,42,1892
"تهران","تهران","مرکز_شهرستان",135,287,47,50,1559,1943,13,1956
"تهران","تهران","مرکز_شهرستان",136,158,31,33,2059,2281,13,2294
"تهران","تهران","مرکز_شهرستان",137,250,62,36,1589,1937,6,1943
"تهران","تهران","مرکز_شهرستان",138,167,32,48,2008,2255,6,2261
"تهران","تهران","مرکز_شهرستان",139,127,25,48,1445,1645,4,1649
"تهران","تهران","مرکز_شهرستان",140,307,55,59,2103,2524,12,2536
"تهران","تهران","مرکز_شهرستان",141,180,36,39,1740,1995,4,1999
"تهران","تهران","مرکز_شهرستان",142,291,39,42,1551,1923,17,1940
"تهران","تهران","مرکز_شهرستان",143,807,103,45,1649,2604,14,2618
"تهران","تهران","مرکز_شهرستان",144,622,58,29,1110,1819,19,1838
"تهران","تهران","مرکز_شهرستان",145,147,42,55,1896,2140,5,2145
"تهران","تهران","مرکز_شهرستان",146,378,50,39,2080,2547,10,2557
"تهران","تهران","مرکز_شهرستان",147,917,71,28,1320,2336,19,2355
"تهران","تهران","مرکز_شهرستان",148,265,55,63,1922,2305,7,2312
"تهران","تهران","مرکز_شهرستان",149,195,27,45,1619,1886,19,1905
"تهران","تهران","مرکز_شهرستان",150,226,42,67,1635,1970,13,1983
"تهران","تهران","مرکز_شهرستان",151,230,44,55,1855,2184,15,2199
"تهران","تهران","مرکز_شهرستان",152,453,59,93,2921,3526,21,3547
"تهران","تهران","مرکز_شهرستان",153,199,45,39,1788,2071,12,2083
"تهران","تهران","مرکز_شهرستان",154,214,35,42,1897,2188,17,2205
"تهران","تهران","مرکز_شهرستان",155,195,43,71,2427,2736,11,2747
"تهران","تهران","مرکز_شهرستان",156,229,5,54,1932,2220,10,2230
"تهران","تهران","مرکز_شهرستان",157,207,70,45,1599,1921,7,1928
"تهران","تهران","مرکز_شهرستان",158,272,58,41,1994,2365,20,2385
"تهران","تهران","مرکز_شهرستان",159,268,49,43,2084,2444,15,2459
"تهران","تهران","مرکز_شهرستان",160,539,45,56,1537,2177,9,2186
"تهران","تهران","مرکز_شهرستان",161,493,39,31,1542,2105,23,2128
"تهران","تهران","مرکز_شهرستان",162,429,22,5,508,964,19,983
"تهران","تهران","مرکز_شهرستان",163,138,16,9,321,484,6,490
"تهران","تهران","مرکز_شهرستان",164,119,16,3,202,340,16,356
"تهران","تهران","مرکز_شهرستان",165,199,18,6,464,687,13,700
"تهران","تهران","مرکز_شهرستان",166,132,10,14,432,588,13,601
"تهران","تهران","مرکز_شهرستان",167,91,18,9,254,372,4,376
"تهران","تهران","مرکز_شهرستان",168,196,12,5,234,447,8,455
"تهران","تهران","مرکز_شهرستان",169,151,19,9,552,731,5,736
"تهران","تهران","مرکز_شهرستان",170,145,16,10,355,526,4,530
"تهران","تهران","مرکز_شهرستان",171,100,24,5,283,412,3,415
"تهران","تهران","مرکز_شهرستان",172,89,16,20,491,616,9,625
"تهران","تهران","مرکز_شهرستان",173,116,22,20,630,788,9,797
"تهران","تهران","مرکز_شهرستان",174,149,16,6,310,481,5,486
"تهران","تهران","مرکز_شهرستان",175,191,9,3,430,633,5,638
"تهران","تهران","مرکز_شهرستان",176,780,85,19,1123,2007,8,2015
"تهران","تهران","مرکز_شهرستان",177,706,94,30,1317,2147,52,2199
"تهران","تهران","مرکز_شهرستان",178,806,89,31,1071,1997,32,2029
"تهران","تهران","مرکز_شهرستان",179,396,57,36,1825,2314,14,2328
"تهران","تهران","مرکز_شهرستان",180,355,44,28,1417,1844,21,1865
"تهران","تهران","مرکز_شهرستان",181,286,52,23,1313,1674,11,1685
"تهران","تهران","مرکز_شهرستان",182,389,58,44,1921,2412,26,2438
"تهران","تهران","مرکز_شهرستان",183,247,23,28,1195,1493,10,1503
"تهران","تهران","مرکز_شهرستان",184,208,33,24,1206,1471,14,1485
"تهران","تهران","مرکز_شهرستان",185,139,23,17,886,1065,6,1071
"تهران","تهران","مرکز_شهرستان",186,335,64,79,2310,2788,31,2819
"تهران","تهران","مرکز_شهرستان",187,266,49,35,1244,1594,16,1610
"تهران","تهران","مرکز_شهرستان",188,223,48,11,673,955,10,965
"تهران","تهران","مرکز_شهرستان",189,287,32,16,586,921,17,938
"تهران","تهران","مرکز_شهرستان",190,359,52,18,736,1165,21,1186
"تهران","تهران","مرکز_شهرستان",191,276,46,31,1162,1515,10,1525
"تهران","تهران","مرکز_شهرستان",192,205,20,19,898,1142,18,1160
"تهران","تهران","مرکز_شهرستان",193,935,43,15,739,1732,12,1744
"تهران","تهران","مرکز_شهرستان",194,322,43,18,715,1098,12,1110
"تهران","تهران","مرکز_شهرستان",195,409,63,32,883,1387,13,1400
"تهران","تهران","مرکز_شهرستان",196,231,48,54,2256,2589,11,2600
"تهران","تهران","مرکز_شهرستان",197,187,25,44,1452,1708,7,1715
"تهران","تهران","مرکز_شهرستان",198,308,51,54,1549,1962,13,1975
"تهران","تهران","مرکز_شهرستان",199,260,64,47,1622,1993,19,2012
"تهران","تهران","مرکز_شهرستان",200,429,86,29,1119,1663,24,1687
"تهران","تهران","مرکز_شهرستان",201,253,29,35,1280,1597,7,1604
"تهران","تهران","مرکز_شهرستان",202,193,21,24,728,966,7,973
"تهران","تهران","مرکز_شهرستان",203,212,38,27,838,1115,12,1127
"تهران","تهران","مرکز_شهرستان",204,155,45,32,1413,1645,8,1653
"تهران","تهران","مرکز_شهرستان",205,641,78,29,1589,2337,52,2389
"تهران","تهران","مرکز_شهرستان",206,469,56,30,1241,1796,4,1800
"تهران","تهران","مرکز_شهرستان",207,599,106,39,1407,2151,0,2151
"تهران","تهران","مرکز_شهرستان",208,722,112,55,2050,2939,61,3000
"تهران","تهران","مرکز_شهرستان",209,169,37,37,1625,1868,13,1881
"تهران","تهران","مرکز_شهرستان",210,461,63,26,1112,1662,32,1694
"تهران","تهران","مرکز_شهرستان",211,456,85,43,1343,1927,16,1943
"تهران","تهران","مرکز_شهرستان",212,166,58,28,1605,1857,12,1869
"تهران","تهران","مرکز_شهرستان",213,527,102,41,1326,1996,31,2027
"تهران","تهران","مرکز_شهرستان",214,211,52,31,1936,2230,270,2500
"تهران","تهران","مرکز_شهرستان",215,241,25,46,1175,1487,9,1496
"تهران","تهران","مرکز_شهرستان",216,529,74,38,1164,1805,38,1843
"تهران","تهران","مرکز_شهرستان",217,573,47,17,1057,1694,28,1722
"تهران","تهران","مرکز_شهرستان",218,358,31,46,1116,1551,15,1566
"تهران","تهران","مرکز_شهرستان",219,328,35,41,1195,1599,11,1610
"تهران","تهران","مرکز_شهرستان",220,349,26,41,1455,1871,13,1884
"تهران","تهران","مرکز_شهرستان",221,140,36,17,736,929,3,932
"تهران","تهران","مرکز_شهرستان",222,195,42,27,1045,1309,14,1323
"تهران","تهران","مرکز_شهرستان",223,377,74,33,1087,1571,28,1599
"تهران","تهران","مرکز_شهرستان",224,437,70,27,1024,1558,17,1575
"تهران","تهران","مرکز_شهرستان",225,239,84,20,1422,1765,13,1778
"تهران","تهران","مرکز_شهرستان",226,286,40,44,1844,2214,53,2267
"تهران","تهران","مرکز_شهرستان",227,328,65,20,661,1074,15,1089
"تهران","تهران","مرکز_شهرستان",228,484,48,11,573,1116,18,1134
"تهران","تهران","مرکز_شهرستان",229,220,40,19,1053,1332,6,1338
"تهران","تهران","مرکز_شهرستان",230,354,73,58,1907,2392,15,2407
"تهران","تهران","مرکز_شهرستان",231,219,27,45,1036,1327,8,1335
"تهران","تهران","مرکز_شهرستان",232,404,55,49,1566,2074,32,2106
"تهران","تهران","مرکز_شهرستان",233,212,36,16,940,1204,14,1218
"تهران","تهران","مرکز_شهرستان",234,280,45,36,1629,1990,24,2014
"تهران","تهران","مرکز_شهرستان",235,468,61,24,902,1455,19,1474
"تهران","تهران","مرکز_شهرستان",236,229,41,31,1400,1701,39,1740
"تهران","تهران","مرکز_شهرستان",237,208,33,53,2158,2452,21,2473
"تهران","تهران","مرکز_شهرستان",238,724,52,15,730,1521,31,1552
"تهران","تهران","مرکز_شهرستان",239,262,49,54,1849,2214,17,2231
"تهران","تهران","مرکز_شهرستان",240,1148,35,9,568,1760,20,1780
"تهران","تهران","مرکز_شهرستان",241,550,31,7,426,1014,16,1030
"تهران","تهران","مرکز_شهرستان",242,237,30,34,1528,1829,10,1839
"تهران","تهران","مرکز_شهرستان",243,318,52,38,976,1384,15,1399
"تهران","تهران","مرکز_شهرستان",244,308,46,42,1330,1726,20,1746
"تهران","تهران","مرکز_شهرستان",245,136,32,14,631,813,7,820
"تهران","تهران","مرکز_شهرستان",246,177,47,55,2271,2550,150,2700
"تهران","تهران","مرکز_شهرستان",247,141,32,46,1563,1782,11,1793
"تهران","تهران","مرکز_شهرستان",248,118,13,28,1149,1308,9,1317
"تهران","تهران","مرکز_شهرستان",249,116,45,35,1359,1555,6,1561
"تهران","تهران","مرکز_شهرستان",250,203,37,41,1952,2233,16,2249
"تهران","تهران","مرکز_شهرستان",251,181,61,45,2103,2390,17,2407
"تهران","تهران","مرکز_شهرستان",252,230,57,47,1658,1992,19,2011
"تهران","تهران","مرکز_شهرستان",253,156,37,22,1312,1527,8,1535
"تهران","تهران","مرکز_شهرستان",254,207,33,41,1711,1992,11,2003
"تهران","تهران","مرکز_شهرستان",255,252,45,43,1455,1795,0,1795
"تهران","تهران","مرکز_شهرستان",256,162,27,56,1848,2093,22,2115
"تهران","تهران","مرکز_شهرستان",257,130,35,25,973,1163,4,1167
"تهران","تهران","مرکز_شهرستان",258,261,48,55,1739,2103,19,2122
"تهران","تهران","مرکز_شهرستان",259,102,26,44,1710,1882,7,1889
"تهران","تهران","مرکز_شهرستان",260,195,47,16,1102,1360,22,1382
"تهران","تهران","مرکز_شهرستان",261,355,60,53,1594,2062,29,2091
"تهران","تهران","مرکز_شهرستان",262,266,31,60,1181,1538,13,1551
"تهران","تهران","مرکز_شهرستان",263,163,20,38,1132,1353,12,1365
"تهران","تهران","مرکز_شهرستان",264,218,42,61,1789,2110,17,2127
"تهران","تهران","مرکز_شهرستان",265,215,30,79,1956,2280,20,2300
"تهران","تهران","مرکز_شهرستان",266,225,38,52,1410,1725,25,1750
"تهران","تهران","مرکز_شهرستان",267,199,27,42,1644,1912,5,1917
"تهران","تهران","مرکز_شهرستان",268,183,44,54,2076,2357,15,2372
"تهران","تهران","مرکز_شهرستان",269,751,89,53,1809,2702,23,2725
"تهران","تهران","مرکز_شهرستان",270,222,34,41,2081,2378,11,2389
"تهران","تهران","مرکز_شهرستان",271,168,26,41,1678,1913,6,1919
"تهران","تهران","مرکز_شهرستان",272,326,37,63,1591,2017,19,2036
"تهران","تهران","مرکز_شهرستان",273,163,27,36,1273,1499,10,1509
"تهران","تهران","مرکز_شهرستان",274,175,33,55,1484,1747,15,1762
"تهران","تهران","مرکز_شهرستان",275,174,30,34,1403,1641,10,1651
"تهران","تهران","مرکز_شهرستان",276,160,31,39,1625,1855,8,1863
"تهران","تهران","مرکز_شهرستان",277,589,28,12,661,1290,0,1290
"تهران","تهران","مرکز_شهرستان",278,462,66,22,827,1377,34,1411
"تهران","تهران","مرکز_شهرستان",279,357,40,9,755,1161,20,1181
"تهران","تهران","مرکز_شهرستان",280,293,49,46,1940,2328,11,2339
"تهران","تهران","مرکز_شهرستان",281,195,36,45,1473,1749,17,1766
"تهران","تهران","مرکز_شهرستان",282,305,43,78,1372,1798,11,1809
"تهران","تهران","مرکز_شهرستان",283,138,20,22,1233,1413,15,1428
"تهران","تهران","مرکز_شهرستان",284,504,46,24,984,1558,31,1589
"تهران","تهران","مرکز_شهرستان",285,244,42,62,2383,2731,69,2800
"تهران","تهران","مرکز_شهرستان",286,200,31,53,1964,2248,14,2262
"تهران","تهران","مرکز_شهرستان",287,241,50,43,2118,2452,23,2475
"تهران","تهران","مرکز_شهرستان",288,698,27,7,457,1189,20,1209
"تهران","تهران","مرکز_شهرستان",289,646,68,59,1656,2429,31,2460
"تهران","تهران","مرکز_شهرستان",290,621,61,59,2050,2791,32,2823
"تهران","تهران","مرکز_شهرستان",291,319,21,41,987,1368,7,1375
"تهران","تهران","مرکز_شهرستان",292,810,49,29,900,1788,29,1817
"تهران","تهران","مرکز_شهرستان",293,187,45,36,922,1190,11,1201
"تهران","تهران","مرکز_شهرستان",294,1174,64,35,648,1921,33,1954
"تهران","تهران","مرکز_شهرستان",295,257,43,28,793,1121,21,1142
"تهران","تهران","مرکز_شهرستان",296,498,37,7,214,756,8,764
"تهران","تهران","مرکز_شهرستان",297,196,13,24,776,1009,14,1023
"تهران","تهران","مرکز_شهرستان",298,589,34,3,433,1059,24,1083
"تهران","تهران","مرکز_شهرستان",299,599,34,4,221,858,16,874
"تهران","تهران","مرکز_شهرستان",300,270,20,13,321,624,20,644
"تهران","تهران","مرکز_شهرستان",301,171,31,20,926,1148,0,1148
"تهران","تهران","مرکز_شهرستان",302,223,44,39,1279,1585,17,1602
"تهران","تهران","مرکز_شهرستان",303,109,15,2,161,287,5,292
"تهران","تهران","مرکز_شهرستان",304,304,29,18,662,1013,12,1025
"تهران","تهران","مرکز_شهرستان",305,383,59,5,447,894,18,912
"تهران","تهران","مرکز_شهرستان",306,392,34,10,503,939,15,954
"تهران","تهران","مرکز_شهرستان",307,139,20,14,475,648,6,654
"تهران","تهران","مرکز_شهرستان",308,625,79,33,1244,1981,34,2015
"تهران","تهران","مرکز_شهرستان",309,696,82,33,1618,2429,31,2460
"تهران","تهران","مرکز_شهرستان",310,290,42,23,1449,1804,15,1819
"تهران","تهران","مرکز_شهرستان",311,751,72,13,995,1831,21,1852
"تهران","تهران","مرکز_شهرستان",312,868,94,21,1136,2119,50,2169
"تهران","تهران","مرکز_شهرستان",313,211,48,28,1347,1634,21,1655
"تهران","تهران","مرکز_شهرستان",314,249,32,34,1130,1445,12,1457
"تهران","تهران","مرکز_شهرستان",315,493,59,22,1324,1898,15,1913
"تهران","تهران","مرکز_شهرستان",316,274,48,25,1490,1837,20,1857
"تهران","تهران","مرکز_شهرستان",317,456,99,59,2425,3039,42,3081
"تهران","تهران","مرکز_شهرستان",318,483,99,78,2542,3202,20,3222
"تهران","تهران","مرکز_شهرستان",319,260,50,45,2101,2456,12,2468
"تهران","تهران","مرکز_شهرستان",320,395,88,38,1783,2304,23,2327
"تهران","تهران","مرکز_شهرستان",321,299,37,37,1212,1585,25,1610
"تهران","تهران","مرکز_شهرستان",322,273,51,28,866,1218,19,1237
"تهران","تهران","مرکز_شهرستان",323,424,39,71,1554,2088,15,2103
"تهران","تهران","مرکز_شهرستان",324,1002,21,15,475,1513,32,1545
"تهران","تهران","مرکز_شهرستان",325,250,34,15,410,709,4,713
"تهران","تهران","مرکز_شهرستان",326,252,37,40,1139,1468,7,1475
"تهران","تهران","مرکز_شهرستان",327,257,55,37,1392,1741,8,1749
"تهران","تهران","مرکز_شهرستان",328,665,58,24,1841,2588,23,2611
"تهران","تهران","مرکز_شهرستان",329,276,37,38,1890,2241,15,2256
"تهران","تهران","مرکز_شهرستان",330,269,58,22,1390,1739,9,1748
"تهران","تهران","مرکز_شهرستان",331,726,81,17,1245,2069,33,2102
"تهران","تهران","مرکز_شهرستان",332,1124,138,60,2178,3500,67,3567
"تهران","تهران","مرکز_شهرستان",333,274,55,25,1459,1813,9,1822
"تهران","تهران","مرکز_شهرستان",334,438,70,22,1361,1891,19,1910
"تهران","تهران","مرکز_شهرستان",335,514,45,16,426,1001,22,1023
"تهران","تهران","مرکز_شهرستان",336,545,38,16,305,904,22,926
"تهران","تهران","مرکز_شهرستان",337,190,40,40,1678,1948,12,1960
"تهران","تهران","مرکز_شهرستان",338,697,44,21,712,1474,25,1499
"تهران","تهران","مرکز_شهرستان",339,474,80,3,410,967,13,980
"تهران","تهران","مرکز_شهرستان",340,811,64,12,599,1486,33,1519
"تهران","تهران","مرکز_شهرستان",341,933,45,7,456,1441,30,1471
"تهران","تهران","مرکز_شهرستان",342,472,42,17,955,1486,15,1501
"تهران","تهران","مرکز_شهرستان",343,945,42,8,409,1404,22,1426
"تهران","تهران","مرکز_شهرستان",344,509,4,4,156,673,12,685
"تهران","تهران","مرکز_شهرستان",345,775,66,28,889,1758,19,1777
"تهران","تهران","مرکز_شهرستان",346,376,34,6,726,1142,22,1164
"تهران","تهران","مرکز_شهرستان",347,466,48,16,734,1264,27,1291
"تهران","تهران","مرکز_شهرستان",348,908,57,17,455,1437,30,1467
"تهران","تهران","مرکز_شهرستان",349,628,49,12,648,1337,27,1364
"تهران","تهران","مرکز_شهرستان",350,711,45,9,565,1330,15,1345
"تهران","تهران","مرکز_شهرستان",351,333,14,7,278,632,13,645
"تهران","تهران","مرکز_شهرستان",352,419,21,23,1182,1645,29,1674
"تهران","تهران","مرکز_شهرستان",353,448,68,45,1785,2346,47,2393
"تهران","تهران","مرکز_شهرستان",354,1102,66,27,973,2168,31,2199
"تهران","تهران","مرکز_شهرستان",355,1112,50,8,759,1929,32,1961
"تهران","تهران","مرکز_شهرستان",356,453,29,7,395,884,22,906
"تهران","تهران","مرکز_شهرستان",357,258,37,49,803,1147,5,1152
"تهران","تهران","مرکز_شهرستان",358,276,22,6,712,1016,19,1035
"تهران","تهران","مرکز_شهرستان",359,534,43,22,995,1594,19,1613
"تهران","تهران","مرکز_شهرستان",360,298,44,27,1369,1738,15,1753
"تهران","تهران","مرکز_شهرستان",361,406,23,23,1093,1545,20,1565
"تهران","تهران","مرکز_شهرستان",362,795,46,13,723,1577,20,1597
"تهران","تهران","مرکز_شهرستان",363,271,12,2,335,620,15,635
"تهران","تهران","مرکز_شهرستان",364,1046,80,31,1024,2181,40,2221
"تهران","تهران","مرکز_شهرستان",365,696,66,10,1087,1859,35,1894
"تهران","تهران","مرکز_شهرستان",366,1085,78,36,936,2135,42,2177
"تهران","تهران","مرکز_شهرستان",367,719,51,16,978,1764,20,1784
"تهران","تهران","مرکز_شهرستان",368,834,56,11,809,1710,27,1737
"تهران","تهران","مرکز_شهرستان",369,1500,77,25,1247,2849,43,2892
"تهران","تهران","مرکز_شهرستان",370,402,51,18,1087,1558,60,1618
"تهران","تهران","مرکز_شهرستان",371,538,57,13,1204,1812,25,1837
"تهران","تهران","مرکز_شهرستان",372,529,40,31,1549,2149,19,2168
"تهران","تهران","مرکز_شهرستان",373,643,42,35,1524,2244,25,2269
"تهران","تهران","مرکز_شهرستان",374,711,54,17,929,1711,29,1740
"تهران","تهران","مرکز_شهرستان",375,521,37,18,606,1182,10,1192
"تهران","تهران","مرکز_شهرستان",376,507,57,23,1366,1953,20,1973
"تهران","تهران","مرکز_شهرستان",377,555,55,47,1847,2504,31,2535
"تهران","تهران","مرکز_شهرستان",378,1331,25,18,825,2199,31,2230
"تهران","تهران","مرکز_شهرستان",379,1189,20,19,426,1654,28,1682
"تهران","تهران","مرکز_شهرستان",380,800,24,4,300,1128,6,1134
"تهران","تهران","مرکز_شهرستان",381,721,18,24,373,1136,40,1176
"تهران","تهران","مرکز_شهرستان",382,496,25,20,517,1058,0,1058
"تهران","تهران","مرکز_شهرستان",383,1497,40,10,666,2213,32,2245
"تهران","تهران","مرکز_شهرستان",384,981,18,11,336,1346,29,1375
"تهران","تهران","مرکز_شهرستان",385,1187,29,3,339,1558,22,1580
"تهران","تهران","مرکز_شهرستان",386,673,32,7,616,1328,22,1350
"تهران","تهران","مرکز_شهرستان",387,663,10,27,425,1125,17,1142
"تهران","تهران","مرکز_شهرستان",388,835,38,10,650,1533,54,1587
"تهران","تهران","مرکز_شهرستان",389,908,54,5,766,1733,14,1747
"تهران","تهران","مرکز_شهرستان",390,502,41,6,625,1174,15,1189
"تهران","تهران","مرکز_شهرستان",391,945,26,24,503,1498,29,1527
"تهران","تهران","مرکز_شهرستان",392,635,25,10,716,1386,18,1404
"تهران","تهران","مرکز_شهرستان",393,898,18,13,760,1689,20,1709
"تهران","تهران","مرکز_شهرستان",394,833,19,17,340,1209,23,1232
"تهران","تهران","مرکز_شهرستان",395,1086,73,25,1351,2535,34,2569
"تهران","تهران","مرکز_شهرستان",396,957,73,29,1190,2249,31,2280
"تهران","تهران","مرکز_شهرستان",397,882,39,33,993,1947,33,1980
"تهران","تهران","مرکز_شهرستان",398,911,65,34,925,1935,38,1973
"تهران","تهران","مرکز_شهرستان",399,841,68,21,1037,1967,38,2005
"تهران","تهران","مرکز_شهرستان",400,633,52,25,800,1510,22,1532
"تهران","تهران","مرکز_شهرستان",401,302,36,24,1020,1382,11,1393
"تهران","تهران","مرکز_شهرستان",402,330,50,22,1098,1500,15,1515
"تهران","تهران","مرکز_شهرستان",403,396,41,35,1460,1932,18,1950
"تهران","تهران","مرکز_شهرستان",404,279,25,20,643,967,12,979
"تهران","تهران","مرکز_شهرستان",405,252,33,23,992,1300,14,1314
"تهران","تهران","مرکز_شهرستان",406,583,43,22,1016,1664,39,1703
"تهران","تهران","مرکز_شهرستان",407,174,24,14,428,640,8,648
"تهران","تهران","مرکز_شهرستان",408,646,45,20,751,1462,18,1480
"تهران","تهران","مرکز_شهرستان",409,298,34,28,1307,1667,19,1686
"تهران","تهران","مرکز_شهرستان",410,722,56,8,580,1366,28,1394
"تهران","تهران","مرکز_شهرستان",411,478,14,8,395,895,18,913
"تهران","تهران","مرکز_شهرستان",412,1000,56,16,801,1873,29,1902
"تهران","تهران","مرکز_شهرستان",413,795,29,17,529,1370,30,1400
"تهران","تهران","مرکز_شهرستان",414,735,35,7,817,1594,25,1619
"تهران","تهران","مرکز_شهرستان",415,446,39,14,923,1422,14,1436
"تهران","تهران","مرکز_شهرستان",416,1594,43,10,840,2487,41,2528
"تهران","تهران","مرکز_شهرستان",417,725,29,23,1553,2330,24,2354
"تهران","تهران","مرکز_شهرستان",418,616,26,4,324,970,14,984
"تهران","تهران","مرکز_شهرستان",419,754,30,10,554,1348,25,1373
"تهران","تهران","مرکز_شهرستان",420,1164,38,12,754,1968,32,2000
"تهران","تهران","مرکز_شهرستان",421,1277,39,14,589,1919,26,1945
"تهران","تهران","مرکز_شهرستان",422,767,33,10,462,1272,27,1299
"تهران","تهران","مرکز_شهرستان",423,867,37,13,505,1422,32,1454
"تهران","تهران","مرکز_شهرستان",424,898,25,2,449,1374,44,1418
"تهران","تهران","مرکز_شهرستان",425,667,38,3,529,1237,18,1255
"تهران","تهران","مرکز_شهرستان",426,1308,43,11,681,2043,29,2072
"تهران","تهران","مرکز_شهرستان",427,450,24,0,242,716,16,732
"تهران","تهران","مرکز_شهرستان",428,1195,58,9,716,1978,29,2007
"تهران","تهران","مرکز_شهرستان",429,883,59,20,966,1928,40,1968
"تهران","تهران","مرکز_شهرستان",430,723,42,14,697,1476,34,1510
"تهران","تهران","مرکز_شهرستان",431,793,46,36,713,1588,30,1618
"تهران","تهران","مرکز_شهرستان",432,713,47,19,712,1491,0,1491
"تهران","تهران","مرکز_شهرستان",433,781,39,17,460,1297,20,1317
"تهران","تهران","مرکز_شهرستان",434,881,49,4,444,1378,19,1397
"تهران","تهران","مرکز_شهرستان",435,595,49,21,936,1601,17,1618
"تهران","تهران","مرکز_شهرستان",436,480,56,27,1215,1778,16,1794
"تهران","تهران","مرکز_شهرستان",437,311,47,32,1394,1784,18,1802
"تهران","تهران","مرکز_شهرستان",438,339,33,20,612,1004,25,1029
"تهران","تهران","مرکز_شهرستان",439,304,49,47,860,1260,22,1282
"تهران","تهران","مرکز_شهرستان",440,320,22,28,955,1325,10,1335
"تهران","تهران","مرکز_شهرستان",441,451,28,5,905,1389,10,1399
"تهران","تهران","مرکز_شهرستان",442,714,30,4,589,1337,22,1359
"تهران","تهران","مرکز_شهرستان",443,695,18,8,399,1120,17,1137
"تهران","تهران","مرکز_شهرستان",444,533,31,21,1097,1682,16,1698
"تهران","تهران","مرکز_شهرستان",445,847,42,13,743,1645,32,1677
"تهران","تهران","مرکز_شهرستان",446,503,37,17,993,1550,24,1574
"تهران","تهران","مرکز_شهرستان",447,339,41,36,913,1329,8,1337
"تهران","تهران","مرکز_شهرستان",448,619,41,15,751,1426,0,1426
"تهران","تهران","مرکز_شهرستان",449,330,20,4,317,671,12,683
"تهران","تهران","مرکز_شهرستان",450,626,40,30,1170,1866,27,1893
"تهران","تهران","مرکز_شهرستان",451,635,42,26,1108,1811,24,1835
"تهران","تهران","مرکز_شهرستان",452,1050,54,8,924,2036,14,2050
"تهران","تهران","مرکز_شهرستان",453,1457,77,11,892,2437,38,2475
"تهران","تهران","مرکز_شهرستان",454,455,46,28,1649,2178,18,2196
"تهران","تهران","مرکز_شهرستان",455,536,58,28,1378,2000,31,2031
"تهران","تهران","مرکز_شهرستان",456,613,44,19,1191,1867,23,1890
"تهران","تهران","مرکز_شهرستان",457,533,32,19,1663,2247,17,2264
"تهران","تهران","مرکز_شهرستان",458,554,41,24,1712,2331,27,2358
"تهران","تهران","مرکز_شهرستان",459,940,47,8,668,1663,12,1675
"تهران","تهران","مرکز_شهرستان",460,955,43,26,954,1978,37,2015
"تهران","تهران","مرکز_شهرستان",461,531,44,35,1455,2065,23,2088
"تهران","تهران","مرکز_شهرستان",462,406,37,32,1361,1836,0,1836
"تهران","تهران","مرکز_شهرستان",463,321,34,22,1542,1919,17,1936
"تهران","تهران","مرکز_شهرستان",464,764,53,18,1125,1960,0,1960
"تهران","تهران","مرکز_شهرستان",465,637,50,44,1170,1901,24,1925
"تهران","تهران","مرکز_شهرستان",466,272,19,18,1178,1487,12,1499
"تهران","تهران","مرکز_شهرستان",467,524,52,28,1261,1865,134,1999
"تهران","تهران","مرکز_شهرستان",468,759,63,28,1303,2153,23,2176
"تهران","تهران","مرکز_شهرستان",469,323,23,31,1455,1832,8,1840
"تهران","تهران","مرکز_شهرستان",470,150,19,28,875,1072,14,1086
"تهران","تهران","مرکز_شهرستان",471,607,72,17,1081,1777,11,1788
"تهران","تهران","مرکز_شهرستان",472,497,51,16,808,1372,31,1403
"تهران","تهران","مرکز_شهرستان",473,925,33,6,668,1632,11,1643
"تهران","تهران","مرکز_شهرستان",474,1119,55,13,980,2167,64,2231
"تهران","تهران","مرکز_شهرستان",475,781,59,29,1291,2160,30,2190
"تهران","تهران","مرکز_شهرستان",476,303,31,23,1304,1661,21,1682
"تهران","تهران","مرکز_شهرستان",477,668,83,63,3224,4038,27,4065
"تهران","تهران","مرکز_شهرستان",478,450,53,29,1398,1930,19,1949
"تهران","تهران","مرکز_شهرستان",479,180,20,9,844,1053,10,1063
"تهران","تهران","مرکز_شهرستان",480,1059,37,15,467,1578,22,1600
"تهران","تهران","مرکز_شهرستان",481,1033,69,25,1373,2500,37,2537
"تهران","تهران","مرکز_شهرستان",482,873,50,9,888,1820,26,1846
"تهران","تهران","مرکز_شهرستان",483,317,25,10,1174,1526,13,1539
"تهران","تهران","مرکز_شهرستان",484,859,67,34,1524,2484,20,2504
"تهران","تهران","مرکز_شهرستان",485,685,37,13,773,1508,19,1527
"تهران","تهران","مرکز_شهرستان",486,875,44,9,819,1747,24,1771
"تهران","تهران","مرکز_شهرستان",487,1039,86,8,868,2001,38,2039
"تهران","تهران","مرکز_شهرستان",488,592,38,10,587,1227,13,1240
"تهران","تهران","مرکز_شهرستان",489,578,27,16,613,1234,24,1258
"تهران","تهران","مرکز_شهرستان",490,689,48,36,1431,2204,34,2238
"تهران","تهران","مرکز_شهرستان",491,546,30,11,1232,1819,10,1829
"تهران","تهران","مرکز_شهرستان",492,718,61,31,1317,2127,33,2160
"تهران","تهران","مرکز_شهرستان",493,479,29,17,1199,1724,19,1743
"تهران","تهران","مرکز_شهرستان",494,965,23,5,558,1551,149,1700
"تهران","تهران","مرکز_شهرستان",495,942,23,19,747,1731,4,1735
"تهران","تهران","مرکز_شهرستان",496,1026,32,13,1053,2124,23,2147
"تهران","تهران","مرکز_شهرستان",497,1248,36,10,691,1985,45,2030
"تهران","تهران","مرکز_شهرستان",498,1143,41,13,874,2071,29,2100
"تهران","تهران","مرکز_شهرستان",499,1025,47,14,982,2068,31,2099
"تهران","تهران","مرکز_شهرستان",500,1030,39,7,785,1861,28,1889
"تهران","تهران","مرکز_شهرستان",501,461,23,12,676,1172,11,1183
"تهران","تهران","مرکز_شهرستان",502,678,29,8,756,1471,29,1500
"تهران","تهران","مرکز_شهرستان",503,1070,47,9,513,1639,30,1669
"تهران","تهران","مرکز_شهرستان",504,891,50,45,635,1621,27,1648
"تهران","تهران","مرکز_شهرستان",505,956,71,22,969,2018,18,2036
"تهران","تهران","مرکز_شهرستان",506,634,33,6,1279,1952,26,1978
"تهران","تهران","مرکز_شهرستان",507,825,20,28,526,1399,32,1431
"تهران","تهران","مرکز_شهرستان",508,630,26,12,574,1242,8,1250
"تهران","تهران","مرکز_شهرستان",509,926,25,9,564,1524,26,1550
"تهران","تهران","مرکز_شهرستان",510,1010,13,18,607,1648,4,1652
"تهران","تهران","مرکز_شهرستان",511,923,14,14,530,1481,17,1498
"تهران","تهران","مرکز_شهرستان",512,1263,30,31,649,1973,25,1998
"تهران","تهران","مرکز_شهرستان",513,1373,21,11,409,1814,24,1838
"تهران","تهران","مرکز_شهرستان",514,1205,28,12,409,1654,33,1687
"تهران","تهران","مرکز_شهرستان",515,990,27,15,510,1542,17,1559
"تهران","تهران","مرکز_شهرستان",516,616,25,24,667,1332,17,1349
"تهران","تهران","مرکز_شهرستان",517,724,33,8,434,1199,101,1300
"تهران","تهران","مرکز_شهرستان",518,832,14,42,617,1505,41,1546
"تهران","تهران","مرکز_شهرستان",519,1050,27,15,835,1927,27,1954
"تهران","تهران","مرکز_شهرستان",520,1210,35,31,797,2073,54,2127
"تهران","تهران","مرکز_شهرستان",521,705,33,31,709,1478,22,1500
"تهران","تهران","مرکز_شهرستان",522,653,33,20,782,1488,19,1507
"تهران","تهران","مرکز_شهرستان",523,935,13,78,722,1748,24,1772
"تهران","تهران","مرکز_شهرستان",524,952,16,44,929,1941,109,2050
"تهران","تهران","مرکز_شهرستان",525,1021,33,10,460,1524,10,1534
"تهران","تهران","مرکز_شهرستان",526,1106,54,18,640,1818,23,1841
"تهران","تهران","مرکز_شهرستان",527,1028,31,23,499,1581,19,1600
"تهران","تهران","مرکز_شهرستان",528,1095,25,5,682,1807,0,1807
"تهران","تهران","مرکز_شهرستان",529,1168,18,12,576,1774,26,1800
"تهران","تهران","مرکز_شهرستان",530,650,53,30,967,1700,25,1725
"تهران","تهران","مرکز_شهرستان",531,621,33,7,891,1552,18,1570
"تهران","تهران","مرکز_شهرستان",532,1203,32,11,517,1763,30,1793
"تهران","تهران","مرکز_شهرستان",533,733,19,3,565,1320,19,1339
"تهران","تهران","مرکز_شهرستان",534,588,15,51,907,1561,25,1586
"تهران","تهران","مرکز_شهرستان",535,669,36,24,768,1497,0,1497
"تهران","تهران","مرکز_شهرستان",536,970,15,25,477,1487,122,1609
"تهران","تهران","مرکز_شهرستان",537,832,30,20,630,1512,20,1532
"تهران","تهران","مرکز_شهرستان",538,650,17,6,507,1180,6,1186
"تهران","تهران","مرکز_شهرستان",539,644,15,10,384,1053,25,1078
"تهران","تهران","مرکز_شهرستان",540,788,23,31,450,1292,17,1309
"تهران","تهران","مرکز_شهرستان",541,1267,36,136,962,2401,49,2450
"تهران","تهران","مرکز_شهرستان",542,1083,35,51,917,2086,59,2145
"تهران","تهران","مرکز_شهرستان",543,931,17,44,435,1427,17,1444
"تهران","تهران","مرکز_شهرستان",544,523,13,19,408,963,20,983
"تهران","تهران","مرکز_شهرستان",545,637,16,22,314,989,19,1008
"تهران","تهران","مرکز_شهرستان",546,585,45,18,766,1414,14,1428
"تهران","تهران","مرکز_شهرستان",547,702,14,32,393,1141,14,1155
"تهران","تهران","مرکز_شهرستان",548,726,8,27,243,1004,10,1014
"تهران","تهران","مرکز_شهرستان",549,838,38,4,131,1011,0,1011
"تهران","تهران","مرکز_شهرستان",550,503,34,27,442,1006,15,1021
"تهران","تهران","مرکز_شهرستان",551,286,18,0,37,341,5,346
"تهران","تهران","مرکز_شهرستان",552,886,55,5,338,1284,31,1315
"تهران","تهران","مرکز_شهرستان",553,275,18,0,44,337,1,338
"تهران","تهران","مرکز_شهرستان",554,567,96,4,512,1179,19,1198
"تهران","تهران","مرکز_شهرستان",555,491,0,4,486,981,69,1050
"تهران","تهران","مرکز_شهرستان",556,498,96,5,457,1056,144,1200
"تهران","تهران","مرکز_شهرستان",557,618,11,23,445,1097,16,1113
"تهران","تهران","مرکز_شهرستان",558,642,38,7,722,1409,31,1440
"تهران","تهران","مرکز_شهرستان",559,753,26,5,658,1442,24,1466
"تهران","تهران","مرکز_شهرستان",560,943,52,6,384,1385,20,1405
"تهران","تهران","مرکز_شهرستان",561,1023,51,5,295,1374,24,1398
"تهران","تهران","مرکز_شهرستان",562,828,59,5,946,1838,21,1859
"تهران","تهران","مرکز_شهرستان",563,900,39,21,1022,1982,27,2009
"تهران","تهران","مرکز_شهرستان",564,650,35,13,632,1330,13,1343
"تهران","تهران","مرکز_شهرستان",565,622,39,14,770,1445,30,1475
"تهران","تهران","مرکز_شهرستان",566,698,47,26,759,1530,24,1554
"تهران","تهران","مرکز_شهرستان",567,708,26,15,765,1514,26,1540
"تهران","تهران","مرکز_شهرستان",568,977,31,4,542,1554,17,1571
"تهران","تهران","مرکز_شهرستان",569,1172,39,11,512,1734,41,1775
"تهران","تهران","مرکز_شهرستان",570,684,48,4,675,1411,22,1433
"تهران","تهران","مرکز_شهرستان",571,501,21,2,524,1048,7,1055
"تهران","تهران","مرکز_شهرستان",572,484,27,7,470,988,11,999
"تهران","تهران","مرکز_شهرستان",573,1052,51,30,995,2128,32,2160
"تهران","تهران","مرکز_شهرستان",574,872,36,3,665,1576,26,1602
"تهران","تهران","مرکز_شهرستان",575,240,13,5,226,484,16,500
"تهران","تهران","مرکز_شهرستان",576,178,6,3,132,319,3,322
"تهران","تهران","مرکز_شهرستان",577,67,10,5,227,309,6,315
"تهران","تهران","مرکز_شهرستان",578,128,10,0,163,301,6,307
"تهران","تهران","مرکز_شهرستان",579,358,39,8,356,761,9,770
"تهران","تهران","مرکز_شهرستان",580,290,20,9,268,587,19,606
"تهران","تهران","مرکز_شهرستان",581,578,39,3,139,759,9,768
"تهران","تهران","مرکز_شهرستان",582,652,14,4,312,982,18,1000
"تهران","تهران","مرکز_شهرستان",583,141,10,2,197,350,6,356
"تهران","تهران","مرکز_شهرستان",584,189,9,4,196,398,5,403
"تهران","تهران","مرکز_شهرستان",585,287,34,26,1156,1503,4,1507
"تهران","تهران","مرکز_شهرستان",586,744,42,35,523,1344,31,1375
"تهران","تهران","مرکز_شهرستان",587,323,27,10,542,902,17,919
"تهران","تهران","مرکز_شهرستان",588,151,14,1,171,337,0,337
"تهران","تهران","مرکز_شهرستان",589,194,16,8,338,556,5,561
"تهران","تهران","مرکز_شهرستان",590,234,10,4,211,459,8,467
"تهران","تهران","مرکز_شهرستان",591,393,26,12,597,1028,14,1042
"تهران","تهران","مرکز_شهرستان",592,278,23,6,312,619,10,629
"تهران","تهران","مرکز_شهرستان",593,215,24,9,460,708,13,721
"تهران","تهران","مرکز_شهرستان",594,558,58,55,1107,1778,36,1814
"تهران","تهران","مرکز_شهرستان",595,617,71,45,1162,1895,24,1919
"تهران","تهران","مرکز_شهرستان",596,193,29,14,436,672,7,679
"تهران","تهران","مرکز_شهرستان",597,262,32,13,858,1165,22,1187
"تهران","تهران","مرکز_شهرستان",598,292,40,28,1032,1392,25,1417
"تهران","تهران","مرکز_شهرستان",599,216,22,24,921,1183,24,1207
"تهران","تهران","مرکز_شهرستان",600,247,25,13,569,854,21,875
"تهران","تهران","مرکز_شهرستان",601,248,18,22,716,1004,12,1016
"تهران","تهران","مرکز_شهرستان",602,185,23,15,636,859,18,877
"تهران","تهران","مرکز_شهرستان",603,194,29,11,530,764,7,771
"تهران","تهران","مرکز_شهرستان",604,250,30,111,998,1389,17,1406
"تهران","تهران","مرکز_شهرستان",605,774,54,28,1031,1887,27,1914
"تهران","تهران","مرکز_شهرستان",606,143,22,18,551,734,12,746
"تهران","تهران","مرکز_شهرستان",607,606,51,34,818,1509,32,1541
"تهران","تهران","مرکز_شهرستان",608,574,21,14,419,1028,9,1037
"تهران","تهران","مرکز_شهرستان",609,641,77,32,832,1582,32,1614
"تهران","تهران","مرکز_شهرستان",610,476,44,12,677,1209,17,1226
"تهران","تهران","مرکز_شهرستان",611,251,21,10,414,696,16,712
"تهران","تهران","مرکز_شهرستان",612,274,25,22,795,1116,14,1130
"تهران","تهران","مرکز_شهرستان",613,323,30,26,729,1108,18,1126
"تهران","تهران","مرکز_شهرستان",614,464,44,36,1009,1553,24,1577
"تهران","تهران","مرکز_شهرستان",615,399,41,21,866,1327,27,1354
"تهران","تهران","مرکز_شهرستان",616,219,30,37,1007,1293,21,1314
"تهران","تهران","مرکز_شهرستان",617,279,34,39,1224,1576,18,1594
"تهران","تهران","مرکز_شهرستان",618,200,31,31,1223,1485,13,1498
"تهران","تهران","مرکز_شهرستان",619,132,10,19,665,826,12,838
"تهران","تهران","مرکز_شهرستان",620,400,44,34,602,1080,16,1096
"تهران","تهران","مرکز_شهرستان",621,307,38,59,842,1246,6,1252
"تهران","تهران","مرکز_شهرستان",622,323,42,92,883,1340,24,1364
"تهران","تهران","مرکز_شهرستان",623,435,67,99,1132,1733,17,1750
"تهران","تهران","مرکز_شهرستان",624,312,52,49,743,1156,24,1180
"تهران","تهران","مرکز_شهرستان",625,269,34,18,1147,1468,9,1477
"تهران","تهران","مرکز_شهرستان",626,417,49,60,1030,1556,29,1585
"تهران","تهران","مرکز_شهرستان",627,605,50,59,973,1687,27,1714
"تهران","تهران","مرکز_شهرستان",628,346,50,23,590,1009,9,1018
"تهران","تهران","مرکز_شهرستان",629,529,46,18,655,1248,15,1263
"تهران","تهران","مرکز_شهرستان",630,473,40,23,654,1190,30,1220
"تهران","تهران","مرکز_شهرستان",631,226,32,24,855,1137,16,1153
"تهران","تهران","مرکز_شهرستان",632,229,30,21,727,1007,8,1015
"تهران","تهران","مرکز_شهرستان",633,144,24,43,512,723,10,733
"تهران","تهران","مرکز_شهرستان",634,255,39,61,1711,2066,14,2080
"تهران","تهران","مرکز_شهرستان",635,194,30,52,838,1114,12,1126
"تهران","تهران","مرکز_شهرستان",636,338,26,35,1069,1468,17,1485
"تهران","تهران","مرکز_شهرستان",637,220,27,18,811,1076,14,1090
"تهران","تهران","مرکز_شهرستان",638,225,20,38,791,1074,7,1081
"تهران","تهران","مرکز_شهرستان",639,363,34,28,826,1251,17,1268
"تهران","تهران","مرکز_شهرستان",640,269,33,25,917,1244,17,1261
"تهران","تهران","مرکز_شهرستان",641,215,41,33,1031,1320,6,1326
"تهران","تهران","مرکز_شهرستان",642,267,37,44,1340,1688,11,1699
"تهران","تهران","مرکز_شهرستان",643,321,35,26,1169,1551,15,1566
"تهران","تهران","مرکز_شهرستان",644,234,64,81,893,1272,20,1292
"تهران","تهران","مرکز_شهرستان",645,324,36,31,1397,1788,18,1806
"تهران","تهران","مرکز_شهرستان",646,210,39,41,1126,1416,18,1434
"تهران","تهران","مرکز_شهرستان",647,201,44,47,1678,1970,19,1989
"تهران","تهران","مرکز_شهرستان",648,264,45,25,1314,1648,15,1663
"تهران","تهران","مرکز_شهرستان",649,139,36,34,951,1160,9,1169
"تهران","تهران","مرکز_شهرستان",650,181,23,28,829,1061,13,1074
"تهران","تهران","مرکز_شهرستان",651,387,38,35,766,1226,15,1241
"تهران","تهران","مرکز_شهرستان",652,256,37,72,854,1219,18,1237
"تهران","تهران","مرکز_شهرستان",653,546,64,49,1258,1917,32,1949
"تهران","تهران","مرکز_شهرستان",654,614,64,36,1525,2239,31,2270
"تهران","تهران","مرکز_شهرستان",655,302,38,32,929,1301,12,1313
"تهران","تهران","مرکز_شهرستان",656,182,28,13,830,1053,6,1059
"تهران","تهران","مرکز_شهرستان",657,199,42,21,722,984,17,1001
"تهران","تهران","مرکز_شهرستان",658,226,28,25,1128,1407,19,1426
"تهران","تهران","مرکز_شهرستان",659,363,69,38,1632,2102,19,2121
"تهران","تهران","مرکز_شهرستان",660,514,62,60,1566,2202,11,2213
"تهران","تهران","مرکز_شهرستان",661,304,47,245,1357,1953,51,2004
"تهران","تهران","مرکز_شهرستان",662,293,45,60,1073,1471,25,1496
"تهران","تهران","مرکز_شهرستان",663,258,36,79,1910,2283,13,2296
"تهران","تهران","مرکز_شهرستان",664,502,64,34,1041,1641,26,1667
"تهران","تهران","مرکز_شهرستان",665,313,59,115,991,1478,22,1500
"تهران","تهران","مرکز_شهرستان",666,107,46,41,1431,1625,8,1633
"تهران","تهران","مرکز_شهرستان",667,140,30,42,1922,2134,23,2157
"تهران","تهران","مرکز_شهرستان",668,191,31,66,976,1264,0,1264
"تهران","تهران","مرکز_شهرستان",669,141,25,19,1079,1264,9,1273
"تهران","تهران","مرکز_شهرستان",670,208,31,23,1407,1669,16,1685
"تهران","تهران","مرکز_شهرستان",671,186,24,25,1566,1801,8,1809
"تهران","تهران","مرکز_شهرستان",672,249,36,56,1457,1798,7,1805
"تهران","تهران","مرکز_شهرستان",673,380,36,43,1399,1858,20,1878
"تهران","تهران","مرکز_شهرستان",674,212,35,22,1404,1673,17,1690
"تهران","تهران","مرکز_شهرستان",675,292,23,51,1384,1750,7,1757
"تهران","تهران","مرکز_شهرستان",676,462,37,44,1028,1571,19,1590
"تهران","تهران","مرکز_شهرستان",677,428,42,24,1035,1529,22,1551
"تهران","تهران","مرکز_شهرستان",678,146,38,38,1077,1299,9,1308
"تهران","تهران","مرکز_شهرستان",679,206,36,29,1109,1380,9,1389
"تهران","تهران","مرکز_شهرستان",680,261,26,29,1299,1615,14,1629
"تهران","تهران","مرکز_شهرستان",681,261,23,51,1754,2089,15,2104
"تهران","تهران","مرکز_شهرستان",682,170,24,51,1604,1849,13,1862
"تهران","تهران","مرکز_شهرستان",683,173,25,37,1525,1760,11,1771
"تهران","تهران","مرکز_شهرستان",684,152,33,37,1537,1759,18,1777
"تهران","تهران","مرکز_شهرستان",685,283,19,23,981,1306,29,1335
"تهران","تهران","مرکز_شهرستان",686,349,37,25,1053,1464,4,1468
"تهران","تهران","مرکز_شهرستان",687,124,25,37,1166,1352,7,1359
"تهران","تهران","مرکز_شهرستان",688,177,37,33,1399,1646,7,1653
"تهران","تهران","مرکز_شهرستان",689,216,34,21,1313,1584,13,1597
"تهران","تهران","مرکز_شهرستان",690,191,41,22,1498,1752,10,1762
"تهران","تهران","مرکز_شهرستان",691,181,35,39,1825,2080,5,2085
"تهران","تهران","مرکز_شهرستان",692,166,28,30,1366,1590,10,1600
"تهران","تهران","مرکز_شهرستان",693,397,74,49,1466,1986,20,2006
"تهران","تهران","مرکز_شهرستان",694,349,42,26,952,1369,21,1390
"تهران","تهران","مرکز_شهرستان",695,219,26,28,1352,1625,10,1635
"تهران","تهران","مرکز_شهرستان",696,372,87,40,1320,1819,19,1838
"تهران","تهران","مرکز_شهرستان",697,339,44,20,1011,1414,19,1433
"تهران","تهران","مرکز_شهرستان",698,190,31,41,1284,1546,17,1563
"تهران","تهران","مرکز_شهرستان",699,201,26,46,1112,1385,37,1422
"تهران","تهران","مرکز_شهرستان",700,177,23,7,773,980,10,990
"تهران","تهران","مرکز_شهرستان",701,88,18,28,1100,1234,5,1239
"تهران","تهران","مرکز_شهرستان",702,130,30,26,638,824,5,829
"تهران","تهران","مرکز_شهرستان",703,309,29,30,1229,1597,12,1609
"تهران","تهران","مرکز_شهرستان",704,168,26,31,991,1216,6,1222
"تهران","تهران","مرکز_شهرستان",705,363,70,98,1340,1871,27,1898
"تهران","تهران","مرکز_شهرستان",706,389,31,17,667,1104,12,1116
"تهران","تهران","مرکز_شهرستان",707,307,18,11,384,720,7,727
"تهران","تهران","مرکز_شهرستان",708,395,33,10,417,855,10,865
"تهران","تهران","مرکز_شهرستان",709,377,19,11,328,735,8,743
"تهران","تهران","مرکز_شهرستان",710,300,13,6,264,583,17,600
"تهران","تهران","مرکز_شهرستان",711,370,52,35,1342,1799,18,1817
"تهران","تهران","مرکز_شهرستان",712,226,18,6,304,554,6,560
"تهران","تهران","مرکز_شهرستان",713,424,26,11,421,882,23,905
"تهران","تهران","مرکز_شهرستان",714,191,8,15,199,413,8,421
"تهران","تهران","مرکز_شهرستان",715,453,29,21,554,1057,19,1076
"تهران","تهران","مرکز_شهرستان",716,244,21,16,634,915,18,933
"تهران","تهران","مرکز_شهرستان",717,238,11,5,235,489,0,489
"تهران","تهران","مرکز_شهرستان",718,421,28,32,792,1273,16,1289
"تهران","تهران","مرکز_شهرستان",719,233,27,17,493,770,12,782
"تهران","تهران","مرکز_شهرستان",720,202,14,15,421,652,12,664
"تهران","تهران","مرکز_شهرستان",721,154,39,75,721,989,11,1000
"تهران","تهران","مرکز_شهرستان",722,132,8,3,230,373,8,381
"تهران","تهران","مرکز_شهرستان",723,211,46,26,1152,1435,11,1446
"تهران","تهران","مرکز_شهرستان",724,338,41,54,1804,2237,24,2261
"تهران","تهران","مرکز_شهرستان",725,131,27,35,1271,1464,36,1500
"تهران","تهران","مرکز_شهرستان",726,106,19,18,1341,1484,13,1497
"تهران","تهران","مرکز_شهرستان",727,355,47,26,1297,1725,14,1739
"تهران","تهران","مرکز_شهرستان",728,479,71,39,1377,1966,36,2002
"تهران","تهران","مرکز_شهرستان",729,218,39,18,1570,1845,8,1853
"تهران","تهران","مرکز_شهرستان",730,207,52,40,1742,2041,10,2051
"تهران","تهران","مرکز_شهرستان",731,163,17,25,1120,1325,15,1340
"تهران","تهران","مرکز_شهرستان",732,250,35,55,1502,1842,9,1851
"تهران","تهران","مرکز_شهرستان",733,176,25,32,863,1096,104,1200
"تهران","تهران","مرکز_شهرستان",734,443,55,25,1055,1578,22,1600
"تهران","تهران","مرکز_شهرستان",735,403,38,41,1464,1946,36,1982
"تهران","تهران","مرکز_شهرستان",736,235,34,37,1174,1480,0,1480
"تهران","تهران","مرکز_شهرستان",737,206,35,32,1297,1570,10,1580
"تهران","تهران","مرکز_شهرستان",738,158,42,36,934,1170,7,1177
"تهران","تهران","مرکز_شهرستان",739,679,66,20,1614,2379,27,2406
"تهران","تهران","مرکز_شهرستان",740,241,26,39,1326,1632,11,1643
"تهران","تهران","مرکز_شهرستان",741,161,17,26,829,1033,10,1043
"تهران","تهران","مرکز_شهرستان",742,314,51,74,2596,3035,15,3050
"تهران","تهران","مرکز_شهرستان",743,195,34,25,1126,1380,6,1386
"تهران","تهران","مرکز_شهرستان",744,276,36,20,1306,1638,12,1650
"تهران","تهران","مرکز_شهرستان",745,357,37,25,1314,1733,27,1760
"تهران","تهران","مرکز_شهرستان",746,346,56,38,1026,1466,34,1500
"تهران","تهران","مرکز_شهرستان",747,345,53,37,1854,2289,16,2305
"تهران","تهران","مرکز_شهرستان",748,500,64,29,1332,1925,29,1954
"تهران","تهران","مرکز_شهرستان",749,538,53,22,1327,1940,21,1961
"تهران","تهران","مرکز_شهرستان",750,711,79,56,1503,2349,32,2381
"تهران","تهران","مرکز_شهرستان",751,264,23,22,994,1303,14,1317
"تهران","تهران","مرکز_شهرستان",752,198,19,9,518,744,9,753
"تهران","تهران","مرکز_شهرستان",753,304,32,16,1113,1465,19,1484
"تهران","تهران","مرکز_شهرستان",754,313,44,39,1344,1740,24,1764
"تهران","تهران","مرکز_شهرستان",755,257,45,33,1219,1554,10,1564
"تهران","تهران","مرکز_شهرستان",756,214,29,28,976,1247,18,1265
"تهران","تهران","مرکز_شهرستان",757,549,56,18,1017,1640,33,1673
"تهران","تهران","مرکز_شهرستان",758,202,33,16,633,884,9,893
"تهران","تهران","مرکز_شهرستان",759,391,51,48,988,1478,29,1507
"تهران","تهران","مرکز_شهرستان",760,315,24,14,909,1262,8,1270
"تهران","تهران","مرکز_شهرستان",761,301,42,25,1348,1716,21,1737
"تهران","تهران","مرکز_شهرستان",762,425,40,20,642,1127,16,1143
"تهران","تهران","مرکز_شهرستان",763,550,45,20,637,1252,19,1271
"تهران","تهران","مرکز_شهرستان",764,475,38,19,1121,1653,17,1670
"تهران","تهران","مرکز_شهرستان",765,539,56,17,1281,1893,32,1925
"تهران","تهران","مرکز_شهرستان",766,1512,156,60,1529,3257,46,3303
"تهران","تهران","مرکز_شهرستان",767,301,30,17,732,1080,9,1089
"تهران","تهران","مرکز_شهرستان",768,841,45,45,1110,2041,26,2067
"تهران","تهران","مرکز_شهرستان",769,324,32,39,1288,1683,11,1694
"تهران","تهران","مرکز_شهرستان",770,220,34,26,936,1216,7,1223
"تهران","تهران","مرکز_شهرستان",771,483,39,21,1078,1621,20,1641
"تهران","تهران","مرکز_شهرستان",772,391,40,16,1055,1502,19,1521
"تهران","تهران","مرکز_شهرستان",773,373,41,38,957,1409,13,1422
"تهران","تهران","مرکز_شهرستان",774,255,28,11,697,991,8,999
"تهران","تهران","مرکز_شهرستان",775,341,38,28,1137,1544,19,1563
"تهران","تهران","مرکز_شهرستان",776,235,24,24,956,1239,10,1249
"تهران","تهران","مرکز_شهرستان",777,469,35,20,847,1371,19,1390
"تهران","تهران","مرکز_شهرستان",778,666,25,40,631,1362,23,1385
"تهران","تهران","مرکز_شهرستان",779,630,46,32,1015,1723,29,1752
"تهران","تهران","مرکز_شهرستان",780,608,31,15,759,1413,38,1451
"تهران","تهران","مرکز_شهرستان",781,277,25,13,768,1083,16,1099
"تهران","تهران","مرکز_شهرستان",782,489,24,13,568,1094,41,1135
"تهران","تهران","مرکز_شهرستان",783,533,31,11,586,1161,15,1176
"تهران","تهران","مرکز_شهرستان",784,358,47,36,1365,1806,25,1831
"تهران","تهران","مرکز_شهرستان",785,420,30,12,612,1074,26,1100
"تهران","تهران","مرکز_شهرستان",786,263,38,23,955,1279,20,1299
"تهران","تهران","مرکز_شهرستان",787,584,73,48,1819,2524,30,2554
"تهران","تهران","مرکز_شهرستان",788,253,36,47,1698,2034,23,2057
"تهران","تهران","مرکز_شهرستان",789,701,63,17,1212,1993,25,2018
"تهران","تهران","مرکز_شهرستان",790,1024,69,46,1285,2424,57,2481
"تهران","تهران","مرکز_شهرستان",791,874,56,21,1023,1974,14,1988
"تهران","تهران","مرکز_شهرستان",792,748,69,31,1652,2500,34,2534
"تهران","تهران","مرکز_شهرستان",793,317,11,3,281,612,10,622
"تهران","تهران","مرکز_شهرستان",794,490,15,6,436,947,20,967
"تهران","تهران","مرکز_شهرستان",795,582,37,9,630,1258,20,1278
"تهران","تهران","مرکز_شهرستان",796,659,38,9,627,1333,13,1346
"تهران","تهران","مرکز_شهرستان",797,436,16,9,589,1050,12,1062
"تهران","تهران","مرکز_شهرستان",798,621,27,7,535,1190,17,1207
"تهران","تهران","مرکز_شهرستان",799,484,20,29,738,1271,20,1291
"تهران","تهران","مرکز_شهرستان",800,335,25,21,641,1022,23,1045
"تهران","تهران","مرکز_شهرستان",801,1028,42,20,692,1782,18,1800
"تهران","تهران","مرکز_شهرستان",802,646,26,5,421,1098,18,1116
"تهران","تهران","مرکز_شهرستان",803,627,27,10,525,1189,9,1198
"تهران","تهران","مرکز_شهرستان",804,473,40,21,963,1497,22,1519
"تهران","تهران","مرکز_شهرستان",805,517,40,29,1004,1590,18,1608
"تهران","تهران","مرکز_شهرستان",806,404,26,19,753,1202,17,1219
"تهران","تهران","مرکز_شهرستان",807,311,19,30,856,1216,13,1229
"تهران","تهران","مرکز_شهرستان",808,342,29,19,537,927,21,948
"تهران","تهران","مرکز_شهرستان",809,841,49,58,1306,2254,33,2287
"تهران","تهران","مرکز_شهرستان",810,916,39,25,821,1801,24,1825
"تهران","تهران","مرکز_شهرستان",811,379,22,9,589,999,14,1013
"تهران","تهران","مرکز_شهرستان",812,568,36,31,441,1076,36,1112
"تهران","تهران","مرکز_شهرستان",813,318,16,24,874,1232,19,1251
"تهران","تهران","مرکز_شهرستان",814,268,19,17,675,979,16,995
"تهران","تهران","مرکز_شهرستان",815,347,39,33,821,1240,17,1257
"تهران","تهران","مرکز_شهرستان",816,319,23,30,1006,1378,17,1395
"تهران","تهران","مرکز_شهرستان",817,1032,61,29,849,1971,21,1992
"تهران","تهران","مرکز_شهرستان",818,914,28,18,558,1518,20,1538
"تهران","تهران","مرکز_شهرستان",819,870,22,14,585,1491,9,1500
"تهران","تهران","مرکز_شهرستان",820,1012,51,32,1076,2171,29,2200
"تهران","تهران","مرکز_شهرستان",821,345,22,4,465,836,19,855
"تهران","تهران","مرکز_شهرستان",822,318,28,17,465,828,25,853
"تهران","تهران","مرکز_شهرستان",823,1013,56,14,588,1671,36,1707
"تهران","تهران","مرکز_شهرستان",824,830,32,4,437,1303,21,1324
"تهران","تهران","مرکز_شهرستان",825,590,36,32,860,1518,26,1544
"تهران","تهران","مرکز_شهرستان",826,746,46,19,576,1387,28,1415
"تهران","تهران","مرکز_شهرستان",827,701,27,10,398,1136,18,1154
"تهران","تهران","مرکز_شهرستان",828,190,13,4,343,550,10,560
"تهران","تهران","مرکز_شهرستان",829,403,18,4,522,947,9,956
"تهران","تهران","مرکز_شهرستان",830,495,25,17,585,1122,33,1155
"تهران","تهران","مرکز_شهرستان",831,535,18,8,263,824,7,831
"تهران","تهران","مرکز_شهرستان",832,1021,59,53,1090,2223,49,2272
"تهران","تهران","مرکز_شهرستان",833,592,19,9,398,1018,24,1042
"تهران","تهران","مرکز_شهرستان",834,534,25,15,739,1313,23,1336
"تهران","تهران","مرکز_شهرستان",835,272,23,6,349,650,13,663
"تهران","تهران","مرکز_شهرستان",836,553,43,14,1067,1677,29,1706
"تهران","تهران","مرکز_شهرستان",837,595,18,7,724,1344,16,1360
"تهران","تهران","مرکز_شهرستان",838,777,29,11,453,1270,31,1301
"تهران","تهران","مرکز_شهرستان",839,448,23,11,739,1221,17,1238
"تهران","تهران","مرکز_شهرستان",840,654,20,2,424,1100,26,1126
"تهران","تهران","مرکز_شهرستان",841,437,33,6,638,1114,21,1135
"تهران","تهران","مرکز_شهرستان",842,915,32,2,417,1366,39,1405
"تهران","تهران","مرکز_شهرستان",843,695,21,3,241,960,40,1000
"تهران","تهران","مرکز_شهرستان",844,306,30,7,607,950,15,965
"تهران","تهران","مرکز_شهرستان",845,862,30,7,559,1458,31,1489
"تهران","تهران","مرکز_شهرستان",846,935,29,20,576,1560,22,1582
"تهران","تهران","مرکز_شهرستان",847,988,32,11,600,1631,20,1651
"تهران","تهران","مرکز_شهرستان",848,238,15,7,436,696,18,714
"تهران","تهران","مرکز_شهرستان",849,836,27,11,781,1655,34,1689
"تهران","تهران","مرکز_شهرستان",850,277,13,4,168,462,8,470
"تهران","تهران","مرکز_شهرستان",851,191,18,9,296,514,7,521
"تهران","تهران","مرکز_شهرستان",852,281,20,8,353,662,38,700
"تهران","تهران","مرکز_شهرستان",853,258,12,21,709,1000,15,1015
"تهران","تهران","مرکز_شهرستان",854,409,28,4,274,715,13,728
"تهران","تهران","مرکز_شهرستان",855,239,27,4,325,595,8,603
"تهران","تهران","مرکز_شهرستان",856,374,13,6,326,719,11,730
"تهران","تهران","مرکز_شهرستان",857,300,27,7,367,701,12,713
"تهران","تهران","مرکز_شهرستان",858,174,21,5,421,621,13,634
"تهران","تهران","مرکز_شهرستان",859,565,16,14,455,1050,18,1068
"تهران","تهران","مرکز_شهرستان",860,367,17,4,250,638,6,644
"تهران","تهران","مرکز_شهرستان",861,151,21,4,293,469,8,477
"تهران","تهران","مرکز_شهرستان",862,239,13,12,504,768,15,783
"تهران","تهران","مرکز_شهرستان",863,550,45,33,2018,2646,24,2670
"تهران","تهران","مرکز_شهرستان",864,324,44,30,1512,1910,16,1926
"تهران","تهران","مرکز_شهرستان",865,333,29,25,1629,2016,20,2036
"تهران","تهران","مرکز_شهرستان",866,377,29,30,1501,1937,18,1955
"تهران","تهران","مرکز_شهرستان",867,434,24,35,1507,2000,15,2015
"تهران","تهران","مرکز_شهرستان",868,294,35,30,1496,1855,15,1870
"تهران","تهران","مرکز_شهرستان",869,327,49,25,1352,1753,19,1772
"تهران","تهران","مرکز_شهرستان",870,753,39,26,1203,2021,29,2050
"تهران","تهران","مرکز_شهرستان",871,678,59,15,918,1670,17,1687
"تهران","تهران","مرکز_شهرستان",872,927,40,14,667,1648,26,1674
"تهران","تهران","مرکز_شهرستان",873,252,42,24,1143,1461,24,1485
"تهران","تهران","مرکز_شهرستان",874,429,12,7,247,695,18,713
"تهران","تهران","مرکز_شهرستان",875,266,35,9,1049,1359,14,1373
"تهران","تهران","مرکز_شهرستان",876,561,43,20,678,1302,16,1318
"تهران","تهران","مرکز_شهرستان",877,526,42,12,652,1232,17,1249
"تهران","تهران","مرکز_شهرستان",878,473,43,19,1678,2213,18,2231
"تهران","تهران","مرکز_شهرستان",879,654,43,39,1326,2062,23,2085
"تهران","تهران","مرکز_شهرستان",880,672,65,21,966,1724,28,1752
"تهران","تهران","مرکز_شهرستان",881,571,52,10,672,1305,29,1334
"تهران","تهران","مرکز_شهرستان",882,249,27,23,1022,1321,14,1335
"تهران","تهران","مرکز_شهرستان",883,366,36,11,758,1171,22,1193
"تهران","تهران","مرکز_شهرستان",884,928,50,30,1096,2104,34,2138
"تهران","تهران","مرکز_شهرستان",885,916,43,23,945,1927,25,1952
"تهران","تهران","مرکز_شهرستان",886,363,41,21,1166,1591,26,1617
"تهران","تهران","مرکز_شهرستان",887,227,27,11,502,767,10,777
"تهران","تهران","مرکز_شهرستان",888,294,22,3,506,825,7,832
"تهران","تهران","مرکز_شهرستان",889,1009,76,15,1093,2193,55,2248
"تهران","تهران","مرکز_شهرستان",890,650,41,15,672,1378,29,1407
"تهران","تهران","مرکز_شهرستان",891,363,30,19,1148,1560,16,1576
"تهران","تهران","مرکز_شهرستان",892,473,38,20,1407,1938,27,1965
"تهران","تهران","مرکز_شهرستان",893,278,28,21,858,1185,15,1200
"تهران","تهران","مرکز_شهرستان",894,382,41,20,1229,1672,17,1689
"تهران","تهران","مرکز_شهرستان",895,1053,87,33,1043,2216,39,2255
"تهران","تهران","مرکز_شهرستان",896,357,65,37,1332,1791,17,1808
"تهران","تهران","مرکز_شهرستان",897,889,59,18,782,1748,23,1771
"تهران","تهران","مرکز_شهرستان",898,363,37,24,1134,1558,21,1579
"تهران","تهران","مرکز_شهرستان",899,725,49,13,726,1513,27,1540
"تهران","تهران","مرکز_شهرستان",900,610,33,2,442,1087,15,1102
"تهران","تهران","مرکز_شهرستان",901,684,33,13,641,1371,27,1398
"تهران","تهران","مرکز_شهرستان",902,314,35,19,884,1252,17,1269
"تهران","تهران","مرکز_شهرستان",903,628,23,9,383,1043,20,1063
"تهران","تهران","مرکز_شهرستان",904,504,41,13,882,1440,60,1500
"تهران","تهران","مرکز_شهرستان",905,743,40,14,708,1505,28,1533
"تهران","تهران","مرکز_شهرستان",906,375,40,33,1211,1659,17,1676
"تهران","تهران","مرکز_شهرستان",907,616,42,15,992,1665,29,1694
"تهران","تهران","مرکز_شهرستان",908,1085,45,9,766,1905,31,1936
"تهران","تهران","مرکز_شهرستان",909,364,35,13,795,1207,20,1227
"تهران","تهران","مرکز_شهرستان",910,526,45,15,1275,1861,29,1890
"تهران","تهران","مرکز_شهرستان",911,242,24,18,1601,1885,21,1906
"تهران","تهران","مرکز_شهرستان",912,378,45,20,1182,1625,27,1652
"تهران","تهران","مرکز_شهرستان",913,487,39,23,1198,1747,20,1767
"تهران","تهران","مرکز_شهرستان",914,417,36,20,1433,1906,16,1922
"تهران","تهران","مرکز_شهرستان",915,542,32,9,544,1127,19,1146
"تهران","تهران","مرکز_شهرستان",916,586,36,6,473,1101,20,1121
"تهران","تهران","مرکز_شهرستان",917,919,57,3,545,1524,22,1546
"تهران","تهران","مرکز_شهرستان",918,1204,59,12,769,2044,36,2080
"تهران","تهران","مرکز_شهرستان",919,513,52,22,1381,1968,33,2001
"تهران","تهران","مرکز_شهرستان",920,281,22,29,766,1098,12,1110
"تهران","تهران","مرکز_شهرستان",921,301,35,8,780,1124,9,1133
"تهران","تهران","مرکز_شهرستان",922,390,38,10,879,1317,15,1332
"تهران","تهران","مرکز_شهرستان",923,555,30,12,508,1105,17,1122
"تهران","تهران","مرکز_شهرستان",924,308,21,8,717,1054,9,1063
"تهران","تهران","مرکز_شهرستان",925,321,42,23,1070,1456,15,1471
"تهران","تهران","مرکز_شهرستان",926,509,50,11,1360,1930,21,1951
"تهران","تهران","مرکز_شهرستان",927,473,40,10,768,1291,23,1314
"تهران","تهران","مرکز_شهرستان",928,421,56,16,1196,1689,16,1705
"تهران","تهران","مرکز_شهرستان",929,559,44,14,972,1589,22,1611
"تهران","تهران","مرکز_شهرستان",930,377,27,5,553,962,13,975
"تهران","تهران","مرکز_شهرستان",931,603,68,11,958,1640,37,1677
"تهران","تهران","مرکز_شهرستان",932,740,24,9,612,1385,27,1412
"تهران","تهران","مرکز_شهرستان",933,140,20,17,1112,1289,8,1297
"تهران","تهران","مرکز_شهرستان",934,254,27,9,1017,1307,15,1322
"تهران","تهران","مرکز_شهرستان",935,767,46,16,771,1600,13,1613
"تهران","تهران","مرکز_شهرستان",936,540,32,6,501,1079,27,1106
"تهران","تهران","مرکز_شهرستان",937,498,27,15,1013,1553,18,1571
"تهران","تهران","مرکز_شهرستان",938,542,22,3,609,1176,31,1207
"تهران","تهران","مرکز_شهرستان",939,226,26,22,1296,1570,13,1583
"تهران","تهران","مرکز_شهرستان",940,404,33,50,1360,1847,11,1858
"تهران","تهران","مرکز_شهرستان",941,440,34,10,971,1455,20,1475
"تهران","تهران","مرکز_شهرستان",942,1081,45,10,804,1940,55,1995
"تهران","تهران","مرکز_شهرستان",943,229,18,13,1092,1352,17,1369
"تهران","تهران","مرکز_شهرستان",944,192,18,47,1878,2135,20,2155
"تهران","تهران","مرکز_شهرستان",945,425,34,34,1058,1551,15,1566
"تهران","تهران","مرکز_شهرستان",946,524,34,9,670,1237,15,1252
"تهران","تهران","مرکز_شهرستان",947,724,30,1,480,1235,20,1255
"تهران","تهران","مرکز_شهرستان",948,785,23,6,458,1272,17,1289
"تهران","تهران","مرکز_شهرستان",949,640,25,15,652,1332,21,1353
"تهران","تهران","مرکز_شهرستان",950,596,34,5,791,1426,21,1447
"تهران","تهران","مرکز_شهرستان",951,467,40,5,821,1333,18,1351
"تهران","تهران","مرکز_شهرستان",952,565,31,6,761,1363,30,1393
"تهران","تهران","مرکز_شهرستان",953,825,36,11,629,1501,21,1522
"تهران","تهران","مرکز_شهرستان",954,765,53,13,997,1828,38,1866
"تهران","تهران","مرکز_شهرستان",955,1178,31,9,554,1772,9,1781
"تهران","تهران","مرکز_شهرستان",956,891,21,7,325,1244,54,1298
"تهران","تهران","مرکز_شهرستان",957,402,25,3,423,853,5,858
"تهران","تهران","مرکز_شهرستان",958,1242,34,11,604,1891,37,1928
"تهران","تهران","مرکز_شهرستان",959,671,28,1,558,1258,19,1277
"تهران","تهران","مرکز_شهرستان",960,843,11,4,365,1223,21,1244
"تهران","تهران","مرکز_شهرستان",961,846,36,8,450,1340,28,1368
"تهران","تهران","مرکز_شهرستان",962,719,29,5,584,1337,18,1355
"تهران","تهران","مرکز_شهرستان",963,202,19,37,1546,1804,17,1821
"تهران","تهران","مرکز_شهرستان",964,274,13,5,404,696,9,705
"تهران","تهران","مرکز_شهرستان",965,635,16,7,387,1045,22,1067
"تهران","تهران","مرکز_شهرستان",966,957,26,7,457,1447,16,1463
"تهران","تهران","مرکز_شهرستان",967,995,37,5,578,1615,40,1655
"تهران","تهران","مرکز_شهرستان",968,406,16,11,530,963,13,976
"تهران","تهران","مرکز_شهرستان",969,1123,45,20,754,1942,31,1973
"تهران","تهران","مرکز_شهرستان",970,623,26,15,334,998,15,1013
"تهران","تهران","مرکز_شهرستان",971,350,20,11,355,736,18,754
"تهران","تهران","مرکز_شهرستان",972,434,27,6,460,927,7,934
"تهران","تهران","مرکز_شهرستان",973,606,39,5,696,1346,15,1361
"تهران","تهران","مرکز_شهرستان",974,326,24,11,484,845,26,871
"تهران","تهران","مرکز_شهرستان",975,364,23,14,953,1354,15,1369
"تهران","تهران","مرکز_شهرستان",976,249,12,5,300,566,9,575
"تهران","تهران","مرکز_شهرستان",977,439,30,3,673,1145,9,1154
"تهران","تهران","مرکز_شهرستان",978,254,7,26,1329,1616,20,1636
"تهران","تهران","مرکز_شهرستان",979,314,14,12,455,795,13,808
"تهران","تهران","مرکز_شهرستان",980,705,19,10,412,1146,22,1168
"تهران","تهران","مرکز_شهرستان",981,742,21,4,346,1113,22,1135
"تهران","تهران","مرکز_شهرستان",982,800,25,6,391,1222,29,1251
"تهران","تهران","مرکز_شهرستان",983,430,32,6,787,1255,12,1267
"تهران","تهران","مرکز_شهرستان",984,748,20,9,443,1220,30,1250
"تهران","تهران","مرکز_شهرستان",985,722,20,5,312,1059,36,1095
"تهران","تهران","مرکز_شهرستان",986,436,33,6,638,1113,20,1133
"تهران","تهران","مرکز_شهرستان",987,875,34,5,496,1410,29,1439
"تهران","تهران","مرکز_شهرستان",988,634,29,4,281,948,24,972
"تهران","تهران","مرکز_شهرستان",989,572,24,1,330,927,15,942
"تهران","تهران","مرکز_شهرستان",990,381,11,5,532,929,9,938
"تهران","تهران","مرکز_شهرستان",991,706,35,5,448,1194,15,1209
"تهران","تهران","مرکز_شهرستان",992,275,23,2,543,843,6,849
"تهران","تهران","مرکز_شهرستان",993,619,31,6,521,1177,14,1191
"تهران","تهران","مرکز_شهرستان",994,322,18,13,581,934,16,950
"تهران","تهران","مرکز_شهرستان",995,710,32,6,780,1528,17,1545
"تهران","تهران","مرکز_شهرستان",996,483,15,10,545,1053,14,1067
"تهران","تهران","مرکز_شهرستان",997,828,26,8,590,1452,23,1475
"تهران","تهران","مرکز_شهرستان",998,653,38,9,604,1304,18,1322
"تهران","تهران","مرکز_شهرستان",999,707,29,11,540,1287,42,1329
"تهران","تهران","مرکز_شهرستان",1000,441,15,10,487,953,16,969
"تهران","تهران","مرکز_شهرستان",1001,404,19,5,463,891,16,907
"تهران","تهران","مرکز_شهرستان",1002,319,9,10,251,589,15,604
"تهران","تهران","مرکز_شهرستان",1003,708,48,24,942,1722,28,1750
"تهران","تهران","مرکز_شهرستان",1004,609,43,10,649,1311,33,1344
"تهران","تهران","مرکز_شهرستان",1005,702,42,6,560,1310,34,1344
"تهران","تهران","مرکز_شهرستان",1006,874,26,5,499,1404,11,1415
"تهران","تهران","مرکز_شهرستان",1007,165,10,2,279,456,10,466
"تهران","تهران","مرکز_شهرستان",1008,176,4,5,155,340,6,346
"تهران","تهران","مرکز_شهرستان",1009,95,8,7,381,491,4,495
"تهران","تهران","مرکز_شهرستان",1010,189,18,1,404,612,7,619
"تهران","تهران","مرکز_شهرستان",1011,76,5,1,424,506,4,510
"تهران","تهران","مرکز_شهرستان",1012,156,8,2,132,298,13,311
"تهران","تهران","مرکز_شهرستان",1013,149,7,3,295,454,7,461
"تهران","تهران","مرکز_شهرستان",1014,228,37,10,723,998,7,1005
"تهران","تهران","مرکز_شهرستان",1015,120,7,4,238,369,10,379
"تهران","تهران","مرکز_شهرستان",1016,338,19,3,474,834,8,842
"تهران","تهران","مرکز_شهرستان",1017,216,16,5,389,626,8,634
"تهران","تهران","مرکز_شهرستان",1018,232,8,2,235,477,4,481
"تهران","تهران","مرکز_شهرستان",1019,185,7,0,113,305,6,311
"تهران","تهران","مرکز_شهرستان",1020,144,5,1,208,358,1,359
"تهران","تهران","مرکز_شهرستان",1021,589,52,7,705,1353,26,1379
"تهران","تهران","مرکز_شهرستان",1022,556,40,9,495,1100,14,1114
"تهران","تهران","مرکز_شهرستان",1023,254,25,12,993,1284,19,1303
"تهران","تهران","مرکز_شهرستان",1024,300,39,16,966,1321,9,1330
"تهران","تهران","مرکز_شهرستان",1025,431,22,3,397,853,14,867
"تهران","تهران","مرکز_شهرستان",1026,484,18,2,377,881,15,896
"تهران","تهران","مرکز_شهرستان",1027,427,24,5,373,829,18,847
"تهران","تهران","مرکز_شهرستان",1028,450,32,7,526,1015,21,1036
"تهران","تهران","مرکز_شهرستان",1029,383,30,7,640,1060,14,1074
"تهران","تهران","مرکز_شهرستان",1030,359,45,12,777,1193,25,1218
"تهران","تهران","مرکز_شهرستان",1031,776,39,11,605,1431,30,1461
"تهران","تهران","مرکز_شهرستان",1032,699,23,8,422,1152,22,1174
"تهران","تهران","مرکز_شهرستان",1033,492,26,9,918,1445,23,1468
"تهران","تهران","مرکز_شهرستان",1034,336,35,7,871,1249,14,1263
"تهران","تهران","مرکز_شهرستان",1035,270,29,5,450,754,21,775
"تهران","تهران","مرکز_شهرستان",1036,333,14,6,475,828,26,854
"تهران","تهران","مرکز_شهرستان",1037,686,27,7,580,1300,20,1320
"تهران","تهران","مرکز_شهرستان",1038,556,21,9,493,1079,21,1100
"تهران","تهران","مرکز_شهرستان",1039,604,18,2,469,1093,20,1113
"تهران","تهران","مرکز_شهرستان",1040,780,25,4,481,1290,16,1306
"تهران","تهران","مرکز_شهرستان",1041,577,23,4,486,1090,35,1125
"تهران","تهران","مرکز_شهرستان",1042,659,12,2,315,988,12,1000
"تهران","تهران","مرکز_شهرستان",1043,730,29,8,446,1213,19,1232
"تهران","تهران","مرکز_شهرستان",1044,736,17,8,253,1014,17,1031
"تهران","تهران","مرکز_شهرستان",1045,421,17,5,535,978,12,990
"تهران","تهران","مرکز_شهرستان",1046,814,31,5,473,1323,28,1351
"تهران","تهران","مرکز_شهرستان",1047,736,18,12,688,1454,25,1479
"تهران","تهران","مرکز_شهرستان",1048,374,20,8,300,702,22,724
"تهران","تهران","مرکز_شهرستان",1049,582,10,6,331,929,18,947
"تهران","تهران","مرکز_شهرستان",1050,583,14,3,253,853,18,871
"تهران","تهران","مرکز_شهرستان",1051,442,31,4,298,775,18,793
"تهران","تهران","مرکز_شهرستان",1052,717,44,13,686,1460,33,1493
"تهران","تهران","مرکز_شهرستان",1053,843,51,8,615,1517,22,1539
"تهران","تهران","مرکز_شهرستان",1054,269,28,11,614,922,18,940
"تهران","تهران","مرکز_شهرستان",1055,337,18,9,639,1003,10,1013
"تهران","تهران","مرکز_شهرستان",1056,501,30,2,300,833,15,848
"تهران","تهران","مرکز_شهرستان",1057,420,23,4,395,842,21,863
"تهران","تهران","مرکز_شهرستان",1058,472,23,15,515,1025,13,1038
"تهران","تهران","مرکز_شهرستان",1059,579,25,10,442,1056,16,1072
"تهران","تهران","مرکز_شهرستان",1060,438,19,9,611,1077,22,1099
"تهران","تهران","مرکز_شهرستان",1061,230,15,3,254,502,10,512
"تهران","تهران","مرکز_شهرستان",1062,452,36,13,1046,1547,33,1580
"تهران","تهران","مرکز_شهرستان",1063,973,40,10,665,1688,28,1716
"تهران","تهران","مرکز_شهرستان",1064,1078,31,9,411,1529,29,1558
"تهران","تهران","مرکز_شهرستان",1065,597,21,7,415,1040,18,1058
"تهران","تهران","مرکز_شهرستان",1066,707,21,9,375,1112,18,1130
"تهران","تهران","مرکز_شهرستان",1067,836,50,9,471,1366,21,1387
"تهران","تهران","مرکز_شهرستان",1068,966,26,9,449,1450,6,1456
"تهران","تهران","مرکز_شهرستان",1069,658,25,7,771,1461,18,1479
"تهران","تهران","مرکز_شهرستان",1070,635,23,3,496,1157,12,1169
"تهران","تهران","مرکز_شهرستان",1071,492,21,4,401,918,20,938
"تهران","تهران","مرکز_شهرستان",1072,730,23,1,401,1155,12,1167
"تهران","تهران","مرکز_شهرستان",1073,827,15,5,225,1072,20,1092
"تهران","تهران","مرکز_شهرستان",1074,668,22,3,313,1006,24,1030
"تهران","تهران","مرکز_شهرستان",1075,466,14,3,414,897,24,921
"تهران","تهران","مرکز_شهرستان",1076,400,22,3,474,899,15,914
"تهران","تهران","مرکز_شهرستان",1077,395,14,5,255,669,22,691
"تهران","تهران","مرکز_شهرستان",1078,458,12,2,233,705,10,715
"تهران","تهران","مرکز_شهرستان",1079,832,36,9,590,1467,44,1511
"تهران","تهران","مرکز_شهرستان",1080,480,19,0,359,858,11,869
"تهران","تهران","مرکز_شهرستان",1081,461,21,7,229,718,9,727
"تهران","تهران","مرکز_شهرستان",1082,459,34,6,558,1057,10,1067
"تهران","تهران","مرکز_شهرستان",1083,637,35,7,372,1051,48,1099
"تهران","تهران","مرکز_شهرستان",1084,627,29,5,320,981,19,1000
"تهران","تهران","مرکز_شهرستان",1085,828,4,3,426,1261,5,1266
"تهران","تهران","مرکز_شهرستان",1086,540,31,12,697,1280,24,1304
"تهران","تهران","مرکز_شهرستان",1087,381,23,4,475,883,17,900
"تهران","تهران","مرکز_شهرستان",1088,429,23,2,309,763,18,781
"تهران","تهران","مرکز_شهرستان",1089,513,15,2,251,781,19,800
"تهران","تهران","مرکز_شهرستان",1090,760,11,2,317,1090,29,1119
"تهران","تهران","مرکز_شهرستان",1091,833,14,6,279,1132,22,1154
"تهران","تهران","مرکز_شهرستان",1092,331,12,2,389,734,4,738
"تهران","تهران","مرکز_شهرستان",1093,378,14,5,353,750,20,770
"تهران","تهران","مرکز_شهرستان",1094,687,21,8,338,1054,34,1088
"تهران","تهران","مرکز_شهرستان",1095,634,24,7,213,878,20,898
"تهران","تهران","مرکز_شهرستان",1096,605,20,4,345,974,24,998
"تهران","تهران","مرکز_شهرستان",1097,708,20,5,443,1176,18,1194
"تهران","تهران","مرکز_شهرستان",1098,282,24,8,425,739,16,755
"تهران","تهران","مرکز_شهرستان",1099,378,26,5,436,845,16,861
"تهران","تهران","مرکز_شهرستان",1100,320,20,9,498,847,18,865
"تهران","تهران","مرکز_شهرستان",1101,315,11,2,358,686,11,697
"تهران","تهران","مرکز_شهرستان",1102,284,32,6,394,716,15,731
"تهران","تهران","مرکز_شهرستان",1103,424,23,3,489,939,12,951
"تهران","تهران","مرکز_شهرستان",1104,274,21,3,405,703,11,714
"تهران","تهران","مرکز_شهرستان",1105,380,21,7,496,904,21,925
"تهران","تهران","مرکز_شهرستان",1106,783,22,11,429,1245,19,1264
"تهران","تهران","مرکز_شهرستان",1107,485,28,4,450,967,21,988
"تهران","تهران","مرکز_شهرستان",1108,777,15,3,311,1106,17,1123
"تهران","تهران","مرکز_شهرستان",1109,1077,64,7,534,1682,37,1719
"تهران","تهران","مرکز_شهرستان",1110,419,21,8,500,948,16,964
"تهران","تهران","مرکز_شهرستان",1111,469,24,4,350,847,18,865
"تهران","تهران","مرکز_شهرستان",1112,513,28,6,351,898,22,920
"تهران","تهران","مرکز_شهرستان",1113,683,39,11,438,1171,25,1196
"تهران","تهران","مرکز_شهرستان",1114,488,24,4,395,911,22,933
"تهران","تهران","مرکز_شهرستان",1115,322,9,1,206,538,10,548
"تهران","تهران","مرکز_شهرستان",1116,322,20,3,304,649,20,669
"تهران","تهران","مرکز_شهرستان",1117,674,32,8,633,1347,19,1366
"تهران","تهران","مرکز_شهرستان",1118,721,23,8,467,1219,23,1242
"تهران","تهران","مرکز_شهرستان",1119,838,33,3,408,1282,21,1303
"تهران","تهران","مرکز_شهرستان",1120,420,15,12,481,928,22,950
"تهران","تهران","مرکز_شهرستان",1121,377,15,8,318,718,17,735
"تهران","تهران","مرکز_شهرستان",1122,929,30,5,655,1619,49,1668
"تهران","تهران","مرکز_شهرستان",1123,594,15,2,320,931,4,935
"تهران","تهران","مرکز_شهرستان",1124,792,39,6,501,1338,23,1361
"تهران","تهران","مرکز_شهرستان",1125,667,29,8,370,1074,17,1091
"تهران","تهران","مرکز_شهرستان",1126,567,24,6,354,951,36,987
"تهران","تهران","مرکز_شهرستان",1127,481,38,23,980,1522,18,1540
"تهران","تهران","مرکز_شهرستان",1128,244,26,2,429,701,17,718
"تهران","تهران","مرکز_شهرستان",1129,356,28,9,520,913,16,929
"تهران","تهران","مرکز_شهرستان",1130,542,31,14,667,1254,17,1271
"تهران","تهران","مرکز_شهرستان",1131,338,23,6,427,794,12,806
"تهران","تهران","مرکز_شهرستان",1132,386,23,1,304,714,13,727
"تهران","تهران","مرکز_شهرستان",1133,124,11,0,174,309,5,314
"تهران","تهران","مرکز_شهرستان",1134,156,16,3,171,346,9,355
"تهران","تهران","مرکز_شهرستان",1135,312,14,5,414,745,6,751
"تهران","تهران","مرکز_شهرستان",1136,285,19,1,287,592,11,603
"تهران","تهران","مرکز_شهرستان",1137,195,9,1,118,323,11,334
"تهران","تهران","مرکز_شهرستان",1138,256,11,2,252,521,0,521
"تهران","تهران","مرکز_شهرستان",1139,107,3,0,96,206,6,212
"تهران","تهران","مرکز_شهرستان",1140,121,7,4,136,268,0,268
"تهران","تهران","مرکز_شهرستان",1141,140,8,2,105,255,11,266
"تهران","تهران","مرکز_شهرستان",1142,284,23,14,738,1059,26,1085
"تهران","تهران","مرکز_شهرستان",1143,310,27,19,680,1036,8,1044
"تهران","تهران","مرکز_شهرستان",1144,243,20,7,363,633,12,645
"تهران","تهران","مرکز_شهرستان",1145,302,18,20,485,825,19,844
"تهران","تهران","مرکز_شهرستان",1146,193,28,9,484,714,11,725
"تهران","تهران","مرکز_شهرستان",1147,241,24,6,629,900,12,912
"تهران","تهران","مرکز_شهرستان",1148,755,36,10,945,1746,32,1778
"تهران","تهران","مرکز_شهرستان",1149,898,57,26,1170,2151,47,2198
"تهران","تهران","مرکز_شهرستان",1150,313,31,19,832,1195,12,1207
"تهران","تهران","مرکز_شهرستان",1151,368,33,15,798,1214,16,1230
"تهران","تهران","مرکز_شهرستان",1152,792,33,10,570,1405,44,1449
"تهران","تهران","مرکز_شهرستان",1153,406,32,8,712,1158,19,1177
"تهران","تهران","مرکز_شهرستان",1154,358,17,9,711,1095,17,1112
"تهران","تهران","مرکز_شهرستان",1155,358,27,20,799,1204,27,1231
"تهران","تهران","مرکز_شهرستان",1156,497,25,12,798,1332,18,1350
"تهران","تهران","مرکز_شهرستان",1157,339,36,6,636,1017,12,1029
"تهران","تهران","مرکز_شهرستان",1158,459,34,3,878,1374,26,1400
"تهران","تهران","مرکز_شهرستان",1159,429,22,13,743,1207,20,1227
"تهران","تهران","مرکز_شهرستان",1160,526,35,7,867,1435,18,1453
"تهران","تهران","مرکز_شهرستان",1161,830,43,16,537,1426,25,1451
"تهران","تهران","مرکز_شهرستان",1162,702,45,18,692,1457,22,1479
"تهران","تهران","مرکز_شهرستان",1163,646,55,17,722,1440,36,1476
"تهران","تهران","مرکز_شهرستان",1164,741,32,7,551,1331,29,1360
"تهران","تهران","مرکز_شهرستان",1165,347,24,10,710,1091,16,1107
"تهران","تهران","مرکز_شهرستان",1166,733,46,31,1197,2007,39,2046
"تهران","تهران","مرکز_شهرستان",1167,667,37,7,839,1550,25,1575
"تهران","تهران","مرکز_شهرستان",1168,557,29,9,770,1365,27,1392
"تهران","تهران","مرکز_شهرستان",1169,582,30,4,633,1249,17,1266
"تهران","تهران","مرکز_شهرستان",1170,499,21,6,507,1033,15,1048
"تهران","تهران","مرکز_شهرستان",1171,404,32,1,540,977,18,995
"تهران","تهران","مرکز_شهرستان",1172,425,15,4,497,941,9,950
"تهران","تهران","مرکز_شهرستان",1173,421,31,15,989,1456,22,1478
"تهران","تهران","مرکز_شهرستان",1174,417,30,2,741,1190,33,1223
"تهران","تهران","مرکز_شهرستان",1175,386,18,13,490,907,14,921
"تهران","تهران","مرکز_شهرستان",1176,247,20,4,290,561,5,566
"تهران","تهران","مرکز_شهرستان",1177,126,9,9,217,361,4,365
"تهران","تهران","مرکز_شهرستان",1178,309,13,2,325,649,9,658
"تهران","تهران","مرکز_شهرستان",1179,254,15,8,446,723,15,738
"تهران","تهران","مرکز_شهرستان",1180,265,14,15,377,671,11,682
"تهران","تهران","مرکز_شهرستان",1181,759,26,2,427,1214,22,1236
"تهران","تهران","مرکز_شهرستان",1182,789,27,2,466,1284,27,1311
"تهران","تهران","مرکز_شهرستان",1183,363,18,3,465,849,16,865
"تهران","تهران","مرکز_شهرستان",1184,523,33,8,686,1250,21,1271
"تهران","تهران","مرکز_شهرستان",1185,533,31,6,763,1333,14,1347
"تهران","تهران","مرکز_شهرستان",1186,400,19,3,447,869,23,892
"تهران","تهران","مرکز_شهرستان",1187,442,23,4,660,1129,23,1152
"تهران","تهران","مرکز_شهرستان",1188,466,26,4,698,1194,7,1201
"تهران","تهران","مرکز_شهرستان",1189,158,4,2,219,383,8,391
"تهران","تهران","مرکز_شهرستان",1190,390,14,7,679,1090,11,1101
"تهران","تهران","مرکز_شهرستان",1191,281,27,14,474,796,4,800
"تهران","تهران","مرکز_شهرستان",1192,271,13,15,494,793,23,816
"تهران","تهران","مرکز_شهرستان",1193,337,21,9,690,1057,17,1074
"تهران","تهران","مرکز_شهرستان",1194,468,32,13,808,1321,27,1348
"تهران","تهران","مرکز_شهرستان",1195,453,35,16,827,1331,18,1349
"تهران","تهران","مرکز_شهرستان",1196,380,31,14,630,1055,15,1070
"تهران","تهران","مرکز_شهرستان",1197,512,17,14,671,1214,23,1237
"تهران","تهران","مرکز_شهرستان",1198,894,42,8,836,1780,35,1815
"تهران","تهران","مرکز_شهرستان",1199,805,26,6,524,1361,0,1361
"تهران","تهران","مرکز_شهرستان",1200,797,29,10,632,1468,29,1497
"تهران","تهران","مرکز_شهرستان",1201,527,31,11,646,1215,12,1227
"تهران","تهران","مرکز_شهرستان",1202,756,44,10,955,1765,23,1788
"تهران","تهران","مرکز_شهرستان",1203,577,24,17,821,1439,24,1463
"تهران","تهران","مرکز_شهرستان",1204,643,29,9,715,1396,20,1416
"تهران","تهران","مرکز_شهرستان",1205,345,18,2,476,841,19,860
"تهران","تهران","مرکز_شهرستان",1207,661,28,7,582,1278,11,1289
"تهران","تهران","مرکز_شهرستان",1208,502,20,15,541,1078,22,1100
"تهران","تهران","مرکز_شهرستان",1209,529,13,16,618,1176,13,1189
"تهران","تهران","مرکز_شهرستان",1210,677,20,17,602,1316,15,1331
"تهران","تهران","مرکز_شهرستان",1211,445,22,4,537,1008,14,1022
"تهران","تهران","مرکز_شهرستان",1212,478,39,11,706,1234,21,1255
"تهران","تهران","مرکز_شهرستان",1213,437,31,7,470,945,19,964
"تهران","تهران","مرکز_شهرستان",1214,1105,31,9,811,1956,19,1975
"تهران","تهران","مرکز_شهرستان",1215,1091,38,6,397,1532,22,1554
"تهران","تهران","مرکز_شهرستان",1216,1197,45,16,832,2090,36,2126
"تهران","تهران","مرکز_شهرستان",1217,586,24,17,535,1162,0,1162
"تهران","تهران","مرکز_شهرستان",1218,630,26,7,808,1471,26,1497
"تهران","تهران","مرکز_شهرستان",1219,647,20,6,572,1245,18,1263
"تهران","تهران","مرکز_شهرستان",1220,305,15,3,284,607,11,618
"تهران","تهران","مرکز_شهرستان",1221,479,25,10,707,1221,21,1242
"تهران","تهران","مرکز_شهرستان",1222,637,20,6,599,1262,16,1278
"تهران","تهران","مرکز_شهرستان",1223,326,20,6,432,784,14,798
"تهران","تهران","مرکز_شهرستان",1224,446,28,3,478,955,11,966
"تهران","تهران","مرکز_شهرستان",1225,444,21,6,693,1164,25,1189
"تهران","تهران","مرکز_شهرستان",1226,485,31,12,658,1186,23,1209
"تهران","تهران","مرکز_شهرستان",1227,797,27,12,639,1475,27,1502
"تهران","تهران","مرکز_شهرستان",1228,1269,71,7,571,1918,45,1963
"تهران","تهران","مرکز_شهرستان",1229,462,24,19,662,1167,18,1185
"تهران","تهران","مرکز_شهرستان",1230,591,23,1,581,1196,27,1223
"تهران","تهران","مرکز_شهرستان",1231,361,36,4,338,739,15,754
"تهران","تهران","مرکز_شهرستان",1232,322,0,0,374,696,0,696
"تهران","تهران","مرکز_شهرستان",1233,457,24,4,513,998,17,1015
"تهران","تهران","مرکز_شهرستان",1234,734,36,12,743,1525,26,1551
"تهران","تهران","مرکز_شهرستان",1235,671,35,2,392,1100,21,1121
"تهران","تهران","مرکز_شهرستان",1236,721,37,5,677,1440,17,1457
"تهران","تهران","مرکز_شهرستان",1237,370,15,3,410,798,15,813
"تهران","تهران","مرکز_شهرستان",1238,379,12,2,425,818,18,836
"تهران","تهران","مرکز_شهرستان",1239,563,30,3,365,961,24,985
"تهران","تهران","مرکز_شهرستان",1240,372,11,4,409,796,12,808
"تهران","تهران","مرکز_شهرستان",1241,307,13,7,484,811,10,821
"تهران","تهران","مرکز_شهرستان",1242,707,37,5,836,1585,26,1611
"تهران","تهران","مرکز_شهرستان",1243,1598,43,7,743,2391,43,2434
"تهران","تهران","مرکز_شهرستان",1244,194,8,5,210,417,3,420
"تهران","تهران","مرکز_شهرستان",1245,239,14,1,264,518,10,528
"تهران","تهران","مرکز_شهرستان",1246,403,10,5,462,880,24,904
"تهران","تهران","مرکز_شهرستان",1247,579,18,3,411,1011,21,1032
"تهران","تهران","مرکز_شهرستان",1248,794,21,5,325,1145,8,1153
"تهران","تهران","مرکز_شهرستان",1249,789,15,4,465,1273,19,1292
"تهران","تهران","مرکز_شهرستان",1250,344,12,0,355,711,18,729
"تهران","تهران","مرکز_شهرستان",1251,385,22,3,335,745,18,763
"تهران","تهران","مرکز_شهرستان",1252,631,34,6,335,1006,18,1024
"تهران","تهران","مرکز_شهرستان",1253,779,29,5,494,1307,29,1336
"تهران","تهران","مرکز_شهرستان",1254,369,18,3,515,905,11,916
"تهران","تهران","مرکز_شهرستان",1255,429,11,1,550,991,9,1000
"تهران","تهران","مرکز_شهرستان",1256,253,14,4,281,552,16,568
"تهران","تهران","مرکز_شهرستان",1257,233,8,1,248,490,0,490
"تهران","تهران","مرکز_شهرستان",1258,516,20,4,511,1051,19,1070
"تهران","تهران","مرکز_شهرستان",1259,308,6,8,313,635,12,647
"تهران","تهران","مرکز_شهرستان",1260,294,11,2,326,633,15,648
"تهران","تهران","مرکز_شهرستان",1261,968,25,1,310,1304,16,1320
"تهران","تهران","مرکز_شهرستان",1262,1173,40,5,585,1803,11,1814
"تهران","تهران","مرکز_شهرستان",1263,136,7,5,169,317,2,319
"تهران","تهران","مرکز_شهرستان",1264,203,12,3,204,422,7,429
"تهران","تهران","مرکز_شهرستان",1265,317,23,4,301,645,17,662
"تهران","تهران","مرکز_شهرستان",1266,362,24,5,354,745,8,753
"تهران","تهران","مرکز_شهرستان",1267,749,28,10,477,1264,28,1292
"تهران","تهران","مرکز_شهرستان",1268,351,15,3,402,771,12,783
"تهران","تهران","مرکز_شهرستان",1269,296,20,4,386,706,10,716
"تهران","تهران","مرکز_شهرستان",1270,475,14,2,344,835,15,850
"تهران","تهران","مرکز_شهرستان",1271,326,20,2,319,667,14,681
"تهران","تهران","مرکز_شهرستان",1272,724,18,3,440,1185,20,1205
"تهران","تهران","مرکز_شهرستان",1273,988,23,0,300,1311,22,1333
"تهران","تهران","مرکز_شهرستان",1274,791,13,6,512,1322,25,1347
"تهران","تهران","مرکز_شهرستان",1275,150,11,5,368,534,6,540
"تهران","تهران","مرکز_شهرستان",1276,449,23,6,679,1157,14,1171
"تهران","تهران","مرکز_شهرستان",1277,161,17,5,305,488,12,500
"تهران","تهران","مرکز_شهرستان",1278,273,27,17,763,1080,120,1200
"تهران","تهران","مرکز_شهرستان",1279,290,29,8,521,848,14,862
"تهران","تهران","مرکز_شهرستان",1280,182,8,0,201,391,9,400
"تهران","تهران","مرکز_شهرستان",1281,253,15,6,468,742,14,756
"تهران","تهران","مرکز_شهرستان",1282,367,35,6,402,810,9,819
"تهران","تهران","مرکز_شهرستان",1283,387,38,10,535,970,0,970
"تهران","تهران","مرکز_شهرستان",1284,102,4,0,129,235,2,237
"تهران","تهران","مرکز_شهرستان",1285,337,26,36,1359,1758,20,1778
"تهران","تهران","مرکز_شهرستان",1286,215,10,13,654,892,16,908
"تهران","تهران","مرکز_شهرستان",1287,243,26,19,612,900,9,909
"تهران","تهران","مرکز_شهرستان",1288,311,36,41,1381,1769,22,1791
"تهران","تهران","مرکز_شهرستان",1289,377,29,30,802,1238,20,1258
"تهران","تهران","مرکز_شهرستان",1290,353,34,36,1257,1680,20,1700
"تهران","تهران","مرکز_شهرستان",1291,344,27,22,848,1241,9,1250
"تهران","تهران","مرکز_شهرستان",1292,246,28,20,817,1111,11,1122
"تهران","تهران","مرکز_شهرستان",1293,309,35,30,974,1348,18,1366
"تهران","تهران","مرکز_شهرستان",1294,860,52,28,1360,2300,30,2330
"تهران","تهران","مرکز_شهرستان",1295,471,37,12,933,1453,18,1471
"تهران","تهران","مرکز_شهرستان",1296,600,37,11,762,1410,19,1429
"تهران","تهران","مرکز_شهرستان",1297,407,33,13,934,1387,17,1404
"تهران","تهران","مرکز_شهرستان",1298,509,36,10,675,1230,19,1249
"تهران","تهران","مرکز_شهرستان",1299,565,43,7,743,1358,17,1375
"تهران","تهران","مرکز_شهرستان",1300,266,35,8,612,921,12,933
"تهران","تهران","مرکز_شهرستان",1301,662,41,15,660,1378,26,1404
"تهران","تهران","مرکز_شهرستان",1302,685,29,15,579,1308,35,1343
"تهران","تهران","مرکز_شهرستان",1303,327,26,20,984,1357,18,1375
"تهران","تهران","مرکز_شهرستان",1304,363,25,9,678,1075,23,1098
"تهران","تهران","مرکز_شهرستان",1305,428,40,8,770,1246,19,1265
"تهران","تهران","مرکز_شهرستان",1306,266,38,22,1304,1630,15,1645
"تهران","تهران","مرکز_شهرستان",1307,690,37,25,849,1601,31,1632
"تهران","تهران","مرکز_شهرستان",1308,532,32,14,549,1127,30,1157
"تهران","تهران","مرکز_شهرستان",1309,814,56,4,877,1751,50,1801
"تهران","تهران","مرکز_شهرستان",1310,731,62,18,801,1612,11,1623
"تهران","تهران","مرکز_شهرستان",1311,291,47,23,936,1297,17,1314
"تهران","تهران","مرکز_شهرستان",1312,564,27,10,635,1236,24,1260
"تهران","تهران","مرکز_شهرستان",1313,602,42,9,636,1289,16,1305
"تهران","تهران","مرکز_شهرستان",1314,353,38,16,831,1238,22,1260
"تهران","تهران","مرکز_شهرستان",1315,252,17,9,697,975,14,989
"تهران","تهران","مرکز_شهرستان",1316,292,28,25,939,1284,12,1296
"تهران","تهران","مرکز_شهرستان",1317,436,32,22,839,1329,21,1350
"تهران","تهران","مرکز_شهرستان",1318,302,35,13,816,1166,18,1184
"تهران","تهران","مرکز_شهرستان",1319,288,45,21,1007,1361,20,1381
"تهران","تهران","مرکز_شهرستان",1320,331,32,13,766,1142,17,1159
"تهران","تهران","مرکز_شهرستان",1321,471,47,27,1242,1787,35,1822
"تهران","تهران","مرکز_شهرستان",1322,431,25,10,943,1409,20,1429
"تهران","تهران","مرکز_شهرستان",1323,257,22,8,558,845,12,857
"تهران","تهران","مرکز_شهرستان",1324,934,59,15,908,1916,28,1944
"تهران","تهران","مرکز_شهرستان",1325,335,25,6,516,882,9,891
"تهران","تهران","مرکز_شهرستان",1326,449,45,9,956,1459,22,1481
"تهران","تهران","مرکز_شهرستان",1327,382,39,23,1106,1550,32,1582
"تهران","تهران","مرکز_شهرستان",1328,626,75,4,1083,1788,23,1811
"تهران","تهران","مرکز_شهرستان",1329,409,36,11,1032,1488,23,1511
"تهران","تهران","مرکز_شهرستان",1330,512,34,8,652,1206,19,1225
"تهران","تهران","مرکز_شهرستان",1331,772,31,14,655,1472,26,1498
"تهران","تهران","مرکز_شهرستان",1332,700,38,11,491,1240,16,1256
"تهران","تهران","مرکز_شهرستان",1333,319,25,8,493,845,12,857
"تهران","تهران","مرکز_شهرستان",1334,626,37,20,857,1540,17,1557
"تهران","تهران","مرکز_شهرستان",1335,247,19,6,460,732,18,750
"تهران","تهران","مرکز_شهرستان",1336,645,16,14,279,954,26,980
"تهران","تهران","مرکز_شهرستان",1337,576,19,6,253,854,31,885
"تهران","تهران","مرکز_شهرستان",1338,1020,84,15,904,2023,33,2056
"تهران","تهران","مرکز_شهرستان",1340,506,30,10,638,1184,32,1216
"تهران","تهران","مرکز_شهرستان",1341,718,39,6,664,1427,12,1439
"تهران","تهران","مرکز_شهرستان",1342,366,19,3,403,791,11,802
"تهران","تهران","مرکز_شهرستان",1343,524,33,3,735,1295,19,1314
"تهران","تهران","مرکز_شهرستان",1344,517,39,15,790,1361,18,1379
"تهران","تهران","مرکز_شهرستان",1345,586,20,10,673,1289,18,1307
"تهران","تهران","مرکز_شهرستان",1346,439,45,14,644,1142,12,1154
"تهران","تهران","مرکز_شهرستان",1347,590,27,8,497,1122,14,1136
"تهران","تهران","مرکز_شهرستان",1348,666,41,11,888,1606,15,1621
"تهران","تهران","مرکز_شهرستان",1349,519,32,19,706,1276,14,1290
"تهران","تهران","مرکز_شهرستان",1350,697,27,16,897,1637,24,1661
"تهران","تهران","مرکز_شهرستان",1351,285,32,10,434,761,4,765
"تهران","تهران","مرکز_شهرستان",1352,318,18,8,528,872,13,885
"تهران","تهران","مرکز_شهرستان",1353,905,48,13,713,1679,23,1702
"تهران","تهران","مرکز_شهرستان",1354,954,40,15,708,1717,38,1755
"تهران","تهران","مرکز_شهرستان",1355,399,34,13,782,1228,24,1252
"تهران","تهران","مرکز_شهرستان",1356,784,50,8,1040,1882,28,1910
"تهران","تهران","مرکز_شهرستان",1357,451,34,6,835,1326,21,1347
"تهران","تهران","مرکز_شهرستان",1358,407,31,4,617,1059,12,1071
"تهران","تهران","مرکز_شهرستان",1359,384,28,7,739,1158,19,1177
"تهران","تهران","مرکز_شهرستان",1360,479,29,3,740,1251,16,1267
"تهران","تهران","مرکز_شهرستان",1361,449,27,13,707,1196,12,1208
"تهران","تهران","مرکز_شهرستان",1362,368,40,7,754,1169,16,1185
"تهران","تهران","مرکز_شهرستان",1363,187,15,3,271,476,7,483
"تهران","تهران","مرکز_شهرستان",1364,643,32,7,460,1142,26,1168
"تهران","تهران","مرکز_شهرستان",1365,278,28,9,495,810,8,818
"تهران","تهران","مرکز_شهرستان",1366,645,42,7,659,1353,26,1379
"تهران","تهران","مرکز_شهرستان",1367,557,38,9,507,1111,20,1131
"تهران","تهران","مرکز_شهرستان",1368,725,41,4,373,1143,27,1170
"تهران","تهران","مرکز_شهرستان",1369,279,15,7,305,606,15,621
"تهران","تهران","مرکز_شهرستان",1370,684,38,10,795,1527,18,1545
"تهران","تهران","مرکز_شهرستان",1371,623,34,8,736,1401,21,1422
"تهران","تهران","مرکز_شهرستان",1372,610,39,10,756,1415,18,1433
"تهران","تهران","مرکز_شهرستان",1373,639,43,9,819,1510,30,1540
"تهران","تهران","مرکز_شهرستان",1374,875,35,3,477,1390,33,1423
"تهران","تهران","مرکز_شهرستان",1375,531,24,10,686,1251,13,1264
"تهران","تهران","مرکز_شهرستان",1376,220,10,3,212,445,5,450
"تهران","تهران","مرکز_شهرستان",1377,398,22,1,313,734,15,749
"تهران","تهران","مرکز_شهرستان",1378,286,11,8,232,537,5,542
"تهران","تهران","مرکز_شهرستان",1379,982,39,12,606,1639,24,1663
"تهران","تهران","مرکز_شهرستان",1380,391,14,11,249,665,20,685
"تهران","تهران","مرکز_شهرستان",1381,498,24,8,423,953,17,970
"تهران","تهران","مرکز_شهرستان",1382,581,33,6,441,1061,6,1067
"تهران","تهران","مرکز_شهرستان",1383,795,27,13,599,1434,30,1464
"تهران","تهران","مرکز_شهرستان",1384,817,26,10,646,1499,27,1526
"تهران","تهران","مرکز_شهرستان",1385,981,28,9,770,1788,40,1828
"تهران","تهران","مرکز_شهرستان",1386,126,6,3,239,374,10,384
"تهران","تهران","مرکز_شهرستان",1387,761,21,3,411,1196,28,1224
"تهران","تهران","مرکز_شهرستان",1388,713,31,9,1126,1879,33,1912
"تهران","تهران","مرکز_شهرستان",1389,280,22,5,254,561,8,569
"تهران","تهران","مرکز_شهرستان",1390,553,33,28,724,1338,24,1362
"تهران","تهران","مرکز_شهرستان",1391,545,18,10,612,1185,17,1202
"تهران","تهران","مرکز_شهرستان",1392,193,13,5,260,471,3,474
"تهران","تهران","مرکز_شهرستان",1393,237,9,3,303,552,8,560
"تهران","تهران","مرکز_شهرستان",1394,457,38,14,664,1173,24,1197
"تهران","تهران","مرکز_شهرستان",1395,140,6,0,206,352,5,357
"تهران","تهران","مرکز_شهرستان",1396,530,27,4,412,973,10,983
"تهران","تهران","مرکز_شهرستان",1397,850,38,15,810,1713,43,1756
"تهران","تهران","مرکز_شهرستان",1398,552,12,5,405,974,9,983
"تهران","تهران","مرکز_شهرستان",1399,396,12,4,372,784,12,796
"تهران","تهران","مرکز_شهرستان",1400,613,18,19,509,1159,23,1182
"تهران","تهران","مرکز_شهرستان",1401,487,12,3,361,863,7,870
"تهران","تهران","مرکز_شهرستان",1402,617,17,1,340,975,25,1000
"تهران","تهران","مرکز_شهرستان",1403,643,16,1,158,818,5,823
"تهران","تهران","مرکز_شهرستان",1404,638,19,8,579,1244,25,1269
"تهران","تهران","مرکز_شهرستان",1405,625,19,7,323,974,18,992
"تهران","تهران","مرکز_شهرستان",1406,386,23,9,328,746,9,755
"تهران","تهران","مرکز_شهرستان",1407,927,39,3,688,1657,26,1683
"تهران","تهران","مرکز_شهرستان",1408,780,29,2,405,1216,5,1221
"تهران","تهران","مرکز_شهرستان",1409,884,13,5,583,1485,39,1524
"تهران","تهران","مرکز_شهرستان",1410,570,26,6,549,1151,23,1174
"تهران","تهران","مرکز_شهرستان",1411,844,15,4,527,1390,29,1419
"تهران","تهران","مرکز_شهرستان",1412,778,47,12,718,1555,19,1574
"تهران","تهران","مرکز_شهرستان",1413,125,5,1,92,223,7,230
"تهران","تهران","مرکز_شهرستان",1414,224,14,1,216,455,12,467
"تهران","تهران","مرکز_شهرستان",1415,157,10,3,260,430,3,433
"تهران","تهران","مرکز_شهرستان",1416,304,10,2,64,380,0,380
"تهران","تهران","مرکز_شهرستان",1417,185,6,4,238,433,7,440
"تهران","تهران","مرکز_شهرستان",1418,346,27,3,317,693,20,713
"تهران","تهران","مرکز_شهرستان",1419,276,6,4,143,429,11,440
"تهران","تهران","مرکز_شهرستان",1420,165,11,2,120,298,2,300
"تهران","تهران","مرکز_شهرستان",1421,277,12,3,210,502,5,507
"تهران","تهران","مرکز_شهرستان",1422,235,14,3,260,512,12,524
"تهران","تهران","مرکز_شهرستان",1423,101,8,10,268,387,7,394
"تهران","تهران","مرکز_شهرستان",1424,932,39,6,255,1232,25,1257
"تهران","تهران","مرکز_شهرستان",1425,431,60,9,684,1184,14,1198
"تهران","تهران","مرکز_شهرستان",1426,697,60,43,1333,2133,30,2163
"تهران","تهران","مرکز_شهرستان",1427,674,42,16,781,1513,32,1545
"تهران","تهران","مرکز_شهرستان",1428,400,40,7,380,827,10,837
"تهران","تهران","مرکز_شهرستان",1429,458,21,8,632,1119,17,1136
"تهران","تهران","مرکز_شهرستان",1430,529,32,24,577,1162,16,1178
"تهران","تهران","مرکز_شهرستان",1431,467,34,6,332,839,21,860
"تهران","تهران","مرکز_شهرستان",1432,506,22,2,262,792,16,808
"تهران","تهران","مرکز_شهرستان",1433,323,16,8,596,943,18,961
"تهران","تهران","مرکز_شهرستان",1434,479,57,10,856,1402,28,1430
"تهران","تهران","مرکز_شهرستان",1435,407,43,11,575,1036,12,1048
"تهران","تهران","مرکز_شهرستان",1436,416,37,3,579,1035,22,1057
"تهران","تهران","مرکز_شهرستان",1437,584,65,22,1063,1734,19,1753
"تهران","تهران","مرکز_شهرستان",1438,268,17,10,389,684,16,700
"تهران","تهران","مرکز_شهرستان",1439,638,50,7,611,1306,24,1330
"تهران","تهران","مرکز_شهرستان",1440,530,63,4,346,943,32,975
"تهران","تهران","مرکز_شهرستان",1441,527,49,5,349,930,16,946
"تهران","تهران","مرکز_شهرستان",1442,294,29,0,218,541,11,552
"تهران","تهران","مرکز_شهرستان",1443,669,48,8,665,1390,29,1419
"تهران","تهران","مرکز_شهرستان",1444,253,20,3,272,548,9,557
"تهران","تهران","مرکز_شهرستان",1445,534,44,4,391,973,21,994
"تهران","تهران","مرکز_شهرستان",1446,506,62,9,356,933,33,966
"تهران","تهران","مرکز_شهرستان",1447,673,59,7,587,1326,24,1350
"تهران","تهران","مرکز_شهرستان",1448,887,42,2,245,1176,21,1197
"تهران","تهران","مرکز_شهرستان",1449,770,50,4,289,1113,21,1134
"تهران","تهران","مرکز_شهرستان",1450,710,39,5,285,1039,23,1062
"تهران","تهران","مرکز_شهرستان",1451,681,38,11,390,1120,22,1142
"تهران","تهران","مرکز_شهرستان",1452,755,29,13,657,1454,27,1481
"تهران","تهران","مرکز_شهرستان",1453,822,55,8,434,1319,29,1348
"تهران","تهران","مرکز_شهرستان",1454,517,46,3,353,919,22,941
"تهران","تهران","مرکز_شهرستان",1455,364,26,1,242,633,18,651
"تهران","تهران","مرکز_شهرستان",1456,580,59,7,553,1199,22,1221
"تهران","تهران","مرکز_شهرستان",1457,566,66,6,501,1139,22,1161
"تهران","تهران","مرکز_شهرستان",1458,535,33,2,311,881,11,892
"تهران","تهران","مرکز_شهرستان",1459,569,41,2,249,861,20,881
"تهران","تهران","مرکز_شهرستان",1460,893,31,11,509,1444,29,1473
"تهران","تهران","مرکز_شهرستان",1461,1135,33,7,482,1657,25,1682
"تهران","تهران","مرکز_شهرستان",1462,684,33,3,315,1035,17,1052
"تهران","تهران","مرکز_شهرستان",1463,729,38,12,450,1229,31,1260
"تهران","تهران","مرکز_شهرستان",1464,796,45,10,649,1500,31,1531
"تهران","تهران","مرکز_شهرستان",1465,413,51,11,608,1083,8,1091
"تهران","تهران","مرکز_شهرستان",1466,438,21,8,297,764,10,774
"تهران","تهران","مرکز_شهرستان",1467,532,13,5,506,1056,21,1077
"تهران","تهران","مرکز_شهرستان",1468,311,18,9,264,602,17,619
"تهران","تهران","مرکز_شهرستان",1469,1057,56,6,367,1486,21,1507
"تهران","تهران","مرکز_شهرستان",1470,520,38,10,345,913,19,932
"تهران","تهران","مرکز_شهرستان",1471,499,28,5,338,870,0,870
"تهران","تهران","مرکز_شهرستان",1472,740,45,6,383,1174,24,1198
"تهران","تهران","مرکز_شهرستان",1473,1066,45,2,525,1638,39,1677
"تهران","تهران","مرکز_شهرستان",1474,1182,52,5,558,1797,34,1831
"تهران","تهران","مرکز_شهرستان",1475,1072,30,5,352,1459,29,1488
"تهران","تهران","مرکز_شهرستان",1476,1107,11,3,188,1309,7,1316
"تهران","تهران","مرکز_شهرستان",1477,827,36,5,536,1404,43,1447
"تهران","تهران","مرکز_شهرستان",1478,978,35,1,309,1323,23,1346
"تهران","تهران","مرکز_شهرستان",1479,551,20,2,443,1016,11,1027
"تهران","تهران","مرکز_شهرستان",1480,427,20,1,273,721,10,731
"تهران","تهران","مرکز_شهرستان",1481,592,32,12,708,1344,23,1367
"تهران","تهران","مرکز_شهرستان",1482,861,31,0,273,1165,18,1183
"تهران","تهران","مرکز_شهرستان",1483,709,43,6,449,1207,34,1241
"تهران","تهران","مرکز_شهرستان",1484,627,30,4,454,1115,16,1131
"تهران","تهران","مرکز_شهرستان",1485,435,15,8,399,857,19,876
"تهران","تهران","مرکز_شهرستان",1486,668,13,3,406,1090,19,1109
"تهران","تهران","مرکز_شهرستان",1487,182,11,0,141,334,4,338
"تهران","تهران","مرکز_شهرستان",1488,773,41,0,439,1253,16,1269
"تهران","تهران","مرکز_شهرستان",1489,464,28,3,356,851,13,864
"تهران","تهران","مرکز_شهرستان",1490,497,37,6,392,932,14,946
"تهران","تهران","مرکز_شهرستان",1492,548,22,3,389,962,29,991
"تهران","تهران","مرکز_شهرستان",1493,793,34,0,304,1131,25,1156
"تهران","تهران","مرکز_شهرستان",1494,836,24,16,419,1295,35,1330
"تهران","تهران","مرکز_شهرستان",1495,527,16,5,209,757,15,772
"تهران","تهران","مرکز_شهرستان",1496,691,15,2,286,994,19,1013
"تهران","تهران","مرکز_شهرستان",1497,419,21,12,334,786,20,806
"تهران","تهران","مرکز_شهرستان",1498,416,34,5,335,790,22,812
"تهران","تهران","مرکز_شهرستان",1499,1177,53,5,285,1520,29,1549
"تهران","تهران","مرکز_شهرستان",1500,595,28,4,633,1260,18,1278
"تهران","تهران","مرکز_شهرستان",1501,383,14,10,405,812,23,835
"تهران","تهران","مرکز_شهرستان",1502,311,20,5,486,822,13,835
"تهران","تهران","مرکز_شهرستان",1503,346,29,14,794,1183,36,1219
"تهران","تهران","مرکز_شهرستان",1504,776,51,17,990,1834,37,1871
"تهران","تهران","مرکز_شهرستان",1505,544,27,20,907,1498,28,1526
"تهران","تهران","مرکز_شهرستان",1506,412,40,50,906,1408,26,1434
"تهران","تهران","مرکز_شهرستان",1507,499,37,9,559,1104,23,1127
"تهران","تهران","مرکز_شهرستان",1508,537,44,17,1174,1772,28,1800
"تهران","تهران","مرکز_شهرستان",1509,831,62,27,1149,2069,31,2100
"تهران","تهران","مرکز_شهرستان",1510,262,27,34,801,1124,13,1137
"تهران","تهران","مرکز_شهرستان",1511,333,36,9,748,1126,17,1143
"تهران","تهران","مرکز_شهرستان",1512,203,16,45,1098,1362,5,1367
"تهران","تهران","مرکز_شهرستان",1514,307,21,45,541,914,15,929
"تهران","تهران","مرکز_شهرستان",1515,193,8,4,236,441,3,444
"تهران","تهران","مرکز_شهرستان",1516,351,7,4,356,718,17,735
"تهران","تهران","مرکز_شهرستان",1517,492,12,10,346,860,17,877
"تهران","تهران","مرکز_شهرستان",1518,441,9,1,191,642,23,665
"تهران","تهران","مرکز_شهرستان",1519,582,15,7,417,1021,14,1035
"تهران","تهران","مرکز_شهرستان",1520,44,6,0,80,130,0,130
"تهران","تهران","مرکز_شهرستان",1521,581,18,7,292,898,23,921
"تهران","تهران","مرکز_شهرستان",1522,760,21,2,278,1061,21,1082
"تهران","تهران","مرکز_شهرستان",1523,951,32,3,373,1359,18,1377
"تهران","تهران","مرکز_شهرستان",1524,814,9,3,315,1141,16,1157
"تهران","تهران","مرکز_شهرستان",1525,688,11,5,538,1242,26,1268
"تهران","تهران","مرکز_شهرستان",1526,1079,26,3,603,1711,16,1727
"تهران","تهران","مرکز_شهرستان",1527,382,16,0,286,684,15,699
"تهران","تهران","مرکز_شهرستان",1528,117,4,0,74,195,6,201
"تهران","تهران","مرکز_شهرستان",1529,800,34,11,663,1508,18,1526
"تهران","تهران","مرکز_شهرستان",1530,1060,38,6,458,1562,33,1595
"تهران","تهران","مرکز_شهرستان",1531,506,37,40,742,1325,23,1348
"تهران","تهران","مرکز_شهرستان",1532,238,13,4,310,565,26,591
"تهران","تهران","مرکز_شهرستان",1533,510,22,7,588,1127,22,1149
"تهران","تهران","مرکز_شهرستان",1534,608,20,13,568,1209,22,1231
"تهران","تهران","مرکز_شهرستان",1535,299,10,9,432,750,11,761
"تهران","تهران","مرکز_شهرستان",1536,383,28,6,531,948,0,948
"تهران","تهران","مرکز_شهرستان",1537,656,21,5,612,1294,19,1313
"تهران","تهران","مرکز_شهرستان",1538,427,6,3,270,706,16,722
"تهران","تهران","مرکز_شهرستان",1539,404,18,3,334,759,8,767
"تهران","تهران","مرکز_شهرستان",1540,260,6,0,258,524,17,541
"تهران","تهران","مرکز_شهرستان",1541,925,29,14,614,1582,22,1604
"تهران","تهران","مرکز_شهرستان",1542,881,33,5,696,1615,24,1639
"تهران","تهران","مرکز_شهرستان",1543,492,39,5,608,1144,19,1163
"تهران","تهران","مرکز_شهرستان",1544,240,12,7,344,603,17,620
"تهران","تهران","مرکز_شهرستان",1545,501,27,4,595,1127,15,1142
"تهران","تهران","مرکز_شهرستان",1546,323,35,23,441,822,26,848
"تهران","تهران","مرکز_شهرستان",1547,561,32,22,599,1214,30,1244
"تهران","تهران","مرکز_شهرستان",1548,870,31,7,563,1471,53,1524
"تهران","تهران","مرکز_شهرستان",1549,937,66,9,735,1747,32,1779
"تهران","تهران","مرکز_شهرستان",1550,690,29,10,427,1156,44,1200
"تهران","تهران","مرکز_شهرستان",1551,281,18,3,187,489,9,498
"تهران","تهران","مرکز_شهرستان",1555,672,39,10,602,1323,19,1342
"تهران","تهران","مرکز_شهرستان",1556,448,39,5,519,1011,89,1100
"تهران","تهران","مرکز_شهرستان",1558,698,14,2,221,935,22,957
"تهران","تهران","مرکز_شهرستان",1559,896,33,1,350,1280,28,1308
"تهران","تهران","مرکز_شهرستان",1561,791,29,3,373,1196,29,1225
"تهران","تهران","مرکز_شهرستان",1563,396,22,9,234,661,10,671
"تهران","تهران","مرکز_شهرستان",1564,694,17,2,297,1010,9,1019
"تهران","تهران","مرکز_شهرستان",1566,736,37,9,618,1400,26,1426
"تهران","تهران","مرکز_شهرستان",1569,752,25,13,508,1298,21,1319
"تهران","تهران","مرکز_شهرستان",1572,398,18,6,262,684,12,696
"تهران","تهران","مرکز_شهرستان",1573,99,12,2,79,192,7,199
"تهران","تهران","مرکز_شهرستان",1574,187,4,2,194,387,15,402
"تهران","تهران","مرکز_شهرستان",1575,153,5,1,135,294,1,295
"تهران","تهران","مرکز_شهرستان",1576,184,7,0,177,368,3,371
"تهران","تهران","مرکز_شهرستان",1577,107,7,4,109,227,2,229
"تهران","تهران","مرکز_شهرستان",1578,125,4,1,75,205,6,211
"تهران","تهران","مرکز_شهرستان",1579,319,11,7,360,697,19,716
"تهران","تهران","مرکز_شهرستان",1580,143,12,4,151,310,3,313
"تهران","تهران","مرکز_شهرستان",1581,132,8,0,119,259,7,266
"تهران","تهران","مرکز_شهرستان",1582,165,16,6,228,415,8,423
"تهران","تهران","مرکز_شهرستان",1583,135,7,4,114,260,8,268
"تهران","تهران","مرکز_شهرستان",1584,183,9,0,107,299,3,302
"تهران","تهران","مرکز_شهرستان",1585,124,1,0,74,199,2,201
"تهران","تهران","مرکز_شهرستان",1586,245,11,3,260,519,7,526
"تهران","تهران","مرکز_شهرستان",1587,187,8,6,200,401,12,413
"تهران","تهران","مرکز_شهرستان",1588,524,31,13,660,1228,22,1250
"تهران","تهران","مرکز_شهرستان",1589,620,26,4,428,1078,23,1101
"تهران","تهران","مرکز_شهرستان",1590,708,38,5,363,1114,13,1127
"تهران","تهران","مرکز_شهرستان",1591,462,19,8,703,1192,23,1215
"تهران","تهران","مرکز_شهرستان",1592,493,11,15,570,1089,9,1098
"تهران","تهران","مرکز_شهرستان",1593,268,11,3,246,528,13,541
"تهران","تهران","مرکز_شهرستان",1594,649,32,8,576,1265,31,1296
"تهران","تهران","مرکز_شهرستان",1595,705,15,5,508,1233,25,1258
"تهران","تهران","مرکز_شهرستان",1596,540,15,8,316,879,20,899
"تهران","تهران","مرکز_شهرستان",1597,491,16,9,447,963,30,993
"تهران","تهران","مرکز_شهرستان",1598,668,27,5,338,1038,16,1054
"تهران","تهران","مرکز_شهرستان",1599,640,20,16,462,1138,31,1169
"تهران","تهران","مرکز_شهرستان",1600,823,24,5,466,1318,15,1333
"تهران","تهران","مرکز_شهرستان",1601,490,15,3,410,918,20,938
"تهران","تهران","مرکز_شهرستان",1602,470,19,5,544,1038,17,1055
"تهران","تهران","مرکز_شهرستان",1603,470,16,5,395,886,15,901
"تهران","تهران","مرکز_شهرستان",1604,379,23,2,279,683,13,696
"تهران","تهران","مرکز_شهرستان",1605,409,15,7,435,866,20,886
"تهران","تهران","مرکز_شهرستان",1606,575,16,1,433,1025,25,1050
"تهران","تهران","مرکز_شهرستان",1607,586,26,7,581,1200,50,1250
"تهران","تهران","مرکز_شهرستان",1608,531,16,4,295,846,10,856
"تهران","تهران","مرکز_شهرستان",1609,442,33,9,490,974,26,1000
"تهران","تهران","مرکز_شهرستان",1610,475,31,11,733,1250,30,1280
"تهران","تهران","مرکز_شهرستان",1611,621,24,9,459,1113,17,1130
"تهران","تهران","مرکز_شهرستان",1612,343,26,3,435,807,18,825
"تهران","تهران","مرکز_شهرستان",1613,481,44,9,863,1397,13,1410
"تهران","تهران","مرکز_شهرستان",1614,215,15,4,103,337,9,346
"تهران","تهران","مرکز_شهرستان",1615,411,30,6,229,676,24,700
"تهران","تهران","مرکز_شهرستان",1616,617,16,5,285,923,11,934
"تهران","تهران","مرکز_شهرستان",1617,533,20,6,407,966,34,1000
"تهران","تهران","مرکز_شهرستان",1618,411,18,2,229,660,22,682
"تهران","تهران","مرکز_شهرستان",1619,453,27,8,318,806,13,819
"تهران","تهران","مرکز_شهرستان",1620,589,34,10,616,1249,23,1272
"تهران","تهران","مرکز_شهرستان",1621,432,33,9,567,1041,13,1054
"تهران","تهران","مرکز_شهرستان",1622,149,17,0,103,269,2,271
"تهران","تهران","مرکز_شهرستان",1623,811,64,15,690,1580,18,1598
"تهران","تهران","مرکز_شهرستان",1624,630,31,6,431,1098,2,1100
"تهران","تهران","مرکز_شهرستان",1625,404,35,8,589,1036,18,1054
"تهران","تهران","مرکز_شهرستان",1626,460,31,4,536,1031,19,1050
"تهران","تهران","مرکز_شهرستان",1627,439,28,5,584,1056,17,1073
"تهران","تهران","مرکز_شهرستان",1628,454,20,1,477,952,24,976
"تهران","تهران","مرکز_شهرستان",1629,623,28,4,387,1042,24,1066
"تهران","تهران","مرکز_شهرستان",1630,438,36,6,635,1115,34,1149
"تهران","تهران","مرکز_شهرستان",1631,445,20,11,598,1074,14,1088
"تهران","تهران","مرکز_شهرستان",1632,673,43,7,473,1196,21,1217
"تهران","تهران","مرکز_شهرستان",1633,608,33,10,481,1132,21,1153
"تهران","تهران","مرکز_شهرستان",1634,442,32,3,360,837,25,862
"تهران","تهران","مرکز_شهرستان",1635,372,27,4,363,766,12,778
"تهران","تهران","مرکز_شهرستان",1636,777,43,12,555,1387,16,1403
"تهران","تهران","مرکز_شهرستان",1637,443,56,6,869,1374,24,1398
"تهران","تهران","مرکز_شهرستان",1638,407,28,5,733,1173,23,1196
"تهران","تهران","مرکز_شهرستان",1639,414,25,13,906,1358,24,1382
"تهران","تهران","مرکز_شهرستان",1640,368,28,7,813,1216,13,1229
"تهران","تهران","مرکز_شهرستان",1641,328,23,9,698,1058,9,1067
"تهران","تهران","مرکز_شهرستان",1642,922,55,5,642,1624,22,1646
"تهران","تهران","مرکز_شهرستان",1643,915,78,17,919,1929,31,1960
"تهران","تهران","مرکز_شهرستان",1644,831,42,6,511,1390,21,1411
"تهران","تهران","مرکز_شهرستان",1645,816,55,14,686,1571,30,1601
"تهران","تهران","مرکز_شهرستان",1646,414,43,17,943,1417,19,1436
"تهران","تهران","مرکز_شهرستان",1647,406,43,10,1128,1587,24,1611
"تهران","تهران","مرکز_شهرستان",1648,506,50,11,972,1539,29,1568
"تهران","تهران","مرکز_شهرستان",1649,393,32,2,370,797,8,805
"تهران","تهران","مرکز_شهرستان",1650,393,21,1,307,722,22,744
"تهران","تهران","مرکز_شهرستان",1651,350,42,8,918,1318,17,1335
"تهران","تهران","مرکز_شهرستان",1652,380,40,9,809,1238,17,1255
"تهران","تهران","مرکز_شهرستان",1653,504,52,11,1015,1582,14,1596
"تهران","تهران","مرکز_شهرستان",1654,192,9,3,296,500,11,511
"تهران","تهران","مرکز_شهرستان",1655,144,13,3,292,452,4,456
"تهران","تهران","مرکز_شهرستان",1656,769,44,1,583,1397,40,1437
"تهران","تهران","مرکز_شهرستان",1657,266,31,5,681,983,17,1000
"تهران","تهران","مرکز_شهرستان",1658,498,27,8,1044,1577,19,1596
"تهران","تهران","مرکز_شهرستان",1659,508,18,6,405,937,20,957
"تهران","تهران","مرکز_شهرستان",1660,529,22,6,508,1065,22,1087
"تهران","تهران","مرکز_شهرستان",1661,451,26,3,381,861,19,880
"تهران","تهران","مرکز_شهرستان",1662,356,15,4,654,1029,16,1045
"تهران","تهران","مرکز_شهرستان",1663,572,34,6,711,1323,26,1349
"تهران","تهران","مرکز_شهرستان",1664,349,27,10,591,977,17,994
"تهران","تهران","مرکز_شهرستان",1665,397,39,14,795,1245,23,1268
"تهران","تهران","مرکز_شهرستان",1666,324,21,8,573,926,19,945
"تهران","تهران","مرکز_شهرستان",1667,772,41,8,533,1354,19,1373
"تهران","تهران","مرکز_شهرستان",1668,423,25,3,341,792,9,801
"تهران","تهران","مرکز_شهرستان",1669,545,35,11,545,1136,22,1158
"تهران","تهران","مرکز_شهرستان",1670,314,24,14,629,981,10,991
"تهران","تهران","مرکز_شهرستان",1671,527,40,13,590,1170,13,1183
"تهران","تهران","مرکز_شهرستان",1672,678,51,7,470,1206,22,1228
"تهران","تهران","مرکز_شهرستان",1673,872,36,10,646,1564,52,1616
"تهران","تهران","مرکز_شهرستان",1674,995,48,10,519,1572,30,1602
"تهران","تهران","مرکز_شهرستان",1675,408,41,4,730,1183,18,1201
"تهران","تهران","مرکز_شهرستان",1676,412,25,4,252,693,7,700
"تهران","تهران","مرکز_شهرستان",1677,364,21,6,313,704,11,715
"تهران","تهران","مرکز_شهرستان",1678,460,48,16,939,1463,21,1484
"تهران","تهران","مرکز_شهرستان",1679,180,19,2,294,495,5,500
"تهران","تهران","مرکز_شهرستان",1680,213,18,0,244,475,7,482
"تهران","تهران","مرکز_شهرستان",1681,421,55,13,810,1299,23,1322
"تهران","تهران","مرکز_شهرستان",1682,850,60,14,649,1573,28,1601
"تهران","تهران","مرکز_شهرستان",1683,894,58,13,878,1843,25,1868
"تهران","تهران","مرکز_شهرستان",1684,652,31,4,431,1118,27,1145
"تهران","تهران","مرکز_شهرستان",1685,825,47,12,633,1517,28,1545
"تهران","تهران","مرکز_شهرستان",1686,447,25,0,466,938,19,957
"تهران","تهران","مرکز_شهرستان",1687,558,43,10,770,1381,19,1400
"تهران","تهران","مرکز_شهرستان",1688,430,45,15,824,1314,24,1338
"تهران","تهران","مرکز_شهرستان",1689,495,41,7,908,1451,28,1479
"تهران","تهران","مرکز_شهرستان",1690,302,27,21,626,976,14,990
"تهران","تهران","مرکز_شهرستان",1691,147,17,4,355,523,14,537
"تهران","تهران","مرکز_شهرستان",1692,172,21,1,415,609,13,622
"تهران","تهران","مرکز_شهرستان",1693,504,39,4,456,1003,22,1025
"تهران","تهران","مرکز_شهرستان",1694,677,44,5,481,1207,31,1238
"تهران","تهران","مرکز_شهرستان",1695,534,36,17,524,1111,18,1129
"تهران","تهران","مرکز_شهرستان",1696,709,40,16,725,1490,19,1509
"تهران","تهران","مرکز_شهرستان",1697,612,55,15,1016,1698,21,1719
"تهران","تهران","مرکز_شهرستان",1698,736,17,7,259,1019,21,1040
"تهران","تهران","مرکز_شهرستان",1699,697,27,6,361,1091,17,1108
"تهران","تهران","مرکز_شهرستان",1700,455,44,10,753,1262,15,1277
"تهران","تهران","مرکز_شهرستان",1701,393,29,13,679,1114,26,1140
"تهران","تهران","مرکز_شهرستان",1702,419,23,11,707,1160,9,1169
"تهران","تهران","مرکز_شهرستان",1703,515,49,15,1080,1659,23,1682
"تهران","تهران","مرکز_شهرستان",1704,416,49,16,805,1286,18,1304
"تهران","تهران","مرکز_شهرستان",1705,179,15,11,416,621,10,631
"تهران","تهران","مرکز_شهرستان",1706,212,23,7,461,703,7,710
"تهران","تهران","مرکز_شهرستان",1707,548,35,18,1228,1829,71,1900
"تهران","تهران","مرکز_شهرستان",1708,386,24,11,633,1054,10,1064
"تهران","تهران","مرکز_شهرستان",1709,347,22,3,313,685,5,690
"تهران","تهران","مرکز_شهرستان",1710,265,8,7,158,438,7,445
"تهران","تهران","مرکز_شهرستان",1711,320,20,3,289,632,13,645
"تهران","تهران","مرکز_شهرستان",1712,509,7,3,155,674,13,687
"تهران","تهران","مرکز_شهرستان",1713,273,12,1,104,390,10,400
"تهران","تهران","مرکز_شهرستان",1714,203,5,2,126,336,12,348
"تهران","تهران","مرکز_شهرستان",1715,131,6,2,121,260,9,269
"تهران","تهران","مرکز_شهرستان",1716,296,11,5,242,554,10,564
"تهران","تهران","مرکز_شهرستان",1717,278,24,4,374,680,15,695
"تهران","تهران","مرکز_شهرستان",1718,246,20,1,236,503,11,514
"تهران","تهران","مرکز_شهرستان",1719,397,13,3,334,747,13,760
"تهران","تهران","مرکز_شهرستان",1720,199,13,3,170,385,15,400
"تهران","تهران","مرکز_شهرستان",1721,203,13,2,163,381,16,397
"تهران","تهران","مرکز_شهرستان",1722,522,45,9,646,1222,14,1236
"تهران","تهران","مرکز_شهرستان",1723,1006,44,10,558,1618,26,1644
"تهران","تهران","مرکز_شهرستان",1724,462,36,10,607,1115,22,1137
"تهران","تهران","مرکز_شهرستان",1725,460,32,14,643,1149,19,1168
"تهران","تهران","مرکز_شهرستان",1726,443,34,6,526,1009,10,1019
"تهران","تهران","مرکز_شهرستان",1727,396,24,14,588,1022,23,1045
"تهران","تهران","مرکز_شهرستان",1728,462,31,12,654,1159,22,1181
"تهران","تهران","مرکز_شهرستان",1729,1039,25,6,347,1417,15,1432
"تهران","تهران","مرکز_شهرستان",1730,620,35,1,654,1310,21,1331
"تهران","تهران","مرکز_شهرستان",1731,572,35,10,659,1276,24,1300
"تهران","تهران","مرکز_شهرستان",1732,396,46,5,476,923,25,948
"تهران","تهران","مرکز_شهرستان",1733,417,28,1,325,771,21,792
"تهران","تهران","مرکز_شهرستان",1734,274,14,5,316,609,16,625
"تهران","تهران","مرکز_شهرستان",1735,553,34,12,550,1149,22,1171
"تهران","تهران","مرکز_شهرستان",1736,663,32,1,447,1143,15,1158
"تهران","تهران","مرکز_شهرستان",1737,544,23,5,358,930,17,947
"تهران","تهران","مرکز_شهرستان",1738,784,33,5,684,1506,24,1530
"تهران","تهران","مرکز_شهرستان",1739,747,42,7,793,1589,30,1619
"تهران","تهران","مرکز_شهرستان",1740,735,54,3,757,1549,31,1580
"تهران","تهران","مرکز_شهرستان",1741,582,15,17,471,1085,9,1094
"تهران","تهران","مرکز_شهرستان",1742,444,28,4,496,972,12,984
"تهران","تهران","مرکز_شهرستان",1743,560,23,7,407,997,19,1016
"تهران","تهران","مرکز_شهرستان",1744,1039,32,3,421,1495,36,1531
"تهران","تهران","مرکز_شهرستان",1745,666,53,13,752,1484,21,1505
"تهران","تهران","مرکز_شهرستان",1746,818,52,6,552,1428,30,1458
"تهران","تهران","مرکز_شهرستان",1747,786,25,1,198,1010,19,1029
"تهران","تهران","مرکز_شهرستان",1748,687,30,1,288,1006,16,1022
"تهران","تهران","مرکز_شهرستان",1749,660,32,2,336,1030,29,1059
"تهران","تهران","مرکز_شهرستان",1750,788,29,0,269,1086,22,1108
"تهران","تهران","مرکز_شهرستان",1751,1070,24,3,296,1393,26,1419
"تهران","تهران","مرکز_شهرستان",1752,551,35,3,370,959,15,974
"تهران","تهران","مرکز_شهرستان",1753,773,42,6,379,1200,20,1220
"تهران","تهران","مرکز_شهرستان",1754,821,36,5,280,1142,20,1162
"تهران","تهران","مرکز_شهرستان",1755,702,31,4,602,1339,14,1353
"تهران","تهران","مرکز_شهرستان",1756,620,23,4,452,1099,15,1114
"تهران","تهران","مرکز_شهرستان",1757,563,27,4,307,901,20,921
"تهران","تهران","مرکز_شهرستان",1758,539,24,2,477,1042,22,1064
"تهران","تهران","مرکز_شهرستان",1759,581,42,11,358,992,17,1009
"تهران","تهران","مرکز_شهرستان",1760,675,14,0,196,885,14,899
"تهران","تهران","مرکز_شهرستان",1761,592,24,5,304,925,19,944
"تهران","تهران","مرکز_شهرستان",1762,651,61,17,941,1670,28,1698
"تهران","تهران","مرکز_شهرستان",1763,766,59,11,817,1653,41,1694
"تهران","تهران","مرکز_شهرستان",1764,659,43,8,562,1272,25,1297
"تهران","تهران","مرکز_شهرستان",1765,750,43,5,516,1314,33,1347
"تهران","تهران","مرکز_شهرستان",1766,435,38,11,550,1034,17,1051
"تهران","تهران","مرکز_شهرستان",1767,373,3,4,236,616,20,636
"تهران","تهران","مرکز_شهرستان",1768,290,11,4,255,560,5,565
"تهران","تهران","مرکز_شهرستان",1769,1137,36,4,402,1579,24,1603
"تهران","تهران","مرکز_شهرستان",1770,1432,55,12,712,2211,35,2246
"تهران","تهران","مرکز_شهرستان",1771,529,16,6,472,1023,12,1035
"تهران","تهران","مرکز_شهرستان",1772,658,26,1,364,1049,21,1070
"تهران","تهران","مرکز_شهرستان",1773,515,40,11,529,1095,25,1120
"تهران","تهران","مرکز_شهرستان",1774,964,21,16,429,1430,27,1457
"تهران","تهران","مرکز_شهرستان",1775,1004,21,2,311,1338,25,1363
"تهران","تهران","مرکز_شهرستان",1776,1032,30,13,468,1543,25,1568
"تهران","تهران","مرکز_شهرستان",1777,1250,39,6,349,1644,41,1685
"تهران","تهران","مرکز_شهرستان",1778,711,30,8,393,1142,14,1156
"تهران","تهران","مرکز_شهرستان",1779,712,32,12,697,1453,26,1479
"تهران","تهران","مرکز_شهرستان",1780,562,9,0,244,815,14,829
"تهران","تهران","مرکز_شهرستان",1781,504,11,1,256,772,19,791
"تهران","تهران","مرکز_شهرستان",1782,471,18,12,428,929,15,944
"تهران","تهران","مرکز_شهرستان",1783,591,27,9,372,999,33,1032
"تهران","تهران","مرکز_شهرستان",1784,622,22,4,392,1040,20,1060
"تهران","تهران","مرکز_شهرستان",1785,558,19,2,311,890,23,913
"تهران","تهران","مرکز_شهرستان",1786,572,22,7,299,900,19,919
"تهران","تهران","مرکز_شهرستان",1787,616,36,5,238,895,14,909
"تهران","تهران","مرکز_شهرستان",1788,616,19,7,228,870,16,886
"تهران","تهران","مرکز_شهرستان",1789,646,16,5,174,841,10,851
"تهران","تهران","مرکز_شهرستان",1790,727,26,3,463,1219,28,1247
"تهران","تهران","مرکز_شهرستان",1791,603,30,4,581,1218,17,1235
"تهران","تهران","مرکز_شهرستان",1792,734,26,4,432,1196,24,1220
"تهران","تهران","مرکز_شهرستان",1793,673,22,8,562,1265,22,1287
"تهران","تهران","مرکز_شهرستان",1794,637,23,10,326,996,21,1017
"تهران","تهران","مرکز_شهرستان",1795,1095,29,6,311,1441,22,1463
"تهران","تهران","مرکز_شهرستان",1796,986,33,25,405,1449,20,1469
"تهران","تهران","مرکز_شهرستان",1797,1233,40,9,571,1853,26,1879
"تهران","تهران","مرکز_شهرستان",1798,1194,35,4,372,1605,28,1633
"تهران","تهران","مرکز_شهرستان",1799,1033,26,12,577,1648,28,1676
"تهران","تهران","مرکز_شهرستان",1800,717,27,7,458,1209,35,1244
"تهران","تهران","مرکز_شهرستان",1801,922,31,5,332,1290,28,1318
"تهران","تهران","مرکز_شهرستان",1802,876,26,6,428,1336,25,1361
"تهران","تهران","مرکز_شهرستان",1803,1141,31,2,663,1837,38,1875
"تهران","تهران","مرکز_شهرستان",1804,881,41,5,626,1553,33,1586
"تهران","تهران","مرکز_شهرستان",1805,1100,28,2,236,1366,29,1395
"تهران","تهران","مرکز_شهرستان",1806,1030,26,5,388,1449,22,1471
"تهران","تهران","مرکز_شهرستان",1807,1608,38,3,469,2118,39,2157
"تهران","تهران","مرکز_شهرستان",1808,1225,19,10,302,1556,32,1588
"تهران","تهران","مرکز_شهرستان",1809,1273,21,1,412,1707,92,1799
"تهران","تهران","مرکز_شهرستان",1810,427,14,7,322,770,14,784
"تهران","تهران","مرکز_شهرستان",1811,772,56,6,832,1666,42,1708
"تهران","تهران","مرکز_شهرستان",1812,995,48,4,663,1710,36,1746
"تهران","تهران","مرکز_شهرستان",1813,918,52,9,649,1628,51,1679
"تهران","تهران","مرکز_شهرستان",1814,382,36,10,579,1007,15,1022
"تهران","تهران","مرکز_شهرستان",1815,415,32,2,505,954,19,973
"تهران","تهران","مرکز_شهرستان",1816,746,49,8,863,1666,34,1700
"تهران","تهران","مرکز_شهرستان",1817,910,54,6,681,1651,39,1690
"تهران","تهران","مرکز_شهرستان",1818,745,32,9,368,1154,22,1176
"تهران","تهران","مرکز_شهرستان",1819,875,36,4,308,1223,18,1241
"تهران","تهران","مرکز_شهرستان",1820,943,48,6,466,1463,27,1490
"تهران","تهران","مرکز_شهرستان",1821,378,30,11,717,1136,14,1150
"تهران","تهران","مرکز_شهرستان",1822,792,22,6,294,1114,18,1132
"تهران","تهران","مرکز_شهرستان",1823,994,22,2,277,1295,28,1323
"تهران","تهران","مرکز_شهرستان",1824,1006,20,1,239,1266,24,1290
"تهران","تهران","مرکز_شهرستان",1825,1790,62,13,924,2789,68,2857
"تهران","تهران","مرکز_شهرستان",1826,1566,55,2,705,2328,31,2359
"تهران","تهران","مرکز_شهرستان",1827,566,18,5,618,1207,16,1223
"تهران","تهران","مرکز_شهرستان",1828,869,35,6,648,1558,28,1586
"تهران","تهران","مرکز_شهرستان",1829,706,37,4,503,1250,16,1266
"تهران","تهران","مرکز_شهرستان",1830,966,40,7,593,1606,94,1700
"تهران","تهران","مرکز_شهرستان",1831,894,41,9,751,1695,12,1707
"تهران","تهران","مرکز_شهرستان",1832,682,27,3,283,995,17,1012
"تهران","تهران","مرکز_شهرستان",1833,987,39,10,624,1660,34,1694
"تهران","تهران","مرکز_شهرستان",1834,738,37,11,505,1291,25,1316
"تهران","تهران","مرکز_شهرستان",1835,783,38,2,520,1343,19,1362
"تهران","تهران","مرکز_شهرستان",1836,879,42,6,576,1503,26,1529
"تهران","تهران","مرکز_شهرستان",1837,805,55,14,768,1642,30,1672
"تهران","تهران","مرکز_شهرستان",1838,817,26,6,317,1166,17,1183
"تهران","تهران","مرکز_شهرستان",1839,1055,29,6,420,1510,26,1536
"تهران","تهران","مرکز_شهرستان",1840,1339,61,4,645,2049,31,2080
"تهران","تهران","مرکز_شهرستان",1841,1304,34,1,383,1722,41,1763
"تهران","تهران","مرکز_شهرستان",1842,821,42,7,567,1437,18,1455
"تهران","تهران","مرکز_شهرستان",1843,767,29,4,560,1360,33,1393
"تهران","تهران","مرکز_شهرستان",1844,736,62,11,653,1462,42,1504
"تهران","تهران","مرکز_شهرستان",1845,490,30,9,632,1161,19,1180
"تهران","تهران","مرکز_شهرستان",1846,859,46,15,879,1799,28,1827
"تهران","تهران","مرکز_شهرستان",1847,791,37,5,544,1377,27,1404
"تهران","تهران","مرکز_شهرستان",1848,951,49,9,590,1599,37,1636
"تهران","تهران","مرکز_شهرستان",1849,826,44,15,741,1626,24,1650
"تهران","تهران","مرکز_شهرستان",1850,540,41,5,448,1034,21,1055
"تهران","تهران","مرکز_شهرستان",1851,856,35,8,724,1623,26,1649
"تهران","تهران","مرکز_شهرستان",1852,853,52,14,920,1839,22,1861
"تهران","تهران","مرکز_شهرستان",1853,980,19,2,295,1296,17,1313
"تهران","تهران","مرکز_شهرستان",1854,907,31,4,424,1366,34,1400
"تهران","تهران","مرکز_شهرستان",1855,724,23,5,386,1138,21,1159
"تهران","تهران","مرکز_شهرستان",1856,696,27,5,415,1143,21,1164
"تهران","تهران","مرکز_شهرستان",1857,634,42,4,949,1629,11,1640
"تهران","تهران","مرکز_شهرستان",1858,659,29,4,773,1465,30,1495
"تهران","تهران","مرکز_شهرستان",1859,557,44,3,660,1264,22,1286
"تهران","تهران","مرکز_شهرستان",1860,600,51,14,797,1462,27,1489
"تهران","تهران","مرکز_شهرستان",1861,636,46,14,874,1570,30,1600
"تهران","تهران","مرکز_شهرستان",1862,703,39,6,737,1485,17,1502
"تهران","تهران","مرکز_شهرستان",1863,552,34,4,426,1016,22,1038
"تهران","تهران","مرکز_شهرستان",1864,437,36,14,808,1295,16,1311
"تهران","تهران","مرکز_شهرستان",1865,527,32,8,713,1280,18,1298
"تهران","تهران","مرکز_شهرستان",1866,754,49,12,1037,1852,40,1892
"تهران","تهران","مرکز_شهرستان",1867,591,49,11,1022,1673,28,1701
"تهران","تهران","مرکز_شهرستان",1868,745,35,8,494,1282,21,1303
"تهران","تهران","مرکز_شهرستان",1869,886,37,2,376,1301,17,1318
"تهران","تهران","مرکز_شهرستان",1870,524,33,9,617,1183,25,1208
"تهران","تهران","مرکز_شهرستان",1871,685,30,14,606,1335,38,1373
"تهران","تهران","مرکز_شهرستان",1872,900,34,12,799,1745,40,1785
"تهران","تهران","مرکز_شهرستان",1873,676,53,11,851,1591,27,1618
"تهران","تهران","مرکز_شهرستان",1874,1061,25,8,425,1519,31,1550
"تهران","تهران","مرکز_شهرستان",1875,802,14,4,435,1255,45,1300
"تهران","تهران","مرکز_شهرستان",1876,495,24,7,293,819,7,826
"تهران","تهران","مرکز_شهرستان",1877,536,18,1,251,806,22,828
"تهران","تهران","مرکز_شهرستان",1878,859,34,12,860,1765,23,1788
"تهران","تهران","مرکز_شهرستان",1879,647,25,9,778,1459,32,1491
"تهران","تهران","مرکز_شهرستان",1880,802,34,2,331,1169,28,1197
"تهران","تهران","مرکز_شهرستان",1881,664,39,6,729,1438,26,1464
"تهران","تهران","مرکز_شهرستان",1882,532,45,8,796,1381,34,1415
"تهران","تهران","مرکز_شهرستان",1883,732,43,6,821,1602,29,1631
"تهران","تهران","مرکز_شهرستان",1884,770,46,11,578,1405,31,1436
"تهران","تهران","مرکز_شهرستان",1885,697,22,1,46,766,1,767
"تهران","تهران","مرکز_شهرستان",1886,620,41,2,56,719,12,731
"تهران","تهران","مرکز_شهرستان",1887,787,35,2,121,945,13,958
"تهران","تهران","مرکز_شهرستان",1888,937,27,5,331,1300,15,1315
"تهران","تهران","مرکز_شهرستان",1889,543,44,6,450,1043,19,1062
"تهران","تهران","مرکز_شهرستان",1890,783,29,7,356,1175,20,1195
"تهران","تهران","مرکز_شهرستان",1891,733,39,11,430,1213,27,1240
"تهران","تهران","مرکز_شهرستان",1892,574,26,8,411,1019,12,1031
"تهران","تهران","مرکز_شهرستان",1893,1036,54,7,514,1611,32,1643
"تهران","تهران","مرکز_شهرستان",1894,834,37,9,512,1392,20,1412
"تهران","تهران","مرکز_شهرستان",1895,920,27,4,385,1336,15,1351
"تهران","تهران","مرکز_شهرستان",1896,736,33,5,385,1159,19,1178
"تهران","تهران","مرکز_شهرستان",1897,689,24,4,257,974,14,988
"تهران","تهران","مرکز_شهرستان",1898,955,25,10,401,1391,20,1411
"تهران","تهران","مرکز_شهرستان",1899,1051,36,21,495,1603,24,1627
"تهران","تهران","مرکز_شهرستان",1900,998,29,12,780,1819,25,1844
"تهران","تهران","مرکز_شهرستان",1901,1046,24,11,550,1631,13,1644
"تهران","تهران","مرکز_شهرستان",1902,554,31,4,463,1052,24,1076
"تهران","تهران","مرکز_شهرستان",1903,457,24,11,488,980,20,1000
"تهران","تهران","مرکز_شهرستان",1904,956,33,4,723,1716,30,1746
"تهران","تهران","مرکز_شهرستان",1905,1472,52,11,736,2271,29,2300
"تهران","تهران","مرکز_شهرستان",1906,1133,35,4,404,1576,43,1619
"تهران","تهران","مرکز_شهرستان",1907,764,25,5,470,1264,32,1296
"تهران","تهران","مرکز_شهرستان",1908,898,22,2,413,1335,21,1356
"تهران","تهران","مرکز_شهرستان",1909,552,20,6,402,980,13,993
"تهران","تهران","مرکز_شهرستان",1910,482,34,6,428,950,41,991
"تهران","تهران","مرکز_شهرستان",1911,380,16,3,198,597,13,610
"تهران","تهران","مرکز_شهرستان",1912,395,21,6,239,661,13,674
"تهران","تهران","مرکز_شهرستان",1913,866,31,5,238,1140,17,1157
"تهران","تهران","مرکز_شهرستان",1914,728,24,1,292,1045,18,1063
"تهران","تهران","مرکز_شهرستان",1915,359,17,4,170,550,6,556
"تهران","تهران","مرکز_شهرستان",1916,705,29,4,39,777,7,784
"تهران","تهران","مرکز_شهرستان",1917,432,20,4,220,676,23,699
"تهران","تهران","مرکز_شهرستان",1918,792,23,3,217,1035,18,1053
"تهران","تهران","مرکز_شهرستان",1919,615,27,7,365,1014,21,1035
"تهران","تهران","مرکز_شهرستان",1920,439,11,5,305,760,15,775
"تهران","تهران","مرکز_شهرستان",1921,495,30,8,557,1090,35,1125
"تهران","تهران","مرکز_شهرستان",1922,894,33,9,270,1206,16,1222
"تهران","تهران","مرکز_شهرستان",1923,552,17,0,164,733,4,737
"تهران","تهران","مرکز_شهرستان",1924,973,14,7,484,1478,52,1530
"تهران","تهران","مرکز_شهرستان",1925,1003,24,4,300,1331,69,1400
"تهران","تهران","مرکز_شهرستان",1926,1295,33,7,598,1933,41,1974
"تهران","تهران","مرکز_شهرستان",1927,1101,20,7,285,1413,31,1444
"تهران","تهران","مرکز_شهرستان",1928,886,36,12,896,1830,18,1848
"تهران","تهران","مرکز_شهرستان",1929,768,37,10,529,1344,35,1379
"تهران","تهران","مرکز_شهرستان",1930,1016,28,8,490,1542,29,1571
"تهران","تهران","مرکز_شهرستان",1931,1060,18,2,317,1397,18,1415
"تهران","تهران","مرکز_شهرستان",1932,860,33,12,818,1723,24,1747
"تهران","تهران","مرکز_شهرستان",1933,674,28,2,503,1207,23,1230
"تهران","تهران","مرکز_شهرستان",1934,676,24,5,543,1248,34,1282
"تهران","تهران","مرکز_شهرستان",1935,939,24,4,420,1387,10,1397
"تهران","تهران","مرکز_شهرستان",1936,634,28,7,612,1281,29,1310
"تهران","تهران","مرکز_شهرستان",1937,783,28,5,488,1304,20,1324
"تهران","تهران","مرکز_شهرستان",1938,800,20,6,520,1346,21,1367
"تهران","تهران","مرکز_شهرستان",1939,579,16,4,443,1042,10,1052
"تهران","تهران","مرکز_شهرستان",1940,509,16,0,281,806,22,828
"تهران","تهران","مرکز_شهرستان",1941,459,14,4,294,771,21,792
"تهران","تهران","مرکز_شهرستان",1942,808,17,7,418,1250,26,1276
"تهران","تهران","مرکز_شهرستان",1943,871,27,1,328,1227,19,1246
"تهران","تهران","مرکز_شهرستان",1944,620,27,2,254,903,27,930
"تهران","تهران","مرکز_شهرستان",1945,699,24,2,181,906,11,917
"تهران","تهران","مرکز_شهرستان",1946,1301,40,10,493,1844,37,1881
"تهران","تهران","مرکز_شهرستان",1947,1440,15,2,323,1780,30,1810
"تهران","تهران","مرکز_شهرستان",1948,786,25,2,517,1330,12,1342
"تهران","تهران","مرکز_شهرستان",1949,990,35,10,738,1773,32,1805
"تهران","تهران","مرکز_شهرستان",1950,1106,26,1,517,1650,15,1665
"تهران","تهران","مرکز_شهرستان",1951,1107,24,2,518,1651,28,1679
"تهران","تهران","مرکز_شهرستان",1952,1044,31,10,473,1558,35,1593
"تهران","تهران","مرکز_شهرستان",1953,1052,31,5,295,1383,32,1415
"تهران","تهران","مرکز_شهرستان",1954,737,15,3,605,1360,25,1385
"تهران","تهران","مرکز_شهرستان",1955,1039,30,9,717,1795,35,1830
"تهران","تهران","مرکز_شهرستان",1956,883,38,6,600,1527,25,1552
"تهران","تهران","مرکز_شهرستان",1957,953,19,6,562,1540,31,1571
"تهران","تهران","مرکز_شهرستان",1958,1039,22,19,658,1738,22,1760
"تهران","تهران","مرکز_شهرستان",1959,648,27,12,545,1232,29,1261
"تهران","تهران","مرکز_شهرستان",1960,681,14,3,325,1023,8,1031
"تهران","تهران","مرکز_شهرستان",1961,1158,31,7,497,1693,32,1725
"تهران","تهران","مرکز_شهرستان",1962,625,11,4,161,801,11,812
"تهران","تهران","مرکز_شهرستان",1963,887,29,10,560,1486,22,1508
"تهران","تهران","مرکز_شهرستان",1964,631,26,3,230,890,14,904
"تهران","تهران","مرکز_شهرستان",1965,604,18,1,115,738,11,749
"تهران","تهران","مرکز_شهرستان",1966,1059,29,5,462,1555,29,1584
"تهران","تهران","مرکز_شهرستان",1967,913,30,3,391,1337,27,1364
"تهران","تهران","مرکز_شهرستان",1968,959,26,7,379,1371,28,1399
"تهران","تهران","مرکز_شهرستان",1969,966,24,7,535,1532,24,1556
"تهران","تهران","مرکز_شهرستان",1970,786,28,5,592,1411,26,1437
"تهران","تهران","مرکز_شهرستان",1971,642,18,1,304,965,21,986
"تهران","تهران","مرکز_شهرستان",1972,1140,28,12,616,1796,43,1839
"تهران","تهران","مرکز_شهرستان",1973,1144,21,1,386,1552,21,1573
"تهران","تهران","مرکز_شهرستان",1974,566,16,8,350,940,16,956
"تهران","تهران","مرکز_شهرستان",1975,714,10,5,312,1041,24,1065
"تهران","تهران","مرکز_شهرستان",1976,854,28,5,348,1235,25,1260
"تهران","تهران","مرکز_شهرستان",1977,1394,27,5,402,1828,32,1860
"تهران","تهران","مرکز_شهرستان",1978,1023,24,10,423,1480,25,1505
"تهران","تهران","مرکز_شهرستان",1979,1132,32,9,312,1485,20,1505
"تهران","تهران","مرکز_شهرستان",1980,909,22,9,306,1246,30,1276
"تهران","تهران","مرکز_شهرستان",1981,891,13,0,192,1096,15,1111
"تهران","تهران","مرکز_شهرستان",1982,811,33,5,541,1390,19,1409
"تهران","تهران","مرکز_شهرستان",1983,653,33,5,284,975,12,987
"تهران","تهران","مرکز_شهرستان",1984,445,14,6,332,797,12,809
"تهران","تهران","مرکز_شهرستان",1985,391,19,4,583,997,7,1004
"تهران","تهران","مرکز_شهرستان",1986,594,41,9,667,1311,33,1344
"تهران","تهران","مرکز_شهرستان",1987,716,35,7,580,1338,29,1367
"تهران","تهران","مرکز_شهرستان",1988,687,43,10,652,1392,13,1405
"تهران","تهران","مرکز_شهرستان",1989,746,44,11,1029,1830,31,1861
"تهران","تهران","مرکز_شهرستان",1990,1171,33,1,386,1591,31,1622
"تهران","تهران","مرکز_شهرستان",1991,1032,41,7,589,1669,31,1700
"تهران","تهران","مرکز_شهرستان",1992,825,32,3,326,1186,26,1212
"تهران","تهران","مرکز_شهرستان",1993,644,15,1,431,1091,14,1105
"تهران","تهران","مرکز_شهرستان",1994,588,17,3,584,1192,19,1211
"تهران","تهران","مرکز_شهرستان",1995,905,13,0,591,1509,24,1533
"تهران","تهران","مرکز_شهرستان",1996,1092,44,4,314,1454,17,1471
"تهران","تهران","مرکز_شهرستان",1997,1203,67,12,434,1716,40,1756
"تهران","تهران","مرکز_شهرستان",1998,444,22,5,370,841,21,862
"تهران","تهران","مرکز_شهرستان",1999,647,13,1,628,1289,12,1301
"تهران","تهران","مرکز_شهرستان",2000,965,43,1,281,1290,19,1309
"تهران","تهران","مرکز_شهرستان",2001,1061,58,8,392,1519,22,1541
"تهران","تهران","مرکز_شهرستان",2002,322,13,3,279,617,14,631
"تهران","تهران","مرکز_شهرستان",2003,737,20,8,298,1063,26,1089
"تهران","تهران","مرکز_شهرستان",2004,593,11,2,160,766,19,785
"تهران","تهران","مرکز_شهرستان",2005,512,10,1,262,785,23,808
"تهران","تهران","مرکز_شهرستان",2006,518,10,1,165,694,5,699
"تهران","تهران","مرکز_شهرستان",2007,399,14,2,363,778,18,796
"تهران","تهران","مرکز_شهرستان",2008,540,10,2,268,820,25,845
"تهران","تهران","مرکز_شهرستان",2009,794,30,12,393,1229,22,1251
"تهران","تهران","مرکز_شهرستان",2010,1030,27,11,326,1394,26,1420
"تهران","تهران","مرکز_شهرستان",2011,1229,19,5,372,1625,25,1650
"تهران","تهران","مرکز_شهرستان",2012,334,13,2,165,514,12,526
"تهران","تهران","مرکز_شهرستان",2013,943,26,4,466,1439,19,1458
"تهران","تهران","مرکز_شهرستان",2014,990,29,6,561,1586,19,1605
"تهران","تهران","مرکز_شهرستان",2015,951,27,6,303,1287,27,1314
"تهران","تهران","مرکز_شهرستان",2016,520,12,3,200,735,10,745
"تهران","تهران","مرکز_شهرستان",2017,513,5,0,115,633,12,645
"تهران","تهران","مرکز_شهرستان",2018,1060,22,2,354,1438,22,1460
"تهران","تهران","مرکز_شهرستان",2019,792,12,0,125,929,10,939
"تهران","تهران","مرکز_شهرستان",2020,337,8,3,116,464,9,473
"تهران","تهران","مرکز_شهرستان",2021,682,11,3,315,1011,26,1037
"تهران","تهران","مرکز_شهرستان",2022,572,9,1,166,748,21,769
"تهران","تهران","مرکز_شهرستان",2023,785,16,1,228,1030,16,1046
"تهران","تهران","مرکز_شهرستان",2024,779,20,2,256,1057,18,1075
"تهران","تهران","مرکز_شهرستان",2025,615,5,0,170,790,19,809
"تهران","تهران","مرکز_شهرستان",2026,647,20,7,592,1266,17,1283
"تهران","تهران","مرکز_شهرستان",2027,906,23,2,473,1404,23,1427
"تهران","تهران","مرکز_شهرستان",2028,453,21,1,351,826,17,843
"تهران","تهران","مرکز_شهرستان",2029,472,9,1,173,655,15,670
"تهران","تهران","مرکز_شهرستان",2030,746,22,5,355,1128,13,1141
"تهران","تهران","مرکز_شهرستان",2031,683,18,1,238,940,29,969
"تهران","تهران","مرکز_شهرستان",2032,1001,15,3,261,1280,25,1305
"تهران","تهران","مرکز_شهرستان",2033,1143,19,7,295,1464,21,1485
"تهران","تهران","مرکز_شهرستان",2034,739,17,1,269,1026,25,1051
"تهران","تهران","مرکز_شهرستان",2035,813,10,1,185,1009,20,1029
"تهران","تهران","مرکز_شهرستان",2036,777,10,2,131,920,15,935
"تهران","تهران","مرکز_شهرستان",2037,979,31,4,287,1301,29,1330
"تهران","تهران","مرکز_شهرستان",2038,703,15,6,419,1143,16,1159
"تهران","تهران","مرکز_شهرستان",2039,921,25,6,503,1455,44,1499
"تهران","تهران","مرکز_شهرستان",2040,728,14,0,223,965,14,979
"تهران","تهران","مرکز_شهرستان",2041,522,15,0,236,773,16,789
"تهران","تهران","مرکز_شهرستان",2042,579,17,0,155,751,12,763
"تهران","تهران","مرکز_شهرستان",2043,763,15,4,288,1070,22,1092
"تهران","تهران","مرکز_شهرستان",2044,547,10,0,189,746,5,751
"تهران","تهران","مرکز_شهرستان",2045,862,29,6,360,1257,19,1276
"تهران","تهران","مرکز_شهرستان",2046,679,18,2,203,902,13,915
"تهران","تهران","مرکز_شهرستان",2047,538,17,4,330,889,20,909
"تهران","تهران","مرکز_شهرستان",2048,389,25,4,347,765,13,778
"تهران","تهران","مرکز_شهرستان",2049,1072,20,2,348,1442,40,1482
"تهران","تهران","مرکز_شهرستان",2050,297,5,1,215,518,7,525
"تهران","تهران","مرکز_شهرستان",2051,598,23,4,314,939,18,957
"تهران","تهران","مرکز_شهرستان",2052,523,13,0,251,787,11,798
"تهران","تهران","مرکز_شهرستان",2053,288,23,5,299,615,12,627
"تهران","تهران","مرکز_شهرستان",2054,353,19,2,204,578,16,594
"تهران","تهران","مرکز_شهرستان",2055,919,16,9,534,1478,30,1508
"تهران","تهران","مرکز_شهرستان",2056,1027,21,5,333,1386,41,1427
"تهران","تهران","مرکز_شهرستان",2057,1262,34,11,557,1864,39,1903
"تهران","تهران","مرکز_شهرستان",2058,1126,8,3,230,1367,28,1395
"تهران","تهران","مرکز_شهرستان",2059,920,22,0,180,1122,18,1140
"تهران","تهران","مرکز_شهرستان",2060,553,14,2,183,752,12,764
"تهران","تهران","مرکز_شهرستان",2061,706,19,2,366,1093,21,1114
"تهران","تهران","مرکز_شهرستان",2062,882,16,0,158,1056,10,1066
"تهران","تهران","مرکز_شهرستان",2063,852,16,1,247,1116,32,1148
"تهران","تهران","مرکز_شهرستان",2064,1461,28,9,422,1920,25,1945
"تهران","تهران","مرکز_شهرستان",2065,634,16,1,281,932,10,942
"تهران","تهران","مرکز_شهرستان",2066,672,17,0,179,868,25,893
"تهران","تهران","مرکز_شهرستان",2067,835,29,7,627,1498,21,1519
"تهران","تهران","مرکز_شهرستان",2068,951,13,7,388,1359,23,1382
"تهران","تهران","مرکز_شهرستان",2069,372,22,2,343,739,22,761
"تهران","تهران","مرکز_شهرستان",2070,623,12,3,303,941,18,959
"تهران","تهران","مرکز_شهرستان",2071,361,12,3,201,577,14,591
"تهران","تهران","مرکز_شهرستان",2072,1291,19,4,354,1668,29,1697
"تهران","تهران","مرکز_شهرستان",2073,954,30,3,303,1290,29,1319
"تهران","تهران","مرکز_شهرستان",2074,529,20,5,272,826,15,841
"تهران","تهران","مرکز_شهرستان",2075,508,13,0,167,688,15,703
"تهران","تهران","مرکز_شهرستان",2076,405,9,2,264,680,14,694
"تهران","تهران","مرکز_شهرستان",2077,416,9,2,181,608,17,625
"تهران","تهران","مرکز_شهرستان",2078,259,10,4,178,451,12,463
"تهران","تهران","مرکز_شهرستان",2079,443,10,3,255,711,4,715
"تهران","تهران","مرکز_شهرستان",2080,1251,39,14,448,1752,51,1803
"تهران","تهران","مرکز_شهرستان",2081,929,19,10,389,1347,31,1378
"تهران","تهران","مرکز_شهرستان",2082,855,13,2,218,1088,30,1118
"تهران","تهران","مرکز_شهرستان",2083,652,20,6,271,949,18,967
"تهران","تهران","مرکز_شهرستان",2084,670,21,6,267,964,23,987
"تهران","تهران","مرکز_شهرستان",2085,754,9,1,158,922,16,938
"تهران","تهران","مرکز_شهرستان",2086,908,9,7,310,1234,18,1252
"تهران","تهران","مرکز_شهرستان",2087,493,13,3,346,855,16,871
"تهران","تهران","مرکز_شهرستان",2088,614,26,1,203,844,10,854
"تهران","تهران","مرکز_شهرستان",2089,767,15,2,375,1159,29,1188
"تهران","تهران","مرکز_شهرستان",2090,833,25,1,286,1145,23,1168
"تهران","تهران","مرکز_شهرستان",2091,799,30,3,359,1191,21,1212
"تهران","تهران","مرکز_شهرستان",2092,228,8,1,133,370,7,377
"تهران","تهران","مرکز_شهرستان",2093,271,2,0,107,380,7,387
"تهران","تهران","مرکز_شهرستان",2094,347,17,2,287,653,10,663
"تهران","تهران","مرکز_شهرستان",2095,324,10,0,168,502,12,514
"تهران","تهران","مرکز_شهرستان",2096,659,14,1,243,917,9,926
"تهران","تهران","مرکز_شهرستان",2097,453,11,0,249,713,9,722
"تهران","تهران","مرکز_شهرستان",2098,228,8,1,187,424,6,430
"تهران","تهران","مرکز_شهرستان",2099,281,4,0,82,367,4,371
"تهران","تهران","مرکز_شهرستان",2100,570,16,2,291,879,11,890
"تهران","تهران","مرکز_شهرستان",2101,1645,32,7,794,2478,61,2539
"تهران","تهران","مرکز_شهرستان",2102,633,15,2,830,1480,45,1525
"تهران","تهران","مرکز_شهرستان",2103,738,6,1,422,1167,12,1179
"تهران","تهران","مرکز_شهرستان",2104,572,12,1,300,885,16,901
"تهران","تهران","مرکز_شهرستان",2105,948,17,2,756,1723,0,1723
"تهران","تهران","مرکز_شهرستان",2106,1086,19,1,724,1830,30,1860
"تهران","تهران","مرکز_شهرستان",2107,747,20,5,762,1534,40,1574
"تهران","تهران","مرکز_شهرستان",2108,767,15,3,884,1669,21,1690
"تهران","تهران","مرکز_شهرستان",2109,733,13,1,446,1193,23,1216
"تهران","تهران","مرکز_شهرستان",2110,1544,26,17,1099,2686,30,2716
"تهران","تهران","مرکز_شهرستان",2111,676,19,3,941,1639,30,1669
"تهران","تهران","مرکز_شهرستان",2112,976,23,3,730,1732,56,1788
"تهران","تهران","مرکز_شهرستان",2113,990,11,4,343,1348,19,1367
"تهران","تهران","مرکز_شهرستان",2114,1072,16,3,742,1833,67,1900
"تهران","تهران","مرکز_شهرستان",2115,2413,76,17,1224,3730,55,3785
"تهران","تهران","مرکز_شهرستان",2116,1347,5,6,471,1829,31,1860
"تهران","تهران","مرکز_شهرستان",2117,1081,42,22,485,1630,31,1661
"تهران","تهران","مرکز_شهرستان",2118,1177,306,6,17,1506,27,1533
"تهران","تهران","مرکز_شهرستان",2119,1213,27,9,553,1802,30,1832
"تهران","تهران","مرکز_شهرستان",2120,1248,21,5,297,1571,32,1603
"تهران","تهران","مرکز_شهرستان",2121,1304,33,6,517,1860,35,1895
"تهران","تهران","مرکز_شهرستان",2122,1365,19,1,276,1661,24,1685
"تهران","تهران","مرکز_شهرستان",2123,1329,36,11,649,2025,45,2070
"تهران","تهران","مرکز_شهرستان",2124,994,35,14,879,1922,40,1962
"تهران","تهران","مرکز_شهرستان",2125,953,22,3,446,1424,25,1449
"تهران","تهران","مرکز_شهرستان",2126,766,32,5,533,1336,31,1367
"تهران","تهران","مرکز_شهرستان",2127,762,37,7,722,1528,29,1557
"تهران","تهران","مرکز_شهرستان",2128,814,26,7,525,1372,26,1398
"تهران","تهران","مرکز_شهرستان",2129,771,16,19,499,1305,25,1330
"تهران","تهران","مرکز_شهرستان",2130,1805,38,16,707,2566,42,2608
"تهران","تهران","مرکز_شهرستان",2131,1101,37,9,520,1667,33,1700
"تهران","تهران","مرکز_شهرستان",2132,1004,15,3,369,1391,21,1412
"تهران","تهران","مرکز_شهرستان",2133,1027,15,3,289,1334,16,1350
"تهران","تهران","مرکز_شهرستان",2134,1805,34,7,689,2535,46,2581
"تهران","تهران","مرکز_شهرستان",2135,1643,16,5,403,2067,30,2097
"تهران","تهران","مرکز_شهرستان",2136,1347,15,3,509,1874,28,1902
"تهران","تهران","مرکز_شهرستان",2137,739,21,6,429,1195,18,1213
"تهران","تهران","مرکز_شهرستان",2138,851,5,2,375,1233,14,1247
"تهران","تهران","مرکز_شهرستان",2139,655,9,3,236,903,21,924
"تهران","تهران","مرکز_شهرستان",2140,2297,32,3,467,2799,26,2825
"تهران","تهران","مرکز_شهرستان",2141,753,21,5,398,1177,15,1192
"تهران","تهران","مرکز_شهرستان",2142,675,14,4,232,925,9,934
"تهران","تهران","مرکز_شهرستان",2143,483,19,10,366,878,4,882
"تهران","تهران","مرکز_شهرستان",2144,550,14,5,317,886,13,899
"تهران","تهران","مرکز_شهرستان",2145,681,40,15,626,1362,31,1393
"تهران","تهران","مرکز_شهرستان",2146,681,32,9,413,1135,21,1156
"تهران","تهران","مرکز_شهرستان",2147,458,21,13,434,926,20,946
"تهران","تهران","مرکز_شهرستان",2148,524,21,3,374,922,18,940
"تهران","تهران","مرکز_شهرستان",2149,553,33,7,570,1163,14,1177
"تهران","تهران","مرکز_شهرستان",2150,621,31,2,407,1061,0,1061
"تهران","تهران","مرکز_شهرستان",2151,471,34,11,567,1083,17,1100
"تهران","تهران","مرکز_شهرستان",2152,510,23,5,398,936,14,950
"تهران","تهران","مرکز_شهرستان",2153,516,23,9,527,1075,19,1094
"تهران","تهران","مرکز_شهرستان",2154,705,39,6,493,1243,15,1258
"تهران","تهران","مرکز_شهرستان",2155,324,22,0,206,552,7,559
"تهران","تهران","مرکز_شهرستان",2156,704,25,6,298,1033,11,1044
"تهران","تهران","مرکز_شهرستان",2157,385,12,1,270,668,11,679
"تهران","تهران","مرکز_شهرستان",2158,896,21,5,288,1210,13,1223
"تهران","تهران","مرکز_شهرستان",2159,1078,29,4,286,1397,19,1416
"تهران","تهران","مرکز_شهرستان",2160,558,13,0,286,857,19,876
"تهران","تهران","مرکز_شهرستان",2161,897,28,7,445,1377,23,1400
"تهران","تهران","مرکز_شهرستان",2162,305,9,0,188,502,11,513
"تهران","تهران","مرکز_شهرستان",2163,832,36,11,667,1546,39,1585
"تهران","تهران","مرکز_شهرستان",2164,571,8,0,147,726,17,743
"تهران","تهران","مرکز_شهرستان",2165,903,34,8,438,1383,50,1433
"تهران","تهران","مرکز_شهرستان",2166,570,23,2,447,1042,24,1066
"تهران","تهران","مرکز_شهرستان",2167,524,25,9,477,1035,16,1051
"تهران","تهران","مرکز_شهرستان",2168,792,15,4,657,1468,27,1495
"تهران","تهران","مرکز_شهرستان",2169,195,3,1,191,390,10,400
"تهران","تهران","مرکز_شهرستان",2170,491,8,3,287,789,20,809
"تهران","تهران","مرکز_شهرستان",2171,527,25,1,163,716,9,725
"تهران","تهران","مرکز_شهرستان",2172,899,8,2,281,1190,21,1211
"تهران","تهران","مرکز_شهرستان",2173,492,12,5,293,802,11,813
"تهران","تهران","مرکز_شهرستان",2174,599,18,1,357,975,16,991
"تهران","تهران","مرکز_شهرستان",2175,431,10,5,436,882,26,908
"تهران","تهران","مرکز_شهرستان",2176,545,9,6,478,1038,28,1066
"تهران","تهران","مرکز_شهرستان",2177,497,18,3,479,997,17,1014
"تهران","تهران","مرکز_شهرستان",2178,492,13,5,475,985,16,1001
"تهران","تهران","مرکز_شهرستان",2179,206,10,2,276,494,15,509
"تهران","تهران","مرکز_شهرستان",2180,200,10,7,234,451,11,462
"تهران","تهران","مرکز_شهرستان",2181,851,24,13,587,1475,26,1501
"تهران","تهران","مرکز_شهرستان",2182,638,12,5,378,1033,28,1061
"تهران","تهران","مرکز_شهرستان",2183,594,16,4,474,1088,17,1105
"تهران","تهران","مرکز_شهرستان",2184,357,17,1,457,832,8,840
"تهران","تهران","مرکز_شهرستان",2185,367,14,0,426,807,10,817
"تهران","تهران","مرکز_شهرستان",2186,692,23,3,616,1334,25,1359
"تهران","تهران","مرکز_شهرستان",2187,743,26,4,618,1391,32,1423
"تهران","تهران","مرکز_شهرستان",2188,262,11,3,325,601,14,615
"تهران","تهران","مرکز_شهرستان",2189,523,13,3,503,1042,23,1065
"تهران","تهران","مرکز_شهرستان",2190,568,11,1,439,1019,26,1045
"تهران","تهران","مرکز_شهرستان",2191,618,14,3,283,918,20,938
"تهران","تهران","مرکز_شهرستان",2192,498,19,1,377,895,13,908
"تهران","تهران","مرکز_شهرستان",2193,461,17,2,471,951,18,969
"تهران","تهران","مرکز_شهرستان",2194,873,17,6,442,1338,35,1373
"تهران","تهران","مرکز_شهرستان",2195,521,16,0,574,1111,21,1132
"تهران","تهران","مرکز_شهرستان",2196,511,18,1,457,987,10,997
"تهران","تهران","مرکز_شهرستان",2197,362,13,2,562,939,12,951
"تهران","تهران","مرکز_شهرستان",2198,625,18,5,473,1121,25,1146
"تهران","تهران","مرکز_شهرستان",2199,690,12,5,368,1075,13,1088
"تهران","تهران","مرکز_شهرستان",2200,818,8,6,590,1422,31,1453
"تهران","تهران","مرکز_شهرستان",2201,678,35,12,747,1472,25,1497
"تهران","تهران","مرکز_شهرستان",2202,639,39,12,946,1636,26,1662
"تهران","تهران","مرکز_شهرستان",2203,413,33,4,579,1029,11,1040
"تهران","تهران","مرکز_شهرستان",2204,312,25,4,625,966,15,981
"تهران","تهران","مرکز_شهرستان",2205,682,46,9,861,1598,54,1652
"تهران","تهران","مرکز_شهرستان",2206,542,18,4,736,1300,19,1319
"تهران","تهران","مرکز_شهرستان",2207,596,24,5,633,1258,16,1274
"تهران","تهران","مرکز_شهرستان",2208,493,24,7,591,1115,25,1140
"تهران","تهران","مرکز_شهرستان",2209,654,26,5,757,1442,23,1465
"تهران","تهران","مرکز_شهرستان",2210,835,41,11,978,1865,32,1897
"تهران","تهران","مرکز_شهرستان",2211,836,27,10,435,1308,21,1329
"تهران","تهران","مرکز_شهرستان",2212,986,41,2,347,1376,23,1399
"تهران","تهران","مرکز_شهرستان",2213,965,16,8,602,1591,29,1620
"تهران","تهران","مرکز_شهرستان",2214,1133,17,3,505,1658,30,1688
"تهران","تهران","مرکز_شهرستان",2215,837,42,12,957,1848,11,1859
"تهران","تهران","مرکز_شهرستان",2216,692,32,3,530,1257,24,1281
"تهران","تهران","مرکز_شهرستان",2217,712,28,1,381,1122,16,1138
"تهران","تهران","مرکز_شهرستان",2218,241,11,1,193,446,8,454
"تهران","تهران","مرکز_شهرستان",2219,586,36,8,664,1294,21,1315
"تهران","تهران","مرکز_شهرستان",2220,584,32,6,625,1247,22,1269
"تهران","تهران","مرکز_شهرستان",2221,707,14,4,589,1314,53,1367
"تهران","تهران","مرکز_شهرستان",2222,415,20,3,318,756,16,772
"تهران","تهران","مرکز_شهرستان",2223,276,19,2,540,837,16,853
"تهران","تهران","مرکز_شهرستان",2224,501,19,3,571,1094,19,1113
"تهران","تهران","مرکز_شهرستان",2225,1151,39,7,583,1780,20,1800
"تهران","تهران","مرکز_شهرستان",2226,1187,39,3,442,1671,16,1687
"تهران","تهران","مرکز_شهرستان",2227,621,30,8,717,1376,21,1397
"تهران","تهران","مرکز_شهرستان",2228,590,45,7,892,1534,25,1559
"تهران","تهران","مرکز_شهرستان",2229,936,40,6,680,1662,30,1692
"تهران","تهران","مرکز_شهرستان",2230,342,15,6,383,746,8,754
"تهران","تهران","مرکز_شهرستان",2231,520,22,8,376,926,12,938
"تهران","تهران","مرکز_شهرستان",2232,595,33,3,566,1197,23,1220
"تهران","تهران","مرکز_شهرستان",2233,487,24,3,363,877,40,917
"تهران","تهران","مرکز_شهرستان",2234,483,16,0,315,814,0,814
"تهران","تهران","مرکز_شهرستان",2235,579,7,3,359,948,16,964
"تهران","تهران","مرکز_شهرستان",2236,464,18,8,517,1007,18,1025
"تهران","تهران","مرکز_شهرستان",2237,619,23,2,527,1171,35,1206
"تهران","تهران","مرکز_شهرستان",2238,415,10,3,247,675,20,695
"تهران","تهران","مرکز_شهرستان",2239,495,10,0,176,681,6,687
"تهران","تهران","مرکز_شهرستان",2240,594,5,1,199,799,11,810
"تهران","تهران","مرکز_شهرستان",2241,541,14,2,393,950,19,969
"تهران","تهران","مرکز_شهرستان",2242,600,14,5,303,922,19,941
"تهران","تهران","مرکز_شهرستان",2243,552,16,2,377,947,31,978
"تهران","تهران","مرکز_شهرستان",2244,851,27,8,497,1383,42,1425
"تهران","تهران","مرکز_شهرستان",2245,426,18,8,446,898,22,920
"تهران","تهران","مرکز_شهرستان",2246,419,16,0,450,885,14,899
"تهران","تهران","مرکز_شهرستان",2247,571,10,0,425,1006,23,1029
"تهران","تهران","مرکز_شهرستان",2248,834,17,1,283,1135,17,1152
"تهران","تهران","مرکز_شهرستان",2249,1124,7,0,481,1612,0,1612
"تهران","تهران","مرکز_شهرستان",2250,1107,26,7,315,1455,29,1484
"تهران","تهران","مرکز_شهرستان",2251,404,10,3,470,887,21,908
"تهران","تهران","مرکز_شهرستان",2252,553,22,0,604,1179,27,1206
"تهران","تهران","مرکز_شهرستان",2253,277,6,6,273,562,11,573
"تهران","تهران","مرکز_شهرستان",2254,638,37,24,823,1522,25,1547
"تهران","تهران","مرکز_شهرستان",2255,576,24,0,369,969,19,988
"تهران","تهران","مرکز_شهرستان",2256,768,18,5,367,1158,2,1160
"تهران","تهران","مرکز_شهرستان",2257,1085,25,4,652,1766,4,1770
"تهران","تهران","مرکز_شهرستان",2258,1221,35,6,520,1782,48,1830
"تهران","تهران","مرکز_شهرستان",2259,474,13,3,492,982,18,1000
"تهران","تهران","مرکز_شهرستان",2260,580,25,10,480,1095,19,1114
"تهران","تهران","مرکز_شهرستان",2261,1061,33,7,843,1944,35,1979
"تهران","تهران","مرکز_شهرستان",2262,878,25,12,575,1490,25,1515
"تهران","تهران","مرکز_شهرستان",2263,1533,34,8,595,2170,57,2227
"تهران","تهران","مرکز_شهرستان",2264,822,29,5,553,1409,29,1438
"تهران","تهران","مرکز_شهرستان",2265,860,17,3,398,1278,24,1302
"تهران","تهران","مرکز_شهرستان",2266,889,22,13,763,1687,25,1712
"تهران","تهران","مرکز_شهرستان",2267,759,27,8,556,1350,26,1376
"تهران","تهران","مرکز_شهرستان",2268,795,16,5,344,1160,35,1195
"تهران","تهران","مرکز_شهرستان",2269,607,33,4,483,1127,11,1138
"تهران","تهران","مرکز_شهرستان",2270,598,27,1,582,1208,22,1230
"تهران","تهران","مرکز_شهرستان",2271,744,23,4,578,1349,21,1370
"تهران","تهران","مرکز_شهرستان",2272,619,24,9,402,1054,24,1078
"تهران","تهران","مرکز_شهرستان",2273,575,11,1,422,1009,17,1026
"تهران","تهران","مرکز_شهرستان",2274,817,19,3,269,1108,9,1117
"تهران","تهران","مرکز_شهرستان",2275,1117,23,4,576,1720,30,1750
"تهران","تهران","مرکز_شهرستان",2276,1194,13,9,557,1773,25,1798
"تهران","تهران","مرکز_شهرستان",2277,1158,31,7,802,1998,35,2033
"تهران","تهران","مرکز_شهرستان",2278,598,16,0,335,949,13,962
"تهران","تهران","مرکز_شهرستان",2279,1112,22,6,428,1568,23,1591
"تهران","تهران","مرکز_شهرستان",2280,737,21,4,368,1130,9,1139
"تهران","تهران","مرکز_شهرستان",2281,246,3,4,166,419,6,425
"تهران","تهران","مرکز_شهرستان",2282,773,32,1,630,1436,30,1466
"تهران","تهران","مرکز_شهرستان",2283,970,26,4,729,1729,45,1774
"تهران","تهران","مرکز_شهرستان",2284,762,23,1,726,1512,38,1550
"تهران","تهران","مرکز_شهرستان",2285,809,17,3,435,1264,15,1279
"تهران","تهران","مرکز_شهرستان",2286,713,31,9,552,1305,36,1341
"تهران","تهران","مرکز_شهرستان",2287,1254,38,3,450,1745,20,1765
"تهران","تهران","مرکز_شهرستان",2288,1158,13,6,687,1864,26,1890
"تهران","تهران","مرکز_شهرستان",2289,867,13,3,425,1308,18,1326
"تهران","تهران","مرکز_شهرستان",2290,621,25,5,260,911,15,926
"تهران","تهران","مرکز_شهرستان",2291,423,13,3,296,735,10,745
"تهران","تهران","مرکز_شهرستان",2292,922,39,9,601,1571,45,1616
"تهران","تهران","مرکز_شهرستان",2293,1011,0,4,458,1473,9,1482
"تهران","تهران","مرکز_شهرستان",2294,268,4,3,277,552,19,571
"تهران","تهران","مرکز_شهرستان",2295,490,7,5,292,794,12,806
"تهران","تهران","مرکز_شهرستان",2296,567,12,1,242,822,13,835
"تهران","تهران","مرکز_شهرستان",2297,280,13,2,202,497,0,497
"تهران","تهران","مرکز_شهرستان",2298,152,4,0,119,275,3,278
"تهران","تهران","مرکز_شهرستان",2299,515,10,2,321,848,23,871
"تهران","تهران","مرکز_شهرستان",2300,769,20,2,431,1222,22,1244
"تهران","تهران","مرکز_شهرستان",2301,188,14,3,220,425,3,428
"تهران","تهران","مرکز_شهرستان",2302,670,11,0,169,850,11,861
"تهران","تهران","مرکز_شهرستان",2303,584,6,1,268,859,10,869
"تهران","تهران","مرکز_شهرستان",2304,158,12,0,133,303,9,312
"تهران","تهران","مرکز_شهرستان",2305,673,9,1,383,1066,11,1077
"تهران","تهران","مرکز_شهرستان",2306,335,9,10,290,644,11,655
"تهران","تهران","مرکز_شهرستان",2307,421,10,10,300,741,11,752
"تهران","تهران","مرکز_شهرستان",2308,422,12,4,376,814,32,846
"تهران","تهران","مرکز_شهرستان",2309,111,7,0,47,165,1,166
"تهران","تهران","مرکز_شهرستان",2310,153,7,2,78,240,8,248
"تهران","تهران","مرکز_شهرستان",2311,196,7,0,138,341,5,346
"تهران","تهران","مرکز_شهرستان",2312,132,2,0,86,220,10,230
"تهران","تهران","مرکز_شهرستان",2313,148,1,0,39,188,2,190
"تهران","تهران","مرکز_شهرستان",2314,244,7,0,139,390,10,400
"تهران","تهران","مرکز_شهرستان",2315,354,8,4,152,518,13,531
"تهران","تهران","مرکز_شهرستان",2316,97,3,1,62,163,3,166
"تهران","تهران","مرکز_شهرستان",2317,106,1,1,128,236,4,240
"تهران","تهران","مرکز_شهرستان",2318,90,3,1,97,191,9,200
"تهران","تهران","مرکز_شهرستان",2319,147,7,3,163,320,3,323
"تهران","تهران","مرکز_شهرستان",2320,99,3,0,71,173,1,174
"تهران","تهران","مرکز_شهرستان",2321,525,19,8,628,1180,27,1207
"تهران","تهران","مرکز_شهرستان",2322,703,0,0,341,1044,0,1044
"تهران","تهران","مرکز_شهرستان",2323,774,43,5,475,1297,52,1349
"تهران","تهران","مرکز_شهرستان",2324,850,24,7,593,1474,34,1508
"تهران","تهران","مرکز_شهرستان",2325,503,10,1,437,951,8,959
"تهران","تهران","مرکز_شهرستان",2326,1138,12,0,254,1404,20,1424
"تهران","تهران","مرکز_شهرستان",2327,1034,11,8,383,1436,25,1461
"تهران","تهران","مرکز_شهرستان",2328,571,17,2,416,1006,23,1029
"تهران","تهران","مرکز_شهرستان",2329,373,15,1,314,703,47,750
"تهران","تهران","مرکز_شهرستان",2330,225,14,4,244,487,5,492
"تهران","تهران","مرکز_شهرستان",2331,238,16,14,337,605,9,614
"تهران","تهران","مرکز_شهرستان",2332,834,28,4,429,1295,30,1325
"تهران","تهران","مرکز_شهرستان",2333,243,8,0,222,473,4,477
"تهران","تهران","مرکز_شهرستان",2334,265,3,0,221,489,11,500
"تهران","تهران","مرکز_شهرستان",2335,626,35,2,892,1555,52,1607
"تهران","تهران","مرکز_شهرستان",2336,831,27,3,578,1439,36,1475
"تهران","تهران","مرکز_شهرستان",2337,375,15,2,403,795,5,800
"تهران","تهران","مرکز_شهرستان",2338,821,13,8,466,1308,31,1339
"تهران","تهران","مرکز_شهرستان",2339,437,13,1,324,775,25,800
"تهران","تهران","مرکز_شهرستان",2340,233,11,3,202,449,6,455
"تهران","تهران","مرکز_شهرستان",2341,536,28,10,534,1108,15,1123
"تهران","تهران","مرکز_شهرستان",2342,635,17,5,601,1258,29,1287
"تهران","تهران","مرکز_شهرستان",2343,532,17,7,315,871,29,900
"تهران","تهران","مرکز_شهرستان",2344,416,18,5,414,853,31,884
"تهران","تهران","مرکز_شهرستان",2345,509,13,8,247,777,20,797
"تهران","تهران","مرکز_شهرستان",2346,560,22,8,725,1315,22,1337
"تهران","تهران","مرکز_شهرستان",2347,595,18,8,685,1306,32,1338
"تهران","تهران","مرکز_شهرستان",2348,709,20,4,496,1229,19,1248
"تهران","تهران","مرکز_شهرستان",2349,1140,47,5,644,1836,58,1894
"تهران","تهران","مرکز_شهرستان",2350,775,18,10,437,1240,16,1256
"تهران","تهران","مرکز_شهرستان",2351,634,6,5,322,967,33,1000
"تهران","تهران","مرکز_شهرستان",2352,799,28,2,469,1298,17,1315
"تهران","تهران","مرکز_شهرستان",2353,653,22,5,483,1163,26,1189
"تهران","تهران","مرکز_شهرستان",2354,359,14,5,349,727,11,738
"تهران","تهران","مرکز_شهرستان",2355,514,20,7,417,958,20,978
"تهران","تهران","مرکز_شهرستان",2356,1096,27,6,550,1679,31,1710
"تهران","تهران","مرکز_شهرستان",2357,380,15,3,316,714,14,728
"تهران","تهران","مرکز_شهرستان",2358,548,17,2,474,1041,14,1055
"تهران","تهران","مرکز_شهرستان",2359,509,9,1,294,813,18,831
"تهران","تهران","مرکز_شهرستان",2360,1155,30,4,538,1727,24,1751
"تهران","تهران","مرکز_شهرستان",2361,633,6,1,287,927,20,947
"تهران","تهران","مرکز_شهرستان",2362,523,11,0,460,994,16,1010
"تهران","تهران","مرکز_شهرستان",2363,1034,23,3,383,1443,57,1500
"تهران","تهران","مرکز_شهرستان",2364,886,29,5,380,1300,17,1317
"تهران","تهران","مرکز_شهرستان",2365,523,7,0,273,803,15,818
"تهران","تهران","مرکز_شهرستان",2366,505,12,4,356,877,23,900
"تهران","تهران","مرکز_شهرستان",2367,520,7,1,195,723,20,743
"تهران","تهران","مرکز_شهرستان",2368,742,25,0,538,1305,46,1351
"تهران","تهران","مرکز_شهرستان",2369,589,17,2,291,899,0,899
"تهران","تهران","مرکز_شهرستان",2370,395,7,4,479,885,18,903
"تهران","تهران","مرکز_شهرستان",2371,584,10,4,465,1063,0,1063
"تهران","تهران","مرکز_شهرستان",2372,631,10,6,461,1108,27,1135
"تهران","تهران","مرکز_شهرستان",2373,632,6,4,364,1006,19,1025
"تهران","تهران","مرکز_شهرستان",2374,446,10,5,196,657,14,671
"تهران","تهران","مرکز_شهرستان",2375,1109,21,5,351,1486,27,1513
"تهران","تهران","مرکز_شهرستان",2376,1167,20,2,435,1624,42,1666
"تهران","تهران","مرکز_شهرستان",2377,853,8,4,310,1175,25,1200
"تهران","تهران","مرکز_شهرستان",2378,506,10,2,197,715,27,742
"تهران","تهران","مرکز_شهرستان",2379,556,15,3,305,879,7,886
"تهران","تهران","مرکز_شهرستان",2380,504,17,4,380,905,17,922
"تهران","تهران","مرکز_شهرستان",2381,335,10,0,243,588,11,599
"تهران","تهران","مرکز_شهرستان",2382,335,5,1,274,615,9,624
"تهران","تهران","مرکز_شهرستان",2383,489,17,0,239,745,9,754
"تهران","تهران","مرکز_شهرستان",2384,381,8,11,462,862,18,880
"تهران","تهران","مرکز_شهرستان",2385,527,17,4,365,913,12,925
"تهران","تهران","مرکز_شهرستان",2386,585,15,5,612,1217,7,1224
"تهران","تهران","مرکز_شهرستان",2387,659,15,1,443,1118,21,1139
"تهران","تهران","مرکز_شهرستان",2388,353,9,2,232,596,21,617
"تهران","تهران","مرکز_شهرستان",2389,364,8,4,175,551,18,569
"تهران","تهران","مرکز_شهرستان",2390,445,16,2,197,660,13,673
"تهران","تهران","مرکز_شهرستان",2391,920,23,3,310,1256,17,1273
"تهران","تهران","مرکز_شهرستان",2392,900,23,4,401,1328,17,1345
"تهران","تهران","مرکز_شهرستان",2393,825,11,2,386,1224,17,1241
"تهران","تهران","مرکز_شهرستان",2394,537,11,2,385,935,18,953
"تهران","تهران","مرکز_شهرستان",2395,382,5,1,284,672,12,684
"تهران","تهران","مرکز_شهرستان",2396,369,5,3,421,798,17,815
"تهران","تهران","مرکز_شهرستان",2397,863,19,1,396,1279,21,1300
"تهران","تهران","مرکز_شهرستان",2398,1009,9,5,309,1332,20,1352
"تهران","تهران","مرکز_شهرستان",2399,1350,19,5,327,1701,31,1732
"تهران","تهران","مرکز_شهرستان",2400,984,18,5,355,1362,24,1386
"تهران","تهران","مرکز_شهرستان",2401,381,20,4,373,778,13,791
"تهران","تهران","مرکز_شهرستان",2402,341,12,1,192,546,14,560
"تهران","تهران","مرکز_شهرستان",2403,530,4,2,311,847,10,857
"تهران","تهران","مرکز_شهرستان",2404,421,9,0,427,857,22,879
"تهران","تهران","مرکز_شهرستان",2405,415,20,4,463,902,16,918
"تهران","تهران","مرکز_شهرستان",2406,1261,28,5,586,1880,30,1910
"تهران","تهران","مرکز_شهرستان",2407,972,14,9,542,1537,29,1566
"تهران","تهران","مرکز_شهرستان",2408,495,14,6,348,863,15,878
"تهران","تهران","مرکز_شهرستان",2409,455,20,5,436,916,14,930
"تهران","تهران","مرکز_شهرستان",2410,679,23,5,454,1161,23,1184
"تهران","تهران","مرکز_شهرستان",2411,437,17,4,373,831,18,849
"تهران","تهران","مرکز_شهرستان",2412,435,17,6,263,721,16,737
"تهران","تهران","مرکز_شهرستان",2413,758,17,4,557,1336,18,1354
"تهران","تهران","مرکز_شهرستان",2414,995,23,1,521,1540,20,1560
"تهران","تهران","مرکز_شهرستان",2415,483,20,0,320,823,4,827
"تهران","تهران","مرکز_شهرستان",2416,562,21,2,590,1175,27,1202
"تهران","تهران","مرکز_شهرستان",2417,278,11,1,191,481,11,492
"تهران","تهران","مرکز_شهرستان",2418,436,7,1,262,706,94,800
"تهران","تهران","مرکز_شهرستان",2419,1313,28,5,515,1861,38,1899
"تهران","تهران","مرکز_شهرستان",2420,1598,37,3,585,2223,39,2262
"تهران","تهران","مرکز_شهرستان",2421,382,15,1,350,748,13,761
"تهران","تهران","مرکز_شهرستان",2422,639,17,5,499,1160,7,1167
"تهران","تهران","مرکز_شهرستان",2423,389,16,3,378,786,14,800
"تهران","تهران","مرکز_شهرستان",2424,1060,19,1,384,1464,26,1490
"تهران","تهران","مرکز_شهرستان",2425,976,17,7,464,1464,40,1504
"تهران","تهران","مرکز_شهرستان",2426,496,20,1,606,1123,11,1134
"تهران","تهران","مرکز_شهرستان",2427,322,6,2,400,730,15,745
"تهران","تهران","مرکز_شهرستان",2428,536,24,0,290,850,20,870
"تهران","تهران","مرکز_شهرستان",2429,1084,40,3,684,1811,37,1848
"تهران","تهران","مرکز_شهرستان",2430,522,9,1,279,811,19,830
"تهران","تهران","مرکز_شهرستان",2431,800,24,0,383,1207,20,1227
"تهران","تهران","مرکز_شهرستان",2432,919,33,7,686,1645,33,1678
"تهران","تهران","مرکز_شهرستان",2433,994,22,0,423,1439,52,1491
"تهران","تهران","مرکز_شهرستان",2434,1038,12,4,436,1490,22,1512
"تهران","تهران","مرکز_شهرستان",2435,777,8,1,224,1010,23,1033
"تهران","تهران","مرکز_شهرستان",2436,763,16,2,369,1150,47,1197
"تهران","تهران","مرکز_شهرستان",2437,551,14,1,325,891,14,905
"تهران","تهران","مرکز_شهرستان",2438,406,14,3,361,784,16,800
"تهران","تهران","مرکز_شهرستان",2439,419,17,0,486,922,31,953
"تهران","تهران","مرکز_شهرستان",2440,615,20,2,403,1040,27,1067
"تهران","تهران","مرکز_شهرستان",2441,747,9,4,543,1303,23,1326
"تهران","تهران","مرکز_شهرستان",2442,701,23,5,616,1345,22,1367
"تهران","تهران","مرکز_شهرستان",2443,690,6,3,233,932,11,943
"تهران","تهران","مرکز_شهرستان",2444,422,10,2,230,664,9,673
"تهران","تهران","مرکز_شهرستان",2445,359,11,0,187,557,14,571
"تهران","تهران","مرکز_شهرستان",2446,840,11,0,278,1129,22,1151
"تهران","تهران","مرکز_شهرستان",2447,1137,18,2,551,1708,54,1762
"تهران","تهران","مرکز_شهرستان",2448,214,8,0,137,359,10,369
"تهران","تهران","مرکز_شهرستان",2449,605,20,4,433,1062,17,1079
"تهران","تهران","مرکز_شهرستان",2450,549,16,1,375,941,26,967
"تهران","تهران","مرکز_شهرستان",2451,466,6,7,420,899,12,911
"تهران","تهران","مرکز_شهرستان",2452,521,8,6,240,775,12,787
"تهران","تهران","مرکز_شهرستان",2453,744,18,3,340,1105,17,1122
"تهران","تهران","مرکز_شهرستان",2454,922,15,1,388,1326,49,1375
"تهران","تهران","مرکز_شهرستان",2455,246,2,1,127,376,9,385
"تهران","تهران","مرکز_شهرستان",2456,125,4,0,80,209,6,215
"تهران","تهران","مرکز_شهرستان",2457,109,5,1,131,246,12,258
"تهران","تهران","مرکز_شهرستان",2458,255,10,3,168,436,14,450
"تهران","تهران","مرکز_شهرستان",2459,243,2,5,143,393,11,404
"تهران","تهران","مرکز_شهرستان",2460,242,16,2,122,382,4,386
"تهران","تهران","مرکز_شهرستان",2461,145,5,0,54,204,5,209
"تهران","تهران","مرکز_شهرستان",2462,244,4,0,114,362,6,368
"تهران","تهران","مرکز_شهرستان",2463,204,8,2,130,344,9,353
"تهران","تهران","مرکز_شهرستان",2464,201,6,0,120,327,8,335
"تهران","تهران","مرکز_شهرستان",2465,444,5,1,199,649,15,664
"تهران","تهران","مرکز_شهرستان",2466,153,8,1,118,280,5,285
"تهران","تهران","مرکز_شهرستان",2467,782,17,4,385,1188,20,1208
"تهران","تهران","مرکز_شهرستان",2468,1149,16,4,543,1712,38,1750
"تهران","تهران","مرکز_شهرستان",2469,695,16,12,462,1185,15,1200
"تهران","تهران","مرکز_شهرستان",2470,652,11,4,326,993,18,1011
"تهران","تهران","مرکز_شهرستان",2471,695,20,4,468,1187,14,1201
"تهران","تهران","مرکز_شهرستان",2472,708,27,5,473,1213,23,1236
"تهران","تهران","مرکز_شهرستان",2473,985,29,4,518,1536,0,1536
"تهران","تهران","مرکز_شهرستان",2474,931,30,2,377,1340,25,1365
"تهران","تهران","مرکز_شهرستان",2475,1141,36,5,700,1882,65,1947
"تهران","تهران","مرکز_شهرستان",2476,904,24,8,430,1366,23,1389
"تهران","تهران","مرکز_شهرستان",2477,735,21,2,466,1224,32,1256
"تهران","تهران","مرکز_شهرستان",2478,370,11,1,260,642,11,653
"تهران","تهران","مرکز_شهرستان",2479,649,29,4,688,1370,34,1404
"تهران","تهران","مرکز_شهرستان",2480,787,20,7,573,1387,23,1410
"تهران","تهران","مرکز_شهرستان",2481,646,20,2,491,1159,14,1173
"تهران","تهران","مرکز_شهرستان",2482,782,32,20,807,1641,28,1669
"تهران","تهران","مرکز_شهرستان",2483,1309,24,9,356,1698,24,1722
"تهران","تهران","مرکز_شهرستان",2484,688,20,2,411,1121,27,1148
"تهران","تهران","مرکز_شهرستان",2485,647,19,4,475,1145,23,1168
"تهران","تهران","مرکز_شهرستان",2486,702,35,8,541,1286,10,1296
"تهران","تهران","مرکز_شهرستان",2487,980,19,12,460,1471,26,1497
"تهران","تهران","مرکز_شهرستان",2488,684,14,5,330,1033,21,1054
"تهران","تهران","مرکز_شهرستان",2489,849,26,8,418,1301,31,1332
"تهران","تهران","مرکز_شهرستان",2490,798,20,2,264,1084,14,1098
"تهران","تهران","مرکز_شهرستان",2491,835,20,6,294,1155,28,1183
"تهران","تهران","مرکز_شهرستان",2492,1156,11,1,221,1389,28,1417
"تهران","تهران","مرکز_شهرستان",2493,858,19,2,282,1161,18,1179
"تهران","تهران","مرکز_شهرستان",2494,1259,31,1,518,1809,28,1837
"تهران","تهران","مرکز_شهرستان",2495,991,12,2,372,1377,23,1400
"تهران","تهران","مرکز_شهرستان",2496,1110,14,0,337,1461,20,1481
"تهران","تهران","مرکز_شهرستان",2497,806,26,4,565,1401,40,1441
"تهران","تهران","مرکز_شهرستان",2498,1048,33,11,657,1749,27,1776
"تهران","تهران","مرکز_شهرستان",2499,749,24,18,588,1379,24,1403
"تهران","تهران","مرکز_شهرستان",2500,611,17,2,333,963,8,971
"تهران","تهران","مرکز_شهرستان",2501,823,26,3,608,1460,29,1489
"تهران","تهران","مرکز_شهرستان",2502,850,26,4,599,1479,29,1508
"تهران","تهران","مرکز_شهرستان",2503,932,25,5,522,1484,29,1513
"تهران","تهران","مرکز_شهرستان",2504,538,13,3,498,1052,25,1077
"تهران","تهران","مرکز_شهرستان",2505,725,32,8,437,1202,25,1227
"تهران","تهران","مرکز_شهرستان",2506,912,10,5,226,1153,8,1161
"تهران","تهران","مرکز_شهرستان",2507,891,13,18,376,1298,25,1323
"تهران","تهران","مرکز_شهرستان",2508,872,14,3,336,1225,20,1245
"تهران","تهران","مرکز_شهرستان",2509,749,14,2,181,946,13,959
"تهران","تهران","مرکز_شهرستان",2510,890,13,3,359,1265,28,1293
"تهران","تهران","مرکز_شهرستان",2511,961,27,2,484,1474,26,1500
"تهران","تهران","مرکز_شهرستان",2512,1319,25,5,337,1686,30,1716
"تهران","تهران","مرکز_شهرستان",2513,576,19,2,514,1111,11,1122
"تهران","تهران","مرکز_شهرستان",2514,529,17,4,431,981,23,1004
"تهران","تهران","مرکز_شهرستان",2515,698,12,1,471,1182,18,1200
"تهران","تهران","مرکز_شهرستان",2516,1058,12,2,333,1405,27,1432
"تهران","تهران","مرکز_شهرستان",2517,540,7,6,445,998,8,1006
"تهران","تهران","مرکز_شهرستان",2518,844,26,4,391,1265,5,1270
"تهران","تهران","مرکز_شهرستان",2519,904,12,3,231,1150,26,1176
"تهران","تهران","مرکز_شهرستان",2520,594,24,5,396,1019,15,1034
"تهران","تهران","مرکز_شهرستان",2521,553,7,3,193,756,13,769
"تهران","تهران","مرکز_شهرستان",2522,796,8,0,291,1095,24,1119
"تهران","تهران","مرکز_شهرستان",2523,1401,26,4,440,1871,0,1871
"تهران","تهران","مرکز_شهرستان",2524,1197,27,5,473,1702,34,1736
"تهران","تهران","مرکز_شهرستان",2525,1117,21,3,370,1511,17,1528
"تهران","تهران","مرکز_شهرستان",2526,925,35,4,539,1503,27,1530
"تهران","تهران","مرکز_شهرستان",2527,948,35,6,610,1599,16,1615
"تهران","تهران","مرکز_شهرستان",2528,1334,32,18,576,1960,34,1994
"تهران","تهران","مرکز_شهرستان",2529,662,23,7,428,1120,25,1145
"تهران","تهران","مرکز_شهرستان",2530,453,8,3,251,715,8,723
"تهران","تهران","مرکز_شهرستان",2531,458,7,7,293,765,18,783
"تهران","تهران","مرکز_شهرستان",2532,803,24,3,663,1493,15,1508
"تهران","تهران","مرکز_شهرستان",2533,1413,26,9,490,1938,30,1968
"تهران","تهران","مرکز_شهرستان",2534,1151,10,8,445,1614,46,1660
"تهران","تهران","مرکز_شهرستان",2535,1355,46,7,580,1988,28,2016
"تهران","تهران","مرکز_شهرستان",2536,466,7,5,201,679,11,690
"تهران","تهران","مرکز_شهرستان",2537,987,44,9,730,1770,40,1810
"تهران","تهران","مرکز_شهرستان",2538,927,27,6,352,1312,32,1344
"تهران","تهران","مرکز_شهرستان",2539,642,21,5,543,1211,26,1237
"تهران","تهران","مرکز_شهرستان",2540,946,25,0,461,1432,32,1464
"تهران","تهران","مرکز_شهرستان",2541,649,16,5,344,1014,14,1028
"تهران","تهران","مرکز_شهرستان",2542,856,8,1,278,1143,18,1161
"تهران","تهران","مرکز_شهرستان",2543,868,28,5,539,1440,24,1464
"تهران","تهران","مرکز_شهرستان",2544,1381,51,4,879,2315,3,2318
"تهران","تهران","مرکز_شهرستان",2545,1259,22,1,585,1867,62,1929
"تهران","تهران","مرکز_شهرستان",2546,1481,27,11,486,2005,31,2036
"تهران","تهران","مرکز_شهرستان",2547,988,30,1,804,1823,23,1846
"تهران","تهران","مرکز_شهرستان",2548,631,26,5,706,1368,27,1395
"تهران","تهران","مرکز_شهرستان",2549,775,26,5,427,1233,24,1257
"تهران","تهران","مرکز_شهرستان",2550,1017,34,11,541,1603,15,1618
"تهران","تهران","مرکز_شهرستان",2551,760,17,26,513,1316,28,1344
"تهران","تهران","مرکز_شهرستان",2552,786,25,5,747,1563,25,1588
"تهران","تهران","مرکز_شهرستان",2553,757,18,3,560,1338,23,1361
"تهران","تهران","مرکز_شهرستان",2554,503,39,1,680,1223,27,1250
"تهران","تهران","مرکز_شهرستان",2555,673,21,4,487,1185,9,1194
"تهران","تهران","مرکز_شهرستان",2556,642,26,6,345,1019,54,1073
"تهران","تهران","مرکز_شهرستان",2557,649,17,7,560,1233,23,1256
"تهران","تهران","مرکز_شهرستان",2558,728,31,6,987,1752,37,1789
"تهران","تهران","مرکز_شهرستان",2559,1071,21,1,454,1547,16,1563
"تهران","تهران","مرکز_شهرستان",2560,1088,24,6,418,1536,33,1569
"تهران","تهران","مرکز_شهرستان",2561,879,19,3,223,1124,6,1130
"تهران","تهران","مرکز_شهرستان",2562,826,23,6,429,1284,35,1319
"تهران","تهران","مرکز_شهرستان",2563,989,28,2,380,1399,25,1424
"تهران","تهران","مرکز_شهرستان",2564,624,20,3,552,1199,17,1216
"تهران","تهران","مرکز_شهرستان",2565,793,13,8,337,1151,16,1167
"تهران","تهران","مرکز_شهرستان",2566,333,4,3,129,469,16,485
"تهران","تهران","مرکز_شهرستان",2567,1109,14,13,457,1593,22,1615
"تهران","تهران","مرکز_شهرستان",2568,994,19,6,547,1566,25,1591
"تهران","تهران","مرکز_شهرستان",2569,901,12,11,706,1630,32,1662
"تهران","تهران","مرکز_شهرستان",2570,1131,16,11,458,1616,33,1649
"تهران","تهران","مرکز_شهرستان",2571,1063,19,3,244,1329,15,1344
"تهران","تهران","مرکز_شهرستان",2572,1089,22,6,460,1577,14,1591
"تهران","تهران","مرکز_شهرستان",2573,867,15,2,240,1124,36,1160
"تهران","تهران","مرکز_شهرستان",2574,851,20,2,481,1354,26,1380
"تهران","تهران","مرکز_شهرستان",2575,1056,9,5,609,1679,32,1711
"تهران","تهران","مرکز_شهرستان",2576,1193,38,6,664,1901,31,1932
"تهران","تهران","مرکز_شهرستان",2577,738,10,2,496,1246,26,1272
"تهران","تهران","مرکز_شهرستان",2578,651,27,5,467,1150,27,1177
"تهران","تهران","مرکز_شهرستان",2579,470,28,7,367,872,28,900
"تهران","تهران","مرکز_شهرستان",2580,605,22,3,400,1030,17,1047
"تهران","تهران","مرکز_شهرستان",2581,352,4,6,211,573,18,591
"تهران","تهران","مرکز_شهرستان",2582,910,25,8,727,1670,0,1670
"تهران","تهران","مرکز_شهرستان",2583,793,27,3,593,1416,16,1432
"تهران","تهران","مرکز_شهرستان",2584,861,19,24,636,1540,36,1576
"تهران","تهران","مرکز_شهرستان",2585,825,21,11,403,1260,37,1297
"تهران","تهران","مرکز_شهرستان",2586,540,11,6,410,967,10,977
"تهران","تهران","مرکز_شهرستان",2587,357,11,0,329,697,8,705
"تهران","تهران","مرکز_شهرستان",2588,592,17,19,584,1212,24,1236
"تهران","تهران","مرکز_شهرستان",2589,377,8,0,169,554,16,570
"تهران","تهران","مرکز_شهرستان",2590,389,17,2,245,653,20,673
"تهران","تهران","مرکز_شهرستان",2591,247,8,1,135,391,15,406
"تهران","تهران","مرکز_شهرستان",2592,352,10,2,146,510,16,526
"تهران","تهران","مرکز_شهرستان",2593,355,7,0,182,544,15,559
"تهران","تهران","مرکز_شهرستان",2594,231,7,2,163,403,7,410
"تهران","تهران","مرکز_شهرستان",2595,419,10,7,256,692,15,707
"تهران","تهران","مرکز_شهرستان",2596,452,13,1,182,648,12,660
"تهران","تهران","مرکز_شهرستان",2597,233,24,4,239,500,11,511
"تهران","تهران","مرکز_شهرستان",2598,355,6,1,179,541,19,560
"تهران","تهران","مرکز_شهرستان",2599,427,20,2,468,917,14,931
"تهران","تهران","مرکز_شهرستان",2600,510,18,2,422,952,14,966
"تهران","تهران","مرکز_شهرستان",2601,433,4,1,414,852,12,864
"تهران","تهران","مرکز_شهرستان",2602,627,22,3,296,948,20,968
"تهران","تهران","مرکز_شهرستان",2603,477,5,0,201,683,7,690
"تهران","تهران","مرکز_شهرستان",2604,716,27,5,529,1277,17,1294
"تهران","تهران","مرکز_شهرستان",2605,621,17,19,628,1285,26,1311
"تهران","تهران","مرکز_شهرستان",2606,674,21,11,663,1369,30,1399
"تهران","تهران","مرکز_شهرستان",2607,515,24,3,523,1065,25,1090
"تهران","تهران","مرکز_شهرستان",2608,405,25,6,453,889,10,899
"تهران","تهران","مرکز_شهرستان",2609,1198,30,16,503,1747,40,1787
"تهران","تهران","مرکز_شهرستان",2610,1095,26,8,639,1768,24,1792
"تهران","تهران","مرکز_شهرستان",2611,675,18,5,538,1236,24,1260
"تهران","تهران","مرکز_شهرستان",2612,643,23,2,738,1406,26,1432
"تهران","تهران","مرکز_شهرستان",2613,579,30,9,528,1146,39,1185
"تهران","تهران","مرکز_شهرستان",2614,460,13,0,306,779,14,793
"تهران","تهران","مرکز_شهرستان",2615,854,20,3,577,1454,29,1483
"تهران","تهران","مرکز_شهرستان",2616,512,16,7,395,930,18,948
"تهران","تهران","مرکز_شهرستان",2617,957,26,7,554,1544,0,1544
"تهران","تهران","مرکز_شهرستان",2618,1220,22,5,430,1677,23,1700
"تهران","تهران","مرکز_شهرستان",2619,503,18,5,483,1009,14,1023
"تهران","تهران","مرکز_شهرستان",2620,702,14,11,757,1484,39,1523
"تهران","تهران","مرکز_شهرستان",2621,736,16,6,482,1240,10,1250
"تهران","تهران","مرکز_شهرستان",2622,922,14,2,414,1352,20,1372
"تهران","تهران","مرکز_شهرستان",2623,1033,28,6,929,1996,47,2043
"تهران","تهران","مرکز_شهرستان",2624,925,31,4,672,1632,34,1666
"تهران","تهران","مرکز_شهرستان",2625,521,22,6,381,930,25,955
"تهران","تهران","مرکز_شهرستان",2626,1026,34,3,731,1794,32,1826
"تهران","تهران","مرکز_شهرستان",2627,726,17,6,523,1272,28,1300
"تهران","تهران","مرکز_شهرستان",2628,843,26,6,656,1531,8,1539
"تهران","تهران","مرکز_شهرستان",2629,536,13,3,398,950,23,973
"تهران","تهران","مرکز_شهرستان",2630,542,18,0,537,1097,10,1107
"تهران","تهران","مرکز_شهرستان",2631,651,15,2,751,1419,31,1450
"تهران","تهران","مرکز_شهرستان",2632,776,30,2,825,1633,42,1675
"تهران","تهران","مرکز_شهرستان",2633,673,28,3,639,1343,24,1367
"تهران","تهران","مرکز_شهرستان",2634,774,15,5,434,1228,19,1247
"تهران","تهران","مرکز_شهرستان",2635,851,29,4,380,1264,13,1277
"تهران","تهران","مرکز_شهرستان",2636,719,31,3,496,1249,16,1265
"تهران","تهران","مرکز_شهرستان",2637,894,14,1,490,1399,24,1423
"تهران","تهران","مرکز_شهرستان",2638,775,19,0,564,1358,21,1379
"تهران","تهران","مرکز_شهرستان",2639,585,18,1,672,1276,24,1300
"تهران","تهران","مرکز_شهرستان",2640,681,15,3,620,1319,32,1351
"تهران","تهران","مرکز_شهرستان",2641,787,23,2,722,1534,39,1573
"تهران","تهران","مرکز_شهرستان",2642,391,18,7,377,793,15,808
"تهران","تهران","مرکز_شهرستان",2643,875,28,10,580,1493,43,1536
"تهران","تهران","مرکز_شهرستان",2644,967,16,0,390,1373,27,1400
"تهران","تهران","مرکز_شهرستان",2645,917,18,2,398,1335,28,1363
"تهران","تهران","مرکز_شهرستان",2646,696,15,3,427,1141,14,1155
"تهران","تهران","مرکز_شهرستان",2647,801,16,2,545,1364,29,1393
"تهران","تهران","مرکز_شهرستان",2648,490,9,6,464,969,17,986
"تهران","تهران","مرکز_شهرستان",2649,592,8,1,442,1043,25,1068
"تهران","تهران","مرکز_شهرستان",2650,804,16,1,589,1410,17,1427
"تهران","تهران","مرکز_شهرستان",2651,827,13,1,354,1195,22,1217
"تهران","تهران","مرکز_شهرستان",2652,964,21,9,547,1541,22,1563
"تهران","تهران","مرکز_شهرستان",2653,1020,16,0,407,1443,28,1471
"تهران","تهران","مرکز_شهرستان",2654,934,18,3,615,1570,30,1600
"تهران","تهران","مرکز_شهرستان",2655,706,10,4,266,986,20,1006
"تهران","تهران","مرکز_شهرستان",2656,558,13,0,320,891,17,908
"تهران","تهران","مرکز_شهرستان",2657,588,16,1,352,957,26,983
"تهران","تهران","مرکز_شهرستان",2658,763,13,1,308,1085,24,1109
"تهران","تهران","مرکز_شهرستان",2659,663,14,2,479,1158,19,1177
"تهران","تهران","مرکز_شهرستان",2660,498,18,5,421,942,23,965
"تهران","تهران","مرکز_شهرستان",2661,876,22,0,675,1573,26,1599
"تهران","تهران","مرکز_شهرستان",2662,572,20,3,361,956,27,983
"تهران","تهران","مرکز_شهرستان",2663,1151,16,1,592,1760,45,1805
"تهران","تهران","مرکز_شهرستان",2664,1252,17,1,353,1623,9,1632
"تهران","تهران","مرکز_شهرستان",2665,466,18,2,394,880,20,900
"تهران","تهران","مرکز_شهرستان",2666,651,19,1,418,1089,16,1105
"تهران","تهران","مرکز_شهرستان",2667,769,18,6,717,1510,30,1540
"تهران","تهران","مرکز_شهرستان",2668,782,10,0,363,1155,14,1169
"تهران","تهران","مرکز_شهرستان",2669,643,7,2,557,1209,29,1238
"تهران","تهران","مرکز_شهرستان",2670,606,16,5,679,1306,16,1322
"تهران","تهران","مرکز_شهرستان",2671,633,12,3,342,990,18,1008
"تهران","تهران","مرکز_شهرستان",2672,873,20,0,514,1407,19,1426
"تهران","تهران","مرکز_شهرستان",2673,466,13,4,255,738,9,747
"تهران","تهران","مرکز_شهرستان",2674,438,15,2,231,686,24,710
"تهران","تهران","مرکز_شهرستان",2675,581,9,0,400,990,14,1004
"تهران","تهران","مرکز_شهرستان",2676,562,3,1,392,958,18,976
"تهران","تهران","مرکز_شهرستان",2677,800,20,4,370,1194,6,1200
"تهران","تهران","مرکز_شهرستان",2678,895,12,2,279,1188,31,1219
"تهران","تهران","مرکز_شهرستان",2679,1237,14,6,469,1726,31,1757
"تهران","تهران","مرکز_شهرستان",2680,578,10,2,195,785,15,800
"تهران","تهران","مرکز_شهرستان",2681,326,9,47,315,697,23,720
"تهران","تهران","مرکز_شهرستان",2682,459,8,42,256,765,19,784
"تهران","تهران","مرکز_شهرستان",2683,425,6,14,214,659,11,670
"تهران","تهران","مرکز_شهرستان",2684,426,12,36,208,682,29,711
"تهران","تهران","مرکز_شهرستان",2685,785,8,41,346,1180,10,1190
"تهران","تهران","مرکز_شهرستان",2686,823,11,14,442,1290,25,1315
"تهران","تهران","مرکز_شهرستان",2687,575,9,10,333,927,5,932
"تهران","تهران","مرکز_شهرستان",2688,471,11,2,215,699,9,708
"تهران","تهران","مرکز_شهرستان",2689,461,9,1,276,747,11,758
"تهران","تهران","مرکز_شهرستان",2690,433,5,0,120,558,3,561
"تهران","تهران","مرکز_شهرستان",2691,262,2,2,208,474,4,478
"تهران","تهران","مرکز_شهرستان",2692,443,14,4,202,663,4,667
"تهران","تهران","مرکز_شهرستان",2693,434,3,0,180,617,7,624
"تهران","تهران","مرکز_شهرستان",2694,709,12,5,362,1088,21,1109
"تهران","تهران","مرکز_شهرستان",2695,945,9,2,413,1369,25,1394
"تهران","تهران","مرکز_شهرستان",2696,832,12,0,296,1140,16,1156
"تهران","تهران","مرکز_شهرستان",2697,666,6,5,359,1036,17,1053
"تهران","تهران","مرکز_شهرستان",2698,701,8,3,212,924,8,932
"تهران","تهران","مرکز_شهرستان",2699,509,8,0,277,794,14,808
"تهران","تهران","مرکز_شهرستان",2700,561,10,4,414,989,14,1003
"تهران","تهران","مرکز_شهرستان",2701,147,3,0,89,239,3,242
"تهران","تهران","مرکز_شهرستان",2702,684,14,1,387,1086,17,1103
"تهران","تهران","مرکز_شهرستان",2703,835,8,5,403,1251,39,1290
"تهران","تهران","مرکز_شهرستان",2704,850,14,7,420,1291,32,1323
"تهران","تهران","مرکز_شهرستان",2705,1124,12,2,275,1413,23,1436
"تهران","تهران","مرکز_شهرستان",2706,547,5,0,295,847,15,862
"تهران","تهران","مرکز_شهرستان",2707,1034,11,2,353,1400,8,1408
"تهران","تهران","مرکز_شهرستان",2708,299,7,1,107,414,7,421
"تهران","تهران","مرکز_شهرستان",2709,919,6,1,207,1133,24,1157
"تهران","تهران","مرکز_شهرستان",2710,321,11,0,235,567,13,580
"تهران","تهران","مرکز_شهرستان",2711,255,9,2,169,435,14,449
"تهران","تهران","مرکز_شهرستان",2712,624,15,8,369,1016,18,1034
"تهران","تهران","مرکز_شهرستان",2713,186,1,0,77,264,4,268
"تهران","تهران","مرکز_شهرستان",2714,254,10,3,173,440,12,452
"تهران","تهران","مرکز_شهرستان",2715,221,5,1,143,370,4,374
"تهران","تهران","مرکز_شهرستان",2716,380,11,3,229,623,4,627
"تهران","تهران","مرکز_شهرستان",2717,313,10,1,205,529,9,538
"تهران","تهران","مرکز_شهرستان",2718,397,5,2,183,587,20,607
"تهران","تهران","مرکز_شهرستان",2719,202,4,2,165,373,8,381
"تهران","تهران","مرکز_شهرستان",2720,654,9,4,255,922,26,948
"تهران","تهران","مرکز_شهرستان",2721,317,12,1,249,579,13,592
"تهران","تهران","مرکز_شهرستان",2722,189,7,0,152,348,13,361
"تهران","تهران","بخش_مرکزی",2723,146,3,0,58,207,0,207
"تهران","تهران","بخش_مرکزی",2724,225,14,2,62,303,7,310
"تهران","تهران","بخش_مرکزی",2725,677,1,2,85,765,16,781
"تهران","تهران","بخش_مرکزی",2726,354,7,1,406,768,9,777
"تهران","تهران","بخش_مرکزی",2727,147,2,1,84,234,5,239
"تهران","تهران","بخش_مرکزی",2728,110,0,4,109,223,3,226
"تهران","تهران","بخش_مرکزی",2729,148,3,2,115,268,7,275
"تهران","تهران","بخش_مرکزی",2730,222,4,1,148,375,6,381
"تهران","تهران","بخش_مرکزی",2731,456,4,12,326,798,15,813
"تهران","تهران","بخش_مرکزی",2732,590,17,4,347,958,42,1000
"تهران","تهران","بخش_مرکزی",2733,466,7,15,191,679,14,693
"تهران","تهران","بخش_مرکزی",2734,764,9,54,241,1068,17,1085
"تهران","تهران","بخش_مرکزی",2735,383,9,29,134,555,10,565
"تهران","تهران","بخش_مرکزی",2736,146,9,1,218,374,19,393
"تهران","تهران","بخش_مرکزی",2737,507,44,15,644,1210,10,1220
"تهران","تهران","بخش_مرکزی",2738,131,3,6,117,257,6,263
"تهران","تهران","بخش_مرکزی",2739,276,11,1,175,463,8,471
"تهران","تهران","بخش_مرکزی",2740,267,7,4,204,482,17,499
"تهران","تهران","بخش_مرکزی",2741,490,21,7,466,984,17,1001
"تهران","تهران","بخش_مرکزی",2742,340,8,39,178,565,9,574
"تهران","تهران","بخش_مرکزی",2743,822,16,59,364,1261,21,1282
"تهران","تهران","بخش_مرکزی",2744,106,0,8,101,215,6,221
"تهران","تهران","بخش_مرکزی",2745,818,13,17,285,1133,9,1142
"تهران","تهران","بخش_مرکزی",2746,219,11,7,165,402,7,409
"تهران","تهران","بخش_مرکزی",2747,528,6,49,156,739,22,761
"تهران","تهران","بخش_مرکزی",2748,290,8,14,159,471,13,484
"تهران","تهران","بخش_مرکزی",2749,865,15,9,373,1262,30,1292
"تهران","تهران","بخش_مرکزی",2750,1028,14,10,383,1435,47,1482
"تهران","تهران","بخش_مرکزی",2751,217,14,3,144,378,10,388
"تهران","تهران","بخش_مرکزی",2752,95,6,10,79,190,2,192
"تهران","تهران","بخش_مرکزی",2753,1074,7,2,276,1359,17,1376
"تهران","تهران","بخش_مرکزی",2754,545,11,8,248,812,18,830
"تهران","تهران","بخش_مرکزی",2755,1162,9,13,298,1482,17,1499
"تهران","تهران","بخش_مرکزی",2756,789,17,3,377,1186,17,1203
"تهران","تهران","بخش_مرکزی",2757,527,14,4,223,768,0,768
"تهران","تهران","بخش_مرکزی",2758,1457,16,18,520,2011,69,2080
"تهران","تهران","بخش_مرکزی",2759,991,13,17,500,1521,20,1541
"تهران","تهران","بخش_مرکزی",2760,961,9,4,378,1352,28,1380
"تهران","تهران","بخش_مرکزی",2761,735,2,0,185,922,9,931
"تهران","تهران","بخش_مرکزی",2762,390,13,5,257,665,10,675
"تهران","تهران","بخش_مرکزی",2763,233,9,4,195,441,3,444
"تهران","تهران","بخش_مرکزی",2764,527,16,14,479,1036,27,1063
"تهران","تهران","بخش_مرکزی",2765,444,22,4,466,936,14,950
"تهران","تهران","بخش_مرکزی",2766,604,32,17,535,1188,22,1210
"تهران","تهران","بخش_مرکزی",2767,485,15,5,414,919,24,943
"تهران","تهران","بخش_مرکزی",2768,833,25,12,597,1467,26,1493
"تهران","تهران","بخش_مرکزی",2769,367,5,11,263,646,18,664
"تهران","تهران","بخش_مرکزی",2770,271,5,4,265,545,8,553
"تهران","تهران","بخش_مرکزی",2771,571,20,5,462,1058,14,1072
"تهران","تهران","بخش_مرکزی",2772,971,38,17,1164,2190,27,2217
"تهران","تهران","بخش_مرکزی",2773,359,15,6,361,741,9,750
"تهران","تهران","بخش_مرکزی",2774,204,16,5,244,469,31,500
"تهران","تهران","بخش_مرکزی",2775,897,38,8,409,1352,13,1365
"تهران","تهران","بخش_مرکزی",2776,305,23,5,217,550,11,561
"تهران","تهران","بخش_مرکزی",2777,58,1,3,24,86,0,86
"تهران","تهران","بخش_مرکزی",2778,581,15,8,444,1048,10,1058
"تهران","تهران","بخش_مرکزی",2779,151,2,1,56,210,5,215
"تهران","تهران","بخش_مرکزی",2780,523,10,185,307,1025,24,1049
"تهران","تهران","بخش_مرکزی",2781,103,2,0,94,199,3,202
"تهران","تهران","بخش_مرکزی",2782,160,7,15,85,267,7,274
"تهران","تهران","بخش_مرکزی",2783,1043,7,2,422,1474,5,1479
"تهران","تهران","بخش_مرکزی",2784,682,11,29,316,1038,24,1062
"تهران","تهران","بخش_مرکزی",2785,260,6,4,117,387,9,396
"تهران","تهران","بخش_مرکزی",2786,265,10,2,245,522,12,534
"تهران","تهران","بخش_مرکزی",2787,549,22,6,475,1052,16,1068
"تهران","تهران","بخش_مرکزی",2788,480,19,7,340,846,16,862
"تهران","تهران","بخش_کن",1,289,42,35,1359,1725,75,1800
"تهران","تهران","بخش_کن",2,267,43,34,1398,1742,21,1763
"تهران","تهران","بخش_کن",3,255,40,40,1487,1822,3,1825
"تهران","تهران","بخش_کن",4,318,28,65,1397,1808,33,1841
"تهران","تهران","بخش_کن",5,231,26,25,1517,1799,14,1813
"تهران","تهران","بخش_کن",6,270,29,45,1439,1783,12,1795
"تهران","تهران","بخش_کن",7,238,28,58,1421,1745,11,1756
"تهران","تهران","بخش_کن",8,301,33,31,1463,1828,12,1840
"تهران","تهران","بخش_کن",9,255,29,41,1171,1496,5,1501
"تهران","تهران","بخش_کن",10,447,59,43,1618,2167,25,2192
"تهران","تهران","بخش_کن",11,248,47,37,1443,1775,11,1786
"تهران","تهران","بخش_کن",12,299,43,42,1551,1935,17,1952
"تهران","تهران","بخش_کن",13,354,51,24,1187,1616,10,1626
"تهران","تهران","بخش_کن",14,401,34,29,1347,1811,19,1830
"تهران","تهران","بخش_کن",15,320,25,50,1380,1775,17,1792
"تهران","تهران","بخش_کن",16,480,33,40,1470,2023,17,2040
"تهران","تهران","بخش_کن",17,268,55,42,1336,1701,16,1717
"تهران","تهران","بخش_کن",18,227,34,56,1574,1891,20,1911
"تهران","تهران","بخش_کن",19,591,19,12,755,1377,25,1402
"تهران","تهران","بخش_کن",20,685,16,8,389,1098,28,1126
"تهران","تهران","بخش_کن",21,565,54,23,1550,2192,39,2231
"تهران","تهران","بخش_کن",22,744,52,9,494,1299,24,1323
"تهران","تهران","بخش_کن",23,648,53,10,460,1171,21,1192
"تهران","تهران","بخش_کن",24,353,38,4,486,881,19,900
"تهران","تهران","بخش_کن",25,351,44,10,503,908,0,908
"تهران","تهران","بخش_کن",26,310,51,30,1434,1825,16,1841
"تهران","تهران","بخش_کن",27,273,46,35,1577,1931,18,1949
"تهران","تهران","بخش_کن",28,335,68,50,1644,2097,22,2119
"تهران","تهران","بخش_کن",29,449,47,31,1191,1718,21,1739
"تهران","تهران","بخش_کن",30,253,25,34,929,1241,11,1252
"تهران","تهران","بخش_کن",31,380,52,25,1402,1859,16,1875
"تهران","تهران","بخش_کن",32,260,46,19,1246,1571,18,1589
"تهران","تهران","بخش_کن",33,799,57,19,1207,2082,29,2111
"تهران","تهران","بخش_کن",34,352,56,24,1073,1505,29,1534
"تهران","تهران","بخش_کن",35,665,71,35,1786,2557,140,2697
"تهران","تهران","بخش_کن",36,523,67,36,2065,2691,23,2714
"تهران","تهران","بخش_کن",37,297,39,11,1035,1382,11,1393
"تهران","تهران","بخش_کن",38,325,45,25,1411,1806,19,1825
"تهران","تهران","بخش_کن",39,309,29,14,1126,1478,11,1489
"تهران","تهران","بخش_کن",40,882,57,11,777,1727,26,1753
"تهران","تهران","بخش_کن",41,481,52,26,1380,1939,27,1966
"تهران","تهران","بخش_کن",42,204,30,11,831,1076,15,1091
"تهران","تهران","بخش_کن",43,236,24,11,544,815,11,826
"تهران","تهران","بخش_کن",44,276,33,19,997,1325,22,1347
"تهران","تهران","بخش_کن",45,774,67,29,1049,1919,32,1951
"تهران","تهران","بخش_کن",46,320,42,20,1142,1524,18,1542
"تهران","تهران","بخش_کن",47,361,46,41,1242,1690,22,1712
"تهران","تهران","بخش_کن",48,354,40,16,1216,1626,35,1661
"تهران","تهران","بخش_کن",49,462,50,22,1739,2273,17,2290
"تهران","تهران","بخش_کن",50,509,56,25,1408,1998,21,2019
"تهران","تهران","بخش_کن",51,485,44,18,1312,1859,16,1875
"تهران","تهران","بخش_کن",52,672,47,18,938,1675,30,1705
"تهران","تهران","بخش_کن",53,624,52,40,1678,2394,42,2436
"تهران","تهران","بخش_کن",54,298,40,21,1129,1488,22,1510
"تهران","تهران","بخش_کن",55,352,38,26,1218,1634,6,1640
"تهران","تهران","بخش_کن",56,615,51,37,1728,2431,17,2448
"تهران","تهران","بخش_کن",57,694,48,22,1821,2585,21,2606
"تهران","تهران","بخش_کن",58,470,33,25,1751,2279,16,2295
"تهران","تهران","بخش_کن",59,867,46,21,1064,1998,19,2017
"تهران","تهران","بخش_کن",60,415,38,27,1980,2460,21,2481
"تهران","تهران","بخش_کن",61,259,30,19,1097,1405,10,1415
"تهران","تهران","بخش_کن",62,351,24,28,1298,1701,25,1726
"تهران","تهران","بخش_کن",63,409,59,22,1409,1899,20,1919
"تهران","تهران","بخش_کن",64,411,28,25,1047,1511,21,1532
"تهران","تهران","بخش_کن",65,443,42,17,1063,1565,34,1599
"تهران","تهران","بخش_کن",66,235,29,13,973,1250,0,1250
"تهران","تهران","بخش_کن",67,259,40,12,996,1307,19,1326
"تهران","تهران","بخش_کن",68,497,51,20,1786,2354,14,2368
"تهران","تهران","بخش_کن",69,585,74,31,1932,2622,26,2648
"تهران","تهران","بخش_کن",70,359,56,25,1297,1737,19,1756
"تهران","تهران","بخش_کن",71,224,40,12,850,1126,11,1137
"تهران","تهران","بخش_کن",72,293,29,17,1205,1544,15,1559
"تهران","تهران","بخش_کن",73,935,39,18,733,1725,26,1751
"تهران","تهران","بخش_کن",74,688,39,12,731,1470,34,1504
"تهران","تهران","بخش_کن",75,377,29,23,947,1376,16,1392
"تهران","تهران","بخش_کن",76,389,47,37,1924,2397,18,2415
"تهران","تهران","بخش_کن",77,488,45,31,1843,2407,10,2417
"تهران","تهران","بخش_کن",78,530,52,30,1367,1979,34,2013
"تهران","تهران","بخش_کن",79,444,58,24,1779,2305,22,2327
"تهران","تهران","بخش_کن",80,676,85,40,1634,2435,15,2450
"تهران","تهران","بخش_کن",81,292,31,14,831,1168,9,1177
"تهران","تهران","بخش_کن",82,192,29,12,1042,1275,10,1285
"تهران","تهران","بخش_کن",83,391,43,28,1642,2104,14,2118
"تهران","تهران","بخش_کن",84,633,58,13,667,1371,26,1397
"تهران","تهران","بخش_کن",85,309,52,16,1711,2088,21,2109
"تهران","تهران","بخش_کن",86,224,28,17,648,917,17,934
"تهران","تهران","بخش_کن",87,364,47,27,1444,1882,29,1911
"تهران","تهران","بخش_کن",88,311,42,38,1131,1522,24,1546
"تهران","تهران","بخش_کن",89,506,42,19,1025,1592,14,1606
"تهران","تهران","بخش_کن",90,619,73,43,1879,2614,13,2627
"تهران","تهران","بخش_کن",91,492,80,24,1482,2078,26,2104
"تهران","تهران","بخش_کن",92,370,61,27,1560,2018,10,2028
"تهران","تهران","بخش_کن",93,413,61,43,1850,2367,21,2388
"تهران","تهران","بخش_کن",94,271,31,19,1102,1423,19,1442
"تهران","تهران","بخش_کن",95,328,58,28,1505,1919,21,1940
"تهران","تهران","بخش_کن",96,395,39,18,1024,1476,11,1487
"تهران","تهران","بخش_کن",97,393,38,9,958,1398,12,1410
"تهران","تهران","بخش_کن",98,238,38,28,1192,1496,13,1509
"تهران","تهران","بخش_کن",99,887,69,14,716,1686,29,1715
"تهران","تهران","بخش_کن",100,959,77,16,700,1752,16,1768
"تهران","تهران","بخش_کن",101,484,46,24,998,1552,17,1569
"تهران","تهران","بخش_کن",102,505,73,36,1539,2153,27,2180
"تهران","تهران","بخش_کن",103,1024,100,28,1495,2647,34,2681
"تهران","تهران","بخش_کن",104,547,55,14,1383,1999,25,2024
"تهران","تهران","بخش_کن",105,496,61,32,1676,2265,15,2280
"تهران","تهران","بخش_کن",106,498,47,17,1437,1999,23,2022
"تهران","تهران","بخش_کن",107,479,38,29,1545,2091,20,2111
"تهران","تهران","بخش_کن",108,518,73,33,1652,2276,22,2298
"تهران","تهران","بخش_کن",109,450,29,24,1158,1661,6,1667
"تهران","تهران","بخش_کن",110,665,57,42,1963,2727,30,2757
"تهران","تهران","بخش_کن",111,806,58,31,1241,2136,33,2169
"تهران","تهران","بخش_کن",112,563,52,23,1101,1739,43,1782
"تهران","تهران","بخش_کن",113,764,63,22,1175,2024,6,2030
"تهران","تهران","بخش_کن",114,440,43,22,1217,1722,9,1731
"تهران","تهران","بخش_کن",115,458,40,13,1250,1761,21,1782
"تهران","تهران","بخش_کن",116,1103,81,20,1390,2594,43,2637
"تهران","تهران","بخش_کن",117,576,47,28,1275,1926,19,1945
"تهران","تهران","بخش_کن",118,510,27,27,1212,1776,17,1793
"تهران","تهران","بخش_کن",119,531,29,21,1433,2014,18,2032
"تهران","تهران","بخش_کن",120,787,81,44,2193,3105,30,3135
"تهران","تهران","بخش_کن",121,613,62,44,901,1620,31,1651
"تهران","تهران","بخش_کن",122,644,88,25,1081,1838,38,1876
"تهران","تهران","بخش_کن",123,500,12,8,966,1486,0,1486
"تهران","تهران","بخش_کن",124,696,62,24,991,1773,14,1787
"تهران","تهران","بخش_کن",125,538,46,16,1127,1727,15,1742
"تهران","تهران","بخش_کن",126,915,39,19,790,1763,37,1800
"تهران","تهران","بخش_کن",127,700,26,16,473,1215,2,1217
"تهران","تهران","بخش_کن",128,318,38,14,1003,1373,25,1398
"تهران","تهران","بخش_کن",129,383,30,14,824,1251,13,1264
"تهران","تهران","بخش_کن",130,524,46,14,1275,1859,19,1878
"تهران","تهران","بخش_کن",131,902,56,16,960,1934,35,1969
"تهران","تهران","بخش_کن",132,778,60,27,845,1710,26,1736
"تهران","تهران","بخش_کن",133,446,43,31,1654,2174,25,2199
"تهران","تهران","بخش_کن",134,719,50,37,1754,2560,34,2594
"تهران","تهران","بخش_کن",135,1114,93,21,1555,2783,43,2826
"تهران","تهران","بخش_کن",136,967,79,30,1696,2772,36,2808
"تهران","تهران","بخش_کن",137,575,32,18,1276,1901,20,1921
"تهران","تهران","بخش_کن",138,513,43,32,1190,1778,17,1795
"تهران","تهران","بخش_کن",139,1020,55,14,758,1847,22,1869
"تهران","تهران","بخش_کن",140,590,48,21,1233,1892,28,1920
"تهران","تهران","بخش_کن",141,595,35,26,1099,1755,2,1757
"تهران","تهران","بخش_کن",142,513,39,18,953,1523,20,1543
"تهران","تهران","بخش_کن",143,660,73,20,1566,2319,26,2345
"تهران","تهران","بخش_کن",144,347,37,17,1167,1568,8,1576
"تهران","تهران","بخش_کن",145,1029,100,24,1521,2674,42,2716
"تهران","تهران","بخش_کن",146,536,49,29,1413,2027,34,2061
"تهران","تهران","بخش_کن",147,646,53,32,1417,2148,23,2171
"تهران","تهران","بخش_کن",148,414,49,9,1013,1485,27,1512
"تهران","تهران","بخش_کن",149,411,33,14,1086,1544,22,1566
"تهران","تهران","بخش_کن",150,607,60,28,2226,2921,30,2951
"تهران","تهران","بخش_کن",151,1131,65,22,1035,2253,45,2298
"تهران","تهران","بخش_کن",152,803,49,19,983,1854,32,1886
"تهران","تهران","بخش_کن",153,298,42,23,1252,1615,34,1649
"تهران","تهران","بخش_کن",154,600,55,22,1297,1974,26,2000
"تهران","تهران","بخش_کن",155,588,46,12,1149,1795,15,1810
"تهران","تهران","بخش_کن",156,654,68,19,1568,2309,34,2343
"تهران","تهران","بخش_کن",157,509,50,15,1166,1740,20,1760
"تهران","تهران","بخش_کن",158,438,47,24,1166,1675,25,1700
"تهران","تهران","بخش_کن",159,660,40,14,875,1589,25,1614
"تهران","تهران","بخش_کن",160,668,49,9,761,1487,23,1510
"تهران","تهران","بخش_کن",161,352,41,10,1425,1828,20,1848
"تهران","تهران","بخش_کن",162,638,51,28,1508,2225,32,2257
"تهران","تهران","بخش_کن",163,399,52,23,1200,1674,26,1700
"تهران","تهران","بخش_کن",164,404,45,20,1613,2082,18,2100
"تهران","تهران","بخش_کن",165,551,38,21,1371,1981,19,2000
"تهران","تهران","بخش_کن",166,687,39,21,1040,1787,19,1806
"تهران","تهران","بخش_کن",167,723,38,11,898,1670,31,1701
"تهران","تهران","بخش_کن",168,549,49,21,1734,2353,23,2376
"تهران","تهران","بخش_کن",169,427,57,14,1173,1671,35,1706
"تهران","تهران","بخش_کن",170,501,60,22,1250,1833,11,1844
"تهران","تهران","بخش_کن",171,326,44,15,1093,1478,15,1493
"تهران","تهران","بخش_کن",172,611,44,10,1487,2152,34,2186
"تهران","تهران","بخش_کن",173,496,50,24,1544,2114,21,2135
"تهران","تهران","بخش_کن",174,535,56,40,1792,2423,27,2450
"تهران","تهران","بخش_کن",175,580,39,22,1382,2023,32,2055
"تهران","تهران","بخش_کن",176,478,53,31,1207,1769,20,1789
"تهران","تهران","بخش_کن",177,611,86,43,2318,3058,34,3092
"تهران","تهران","بخش_کن",178,406,36,13,1163,1618,12,1630
"تهران","تهران","بخش_کن",179,634,37,25,1562,2258,21,2279
"تهران","تهران","بخش_کن",180,459,53,28,1052,1592,16,1608
"تهران","تهران","بخش_کن",181,497,46,32,2185,2760,25,2785
"تهران","تهران","بخش_کن",182,442,37,20,1428,1927,22,1949
"تهران","تهران","بخش_کن",183,1250,62,12,779,2103,39,2142
"تهران","تهران","بخش_کن",184,423,26,10,411,870,17,887
"تهران","تهران","بخش_کن",185,648,36,9,730,1423,36,1459
"تهران","تهران","بخش_کن",186,674,30,13,370,1087,40,1127
"تهران","تهران","بخش_کن",187,735,28,25,806,1594,32,1626
"تهران","تهران","بخش_کن",188,715,31,6,377,1129,22,1151
"تهران","تهران","بخش_کن",189,758,28,8,425,1219,18,1237
"تهران","تهران","بخش_کن",190,621,33,1,274,929,23,952
"تهران","تهران","بخش_کن",191,681,45,17,918,1661,24,1685
"تهران","تهران","بخش_کن",192,723,53,31,975,1782,39,1821
"تهران","تهران","بخش_کن",193,842,56,10,963,1871,129,2000
"تهران","تهران","بخش_کن",194,701,50,22,979,1752,25,1777
"تهران","تهران","بخش_کن",195,369,48,17,1128,1562,15,1577
"تهران","تهران","بخش_کن",196,492,24,10,1095,1621,24,1645
"تهران","تهران","بخش_کن",197,403,22,9,576,1010,36,1046
"تهران","تهران","بخش_کن",198,558,44,18,958,1578,27,1605
"تهران","تهران","بخش_کن",199,656,51,10,851,1568,20,1588
"تهران","تهران","بخش_کن",200,720,69,20,1486,2295,28,2323
"تهران","تهران","بخش_کن",201,483,32,13,881,1409,16,1425
"تهران","تهران","بخش_کن",202,731,50,22,1289,2092,39,2131
"تهران","تهران","بخش_کن",203,446,31,2,401,880,5,885
"تهران","تهران","بخش_کن",204,766,47,8,688,1509,23,1532
"تهران","تهران","بخش_کن",205,653,38,23,1498,2212,15,2227
"تهران","تهران","بخش_کن",206,791,58,8,1349,2206,33,2239
"تهران","تهران","بخش_کن",207,684,56,19,1394,2153,30,2183
"تهران","تهران","بخش_کن",208,462,31,6,831,1330,23,1353
"تهران","تهران","بخش_کن",209,685,29,8,603,1325,23,1348
"تهران","تهران","بخش_کن",210,728,45,19,791,1583,27,1610
"تهران","تهران","بخش_کن",211,711,44,12,582,1349,20,1369
"تهران","تهران","بخش_کن",212,1493,69,7,589,2158,34,2192
"تهران","تهران","بخش_کن",213,579,34,14,323,950,24,974
"تهران","تهران","بخش_کن",214,833,46,11,1182,2072,23,2095
"تهران","تهران","بخش_کن",215,568,29,15,1122,1734,24,1758
"تهران","تهران","بخش_کن",216,957,59,19,1588,2623,26,2649
"تهران","تهران","بخش_کن",217,494,49,20,918,1481,26,1507
"تهران","تهران","بخش_کن",218,355,42,5,633,1035,11,1046
"تهران","تهران","بخش_کن",219,405,47,18,930,1400,18,1418
"تهران","تهران","بخش_کن",220,828,38,4,113,983,18,1001
"تهران","تهران","بخش_کن",221,841,36,4,423,1304,11,1315
"تهران","تهران","بخش_کن",222,786,44,12,585,1427,25,1452
"تهران","تهران","بخش_کن",223,577,41,13,565,1196,18,1214
"تهران","تهران","بخش_کن",224,656,43,6,567,1272,18,1290
"تهران","تهران","بخش_کن",225,884,29,4,401,1318,76,1394
"تهران","تهران","بخش_کن",226,1295,54,12,904,2265,59,2324
"تهران","تهران","بخش_کن",227,596,15,8,330,949,24,973
"تهران","تهران","بخش_کن",228,380,13,3,435,831,16,847
"تهران","تهران","بخش_کن",229,511,15,6,587,1119,10,1129
"تهران","تهران","بخش_کن",230,354,39,10,765,1168,19,1187
"تهران","تهران","بخش_کن",231,621,26,5,443,1095,19,1114
"تهران","تهران","بخش_کن",232,1076,26,7,546,1655,33,1688
"تهران","تهران","بخش_کن",233,980,39,7,1020,2046,15,2061
"تهران","تهران","بخش_کن",234,868,28,4,599,1499,21,1520
"تهران","تهران","بخش_کن",235,635,21,6,436,1098,28,1126
"تهران","تهران","بخش_کن",236,891,27,4,392,1314,26,1340
"تهران","تهران","بخش_کن",237,380,27,20,490,917,21,938
"تهران","تهران","بخش_کن",238,685,31,17,856,1589,41,1630
"تهران","تهران","بخش_کن",239,548,32,8,574,1162,12,1174
"تهران","تهران","بخش_کن",240,409,25,15,749,1198,8,1206
"تهران","تهران","بخش_کن",241,778,15,66,368,1227,11,1238
"تهران","تهران","بخش_کن",242,510,19,15,268,812,18,830
"تهران","تهران","بخش_کن",243,670,24,18,550,1262,21,1283
"تهران","تهران","بخش_کن",244,774,24,15,553,1366,26,1392
"تهران","تهران","بخش_کن",245,671,32,16,785,1504,30,1534
"تهران","تهران","بخش_کن",246,815,36,14,720,1585,39,1624
"تهران","تهران","بخش_کن",247,322,16,22,734,1094,16,1110
"تهران","تهران","بخش_کن",248,480,32,18,1043,1573,22,1595
"تهران","تهران","بخش_کن",249,379,24,6,890,1299,12,1311
"تهران","تهران","بخش_کن",250,498,44,19,1163,1724,24,1748
"تهران","تهران","بخش_کن",251,353,25,31,1271,1680,20,1700
"تهران","تهران","بخش_کن",252,875,48,5,595,1523,26,1549
"تهران","تهران","بخش_کن",253,830,45,8,633,1516,28,1544
"تهران","تهران","بخش_کن",254,535,31,18,1076,1660,21,1681
"تهران","تهران","بخش_کن",255,651,36,2,129,818,16,834
"تهران","تهران","بخش_کن",256,904,67,9,939,1919,22,1941
"تهران","تهران","بخش_کن",257,1014,44,9,676,1743,9,1752
"تهران","تهران","بخش_کن",258,980,56,18,992,2046,26,2072
"تهران","تهران","بخش_کن",259,434,32,11,1020,1497,36,1533
"تهران","تهران","بخش_کن",260,698,30,11,1135,1874,26,1900
"تهران","تهران","بخش_کن",261,568,36,25,1227,1856,31,1887
"تهران","تهران","بخش_کن",262,512,40,12,1291,1855,20,1875
"تهران","تهران","بخش_کن",263,751,57,15,1455,2278,32,2310
"تهران","تهران","بخش_کن",264,380,28,7,654,1069,1,1070
"تهران","تهران","بخش_کن",265,477,18,4,673,1172,18,1190
"تهران","تهران","بخش_کن",266,966,51,1,530,1548,26,1574
"تهران","تهران","بخش_کن",267,877,64,13,770,1724,19,1743
"تهران","تهران","بخش_کن",268,774,41,2,522,1339,13,1352
"تهران","تهران","بخش_کن",269,575,30,6,554,1165,26,1191
"تهران","تهران","بخش_کن",270,1489,45,8,499,2041,25,2066
"تهران","تهران","بخش_کن",271,1301,60,17,698,2076,23,2099
"تهران","تهران","بخش_کن",272,904,55,3,290,1252,19,1271
"تهران","تهران","بخش_کن",273,803,52,29,1204,2088,32,2120
"تهران","تهران","بخش_کن",274,930,66,9,1146,2151,24,2175
"تهران","تهران","بخش_کن",275,879,54,22,1316,2271,28,2299
"تهران","تهران","بخش_کن",276,664,32,7,774,1477,21,1498
"تهران","تهران","بخش_کن",277,698,40,2,536,1276,28,1304
"تهران","تهران","بخش_کن",278,819,39,11,776,1645,34,1679
"تهران","تهران","بخش_کن",279,843,47,9,766,1665,23,1688
"تهران","تهران","بخش_کن",280,851,35,4,692,1582,42,1624
"تهران","تهران","بخش_کن",281,1562,47,10,873,2492,43,2535
"تهران","تهران","بخش_کن",282,882,44,15,964,1905,32,1937
"تهران","تهران","بخش_کن",283,649,40,10,769,1468,30,1498
"تهران","تهران","بخش_کن",284,895,46,7,773,1721,32,1753
"تهران","تهران","بخش_کن",285,751,32,10,815,1608,22,1630
"تهران","تهران","بخش_کن",286,765,44,23,809,1641,33,1674
"تهران","تهران","بخش_کن",287,789,33,9,668,1499,33,1532
"تهران","تهران","بخش_کن",288,798,24,6,481,1309,17,1326
"تهران","تهران","بخش_کن",289,966,25,7,593,1591,31,1622
"تهران","تهران","بخش_کن",290,888,24,5,352,1269,34,1303
"تهران","تهران","بخش_کن",291,894,50,8,595,1547,27,1574
"تهران","تهران","بخش_کن",292,1213,24,9,721,1967,33,2000
"تهران","تهران","بخش_کن",293,933,18,13,500,1464,32,1496
"تهران","تهران","بخش_کن",294,1152,11,1,395,1559,24,1583
"تهران","تهران","بخش_کن",295,1333,37,4,979,2353,30,2383
"تهران","تهران","بخش_کن",296,1709,15,5,522,2251,24,2275
"تهران","تهران","بخش_کن",297,1643,26,10,615,2294,24,2318
"تهران","تهران","بخش_کن",298,1414,31,8,972,2425,22,2447
"تهران","تهران","بخش_کن",299,820,17,4,442,1283,28,1311
"تهران","تهران","بخش_کن",300,1432,25,1,447,1905,29,1934
"تهران","تهران","بخش_کن",301,1116,22,5,542,1685,15,1700
"تهران","تهران","بخش_کن",302,1275,10,7,523,1815,50,1865
"تهران","تهران","بخش_کن",303,1227,14,0,391,1632,40,1672
"تهران","تهران","بخش_کن",304,979,15,6,558,1558,30,1588
"تهران","تهران","بخش_کن",305,1026,25,12,671,1734,31,1765
"تهران","تهران","بخش_کن",306,1353,25,7,525,1910,20,1930
"تهران","تهران","بخش_کن",307,480,22,0,236,738,20,758
"تهران","تهران","بخش_کن",308,858,36,15,580,1489,36,1525
"تهران","تهران","بخش_کن",309,272,1,1,43,317,6,323
"تهران","تهران","بخش_کن",310,582,11,8,197,798,10,808
"تهران","تهران","بخش_کن",311,280,10,15,111,416,13,429
"تهران","تهران","بخش_کن",312,168,3,0,36,207,1,208
"تهران","تهران","بخش_کن",313,104,2,0,36,142,3,145
"تهران","تهران","بخش_کن",314,177,7,2,23,209,2,211
"تهران","تهران","بخش_کن",315,172,7,1,84,264,8,272
"تهران","تهران","بخش_کن",316,148,1,3,44,196,1,197
"تهران","تهران","بخش_کن",317,223,1,1,117,342,6,348
"تهران","تهران","بخش_کن",318,116,0,0,40,156,1,157
"تهران","تهران","بخش_کن",319,72,0,0,46,118,0,118
"تهران","تهران","بخش_کن",320,587,52,29,1630,2298,33,2331
"تهران","تهران","بخش_کن",321,762,45,14,743,1564,19,1583
"تهران","تهران","بخش_کن",322,403,14,3,279,699,6,705
"تهران","تهران","بخش_کن",323,367,13,3,177,560,10,570
"تهران","تهران","بخش_کن",324,435,21,10,271,737,14,751
"تهران","تهران","بخش_کن",325,241,14,2,148,405,6,411
"تهران","تهران","بخش_کن",326,196,4,1,143,344,9,353
"تهران","تهران","بخش_کن",327,172,5,3,203,383,3,386
"تهران","تهران","بخش_کن",328,390,23,7,446,866,32,898
"تهران","تهران","بخش_کن",329,239,11,2,127,379,8,387
"تهران","تهران","بخش_کن",330,211,23,2,353,589,11,600
"تهران","تهران","بخش_کن",331,317,25,16,440,798,15,813
"تهران","تهران","بخش_کن",332,257,10,0,138,405,11,416
"تهران","تهران","بخش_کن",333,519,28,4,498,1049,20,1069
"تهران","تهران","بخش_کن",334,566,13,2,151,732,20,752
"تهران","تهران","بخش_کن",335,255,28,18,885,1186,10,1196
"تهران","تهران","بخش_کن",336,287,9,12,254,562,8,570
"تهران","تهران","بخش_کن",337,134,6,4,187,331,7,338
"تهران","تهران","بخش_کن",338,297,9,5,239,550,10,560
"تهران","تهران","بخش_آفتاب",1,915,14,4,552,1485,26,1511
"تهران","تهران","بخش_آفتاب",2,939,12,0,318,1269,21,1290
"تهران","تهران","بخش_آفتاب",3,834,9,3,486,1332,13,1345
"تهران","تهران","بخش_آفتاب",4,603,4,0,140,747,6,753
"تهران","تهران","بخش_آفتاب",5,472,5,0,202,679,7,686
"تهران","تهران","بخش_آفتاب",6,957,28,11,511,1507,19,1526
"تهران","تهران","بخش_آفتاب",7,275,3,2,279,559,5,564
"تهران","تهران","بخش_آفتاب",8,587,4,4,234,829,10,839
"تهران","تهران","بخش_آفتاب",9,810,8,4,306,1128,21,1149
"تهران","تهران","بخش_آفتاب",10,393,3,0,89,485,5,490
"تهران","تهران","بخش_آفتاب",11,422,7,2,252,683,11,694
"تهران","تهران","بخش_آفتاب",12,145,2,0,82,229,3,232
"تهران","تهران","بخش_آفتاب",13,164,4,1,90,259,9,268
"تهران","تهران","بخش_آفتاب",14,293,8,1,125,427,7,434
"تهران","تهران","بخش_آفتاب",15,161,3,1,69,234,6,240
"تهران","تهران","بخش_آفتاب",16,845,24,7,372,1248,19,1267
"تهران","تهران","بخش_آفتاب",17,795,21,3,208,1027,11,1038
"تهران","تهران","بخش_آفتاب",18,383,18,1,227,629,21,650
"تهران","تهران","بخش_آفتاب",19,498,22,2,328,850,14,864
"تهران","تهران","بخش_آفتاب",20,542,25,6,310,883,14,897
"تهران","تهران","بخش_آفتاب",21,621,22,1,298,942,48,990
"تهران","تهران","بخش_آفتاب",22,589,14,1,407,1011,21,1032
"تهران","تهران","بخش_آفتاب",23,240,7,1,192,440,12,452
"تهران","تهران","بخش_آفتاب",24,566,35,7,530,1138,13,1151
"تهران","تهران","بخش_آفتاب",25,340,7,0,108,455,6,461
"تهران","تهران","بخش_آفتاب",26,294,14,5,168,481,10,491
"تهران","دماوند","مرکزی",1,583,35,6,266,890,14,904
"تهران","دماوند","مرکزی",2,492,24,3,189,708,10,718
"تهران","دماوند","مرکزی",3,195,15,0,342,552,15,567
"تهران","دماوند","مرکزی",4,379,18,2,329,728,11,739
"تهران","دماوند","مرکزی",5,281,14,5,383,683,15,698
"تهران","دماوند","مرکزی",6,474,14,9,704,1201,29,1230
"تهران","دماوند","مرکزی",7,561,26,5,540,1132,17,1149
"تهران","دماوند","مرکزی",8,665,42,6,625,1338,24,1362
"تهران","دماوند","مرکزی",9,478,12,4,236,730,16,746
"تهران","دماوند","مرکزی",10,302,15,9,196,522,11,533
"تهران","دماوند","مرکزی",11,528,24,8,300,860,11,871
"تهران","دماوند","مرکزی",12,560,17,6,247,830,11,841
"تهران","دماوند","مرکزی",13,692,29,5,399,1125,23,1148
"تهران","دماوند","مرکزی",14,536,10,6,242,794,7,801
"تهران","دماوند","مرکزی",15,622,19,12,514,1167,24,1191
"تهران","دماوند","مرکزی",16,854,23,13,447,1337,28,1365
"تهران","دماوند","مرکزی",17,995,43,44,761,1843,29,1872
"تهران","دماوند","مرکزی",18,785,25,9,442,1261,21,1282
"تهران","دماوند","مرکزی",19,420,14,12,556,1002,15,1017
"تهران","دماوند","مرکزی",20,390,17,6,282,695,10,705
"تهران","دماوند","مرکزی",21,336,19,1,467,823,8,831
"تهران","دماوند","مرکزی",22,406,12,3,465,886,10,896
"تهران","دماوند","مرکزی",23,630,26,26,541,1223,20,1243
"تهران","دماوند","مرکزی",24,696,30,3,436,1165,12,1177
"تهران","دماوند","مرکزی",25,406,25,3,334,768,4,772
"تهران","دماوند","مرکزی",26,419,24,2,203,648,12,660
"تهران","دماوند","مرکزی",27,175,2,3,143,323,16,339
"تهران","دماوند","مرکزی",28,231,5,0,102,338,4,342
"تهران","دماوند","مرکزی",29,257,5,1,210,473,4,477
"تهران","دماوند","مرکزی",30,462,19,8,413,902,11,913
"تهران","دماوند","مرکزی",31,612,37,11,733,1393,22,1415
"تهران","دماوند","مرکزی",32,342,10,3,296,651,5,656
"تهران","دماوند","مرکزی",33,338,5,1,145,489,3,492
"تهران","دماوند","مرکزی",34,432,3,0,161,596,6,602
"تهران","دماوند","مرکزی",35,283,4,0,58,345,5,350
"تهران","دماوند","مرکزی",36,264,9,2,294,569,2,571
"تهران","دماوند","مرکزی",37,272,10,5,369,656,11,667
"تهران","دماوند","مرکزی",38,296,13,8,287,604,9,613
"تهران","دماوند","مرکزی",39,204,8,2,368,582,7,589
"تهران","دماوند","مرکزی",40,340,1,0,114,455,3,458
"تهران","دماوند","مرکزی",41,346,17,7,260,630,6,636
"تهران","دماوند","مرکزی",42,246,3,1,48,298,3,301
"تهران","دماوند","مرکزی",43,206,1,1,60,268,4,272
"تهران","دماوند","مرکزی",44,354,3,0,157,514,13,527
"تهران","دماوند","مرکزی",45,725,18,1,500,1244,11,1255
"تهران","دماوند","مرکزی",46,952,38,13,573,1576,29,1605
"تهران","دماوند","مرکزی",47,425,9,10,306,750,12,762
"تهران","دماوند","مرکزی",48,312,1,0,5,318,2,320
"تهران","دماوند","مرکزی",49,403,8,0,132,543,6,549
"تهران","دماوند","مرکزی",50,471,11,2,330,814,17,831
"تهران","دماوند","مرکزی",51,438,1,2,163,604,4,608
"تهران","دماوند","مرکزی",52,537,7,5,188,737,8,745
"تهران","دماوند","مرکزی",53,523,8,0,132,663,13,676
"تهران","دماوند","مرکزی",54,736,5,5,176,922,21,943
"تهران","دماوند","مرکزی",55,684,30,5,497,1216,13,1229
"تهران","دماوند","مرکزی",56,469,4,1,279,753,11,764
"تهران","دماوند","مرکزی",57,337,6,0,108,451,6,457
"تهران","دماوند","مرکزی",58,751,4,0,85,840,11,851
"تهران","دماوند","مرکزی",59,195,0,1,42,238,4,242
"تهران","دماوند","مرکزی",60,478,5,2,69,554,13,567
"تهران","دماوند","مرکزی",61,325,2,0,102,429,6,435
"تهران","دماوند","مرکزی",62,277,2,1,50,330,2,332
"تهران","دماوند","مرکزی",63,325,4,1,137,467,0,467
"تهران","دماوند","مرکزی",64,300,6,0,60,366,12,378
"تهران","دماوند","رودهن",1,735,23,138,675,1571,27,1598
"تهران","دماوند","رودهن",2,122,15,69,116,322,5,327
"تهران","دماوند","رودهن",3,217,13,64,346,640,4,644
"تهران","دماوند","رودهن",4,638,25,48,594,1305,24,1329
"تهران","دماوند","رودهن",5,214,10,39,262,525,0,525
"تهران","دماوند","رودهن",6,322,13,150,383,868,10,878
"تهران","دماوند","رودهن",7,579,14,34,427,1054,12,1066
"تهران","دماوند","رودهن",8,303,3,31,252,589,13,602
"تهران","دماوند","رودهن",9,424,22,38,465,949,11,960
"تهران","دماوند","رودهن",10,164,5,226,135,530,3,533
"تهران","دماوند","رودهن",11,313,7,341,258,919,9,928
"تهران","دماوند","رودهن",12,250,10,96,389,745,17,762
"تهران","دماوند","رودهن",13,280,8,56,506,850,6,856
"تهران","دماوند","رودهن",14,322,7,73,223,625,16,641
"تهران","دماوند","رودهن",15,459,7,16,164,646,9,655
"تهران","دماوند","رودهن",16,525,5,4,282,816,13,829
"تهران","دماوند","رودهن",17,457,7,4,288,756,16,772
"تهران","دماوند","رودهن",18,335,1,2,69,407,3,410
"تهران","دماوند","رودهن",19,173,4,0,63,240,5,245
"تهران","دماوند","رودهن",20,252,9,0,177,438,7,445
"تهران","دماوند","رودهن",21,277,0,5,80,362,5,367
"تهران","دماوند","رودهن",22,185,5,1,35,226,2,228
"تهران","دماوند","رودهن",23,192,6,7,99,304,6,310
"تهران","دماوند","رودهن",24,362,2,0,68,432,1,433
"تهران","دماوند","رودهن",25,527,16,124,463,1130,3,1133
"تهران","دماوند","رودهن",26,295,12,109,237,653,4,657
"تهران","دماوند","رودهن",27,250,10,1,183,444,4,448
"تهران","دماوند","رودهن",28,115,4,47,123,289,1,290
"تهران","دماوند","رودهن",29,160,3,3,106,272,4,276
"تهران","رباط_کریم","مرکزی",1,1314,25,4,620,1963,29,1992
"تهران","رباط_کریم","مرکزی",2,1179,12,4,338,1533,40,1573
"تهران","رباط_کریم","مرکزی",3,897,24,2,381,1304,29,1333
"تهران","رباط_کریم","مرکزی",4,832,24,2,544,1402,38,1440
"تهران","رباط_کریم","مرکزی",5,940,32,10,837,1819,26,1845
"تهران","رباط_کریم","مرکزی",6,625,15,3,476,1119,14,1133
"تهران","رباط_کریم","مرکزی",7,715,16,5,588,1324,24,1348
"تهران","رباط_کریم","مرکزی",8,555,5,11,343,914,14,928
"تهران","رباط_کریم","مرکزی",9,1092,1,2,121,1216,13,1229
"تهران","رباط_کریم","مرکزی",10,889,16,4,158,1067,21,1088
"تهران","رباط_کریم","مرکزی",11,971,9,3,169,1152,19,1171
"تهران","رباط_کریم","مرکزی",12,827,18,7,494,1346,32,1378
"تهران","رباط_کریم","مرکزی",13,1082,10,4,413,1509,0,1509
"تهران","رباط_کریم","مرکزی",14,681,18,2,482,1183,23,1206
"تهران","رباط_کریم","مرکزی",15,962,12,2,308,1284,14,1298
"تهران","رباط_کریم","مرکزی",16,970,17,4,442,1433,27,1460
"تهران","رباط_کریم","مرکزی",17,463,14,3,373,853,14,867
"تهران","رباط_کریم","مرکزی",18,753,10,0,398,1161,24,1185
"تهران","رباط_کریم","مرکزی",19,877,10,5,412,1304,27,1331
"تهران","رباط_کریم","مرکزی",20,739,20,5,400,1164,7,1171
"تهران","رباط_کریم","مرکزی",21,929,24,15,549,1517,29,1546
"تهران","رباط_کریم","مرکزی",22,842,16,1,473,1332,31,1363
"تهران","رباط_کریم","مرکزی",23,865,15,10,583,1473,22,1495
"تهران","رباط_کریم","مرکزی",24,594,20,7,546,1167,32,1199
"تهران","رباط_کریم","مرکزی",25,737,6,1,337,1081,15,1096
"تهران","رباط_کریم","مرکزی",26,1233,9,4,260,1506,23,1529
"تهران","رباط_کریم","مرکزی",27,1223,18,5,410,1656,44,1700
"تهران","رباط_کریم","مرکزی",28,1366,6,1,205,1578,38,1616
"تهران","رباط_کریم","مرکزی",29,1154,8,0,111,1273,15,1288
"تهران","رباط_کریم","مرکزی",30,1025,17,7,390,1439,17,1456
"تهران","رباط_کریم","مرکزی",31,792,0,2,185,979,24,1003
"تهران","رباط_کریم","مرکزی",32,744,7,1,218,970,17,987
"تهران","رباط_کریم","مرکزی",33,726,10,6,278,1020,11,1031
"تهران","رباط_کریم","مرکزی",34,528,6,17,249,800,13,813
"تهران","رباط_کریم","مرکزی",35,697,4,7,235,943,17,960
"تهران","رباط_کریم","مرکزی",36,935,10,1,270,1216,19,1235
"تهران","رباط_کریم","مرکزی",37,1045,11,2,305,1363,25,1388
"تهران","رباط_کریم","مرکزی",38,381,6,1,101,489,3,492
"تهران","رباط_کریم","مرکزی",39,1153,6,6,236,1401,29,1430
"تهران","رباط_کریم","مرکزی",40,857,6,6,222,1091,15,1106
"تهران","رباط_کریم","مرکزی",41,929,6,4,264,1203,34,1237
"تهران","رباط_کریم","مرکزی",42,460,5,5,119,589,7,596
"تهران","رباط_کریم","مرکزی",43,687,8,1,346,1042,13,1055
"تهران","رباط_کریم","مرکزی",44,407,5,1,151,564,10,574
"تهران","رباط_کریم","مرکزی",45,767,6,3,400,1176,27,1203
"تهران","رباط_کریم","مرکزی",46,517,12,1,277,807,16,823
"تهران","رباط_کریم","مرکزی",47,490,1,4,241,736,6,742
"تهران","رباط_کریم","مرکزی",48,521,11,4,396,932,10,942
"تهران","رباط_کریم","مرکزی",49,874,40,15,526,1455,23,1478
"تهران","رباط_کریم","مرکزی",50,1078,34,3,650,1765,28,1793
"تهران","رباط_کریم","مرکزی",51,981,41,6,726,1754,30,1784
"تهران","رباط_کریم","مرکزی",52,1144,33,13,768,1958,30,1988
"تهران","رباط_کریم","مرکزی",53,723,11,5,257,996,24,1020
"تهران","رباط_کریم","مرکزی",54,1603,16,12,382,2013,36,2049
"تهران","رباط_کریم","مرکزی",55,808,15,5,483,1311,62,1373
"تهران","رباط_کریم","مرکزی",56,630,11,7,330,978,48,1026
"تهران","رباط_کریم","مرکزی",57,811,21,2,296,1130,29,1159
"تهران","رباط_کریم","مرکزی",58,529,7,9,304,849,23,872
"تهران","رباط_کریم","مرکزی",59,406,7,7,192,612,0,612
"تهران","رباط_کریم","مرکزی",60,521,8,1,258,788,16,804
"تهران","رباط_کریم","گلستان",1,1037,18,4,505,1564,40,1604
"تهران","رباط_کریم","گلستان",2,1026,11,5,301,1343,16,1359
"تهران","رباط_کریم","گلستان",3,1809,12,3,643,2467,33,2500
"تهران","رباط_کریم","گلستان",4,1401,19,6,704,2130,36,2166
"تهران","رباط_کریم","گلستان",5,1335,14,6,494,1849,1,1850
"تهران","رباط_کریم","گلستان",6,922,13,4,341,1280,21,1301
"تهران","رباط_کریم","گلستان",7,855,7,10,509,1381,18,1399
"تهران","رباط_کریم","گلستان",8,969,17,5,282,1273,28,1301
"تهران","رباط_کریم","گلستان",9,1022,4,1,258,1285,25,1310
"تهران","رباط_کریم","گلستان",10,1406,13,4,317,1740,32,1772
"تهران","رباط_کریم","گلستان",11,901,12,4,380,1297,18,1315
"تهران","رباط_کریم","گلستان",12,1120,12,5,245,1382,36,1418
"تهران","رباط_کریم","گلستان",13,1000,9,8,186,1203,16,1219
"تهران","رباط_کریم","گلستان",14,1549,7,3,462,2021,26,2047
"تهران","رباط_کریم","گلستان",15,959,12,4,457,1432,35,1467
"تهران","رباط_کریم","گلستان",16,1232,6,2,313,1553,33,1586
"تهران","رباط_کریم","گلستان",17,1547,19,6,558,2130,30,2160
"تهران","رباط_کریم","گلستان",18,1533,13,2,508,2056,44,2100
"تهران","رباط_کریم","گلستان",19,1277,11,1,430,1719,37,1756
"تهران","رباط_کریم","گلستان",20,1202,8,3,236,1449,21,1470
"تهران","رباط_کریم","گلستان",21,924,8,4,497,1433,18,1451
"تهران","رباط_کریم","گلستان",22,1011,11,3,286,1311,20,1331
"تهران","رباط_کریم","گلستان",23,1037,10,2,362,1411,20,1431
"تهران","رباط_کریم","گلستان",24,1138,10,4,258,1410,21,1431
"تهران","رباط_کریم","گلستان",25,818,11,4,399,1232,24,1256
"تهران","رباط_کریم","گلستان",26,1078,9,0,333,1420,23,1443
"تهران","رباط_کریم","گلستان",27,1108,7,1,353,1469,31,1500
"تهران","رباط_کریم","گلستان",28,1477,15,3,366,1861,36,1897
"تهران","رباط_کریم","گلستان",29,1055,3,1,279,1338,16,1354
"تهران","رباط_کریم","گلستان",30,932,7,1,231,1171,24,1195
"تهران","رباط_کریم","گلستان",31,1201,8,2,457,1668,11,1679
"تهران","رباط_کریم","گلستان",32,1260,6,3,342,1611,69,1680
"تهران","رباط_کریم","گلستان",33,1267,9,1,271,1548,33,1581
"تهران","رباط_کریم","گلستان",34,1049,9,0,298,1356,13,1369
"تهران","رباط_کریم","گلستان",35,1355,19,1,282,1657,48,1705
"تهران","رباط_کریم","گلستان",36,1503,9,2,347,1861,39,1900
"تهران","رباط_کریم","گلستان",37,896,7,4,120,1027,11,1038
"تهران","رباط_کریم","گلستان",38,962,6,0,271,1239,12,1251
"تهران","رباط_کریم","گلستان",39,1406,18,4,241,1669,31,1700
"تهران","رباط_کریم","گلستان",40,1053,14,3,267,1337,31,1368
"تهران","رباط_کریم","گلستان",41,1478,11,4,332,1825,33,1858
"تهران","رباط_کریم","گلستان",42,945,13,2,177,1137,17,1154
"تهران","رباط_کریم","گلستان",43,1449,11,7,309,1776,36,1812
"تهران","رباط_کریم","گلستان",44,1048,10,3,261,1322,16,1338
"تهران","رباط_کریم","گلستان",45,1256,9,7,417,1689,34,1723
"تهران","رباط_کریم","گلستان",46,1519,10,5,426,1960,51,2011
"تهران","رباط_کریم","گلستان",47,1263,10,4,309,1586,0,1586
"تهران","رباط_کریم","گلستان",48,1281,8,5,425,1719,33,1752
"تهران","رباط_کریم","گلستان",49,867,4,3,237,1111,27,1138
"تهران","رباط_کریم","گلستان",50,1396,12,3,312,1723,29,1752
"تهران","رباط_کریم","گلستان",51,1228,12,5,212,1457,21,1478
"تهران","رباط_کریم","گلستان",52,1172,14,7,405,1598,4,1602
"تهران","رباط_کریم","گلستان",53,1041,7,4,307,1359,18,1377
"تهران","رباط_کریم","گلستان",54,734,8,7,236,985,24,1009
"تهران","رباط_کریم","گلستان",55,1170,21,6,441,1638,26,1664
"تهران","رباط_کریم","گلستان",56,727,6,3,201,937,13,950
"تهران","رباط_کریم","گلستان",57,1156,12,6,321,1495,45,1540
"تهران","رباط_کریم","گلستان",58,909,6,4,315,1234,23,1257
"تهران","رباط_کریم","گلستان",59,894,8,3,209,1114,14,1128
"تهران","رباط_کریم","گلستان",60,873,9,3,276,1161,37,1198
"تهران","رباط_کریم","گلستان",61,899,14,2,446,1361,19,1380
"تهران","رباط_کریم","گلستان",62,803,2,4,283,1092,10,1102
"تهران","رباط_کریم","گلستان",63,781,6,4,355,1146,12,1158
"تهران","رباط_کریم","گلستان",64,1416,9,3,373,1801,47,1848
"تهران","رباط_کریم","گلستان",65,960,9,3,294,1266,16,1282
"تهران","رباط_کریم","گلستان",66,1038,3,2,204,1247,23,1270
"تهران","رباط_کریم","گلستان",67,946,6,1,212,1165,19,1184
"تهران","رباط_کریم","گلستان",68,940,12,2,384,1338,23,1361
"تهران","رباط_کریم","گلستان",69,1016,6,3,210,1235,25,1260
"تهران","رباط_کریم","گلستان",70,1183,10,3,377,1573,33,1606
"تهران","رباط_کریم","گلستان",71,1197,8,7,324,1536,17,1553
"تهران","رباط_کریم","گلستان",72,1051,10,5,444,1510,13,1523
"تهران","رباط_کریم","گلستان",73,785,6,0,200,991,15,1006
"تهران","رباط_کریم","گلستان",74,1127,16,2,341,1486,12,1498
"تهران","رباط_کریم","گلستان",75,1145,7,4,420,1576,33,1609
"تهران","رباط_کریم","گلستان",76,1310,7,1,207,1525,24,1549
"تهران","رباط_کریم","گلستان",77,1061,8,2,211,1282,25,1307
"تهران","رباط_کریم","گلستان",78,895,9,0,364,1268,15,1283
"تهران","رباط_کریم","بوستان",1,938,6,5,257,1206,26,1232
"تهران","رباط_کریم","بوستان",2,1033,13,7,343,1396,20,1416
"تهران","رباط_کریم","بوستان",3,930,20,5,488,1443,27,1470
"تهران","رباط_کریم","بوستان",4,1083,7,2,236,1328,27,1355
"تهران","رباط_کریم","بوستان",5,1429,9,6,478,1922,19,1941
"تهران","رباط_کریم","بوستان",6,1343,27,5,412,1787,26,1813
"تهران","رباط_کریم","بوستان",7,906,9,7,286,1208,20,1228
"تهران","رباط_کریم","بوستان",8,938,7,2,681,1628,24,1652
"تهران","رباط_کریم","بوستان",9,556,6,5,280,847,17,864
"تهران","رباط_کریم","بوستان",10,1028,4,0,217,1249,18,1267
"تهران","رباط_کریم","بوستان",11,821,6,1,374,1202,27,1229
"تهران","رباط_کریم","بوستان",12,717,2,1,205,925,23,948
"تهران","رباط_کریم","بوستان",13,833,7,3,349,1192,10,1202
"تهران","رباط_کریم","بوستان",14,1041,4,1,385,1431,41,1472
"تهران","رباط_کریم","بوستان",15,919,9,0,461,1389,28,1417
"تهران","رباط_کریم","بوستان",16,1044,10,1,435,1490,24,1514
"تهران","رباط_کریم","بوستان",17,881,5,2,354,1242,19,1261
"تهران","رباط_کریم","بوستان",18,1038,9,0,256,1303,29,1332
"تهران","رباط_کریم","بوستان",19,1054,8,3,387,1452,27,1479
"تهران","رباط_کریم","بوستان",20,1105,12,4,501,1622,17,1639
"تهران","رباط_کریم","بوستان",21,805,9,4,416,1234,66,1300
"تهران","رباط_کریم","بوستان",22,1366,6,3,598,1973,34,2007
"تهران","رباط_کریم","بوستان",23,1158,8,0,487,1653,46,1699
"تهران","رباط_کریم","بوستان",24,954,10,3,342,1309,23,1332
"تهران","رباط_کریم","بوستان",25,722,14,5,413,1154,26,1180
"تهران","رباط_کریم","بوستان",26,669,8,0,458,1135,12,1147
"تهران","رباط_کریم","بوستان",27,935,12,2,426,1375,24,1399
"تهران","رباط_کریم","بوستان",28,881,6,3,487,1377,32,1409
"تهران","رباط_کریم","بوستان",29,855,8,2,368,1233,25,1258
"تهران","رباط_کریم","بوستان",30,948,15,2,278,1243,25,1268
"تهران","رباط_کریم","بوستان",31,1247,17,0,514,1778,31,1809
"تهران","رباط_کریم","بوستان",32,881,8,3,450,1342,32,1374
"تهران","رباط_کریم","بوستان",33,879,1,2,277,1159,42,1201
"تهران","رباط_کریم","بوستان",34,1014,10,0,322,1346,24,1370
"تهران","رباط_کریم","بوستان",35,1118,8,3,420,1549,16,1565
"تهران","رباط_کریم","بوستان",36,1018,7,1,347,1373,20,1393
"تهران","رباط_کریم","بوستان",37,845,13,2,276,1136,25,1161
"تهران","رباط_کریم","بوستان",38,908,6,1,216,1131,24,1155
"تهران","رباط_کریم","بوستان",39,1083,7,2,328,1420,24,1444
"تهران","رباط_کریم","بوستان",40,1158,9,0,235,1402,20,1422
"تهران","رباط_کریم","بوستان",41,988,17,3,443,1451,41,1492
"تهران","رباط_کریم","بوستان",42,686,7,2,436,1131,28,1159
"تهران","رباط_کریم","بوستان",43,878,17,10,473,1378,30,1408
"تهران","رباط_کریم","بوستان",44,1037,9,4,432,1482,25,1507
"تهران","رباط_کریم","بوستان",45,854,19,5,547,1425,34,1459
"تهران","رباط_کریم","بوستان",46,817,11,1,253,1082,28,1110
"تهران","رباط_کریم","بوستان",47,736,3,3,268,1010,26,1036
"تهران","رباط_کریم","بوستان",48,1160,1,0,267,1428,32,1460
"تهران","رباط_کریم","بوستان",49,1231,5,2,300,1538,36,1574
"تهران","رباط_کریم","بوستان",50,1177,8,8,252,1445,31,1476
"تهران","رباط_کریم","بوستان",51,1508,10,3,346,1867,45,1912
"تهران","رباط_کریم","بوستان",52,1247,5,1,321,1574,24,1598
"تهران","رباط_کریم","بوستان",53,1018,4,2,279,1303,26,1329
"تهران","رباط_کریم","بوستان",54,1316,11,3,332,1662,23,1685
"تهران","رباط_کریم","بوستان",55,1122,15,4,350,1491,16,1507
"تهران","رباط_کریم","بوستان",56,1202,6,3,408,1619,45,1664
"تهران","ری","مرکزی",1,831,32,7,702,1572,22,1594
"تهران","ری","مرکزی",2,807,25,6,598,1436,30,1466
"تهران","ری","مرکزی",3,350,22,9,391,772,16,788
"تهران","ری","مرکزی",4,418,23,4,322,767,16,783
"تهران","ری","مرکزی",5,602,27,3,318,950,20,970
"تهران","ری","مرکزی",6,424,15,1,217,657,6,663
"تهران","ری","مرکزی",7,589,24,2,213,828,23,851
"تهران","ری","مرکزی",8,804,29,5,242,1080,27,1107
"تهران","ری","مرکزی",9,853,30,9,298,1190,26,1216
"تهران","ری","مرکزی",10,822,15,4,255,1096,20,1116
"تهران","ری","مرکزی",11,658,16,10,149,833,19,852
"تهران","ری","مرکزی",12,1114,36,3,319,1472,33,1505
"تهران","ری","مرکزی",13,693,28,2,289,1012,18,1030
"تهران","ری","مرکزی",14,550,35,9,595,1189,26,1215
"تهران","ری","مرکزی",15,781,35,7,366,1189,22,1211
"تهران","ری","مرکزی",16,516,28,6,365,915,20,935
"تهران","ری","مرکزی",17,648,25,8,324,1005,26,1031
"تهران","ری","مرکزی",18,575,14,2,174,765,12,777
"تهران","ری","مرکزی",19,408,14,0,237,659,14,673
"تهران","ری","مرکزی",20,735,9,1,230,975,22,997
"تهران","ری","مرکزی",21,760,17,2,377,1156,25,1181
"تهران","ری","مرکزی",22,873,16,3,280,1172,20,1192
"تهران","ری","مرکزی",23,645,18,2,322,987,23,1010
"تهران","ری","مرکزی",24,826,15,2,231,1074,23,1097
"تهران","ری","مرکزی",25,699,25,3,378,1105,19,1124
"تهران","ری","مرکزی",26,362,8,1,205,576,6,582
"تهران","ری","مرکزی",27,816,37,11,479,1343,43,1386
"تهران","ری","مرکزی",28,914,28,5,593,1540,24,1564
"تهران","ری","مرکزی",29,545,21,9,495,1070,17,1087
"تهران","ری","مرکزی",30,699,17,7,318,1041,16,1057
"تهران","ری","مرکزی",31,590,8,2,183,783,20,803
"تهران","ری","مرکزی",32,573,25,14,420,1032,20,1052
"تهران","ری","مرکزی",33,428,14,6,268,716,22,738
"تهران","ری","مرکزی",34,390,21,0,312,723,9,732
"تهران","ری","مرکزی",35,631,25,1,216,873,19,892
"تهران","ری","مرکزی",36,673,10,3,154,840,13,853
"تهران","ری","مرکزی",37,430,24,0,375,829,18,847
"تهران","ری","مرکزی",38,594,24,4,420,1042,31,1073
"تهران","ری","مرکزی",39,464,14,3,315,796,25,821
"تهران","ری","مرکزی",40,600,15,5,218,838,19,857
"تهران","ری","مرکزی",41,535,25,3,358,921,18,939
"تهران","ری","مرکزی",42,633,17,2,197,849,15,864
"تهران","ری","مرکزی",43,556,24,4,275,859,17,876
"تهران","ری","مرکزی",44,401,18,3,261,683,20,703
"تهران","ری","مرکزی",45,489,21,3,187,700,18,718
"تهران","ری","مرکزی",46,762,29,12,595,1398,34,1432
"تهران","ری","مرکزی",47,498,17,5,251,771,25,796
"تهران","ری","مرکزی",48,513,12,7,438,970,16,986
"تهران","ری","مرکزی",49,293,15,6,393,707,13,720
"تهران","ری","مرکزی",50,948,23,5,434,1410,27,1437
"تهران","ری","مرکزی",51,267,16,3,367,653,6,659
"تهران","ری","مرکزی",52,614,27,3,386,1030,21,1051
"تهران","ری","مرکزی",53,682,30,5,249,966,11,977
"تهران","ری","مرکزی",54,423,25,4,293,745,9,754
"تهران","ری","مرکزی",55,784,22,8,328,1142,15,1157
"تهران","ری","مرکزی",56,760,9,4,210,983,20,1003
"تهران","ری","مرکزی",57,673,11,2,383,1069,26,1095
"تهران","ری","مرکزی",58,742,5,5,225,977,20,997
"تهران","ری","مرکزی",59,923,22,5,409,1359,27,1386
"تهران","ری","مرکزی",60,948,15,2,210,1175,19,1194
"تهران","ری","مرکزی",61,730,17,1,237,985,15,1000
"تهران","ری","مرکزی",62,743,14,3,337,1097,15,1112
"تهران","ری","مرکزی",63,598,21,11,509,1139,22,1161
"تهران","ری","مرکزی",64,492,11,8,421,932,16,948
"تهران","ری","مرکزی",65,742,19,4,345,1110,9,1119
"تهران","ری","مرکزی",66,522,12,1,270,805,24,829
"تهران","ری","مرکزی",67,364,11,0,173,548,6,554
"تهران","ری","مرکزی",68,337,16,5,224,582,18,600
"تهران","ری","مرکزی",69,454,18,1,183,656,15,671
"تهران","ری","مرکزی",70,412,16,1,250,679,17,696
"تهران","ری","مرکزی",71,697,13,3,200,913,22,935
"تهران","ری","مرکزی",72,558,13,3,300,874,13,887
"تهران","ری","مرکزی",73,831,30,2,271,1134,21,1155
"تهران","ری","مرکزی",74,283,15,6,387,691,17,708
"تهران","ری","مرکزی",75,331,9,0,189,529,14,543
"تهران","ری","مرکزی",76,375,13,2,161,551,12,563
"تهران","ری","مرکزی",77,463,16,4,307,790,27,817
"تهران","ری","مرکزی",78,895,18,3,326,1242,25,1267
"تهران","ری","مرکزی",79,534,7,2,170,713,11,724
"تهران","ری","مرکزی",80,948,18,8,463,1437,27,1464
"تهران","ری","مرکزی",81,401,18,9,361,789,7,796
"تهران","ری","مرکزی",82,607,10,3,315,935,22,957
"تهران","ری","مرکزی",83,826,12,4,285,1127,17,1144
"تهران","ری","مرکزی",84,593,15,1,191,800,19,819
"تهران","ری","مرکزی",85,405,13,0,125,543,10,553
"تهران","ری","مرکزی",86,384,9,0,133,526,10,536
"تهران","ری","مرکزی",87,630,7,2,229,868,15,883
"تهران","ری","مرکزی",88,676,7,2,124,809,11,820
"تهران","ری","مرکزی",89,902,15,3,352,1272,11,1283
"تهران","ری","مرکزی",90,314,1,0,87,402,4,406
"تهران","ری","مرکزی",91,624,6,2,227,859,16,875
"تهران","ری","مرکزی",92,738,3,0,167,908,15,923
"تهران","ری","مرکزی",93,912,10,0,177,1099,8,1107
"تهران","ری","مرکزی",94,550,9,3,361,923,20,943
"تهران","ری","مرکزی",95,600,3,0,158,761,18,779
"تهران","ری","مرکزی",96,766,12,8,358,1144,29,1173
"تهران","ری","مرکزی",97,830,9,1,340,1180,23,1203
"تهران","ری","مرکزی",98,942,7,1,317,1267,20,1287
"تهران","ری","مرکزی",99,1023,14,4,441,1482,27,1509
"تهران","ری","مرکزی",100,808,11,4,219,1042,7,1049
"تهران","ری","مرکزی",101,1021,16,1,206,1244,14,1258
"تهران","ری","مرکزی",102,489,14,5,223,731,6,737
"تهران","ری","مرکزی",103,609,22,4,203,838,21,859
"تهران","ری","مرکزی",104,398,12,2,184,596,20,616
"تهران","ری","مرکزی",105,399,10,1,131,541,12,553
"تهران","ری","مرکزی",106,567,23,3,336,929,27,956
"تهران","ری","مرکزی",107,420,14,0,224,658,11,669
"تهران","ری","مرکزی",108,531,11,2,196,740,10,750
"تهران","ری","مرکزی",109,572,23,9,399,1003,23,1026
"تهران","ری","مرکزی",110,621,26,4,303,954,32,986
"تهران","ری","مرکزی",111,571,40,5,358,974,16,990
"تهران","ری","مرکزی",112,660,19,4,225,908,18,926
"تهران","ری","مرکزی",113,342,26,10,482,860,16,876
"تهران","ری","مرکزی",114,441,11,2,217,671,18,689
"تهران","ری","مرکزی",115,614,17,1,189,821,15,836
"تهران","ری","مرکزی",116,644,19,0,218,881,18,899
"تهران","ری","مرکزی",117,511,25,6,163,705,15,720
"تهران","ری","مرکزی",118,586,18,5,147,756,11,767
"تهران","ری","مرکزی",119,877,30,9,465,1381,20,1401
"تهران","ری","مرکزی",120,759,15,2,269,1045,14,1059
"تهران","ری","مرکزی",121,802,42,3,719,1566,35,1601
"تهران","ری","مرکزی",122,797,24,0,419,1240,21,1261
"تهران","ری","مرکزی",123,263,5,2,231,501,12,513
"تهران","ری","مرکزی",124,203,9,2,145,359,10,369
"تهران","ری","مرکزی",125,44,3,0,289,336,4,340
"تهران","ری","مرکزی",126,802,18,5,432,1257,31,1288
"تهران","ری","مرکزی",127,725,12,4,232,973,25,998
"تهران","ری","مرکزی",128,899,19,11,540,1469,29,1498
"تهران","ری","مرکزی",129,1005,22,7,381,1415,85,1500
"تهران","ری","مرکزی",130,519,14,5,393,931,11,942
"تهران","ری","مرکزی",131,734,21,0,449,1204,28,1232
"تهران","ری","مرکزی",132,778,22,1,300,1101,18,1119
"تهران","ری","مرکزی",133,779,13,5,425,1222,21,1243
"تهران","ری","مرکزی",134,616,21,10,470,1117,24,1141
"تهران","ری","مرکزی",135,429,17,3,242,691,17,708
"تهران","ری","مرکزی",136,905,32,12,472,1421,34,1455
"تهران","ری","مرکزی",137,998,20,3,288,1309,24,1333
"تهران","ری","مرکزی",138,374,30,5,631,1040,7,1047
"تهران","ری","مرکزی",139,430,28,7,567,1032,21,1053
"تهران","ری","مرکزی",140,828,21,3,356,1208,29,1237
"تهران","ری","مرکزی",141,1016,20,1,285,1322,32,1354
"تهران","ری","مرکزی",142,591,23,4,508,1126,20,1146
"تهران","ری","مرکزی",143,374,13,2,232,621,17,638
"تهران","ری","مرکزی",144,380,17,4,314,715,10,725
"تهران","ری","مرکزی",145,561,18,2,306,887,12,899
"تهران","ری","مرکزی",146,578,12,1,178,769,24,793
"تهران","ری","مرکزی",147,620,23,5,321,969,31,1000
"تهران","ری","مرکزی",148,719,17,3,207,946,15,961
"تهران","ری","مرکزی",149,493,15,6,232,746,11,757
"تهران","ری","مرکزی",150,509,22,2,200,733,16,749
"تهران","ری","مرکزی",151,424,10,1,283,718,8,726
"تهران","ری","مرکزی",152,510,14,3,187,714,11,725
"تهران","ری","مرکزی",153,301,10,1,182,494,12,506
"تهران","ری","مرکزی",154,380,5,2,121,508,13,521
"تهران","ری","مرکزی",155,272,8,3,261,544,7,551
"تهران","ری","مرکزی",156,526,15,4,633,1178,32,1210
"تهران","ری","مرکزی",157,611,29,7,412,1059,41,1100
"تهران","ری","مرکزی",158,753,21,9,301,1084,35,1119
"تهران","ری","مرکزی",159,722,25,9,483,1239,12,1251
"تهران","ری","مرکزی",160,694,15,4,285,998,15,1013
"تهران","ری","مرکزی",161,691,12,3,186,892,8,900
"تهران","ری","مرکزی",162,494,14,2,195,705,11,716
"تهران","ری","مرکزی",163,524,18,1,137,680,6,686
"تهران","ری","مرکزی",164,385,13,1,432,831,14,845
"تهران","ری","مرکزی",165,497,11,1,128,637,13,650
"تهران","ری","مرکزی",166,575,24,4,247,850,19,869
"تهران","ری","مرکزی",167,746,19,3,352,1120,18,1138
"تهران","ری","مرکزی",168,799,18,6,235,1058,15,1073
"تهران","ری","مرکزی",169,471,7,1,252,731,5,736
"تهران","ری","مرکزی",170,406,4,0,159,569,6,575
"تهران","ری","مرکزی",171,638,13,0,325,976,24,1000
"تهران","ری","مرکزی",172,325,7,3,450,785,10,795
"تهران","ری","مرکزی",173,615,21,4,382,1022,19,1041
"تهران","ری","مرکزی",174,635,14,1,254,904,17,921
"تهران","ری","مرکزی",175,261,6,6,210,483,6,489
"تهران","ری","مرکزی",176,368,10,0,182,560,20,580
"تهران","ری","مرکزی",177,950,6,3,306,1265,24,1289
"تهران","ری","مرکزی",178,802,8,2,384,1196,2,1198
"تهران","ری","مرکزی",179,565,16,1,139,721,21,742
"تهران","ری","مرکزی",180,562,14,3,468,1047,21,1068
"تهران","ری","مرکزی",181,694,16,4,435,1149,15,1164
"تهران","ری","مرکزی",182,635,17,0,262,914,7,921
"تهران","ری","مرکزی",183,689,31,4,435,1159,17,1176
"تهران","ری","مرکزی",184,831,23,3,349,1206,21,1227
"تهران","ری","مرکزی",185,707,19,2,473,1201,17,1218
"تهران","ری","مرکزی",186,654,26,3,277,960,37,997
"تهران","ری","مرکزی",187,749,22,1,165,937,23,960
"تهران","ری","مرکزی",188,609,22,4,511,1146,21,1167
"تهران","ری","مرکزی",189,574,25,8,701,1308,32,1340
"تهران","ری","مرکزی",190,385,19,2,399,805,20,825
"تهران","ری","مرکزی",191,499,21,5,432,957,28,985
"تهران","ری","مرکزی",192,577,40,5,570,1192,30,1222
"تهران","ری","مرکزی",193,647,19,5,379,1050,31,1081
"تهران","ری","مرکزی",194,582,20,6,524,1132,28,1160
"تهران","ری","مرکزی",195,740,36,6,377,1159,33,1192
"تهران","ری","مرکزی",196,499,31,6,574,1110,23,1133
"تهران","ری","مرکزی",197,611,26,2,434,1073,15,1088
"تهران","ری","مرکزی",198,358,10,4,353,725,20,745
"تهران","ری","مرکزی",199,364,10,4,287,665,13,678
"تهران","ری","مرکزی",200,502,21,9,592,1124,23,1147
"تهران","ری","مرکزی",201,601,19,6,436,1062,21,1083
"تهران","ری","مرکزی",202,798,22,5,283,1108,22,1130
"تهران","ری","مرکزی",203,1034,24,3,210,1271,20,1291
"تهران","ری","مرکزی",204,490,35,7,369,901,12,913
"تهران","ری","مرکزی",205,611,30,4,320,965,25,990
"تهران","ری","مرکزی",206,633,80,3,491,1207,40,1247
"تهران","ری","مرکزی",207,619,44,6,608,1277,39,1316
"تهران","ری","مرکزی",208,577,37,1,344,959,9,968
"تهران","ری","مرکزی",209,651,41,2,361,1055,15,1070
"تهران","ری","مرکزی",210,660,9,6,250,925,13,938
"تهران","ری","مرکزی",211,629,11,2,146,788,16,804
"تهران","ری","مرکزی",212,733,22,17,666,1438,21,1459
"تهران","ری","مرکزی",213,703,18,7,390,1118,15,1133
"تهران","ری","مرکزی",214,877,11,5,519,1412,32,1444
"تهران","ری","مرکزی",215,694,13,1,270,978,12,990
"تهران","ری","مرکزی",216,437,13,0,226,676,16,692
"تهران","ری","مرکزی",217,535,5,0,184,724,19,743
"تهران","ری","مرکزی",218,933,13,2,379,1327,16,1343
"تهران","ری","مرکزی",219,1002,9,2,209,1222,20,1242
"تهران","ری","مرکزی",220,588,12,2,472,1074,26,1100
"تهران","ری","مرکزی",221,555,13,1,263,832,10,842
"تهران","ری","مرکزی",222,1360,20,5,441,1826,38,1864
"تهران","ری","مرکزی",223,1060,8,0,195,1263,14,1277
"تهران","ری","مرکزی",224,833,13,2,340,1188,13,1201
"تهران","ری","مرکزی",225,1029,8,2,189,1228,17,1245
"تهران","ری","مرکزی",226,919,10,2,521,1452,24,1476
"تهران","ری","مرکزی",227,874,11,3,502,1390,18,1408
"تهران","ری","مرکزی",228,930,15,1,283,1229,10,1239
"تهران","ری","مرکزی",229,789,9,4,343,1145,20,1165
"تهران","ری","مرکزی",230,828,7,0,409,1244,26,1270
"تهران","ری","مرکزی",231,867,7,0,243,1117,21,1138
"تهران","ری","مرکزی",232,784,17,9,344,1154,18,1172
"تهران","ری","مرکزی",233,330,10,0,131,471,7,478
"تهران","ری","مرکزی",234,512,8,2,291,813,16,829
"تهران","ری","مرکزی",235,812,29,2,512,1355,20,1375
"تهران","ری","مرکزی",236,822,20,1,394,1237,21,1258
"تهران","ری","مرکزی",237,424,10,3,325,762,10,772
"تهران","ری","مرکزی",238,631,25,10,609,1275,17,1292
"تهران","ری","مرکزی",239,451,14,10,419,894,14,908
"تهران","ری","مرکزی",240,606,26,2,294,928,28,956
"تهران","ری","مرکزی",241,210,7,1,170,388,6,394
"تهران","ری","مرکزی",242,627,25,3,451,1106,18,1124
"تهران","ری","مرکزی",243,409,17,0,170,596,18,614
"تهران","ری","مرکزی",244,368,3,10,169,550,5,555
"تهران","ری","مرکزی",245,394,10,3,417,824,20,844
"تهران","ری","مرکزی",246,510,8,4,308,830,10,840
"تهران","ری","مرکزی",247,815,19,9,441,1284,15,1299
"تهران","ری","مرکزی",248,698,30,4,444,1176,32,1208
"تهران","ری","مرکزی",249,781,21,2,323,1127,8,1135
"تهران","ری","مرکزی",250,594,18,3,331,946,10,956
"تهران","ری","مرکزی",251,548,19,2,305,874,19,893
"تهران","ری","مرکزی",252,527,5,3,244,779,6,785
"تهران","ری","مرکزی",253,575,5,3,255,838,16,854
"تهران","ری","مرکزی",254,453,3,5,217,678,9,687
"تهران","ری","مرکزی",255,143,10,0,104,257,13,270
"تهران","ری","مرکزی",256,530,5,0,164,699,13,712
"تهران","ری","مرکزی",257,338,6,2,172,518,12,530
"تهران","ری","مرکزی",258,649,14,4,209,876,24,900
"تهران","ری","مرکزی",259,309,10,1,151,471,11,482
"تهران","ری","مرکزی",260,469,6,1,154,630,4,634
"تهران","ری","مرکزی",261,180,3,3,101,287,7,294
"تهران","ری","مرکزی",262,234,2,0,66,302,3,305
"تهران","ری","مرکزی",263,474,13,1,250,738,20,758
"تهران","ری","مرکزی",264,246,3,0,97,346,5,351
"تهران","ری","مرکزی",265,332,10,5,174,521,10,531
"تهران","ری","مرکزی",266,629,24,7,431,1091,17,1108
"تهران","ری","مرکزی",267,388,16,1,306,711,12,723
"تهران","ری","مرکزی",268,434,10,4,303,751,7,758
"تهران","ری","مرکزی",269,121,2,1,45,169,4,173
"تهران","ری","مرکزی",270,298,13,1,204,516,13,529
"تهران","ری","مرکزی",271,570,24,3,319,916,3,919
"تهران","ری","مرکزی",272,438,1,0,184,623,18,641
"تهران","ری","مرکزی",273,267,7,3,193,470,12,482
"تهران","ری","مرکزی",274,179,2,0,118,299,4,303
"تهران","ری","فشافویه",1,933,13,1,251,1198,12,1210
"تهران","ری","فشافویه",2,372,3,0,131,506,16,522
"تهران","ری","فشافویه",3,422,8,0,109,539,5,544
"تهران","ری","فشافویه",4,721,7,3,302,1033,22,1055
"تهران","ری","فشافویه",5,679,9,2,171,861,12,873
"تهران","ری","فشافویه",6,788,17,5,456,1266,22,1288
"تهران","ری","فشافویه",7,483,12,1,199,695,19,714
"تهران","ری","فشافویه",8,383,9,1,180,573,11,584
"تهران","ری","فشافویه",9,768,6,0,237,1011,14,1025
"تهران","ری","فشافویه",10,422,9,2,128,561,12,573
"تهران","ری","فشافویه",11,439,1,1,166,607,6,613
"تهران","ری","فشافویه",12,665,45,26,935,1671,25,1696
"تهران","ری","فشافویه",13,805,60,24,831,1720,37,1757
"تهران","ری","فشافویه",14,638,8,4,168,818,19,837
"تهران","ری","فشافویه",15,307,14,3,231,555,20,575
"تهران","ری","فشافویه",16,218,13,1,153,385,6,391
"تهران","ری","فشافویه",17,635,1,1,124,761,15,776
"تهران","ری","فشافویه",18,349,13,2,76,440,2,442
"تهران","ری","فشافویه",19,152,6,0,108,266,11,277
"تهران","ری","فشافویه",20,157,0,1,32,190,4,194
"تهران","ری","فشافویه",21,230,2,0,68,300,12,312
"تهران","ری","فشافویه",22,143,0,0,23,166,0,166
"تهران","ری","فشافویه",23,418,3,0,53,474,4,478
"تهران","ری","فشافویه",24,66,0,0,64,130,1,131
"تهران","ری","فشافویه",25,218,4,0,57,279,10,289
"تهران","ری","کهریزک",1,616,10,3,348,977,11,988
"تهران","ری","کهریزک",2,647,16,2,208,873,20,893
"تهران","ری","کهریزک",3,483,13,3,200,699,14,713
"تهران","ری","کهریزک",4,276,7,12,162,457,0,457
"تهران","ری","کهریزک",5,551,13,1,226,791,15,806
"تهران","ری","کهریزک",6,535,11,1,129,676,9,685
"تهران","ری","کهریزک",7,575,7,11,254,847,14,861
"تهران","ری","کهریزک",8,685,11,4,188,888,18,906
"تهران","ری","کهریزک",9,508,2,7,215,732,6,738
"تهران","ری","کهریزک",10,595,16,13,338,962,38,1000
"تهران","ری","کهریزک",11,234,9,0,134,377,7,384
"تهران","ری","کهریزک",12,1222,26,4,399,1651,38,1689
"تهران","ری","کهریزک",13,508,12,5,179,704,11,715
"تهران","ری","کهریزک",14,550,9,10,404,973,25,998
"تهران","ری","کهریزک",15,610,12,5,394,1021,20,1041
"تهران","ری","کهریزک",16,826,11,14,434,1285,21,1306
"تهران","ری","کهریزک",17,813,10,17,363,1203,15,1218
"تهران","ری","کهریزک",18,741,1,11,175,928,6,934
"تهران","ری","کهریزک",19,842,14,8,332,1196,24,1220
"تهران","ری","کهریزک",20,595,12,20,432,1059,23,1082
"تهران","ری","کهریزک",21,400,3,7,237,647,11,658
"تهران","ری","کهریزک",22,614,7,17,262,900,22,922
"تهران","ری","کهریزک",23,370,8,4,212,594,7,601
"تهران","ری","کهریزک",24,609,13,3,455,1080,13,1093
"تهران","ری","کهریزک",25,415,8,5,280,708,12,720
"تهران","ری","کهریزک",26,543,9,4,182,738,10,748
"تهران","ری","کهریزک",27,268,15,2,158,443,11,454
"تهران","ری","کهریزک",28,594,25,4,290,913,4,917
"تهران","ری","کهریزک",29,471,14,2,164,651,12,663
"تهران","ری","کهریزک",30,205,0,0,67,272,9,281
"تهران","ری","کهریزک",31,448,5,3,211,667,10,677
"تهران","ری","کهریزک",32,406,6,0,120,532,15,547
"تهران","ری","کهریزک",33,616,7,3,204,830,22,852
"تهران","ری","کهریزک",34,544,12,6,297,859,15,874
"تهران","ری","کهریزک",35,486,4,5,183,678,11,689
"تهران","ری","کهریزک",36,204,2,0,73,279,0,279
"تهران","ری","کهریزک",37,142,0,0,50,192,3,195
"تهران","ری","کهریزک",38,264,3,2,75,344,10,354
"تهران","ری","کهریزک",39,330,15,0,171,516,7,523
"تهران","ری","کهریزک",40,455,8,2,97,562,11,573
"تهران","ری","کهریزک",41,484,1,0,154,639,9,648
"تهران","ری","کهریزک",42,189,2,0,63,254,10,264
"تهران","ری","کهریزک",43,830,7,2,231,1070,7,1077
"تهران","ری","کهریزک",44,416,5,0,253,674,7,681
"تهران","ری","کهریزک",45,378,4,2,195,579,10,589
"تهران","ری","کهریزک",46,390,7,3,200,600,10,610
"تهران","ری","کهریزک",47,304,6,2,91,403,8,411
"تهران","ری","کهریزک",48,170,1,0,77,248,5,253
"تهران","ری","کهریزک",49,299,3,1,90,393,10,403
"تهران","ری","کهریزک",50,141,3,0,27,171,0,171
"تهران","ری","کهریزک",51,393,9,5,145,552,14,566
"تهران","ری","کهریزک",52,99,4,0,26,129,4,133
"تهران","ری","کهریزک",53,144,15,1,66,226,5,231
"تهران","ری","کهریزک",54,300,1,2,164,467,6,473
"تهران","ری","کهریزک",55,48,33,0,0,81,0,81
"تهران","ری","کهریزک",56,210,2,0,103,315,6,321
"تهران","ری","کهریزک",57,702,18,5,158,883,13,896
"تهران","ری","کهریزک",58,174,7,0,38,219,4,223
"تهران","ری","کهریزک",59,229,8,1,90,328,1,329
"تهران","ری","کهریزک",60,661,10,6,181,858,10,868
"تهران","ری","کهریزک",61,522,7,2,134,665,13,678
"تهران","ری","کهریزک",62,589,4,2,106,701,23,724
"تهران","ری","کهریزک",63,206,1,0,72,279,10,289
"تهران","ری","کهریزک",64,537,7,1,174,719,29,748
"تهران","ری","کهریزک",65,474,2,1,86,563,15,578
"تهران","ری","کهریزک",66,284,3,0,114,401,7,408
"تهران","ری","کهریزک",67,162,0,0,17,179,1,180
"تهران","ری","کهریزک",68,384,6,1,110,501,18,519
"تهران","ری","کهریزک",69,154,0,0,35,189,5,194
"تهران","ری","کهریزک",70,767,11,3,185,966,28,994
"تهران","ری","کهریزک",71,679,7,0,238,924,11,935
"تهران","ری","کهریزک",72,445,13,0,87,545,9,554
"تهران","ری","کهریزک",73,493,2,1,170,666,8,674
"تهران","ری","کهریزک",74,483,5,2,141,631,26,657
"تهران","ری","کهریزک",75,407,7,0,100,514,11,525
"تهران","ری","کهریزک",76,727,4,4,159,894,19,913
"تهران","ری","کهریزک",77,834,10,9,85,938,11,949
"تهران","ری","کهریزک",78,332,7,3,66,408,6,414
"تهران","ری","کهریزک",79,557,4,4,134,699,15,714
"تهران","ری","کهریزک",80,290,2,0,67,359,0,359
"تهران","ری","کهریزک",81,257,1,0,52,310,0,310
"تهران","ری","کهریزک",82,399,3,0,43,445,9,454
"تهران","ری","کهریزک",83,470,6,0,143,619,10,629
"تهران","ری","کهریزک",84,354,5,1,136,496,8,504
"تهران","ری","کهریزک",85,108,0,0,26,134,2,136
"تهران","ری","کهریزک",86,412,1,2,88,503,9,512
"تهران","ری","کهریزک",87,273,1,0,43,317,4,321
"تهران","ری","کهریزک",88,330,2,0,57,389,7,396
"تهران","ری","کهریزک",89,463,2,0,63,528,3,531
"تهران","ری","کهریزک",90,644,5,3,181,833,13,846
"تهران","ری","کهریزک",91,766,6,5,202,979,12,991
"تهران","ری","کهریزک",92,721,6,0,226,953,14,967
"تهران","ری","کهریزک",93,194,4,2,133,333,6,339
"تهران","ری","کهریزک",94,227,19,3,148,397,7,404
"تهران","ری","کهریزک",95,105,1,0,48,154,6,160
"تهران","ری","کهریزک",96,155,3,2,39,199,0,199
"تهران","ری","کهریزک",97,351,5,5,284,645,18,663
"تهران","ری","کهریزک",98,97,2,3,30,132,4,136
"تهران","ری","کهریزک",99,59,4,1,13,77,1,78
"تهران","ری","کهریزک",100,81,1,0,17,99,0,99
"تهران","ری","کهریزک",101,54,1,0,16,71,0,71
"تهران","ساوجبلاغ","مرکزی",1,933,26,13,583,1555,46,1601
"تهران","ساوجبلاغ","مرکزی",2,894,11,4,367,1276,14,1290
"تهران","ساوجبلاغ","مرکزی",3,895,17,12,643,1567,23,1590
"تهران","ساوجبلاغ","مرکزی",4,277,12,13,279,581,15,596
"تهران","ساوجبلاغ","مرکزی",5,955,26,5,496,1482,13,1495
"تهران","ساوجبلاغ","مرکزی",6,750,12,2,263,1027,13,1040
"تهران","ساوجبلاغ","مرکزی",7,504,12,1,208,725,19,744
"تهران","ساوجبلاغ","مرکزی",8,906,29,9,615,1559,37,1596
"تهران","ساوجبلاغ","مرکزی",9,963,28,11,563,1565,23,1588
"تهران","ساوجبلاغ","مرکزی",10,860,22,4,462,1348,26,1374
"تهران","ساوجبلاغ","مرکزی",11,489,4,23,378,894,11,905
"تهران","ساوجبلاغ","مرکزی",12,737,18,30,1094,1879,45,1924
"تهران","ساوجبلاغ","مرکزی",13,494,6,14,448,962,16,978
"تهران","ساوجبلاغ","مرکزی",14,699,5,10,374,1088,22,1110
"تهران","ساوجبلاغ","مرکزی",15,525,1,35,564,1125,20,1145
"تهران","ساوجبلاغ","مرکزی",16,524,7,13,732,1276,24,1300
"تهران","ساوجبلاغ","مرکزی",17,540,6,18,532,1096,21,1117
"تهران","ساوجبلاغ","مرکزی",18,555,13,7,471,1046,8,1054
"تهران","ساوجبلاغ","مرکزی",19,606,7,8,296,917,21,938
"تهران","ساوجبلاغ","مرکزی",20,825,16,10,317,1168,17,1185
"تهران","ساوجبلاغ","مرکزی",21,1239,11,5,277,1532,14,1546
"تهران","ساوجبلاغ","مرکزی",22,291,1,2,116,410,1,411
"تهران","ساوجبلاغ","مرکزی",23,661,22,5,492,1180,16,1196
"تهران","ساوجبلاغ","مرکزی",24,550,6,2,476,1034,16,1050
"تهران","ساوجبلاغ","مرکزی",25,1098,6,13,296,1413,19,1432
"تهران","ساوجبلاغ","مرکزی",26,997,7,5,213,1222,18,1240
"تهران","ساوجبلاغ","مرکزی",27,222,8,2,91,323,8,331
"تهران","ساوجبلاغ","مرکزی",28,1138,30,12,772,1952,32,1984
"تهران","ساوجبلاغ","مرکزی",29,743,29,18,967,1757,22,1779
"تهران","ساوجبلاغ","مرکزی",30,902,33,25,807,1767,28,1795
"تهران","ساوجبلاغ","مرکزی",31,672,16,12,447,1147,15,1162
"تهران","ساوجبلاغ","مرکزی",32,283,5,5,240,533,2,535
"تهران","ساوجبلاغ","مرکزی",33,392,4,5,322,723,5,728
"تهران","ساوجبلاغ","مرکزی",34,144,4,0,81,229,5,234
"تهران","ساوجبلاغ","مرکزی",35,1085,20,4,390,1499,36,1535
"تهران","ساوجبلاغ","مرکزی",36,530,6,2,262,800,16,816
"تهران","ساوجبلاغ","مرکزی",37,548,15,5,395,963,22,985
"تهران","ساوجبلاغ","مرکزی",38,761,28,2,387,1178,24,1202
"تهران","ساوجبلاغ","مرکزی",39,563,16,7,333,919,20,939
"تهران","ساوجبلاغ","مرکزی",40,819,9,5,234,1067,12,1079
"تهران","ساوجبلاغ","مرکزی",41,748,12,3,132,895,6,901
"تهران","ساوجبلاغ","مرکزی",42,253,5,0,79,337,6,343
"تهران","ساوجبلاغ","مرکزی",43,784,20,1,201,1006,8,1014
"تهران","ساوجبلاغ","مرکزی",44,563,12,3,193,771,6,777
"تهران","ساوجبلاغ","مرکزی",45,721,12,3,280,1016,8,1024
"تهران","ساوجبلاغ","مرکزی",46,512,5,2,97,616,15,631
"تهران","ساوجبلاغ","مرکزی",47,368,11,1,127,507,10,517
"تهران","ساوجبلاغ","مرکزی",48,851,17,4,499,1371,11,1382
"تهران","ساوجبلاغ","مرکزی",49,1197,9,7,255,1468,35,1503
"تهران","ساوجبلاغ","مرکزی",50,547,9,4,67,627,6,633
"تهران","ساوجبلاغ","مرکزی",51,654,8,0,245,907,9,916
"تهران","ساوجبلاغ","مرکزی",52,331,1,2,66,400,2,402
"تهران","ساوجبلاغ","مرکزی",53,490,6,1,156,653,17,670
"تهران","ساوجبلاغ","مرکزی",54,605,3,1,250,859,6,865
"تهران","ساوجبلاغ","مرکزی",55,448,10,2,311,771,8,779
"تهران","ساوجبلاغ","مرکزی",56,356,2,0,157,515,3,518
"تهران","ساوجبلاغ","مرکزی",57,516,0,3,141,660,3,663
"تهران","ساوجبلاغ","مرکزی",58,419,10,1,201,631,6,637
"تهران","ساوجبلاغ","مرکزی",59,616,10,4,134,764,8,772
"تهران","ساوجبلاغ","مرکزی",60,1103,16,8,235,1362,21,1383
"تهران","ساوجبلاغ","مرکزی",61,868,6,10,193,1077,5,1082
"تهران","ساوجبلاغ","مرکزی",62,980,19,21,317,1337,23,1360
"تهران","ساوجبلاغ","مرکزی",63,873,19,24,136,1052,9,1061
"تهران","ساوجبلاغ","مرکزی",64,887,37,23,109,1056,13,1069
"تهران","ساوجبلاغ","چشمدار",1,844,9,15,351,1219,21,1240
"تهران","ساوجبلاغ","چشمدار",2,877,14,6,316,1213,0,1213
"تهران","ساوجبلاغ","چشمدار",3,707,12,8,390,1117,17,1134
"تهران","ساوجبلاغ","چشمدار",4,498,19,3,682,1202,10,1212
"تهران","ساوجبلاغ","چشمدار",5,493,13,22,644,1172,16,1188
"تهران","ساوجبلاغ","چشمدار",6,406,10,23,306,745,12,757
"تهران","ساوجبلاغ","چشمدار",7,238,4,1,197,440,4,444
"تهران","ساوجبلاغ","چشمدار",8,511,18,4,433,966,20,986
"تهران","ساوجبلاغ","چشمدار",9,688,21,3,291,1003,9,1012
"تهران","ساوجبلاغ","چشمدار",10,644,14,39,374,1071,6,1077
"تهران","ساوجبلاغ","چشمدار",11,219,1,1,50,271,7,278
"تهران","ساوجبلاغ","چشمدار",12,408,6,2,147,563,12,575
"تهران","ساوجبلاغ","چشمدار",13,427,18,7,219,671,0,671
"تهران","ساوجبلاغ","چشمدار",14,667,23,7,438,1135,12,1147
"تهران","ساوجبلاغ","چشمدار",15,482,24,29,912,1447,9,1456
"تهران","ساوجبلاغ","چشمدار",16,311,4,4,166,485,23,508
"تهران","ساوجبلاغ","چشمدار",17,367,4,1,193,565,19,584
"تهران","ساوجبلاغ","چشمدار",18,287,4,1,86,378,2,380
"تهران","ساوجبلاغ","چشمدار",19,170,7,3,208,388,8,396
"تهران","ساوجبلاغ","چشمدار",20,415,24,6,489,934,7,941
"تهران","ساوجبلاغ","چشمدار",21,478,26,10,717,1231,13,1244
"تهران","ساوجبلاغ","چهارباغ",1,763,22,29,465,1279,21,1300
"تهران","ساوجبلاغ","چهارباغ",2,1036,7,5,296,1344,15,1359
"تهران","ساوجبلاغ","چهارباغ",3,684,12,7,495,1198,26,1224
"تهران","ساوجبلاغ","چهارباغ",4,930,4,7,167,1108,17,1125
"تهران","ساوجبلاغ","چهارباغ",5,803,7,3,220,1033,20,1053
"تهران","ساوجبلاغ","چهارباغ",6,1389,5,3,284,1681,19,1700
"تهران","ساوجبلاغ","چهارباغ",7,566,15,3,590,1174,12,1186
"تهران","ساوجبلاغ","چهارباغ",8,869,3,4,196,1072,5,1077
"تهران","ساوجبلاغ","چهارباغ",9,1231,8,7,183,1429,8,1437
"تهران","ساوجبلاغ","چهارباغ",10,926,8,14,172,1120,6,1126
"تهران","ساوجبلاغ","چهارباغ",11,1170,12,46,140,1368,21,1389
"تهران","ساوجبلاغ","چهارباغ",12,894,5,42,143,1084,10,1094
"تهران","ساوجبلاغ","چهارباغ",13,990,9,18,224,1241,13,1254
"تهران","ساوجبلاغ","چهارباغ",14,539,4,5,116,664,7,671
"تهران","ساوجبلاغ","چهارباغ",15,862,8,37,313,1220,10,1230
"تهران","ساوجبلاغ","چهارباغ",16,769,7,4,230,1010,8,1018
"تهران","ساوجبلاغ","چهارباغ",17,770,11,7,260,1048,10,1058
"تهران","ساوجبلاغ","چهارباغ",18,402,8,0,145,555,6,561
"تهران","ساوجبلاغ","چهارباغ",19,465,9,2,195,671,11,682
"تهران","ساوجبلاغ","چهارباغ",20,561,8,6,440,1015,12,1027
"تهران","ساوجبلاغ","چهارباغ",21,713,4,1,329,1047,4,1051
"تهران","ساوجبلاغ","چهارباغ",22,625,2,8,329,964,10,974
"تهران","ساوجبلاغ","چهارباغ",23,691,5,3,172,871,13,884
"تهران","ساوجبلاغ","چهارباغ",24,971,13,5,394,1383,3,1386
"تهران","ساوجبلاغ","چهارباغ",25,1137,1,4,127,1269,14,1283
"تهران","ساوجبلاغ","چهارباغ",26,632,19,2,235,888,9,897
"تهران","ساوجبلاغ","چهارباغ",27,394,5,10,125,534,5,539
"تهران","ساوجبلاغ","چهارباغ",28,430,7,4,160,601,5,606
"تهران","ساوجبلاغ","چهارباغ",29,226,7,4,337,574,4,578
"تهران","ساوجبلاغ","چهارباغ",30,234,5,0,267,506,3,509
"تهران","ساوجبلاغ","طالقان",1,356,17,8,404,785,10,795
"تهران","ساوجبلاغ","طالقان",2,297,7,2,192,498,13,511
"تهران","ساوجبلاغ","طالقان",3,439,19,3,340,801,10,811
"تهران","ساوجبلاغ","طالقان",4,326,6,3,275,610,1,611
"تهران","ساوجبلاغ","طالقان",5,186,13,1,318,518,9,527
"تهران","ساوجبلاغ","طالقان",6,239,3,0,88,330,5,335
"تهران","ساوجبلاغ","طالقان",7,280,1,0,61,342,3,345
"تهران","ساوجبلاغ","طالقان",8,545,19,0,123,687,6,693
"تهران","ساوجبلاغ","طالقان",9,702,4,1,67,774,5,779
"تهران","ساوجبلاغ","طالقان",10,405,8,1,193,607,8,615
"تهران","ساوجبلاغ","طالقان",11,138,4,0,127,269,3,272
"تهران","ساوجبلاغ","طالقان",12,347,6,2,111,466,3,469
"تهران","ساوجبلاغ","طالقان",13,290,5,0,76,371,10,381
"تهران","ساوجبلاغ","طالقان",14,104,5,0,92,201,4,205
"تهران","ساوجبلاغ","طالقان",15,484,8,0,91,583,6,589
"تهران","ساوجبلاغ","طالقان",16,189,6,0,75,270,11,281
"تهران","ساوجبلاغ","طالقان",17,300,8,1,123,432,8,440
"تهران","ساوجبلاغ","طالقان",18,151,2,1,85,239,3,242
"تهران","ساوجبلاغ","طالقان",19,262,3,1,76,342,7,349
"تهران","ساوجبلاغ","طالقان",20,492,13,1,318,824,17,841
"تهران","ساوجبلاغ","طالقان",21,295,15,1,374,685,9,694
"تهران","ساوجبلاغ","طالقان",22,279,18,3,336,636,8,644
"تهران","ساوجبلاغ","طالقان",23,275,5,3,344,627,15,642
"تهران","ساوجبلاغ","طالقان",24,249,10,3,194,456,15,471
"تهران","ساوجبلاغ","طالقان",25,120,1,2,66,189,2,191
"تهران","ساوجبلاغ","طالقان",26,259,8,2,94,363,6,369
"تهران","ساوجبلاغ","طالقان",27,70,0,0,38,108,3,111
"تهران","ساوجبلاغ","طالقان",28,125,4,1,119,249,0,249
"تهران","ساوجبلاغ","طالقان",29,140,1,0,118,259,3,262
"تهران","ساوجبلاغ","طالقان",30,136,0,0,34,170,1,171
"تهران","ساوجبلاغ","طالقان",31,260,3,1,101,365,4,369
"تهران","ساوجبلاغ","طالقان",32,171,0,0,28,199,1,200
"تهران","ساوجبلاغ","طالقان",33,507,22,15,546,1090,14,1104
"تهران","شمیرانات","مرکزی",1,547,53,35,1274,1909,13,1922
"تهران","شمیرانات","مرکزی",2,646,61,44,1514,2265,31,2296
"تهران","شمیرانات","مرکزی",3,884,30,11,712,1637,42,1679
"تهران","شمیرانات","مرکزی",4,343,32,32,1115,1522,16,1538
"تهران","شمیرانات","مرکزی",5,368,48,69,1536,2021,24,2045
"تهران","شمیرانات","مرکزی",6,184,34,38,1518,1774,4,1778
"تهران","شمیرانات","مرکزی",7,261,30,44,1268,1603,11,1614
"تهران","شمیرانات","مرکزی",8,250,36,24,1190,1500,11,1511
"تهران","شمیرانات","مرکزی",9,135,18,21,1722,1896,12,1908
"تهران","شمیرانات","مرکزی",10,595,77,86,2224,2982,32,3014
"تهران","شمیرانات","مرکزی",11,557,76,51,1845,2529,35,2564
"تهران","شمیرانات","مرکزی",12,151,23,57,1867,2098,52,2150
"تهران","شمیرانات","مرکزی",13,435,36,25,1117,1613,12,1625
"تهران","شمیرانات","مرکزی",14,184,43,28,1504,1759,15,1774
"تهران","شمیرانات","مرکزی",15,165,32,38,1748,1983,8,1991
"تهران","شمیرانات","مرکزی",16,249,34,26,897,1206,10,1216
"تهران","شمیرانات","مرکزی",17,463,34,44,1628,2169,17,2186
"تهران","شمیرانات","مرکزی",18,356,45,31,1311,1743,19,1762
"تهران","شمیرانات","مرکزی",19,387,55,21,1472,1935,15,1950
"تهران","شمیرانات","مرکزی",20,226,21,64,1973,2284,15,2299
"تهران","شمیرانات","مرکزی",21,206,35,58,2129,2428,14,2442
"تهران","شمیرانات","مرکزی",22,163,23,54,1854,2094,9,2103
"تهران","شمیرانات","مرکزی",23,192,33,64,2348,2637,17,2654
"تهران","شمیرانات","مرکزی",24,295,39,37,1321,1692,14,1706
"تهران","شمیرانات","مرکزی",25,205,15,32,1486,1738,14,1752
"تهران","شمیرانات","مرکزی",26,178,21,32,1134,1365,5,1370
"تهران","شمیرانات","مرکزی",27,342,40,36,1006,1424,10,1434
"تهران","شمیرانات","مرکزی",28,319,43,50,1029,1441,21,1462
"تهران","شمیرانات","مرکزی",29,242,27,30,1004,1303,12,1315
"تهران","شمیرانات","مرکزی",30,243,33,59,1097,1432,11,1443
"تهران","شمیرانات","مرکزی",31,897,52,34,1157,2140,31,2171
"تهران","شمیرانات","مرکزی",32,720,43,41,854,1658,33,1691
"تهران","شمیرانات","مرکزی",33,601,38,17,826,1482,29,1511
"تهران","شمیرانات","مرکزی",34,444,52,23,954,1473,13,1486
"تهران","شمیرانات","مرکزی",35,546,41,9,598,1194,27,1221
"تهران","شمیرانات","مرکزی",36,444,57,32,1377,1910,26,1936
"تهران","شمیرانات","مرکزی",37,438,55,48,1834,2375,15,2390
"تهران","شمیرانات","مرکزی",38,264,27,29,1316,1636,12,1648
"تهران","شمیرانات","مرکزی",39,185,30,40,1363,1618,9,1627
"تهران","شمیرانات","مرکزی",40,234,51,51,2385,2721,10,2731
"تهران","شمیرانات","مرکزی",41,182,28,43,1639,1892,18,1910
"تهران","شمیرانات","مرکزی",42,708,63,47,1625,2443,40,2483
"تهران","شمیرانات","مرکزی",43,382,64,25,1224,1695,22,1717
"تهران","شمیرانات","مرکزی",44,241,60,27,1307,1635,21,1656
"تهران","شمیرانات","مرکزی",45,750,60,31,1138,1979,21,2000
"تهران","شمیرانات","مرکزی",46,845,64,30,1195,2134,24,2158
"تهران","شمیرانات","مرکزی",47,429,84,66,2219,2798,16,2814
"تهران","شمیرانات","مرکزی",48,614,70,25,1181,1890,19,1909
"تهران","شمیرانات","مرکزی",49,470,41,43,1112,1666,20,1686
"تهران","شمیرانات","مرکزی",50,486,57,25,1180,1748,24,1772
"تهران","شمیرانات","مرکزی",51,194,40,47,1655,1936,16,1952
"تهران","شمیرانات","مرکزی",52,539,55,7,716,1317,29,1346
"تهران","شمیرانات","مرکزی",53,535,67,9,872,1483,26,1509
"تهران","شمیرانات","مرکزی",54,291,4,33,2270,2598,27,2625
"تهران","شمیرانات","مرکزی",55,935,66,21,1247,2269,36,2305
"تهران","شمیرانات","مرکزی",56,1068,79,33,1353,2533,29,2562
"تهران","شمیرانات","مرکزی",57,194,36,28,1638,1896,16,1912
"تهران","شمیرانات","مرکزی",58,545,67,63,2161,2836,19,2855
"تهران","شمیرانات","مرکزی",59,724,92,15,629,1460,25,1485
"تهران","شمیرانات","مرکزی",60,733,92,17,764,1606,31,1637
"تهران","شمیرانات","مرکزی",61,232,34,55,2366,2687,16,2703
"تهران","شمیرانات","مرکزی",62,180,33,63,2012,2288,11,2299
"تهران","شمیرانات","مرکزی",63,498,57,32,1286,1873,24,1897
"تهران","شمیرانات","مرکزی",64,411,58,25,1464,1958,13,1971
"تهران","شمیرانات","مرکزی",65,489,48,28,1276,1841,17,1858
"تهران","شمیرانات","مرکزی",66,276,43,83,1502,1904,13,1917
"تهران","شمیرانات","مرکزی",67,648,71,13,1172,1904,16,1920
"تهران","شمیرانات","مرکزی",68,549,54,16,998,1617,33,1650
"تهران","شمیرانات","مرکزی",69,132,27,30,1230,1419,4,1423
"تهران","شمیرانات","مرکزی",70,442,41,25,1088,1596,14,1610
"تهران","شمیرانات","مرکزی",71,688,53,12,748,1501,21,1522
"تهران","شمیرانات","مرکزی",72,794,61,20,837,1712,18,1730
"تهران","شمیرانات","مرکزی",73,285,43,45,1555,1928,21,1949
"تهران","شمیرانات","مرکزی",74,698,36,14,864,1612,26,1638
"تهران","شمیرانات","مرکزی",75,355,66,27,1729,2177,18,2195
"تهران","شمیرانات","مرکزی",76,433,63,16,1299,1811,18,1829
"تهران","شمیرانات","مرکزی",77,796,68,15,870,1749,23,1772
"تهران","شمیرانات","مرکزی",78,271,39,19,977,1306,17,1323
"تهران","شمیرانات","مرکزی",79,339,42,8,500,889,14,903
"تهران","شمیرانات","مرکزی",80,496,51,27,1030,1604,18,1622
"تهران","شمیرانات","مرکزی",81,456,56,27,938,1477,20,1497
"تهران","شمیرانات","مرکزی",82,417,51,26,1419,1913,9,1922
"تهران","شمیرانات","مرکزی",83,821,54,4,208,1087,18,1105
"تهران","شمیرانات","مرکزی",84,581,37,0,103,721,11,732
"تهران","شمیرانات","مرکزی",85,1091,81,15,540,1727,36,1763
"تهران","شمیرانات","مرکزی",86,762,53,7,311,1133,17,1150
"تهران","شمیرانات","مرکزی",87,712,93,6,302,1113,11,1124
"تهران","شمیرانات","مرکزی",88,953,107,4,260,1324,20,1344
"تهران","شمیرانات","مرکزی",89,979,72,2,217,1270,10,1280
"تهران","شمیرانات","مرکزی",90,980,122,8,567,1677,17,1694
"تهران","شمیرانات","مرکزی",91,808,49,5,175,1037,7,1044
"تهران","شمیرانات","مرکزی",92,765,50,4,129,948,10,958
"تهران","شمیرانات","مرکزی",93,750,49,2,174,975,12,987
"تهران","شمیرانات","مرکزی",94,845,58,3,165,1071,13,1084
"تهران","شمیرانات","مرکزی",95,550,107,4,349,1010,15,1025
"تهران","شمیرانات","مرکزی",96,784,100,13,243,1140,11,1151
"تهران","شمیرانات","مرکزی",97,775,78,6,180,1039,11,1050
"تهران","شمیرانات","مرکزی",98,780,68,3,246,1097,12,1109
"تهران","شمیرانات","مرکزی",99,552,60,8,340,960,21,981
"تهران","شمیرانات","مرکزی",100,605,36,18,1098,1757,32,1789
"تهران","شمیرانات","مرکزی",101,790,51,21,1197,2059,23,2082
"تهران","شمیرانات","مرکزی",102,644,44,41,1541,2270,18,2288
"تهران","شمیرانات","مرکزی",103,537,35,14,1427,2013,10,2023
"تهران","شمیرانات","مرکزی",104,578,48,17,904,1547,15,1562
"تهران","شمیرانات","مرکزی",105,468,44,23,1288,1823,19,1842
"تهران","شمیرانات","مرکزی",106,429,46,25,1065,1565,17,1582
"تهران","شمیرانات","مرکزی",107,341,50,17,1090,1498,14,1512
"تهران","شمیرانات","مرکزی",108,347,6,1,328,682,10,692
"تهران","شمیرانات","مرکزی",109,366,58,25,1341,1790,16,1806
"تهران","شمیرانات","مرکزی",110,102,15,36,1476,1629,6,1635
"تهران","شمیرانات","مرکزی",111,257,19,4,939,1219,0,1219
"تهران","شمیرانات","مرکزی",112,986,21,4,704,1715,36,1751
"تهران","شمیرانات","مرکزی",113,460,31,19,754,1264,23,1287
"تهران","شمیرانات","مرکزی",114,458,23,14,620,1115,8,1123
"تهران","شمیرانات","مرکزی",115,476,70,40,1500,2086,28,2114
"تهران","شمیرانات","مرکزی",116,423,67,55,1323,1868,18,1886
"تهران","شمیرانات","مرکزی",117,396,67,28,1003,1494,18,1512
"تهران","شمیرانات","مرکزی",118,527,23,21,579,1150,17,1167
"تهران","شمیرانات","مرکزی",119,421,39,25,1391,1876,19,1895
"تهران","شمیرانات","مرکزی",120,481,31,24,869,1405,11,1416
"تهران","شمیرانات","مرکزی",121,1133,41,0,551,1725,29,1754
"تهران","شمیرانات","مرکزی",122,1354,35,13,782,2184,48,2232
"تهران","شمیرانات","مرکزی",123,732,52,27,1058,1869,29,1898
"تهران","شمیرانات","مرکزی",124,641,38,19,891,1589,7,1596
"تهران","شمیرانات","مرکزی",125,431,56,31,1332,1850,21,1871
"تهران","شمیرانات","مرکزی",126,279,45,45,1675,2044,21,2065
"تهران","شمیرانات","مرکزی",127,273,37,32,1702,2044,16,2060
"تهران","شمیرانات","مرکزی",128,754,27,15,835,1631,16,1647
"تهران","شمیرانات","مرکزی",129,310,37,27,1067,1441,9,1450
"تهران","شمیرانات","مرکزی",130,853,71,46,1384,2354,40,2394
"تهران","شمیرانات","مرکزی",131,771,73,24,1148,2016,0,2016
"تهران","شمیرانات","مرکزی",132,343,41,44,1813,2241,19,2260
"تهران","شمیرانات","مرکزی",133,277,49,54,2036,2416,10,2426
"تهران","شمیرانات","مرکزی",134,165,18,21,1025,1229,8,1237
"تهران","شمیرانات","مرکزی",135,272,36,23,1154,1485,7,1492
"تهران","شمیرانات","مرکزی",136,267,38,27,1244,1576,15,1591
"تهران","شمیرانات","مرکزی",137,290,29,27,960,1306,15,1321
"تهران","شمیرانات","مرکزی",138,308,25,20,1036,1389,12,1401
"تهران","شمیرانات","مرکزی",139,446,56,57,1462,2021,20,2041
"تهران","شمیرانات","مرکزی",140,426,57,39,966,1488,14,1502
"تهران","شمیرانات","مرکزی",141,368,48,37,1202,1655,29,1684
"تهران","شمیرانات","مرکزی",142,264,14,3,235,516,7,523
"تهران","شمیرانات","مرکزی",143,178,23,35,1793,2029,12,2041
"تهران","شمیرانات","مرکزی",144,348,41,23,1366,1778,9,1787
"تهران","شمیرانات","مرکزی",145,152,17,26,1270,1465,6,1471
"تهران","شمیرانات","مرکزی",146,169,47,37,2218,2471,10,2481
"تهران","شمیرانات","مرکزی",147,348,42,19,1005,1414,13,1427
"تهران","شمیرانات","مرکزی",148,420,62,13,641,1136,15,1151
"تهران","شمیرانات","مرکزی",149,522,73,4,636,1235,20,1255
"تهران","شمیرانات","مرکزی",150,804,32,11,573,1420,28,1448
"تهران","شمیرانات","مرکزی",151,850,19,7,403,1279,14,1293
"تهران","شمیرانات","مرکزی",152,735,31,6,491,1263,20,1283
"تهران","شمیرانات","مرکزی",153,693,95,18,1022,1828,26,1854
"تهران","شمیرانات","مرکزی",154,289,19,17,1008,1333,13,1346
"تهران","شمیرانات","مرکزی",155,691,64,14,844,1613,32,1645
"تهران","شمیرانات","مرکزی",156,634,51,6,542,1233,17,1250
"تهران","شمیرانات","مرکزی",157,540,51,11,540,1142,19,1161
"تهران","شمیرانات","مرکزی",158,298,47,21,1107,1473,11,1484
"تهران","شمیرانات","مرکزی",159,371,14,10,356,751,25,776
"تهران","شمیرانات","مرکزی",160,277,59,8,680,1024,7,1031
"تهران","شمیرانات","مرکزی",161,434,17,6,264,721,12,733
"تهران","شمیرانات","مرکزی",162,511,15,5,264,795,22,817
"تهران","شمیرانات","مرکزی",163,332,19,3,263,617,16,633
"تهران","شمیرانات","لواسانات",1,523,35,15,843,1416,22,1438
"تهران","شمیرانات","لواسانات",2,457,25,17,726,1225,11,1236
"تهران","شمیرانات","لواسانات",3,628,27,15,493,1163,13,1176
"تهران","شمیرانات","لواسانات",4,673,51,18,1213,1955,26,1981
"تهران","شمیرانات","لواسانات",5,333,26,19,1014,1392,8,1400
"تهران","شمیرانات","لواسانات",6,562,44,5,715,1326,15,1341
"تهران","شمیرانات","لواسانات",7,346,21,15,865,1247,11,1258
"تهران","شمیرانات","لواسانات",8,474,32,14,696,1216,15,1231
"تهران","شمیرانات","لواسانات",9,394,18,7,435,854,9,863
"تهران","شمیرانات","لواسانات",10,627,4,0,138,769,12,781
"تهران","شمیرانات","لواسانات",11,194,6,6,133,339,9,348
"تهران","شمیرانات","لواسانات",12,387,2,0,167,556,7,563
"تهران","شمیرانات","لواسانات",13,553,11,3,323,890,13,903
"تهران","شمیرانات","لواسانات",14,195,7,3,130,335,5,340
"تهران","شمیرانات","لواسانات",15,192,2,3,241,438,5,443
"تهران","شمیرانات","لواسانات",16,519,10,0,242,771,22,793
"تهران","شمیرانات","لواسانات",17,896,14,2,285,1197,21,1218
"تهران","شمیرانات","لواسانات",18,184,4,1,94,283,3,286
"تهران","شمیرانات","لواسانات",19,277,17,7,253,554,12,566
"تهران","شمیرانات","لواسانات",20,177,6,0,169,352,5,357
"تهران","شمیرانات","لواسانات",21,257,5,0,136,398,10,408
"تهران","شمیرانات","لواسانات",22,566,22,1,288,877,14,891
"تهران","شمیرانات","لواسانات",23,274,18,1,117,410,3,413
"تهران","شمیرانات","لواسانات",24,380,43,18,840,1281,14,1295
"تهران","شمیرانات","لواسانات",25,372,22,2,248,644,9,653
"تهران","شمیرانات","لواسانات",26,222,14,4,384,624,7,631
"تهران","شمیرانات","لواسانات",27,389,9,0,218,616,11,627
"تهران","شمیرانات","لواسانات",28,209,4,4,206,423,4,427
"تهران","شمیرانات","لواسانات",29,169,9,0,104,282,6,288
"تهران","شمیرانات","لواسانات",30,74,0,0,37,111,4,115
"تهران","شمیرانات","لواسانات",31,207,12,5,9,233,2,235
"تهران","شمیرانات","رودبار_قصران",1,615,32,12,935,1594,18,1612
"تهران","شمیرانات","رودبار_قصران",2,835,23,3,369,1230,16,1246
"تهران","شمیرانات","رودبار_قصران",3,504,22,8,574,1108,10,1118
"تهران","شمیرانات","رودبار_قصران",4,276,8,1,282,567,8,575
"تهران","شمیرانات","رودبار_قصران",5,622,16,7,556,1201,13,1214
"تهران","شمیرانات","رودبار_قصران",6,740,19,6,475,1240,19,1259
"تهران","شمیرانات","رودبار_قصران",7,293,28,8,517,846,13,859
"تهران","شمیرانات","رودبار_قصران",8,439,31,15,573,1058,6,1064
"تهران","شمیرانات","رودبار_قصران",9,407,11,10,433,861,14,875
"تهران","شمیرانات","رودبار_قصران",10,222,8,1,209,440,3,443
"تهران","شمیرانات","رودبار_قصران",11,100,1,0,53,154,2,156
"تهران","شمیرانات","رودبار_قصران",12,299,5,3,201,508,12,520
"تهران","شمیرانات","رودبار_قصران",13,824,22,10,536,1392,23,1415
"تهران","شمیرانات","رودبار_قصران",14,803,18,2,239,1062,12,1074
"تهران","شمیرانات","رودبار_قصران",15,272,13,4,93,382,4,386
"تهران","شمیرانات","رودبار_قصران",16,238,15,10,147,410,5,415
"تهران","شمیرانات","رودبار_قصران",17,380,4,1,122,507,5,512
"تهران","شمیرانات","رودبار_قصران",18,580,17,2,395,994,13,1007
"تهران","شمیرانات","رودبار_قصران",19,442,15,2,269,728,8,736
"تهران","شمیرانات","رودبار_قصران",20,248,12,0,89,349,8,357
"تهران","شمیرانات","رودبار_قصران",21,111,2,2,53,168,3,171
"تهران","شمیرانات","رودبار_قصران",22,250,5,0,157,412,7,419
"تهران","شمیرانات","رودبار_قصران",23,182,5,2,209,398,6,404
"تهران","شمیرانات","رودبار_قصران",24,101,4,0,82,187,4,191
"تهران","شمیرانات","رودبار_قصران",25,97,3,1,147,248,4,252
"تهران","شمیرانات","رودبار_قصران",26,593,12,7,233,845,8,853
"تهران","شمیرانات","رودبار_قصران",27,261,5,3,231,500,18,518
"تهران","شمیرانات","رودبار_قصران",28,93,6,1,52,152,3,155
"تهران","شمیرانات","رودبار_قصران",29,202,9,2,226,439,5,444
"تهران","شمیرانات","رودبار_قصران",30,123,1,0,31,155,3,158
"تهران","شمیرانات","رودبار_قصران",31,144,4,1,99,248,3,251
"تهران","شهریار","مرکزی",1,571,36,10,674,1291,22,1313
"تهران","شهریار","مرکزی",2,603,26,5,550,1184,20,1204
"تهران","شهریار","مرکزی",3,663,21,9,711,1404,32,1436
"تهران","شهریار","مرکزی",4,735,19,12,745,1511,25,1536
"تهران","شهریار","مرکزی",5,995,19,9,459,1482,20,1502
"تهران","شهریار","مرکزی",6,534,28,8,824,1394,26,1420
"تهران","شهریار","مرکزی",7,1183,25,2,483,1693,37,1730
"تهران","شهریار","مرکزی",8,868,28,7,512,1415,14,1429
"تهران","شهریار","مرکزی",9,824,33,17,980,1854,29,1883
"تهران","شهریار","مرکزی",10,856,29,4,520,1409,24,1433
"تهران","شهریار","مرکزی",11,864,26,2,546,1438,25,1463
"تهران","شهریار","مرکزی",12,645,20,3,611,1279,4,1283
"تهران","شهریار","مرکزی",13,691,28,6,704,1429,31,1460
"تهران","شهریار","مرکزی",14,705,25,5,701,1436,23,1459
"تهران","شهریار","مرکزی",15,493,32,13,622,1160,27,1187
"تهران","شهریار","مرکزی",16,853,25,5,565,1448,19,1467
"تهران","شهریار","مرکزی",17,650,28,11,355,1044,13,1057
"تهران","شهریار","مرکزی",18,994,31,8,591,1624,28,1652
"تهران","شهریار","مرکزی",19,543,26,6,634,1209,27,1236
"تهران","شهریار","مرکزی",20,786,44,12,652,1494,18,1512
"تهران","شهریار","مرکزی",21,662,24,2,543,1231,31,1262
"تهران","شهریار","مرکزی",22,798,22,8,350,1178,20,1198
"تهران","شهریار","مرکزی",23,914,13,5,281,1213,7,1220
"تهران","شهریار","مرکزی",24,1002,26,3,562,1593,14,1607
"تهران","شهریار","مرکزی",25,900,14,6,421,1341,13,1354
"تهران","شهریار","مرکزی",26,925,19,8,467,1419,17,1436
"تهران","شهریار","مرکزی",27,581,16,4,402,1003,8,1011
"تهران","شهریار","مرکزی",28,766,10,4,242,1022,14,1036
"تهران","شهریار","مرکزی",29,637,25,8,614,1284,20,1304
"تهران","شهریار","مرکزی",30,891,41,15,808,1755,45,1800
"تهران","شهریار","مرکزی",31,746,17,14,781,1558,26,1584
"تهران","شهریار","مرکزی",32,912,29,14,928,1883,24,1907
"تهران","شهریار","مرکزی",33,1113,30,6,711,1860,31,1891
"تهران","شهریار","مرکزی",34,900,22,11,785,1718,34,1752
"تهران","شهریار","مرکزی",35,884,18,6,538,1446,16,1462
"تهران","شهریار","مرکزی",36,876,39,3,710,1628,26,1654
"تهران","شهریار","مرکزی",37,713,22,12,719,1466,31,1497
"تهران","شهریار","مرکزی",38,949,34,7,602,1592,17,1609
"تهران","شهریار","مرکزی",39,954,24,26,984,1988,36,2024
"تهران","شهریار","مرکزی",40,1842,39,7,875,2763,67,2830
"تهران","شهریار","مرکزی",41,1105,20,10,505,1640,30,1670
"تهران","شهریار","مرکزی",42,782,31,9,714,1536,21,1557
"تهران","شهریار","مرکزی",43,1044,26,21,873,1964,35,1999
"تهران","شهریار","مرکزی",44,1147,17,11,815,1990,36,2026
"تهران","شهریار","مرکزی",45,975,22,6,501,1504,9,1513
"تهران","شهریار","مرکزی",46,1025,20,8,484,1537,10,1547
"تهران","شهریار","مرکزی",47,558,27,7,620,1212,16,1228
"تهران","شهریار","مرکزی",48,871,15,4,288,1178,8,1186
"تهران","شهریار","مرکزی",49,784,8,1,153,946,0,946
"تهران","شهریار","مرکزی",50,843,9,0,173,1025,11,1036
"تهران","شهریار","مرکزی",51,869,8,0,227,1104,16,1120
"تهران","شهریار","مرکزی",52,903,8,3,187,1101,23,1124
"تهران","شهریار","مرکزی",53,1142,16,1,286,1445,22,1467
"تهران","شهریار","مرکزی",54,1133,17,4,299,1453,28,1481
"تهران","شهریار","مرکزی",55,871,13,1,288,1173,14,1187
"تهران","شهریار","مرکزی",56,1086,7,3,289,1385,35,1420
"تهران","شهریار","مرکزی",57,825,10,2,166,1003,10,1013
"تهران","شهریار","مرکزی",58,744,7,12,389,1152,14,1166
"تهران","شهریار","مرکزی",59,734,4,1,571,1310,33,1343
"تهران","شهریار","مرکزی",60,689,4,4,146,843,13,856
"تهران","شهریار","مرکزی",61,763,15,2,249,1029,22,1051
"تهران","شهریار","مرکزی",62,871,16,4,257,1148,20,1168
"تهران","شهریار","مرکزی",63,1251,10,4,357,1622,21,1643
"تهران","شهریار","مرکزی",64,1042,20,11,504,1577,25,1602
"تهران","شهریار","مرکزی",65,688,14,3,315,1020,14,1034
"تهران","شهریار","مرکزی",66,980,23,19,605,1627,22,1649
"تهران","شهریار","مرکزی",67,757,26,4,297,1084,17,1101
"تهران","شهریار","مرکزی",68,1033,8,18,203,1262,9,1271
"تهران","شهریار","مرکزی",69,1078,13,36,330,1457,19,1476
"تهران","شهریار","مرکزی",70,935,14,49,325,1323,20,1343
"تهران","شهریار","مرکزی",71,918,10,33,173,1134,0,1134
"تهران","شهریار","مرکزی",72,1210,9,11,340,1570,20,1590
"تهران","شهریار","مرکزی",73,907,14,2,543,1466,21,1487
"تهران","شهریار","مرکزی",74,864,7,0,274,1145,24,1169
"تهران","شهریار","مرکزی",75,872,5,9,446,1332,28,1360
"تهران","شهریار","مرکزی",76,1220,14,13,476,1723,33,1756
"تهران","شهریار","مرکزی",77,686,8,8,365,1067,11,1078
"تهران","شهریار","مرکزی",78,836,14,1,288,1139,29,1168
"تهران","شهریار","مرکزی",79,1219,10,3,375,1607,20,1627
"تهران","شهریار","مرکزی",80,854,12,7,415,1288,22,1310
"تهران","شهریار","مرکزی",81,1019,13,7,413,1452,21,1473
"تهران","شهریار","مرکزی",82,711,9,3,363,1086,19,1105
"تهران","شهریار","مرکزی",83,897,21,6,329,1253,9,1262
"تهران","شهریار","مرکزی",84,907,8,11,392,1318,9,1327
"تهران","شهریار","مرکزی",85,637,4,5,322,968,10,978
"تهران","شهریار","مرکزی",86,463,13,1,194,671,4,675
"تهران","شهریار","مرکزی",87,1400,23,9,381,1813,19,1832
"تهران","شهریار","مرکزی",88,969,19,8,408,1404,0,1404
"تهران","شهریار","مرکزی",89,620,11,2,341,974,24,998
"تهران","شهریار","مرکزی",90,693,7,2,243,945,0,945
"تهران","شهریار","مرکزی",91,584,6,0,211,801,27,828
"تهران","شهریار","مرکزی",92,682,3,17,249,951,8,959
"تهران","شهریار","مرکزی",93,734,8,2,209,953,21,974
"تهران","شهریار","مرکزی",94,592,13,0,250,855,9,864
"تهران","شهریار","مرکزی",95,622,8,7,242,879,19,898
"تهران","شهریار","مرکزی",96,882,33,7,871,1793,29,1822
"تهران","شهریار","مرکزی",97,1084,36,23,1064,2207,34,2241
"تهران","شهریار","مرکزی",98,1239,48,8,640,1935,36,1971
"تهران","شهریار","مرکزی",99,874,24,14,935,1847,30,1877
"تهران","شهریار","مرکزی",100,966,59,18,967,2010,28,2038
"تهران","شهریار","مرکزی",101,897,25,12,836,1770,19,1789
"تهران","شهریار","مرکزی",102,1122,39,17,906,2084,48,2132
"تهران","شهریار","مرکزی",103,600,25,8,703,1336,20,1356
"تهران","شهریار","مرکزی",104,812,49,22,845,1728,27,1755
"تهران","شهریار","مرکزی",105,582,25,7,678,1292,21,1313
"تهران","شهریار","مرکزی",106,805,31,15,748,1599,35,1634
"تهران","شهریار","مرکزی",107,1085,37,23,1010,2155,40,2195
"تهران","شهریار","مرکزی",108,928,20,12,865,1825,17,1842
"تهران","شهریار","مرکزی",109,1608,41,26,1343,3018,41,3059
"تهران","شهریار","مرکزی",110,854,29,25,609,1517,20,1537
"تهران","شهریار","مرکزی",111,1061,39,7,952,2059,48,2107
"تهران","شهریار","مرکزی",112,805,34,12,802,1653,41,1694
"تهران","شهریار","مرکزی",113,997,27,6,789,1819,27,1846
"تهران","شهریار","مرکزی",114,957,34,3,664,1658,28,1686
"تهران","شهریار","مرکزی",115,1026,34,15,716,1791,34,1825
"تهران","شهریار","مرکزی",116,995,12,11,575,1593,32,1625
"تهران","شهریار","مرکزی",117,610,11,3,477,1101,30,1131
"تهران","شهریار","مرکزی",118,701,10,31,813,1555,19,1574
"تهران","شهریار","مرکزی",119,582,8,1,332,923,31,954
"تهران","شهریار","مرکزی",120,426,5,8,589,1028,28,1056
"تهران","شهریار","مرکزی",121,586,1,3,290,880,20,900
"تهران","شهریار","مرکزی",122,470,2,38,541,1051,24,1075
"تهران","شهریار","مرکزی",123,784,15,9,552,1360,15,1375
"تهران","شهریار","مرکزی",124,720,13,16,600,1349,22,1371
"تهران","شهریار","مرکزی",125,781,8,21,405,1215,27,1242
"تهران","شهریار","مرکزی",126,862,15,6,451,1334,24,1358
"تهران","شهریار","مرکزی",127,1055,15,3,364,1437,9,1446
"تهران","شهریار","مرکزی",128,1040,41,8,747,1836,39,1875
"تهران","شهریار","مرکزی",129,735,10,1,395,1141,12,1153
"تهران","شهریار","مرکزی",130,895,12,4,378,1289,11,1300
"تهران","شهریار","مرکزی",131,616,17,3,368,1004,9,1013
"تهران","شهریار","مرکزی",132,380,9,8,313,710,4,714
"تهران","شهریار","مرکزی",133,509,12,6,284,811,23,834
"تهران","شهریار","مرکزی",134,493,12,4,258,767,12,779
"تهران","شهریار","مرکزی",135,973,30,4,452,1459,10,1469
"تهران","شهریار","مرکزی",136,761,22,13,589,1385,53,1438
"تهران","شهریار","مرکزی",137,842,19,27,555,1443,0,1443
"تهران","شهریار","مرکزی",138,676,17,21,377,1091,18,1109
"تهران","شهریار","مرکزی",139,670,17,16,352,1055,24,1079
"تهران","شهریار","مرکزی",140,510,9,13,535,1067,25,1092
"تهران","شهریار","مرکزی",141,622,16,14,821,1473,16,1489
"تهران","شهریار","مرکزی",142,908,11,2,219,1140,3,1143
"تهران","شهریار","مرکزی",143,795,11,4,406,1216,35,1251
"تهران","شهریار","مرکزی",144,822,6,1,216,1045,16,1061
"تهران","شهریار","مرکزی",145,946,5,3,380,1334,23,1357
"تهران","شهریار","مرکزی",146,948,7,1,335,1291,14,1305
"تهران","شهریار","مرکزی",147,481,4,1,227,713,18,731
"تهران","شهریار","مرکزی",148,961,10,4,341,1316,15,1331
"تهران","شهریار","مرکزی",149,648,15,5,264,932,11,943
"تهران","شهریار","مرکزی",150,405,3,4,187,599,3,602
"تهران","شهریار","مرکزی",151,786,11,3,231,1031,23,1054
"تهران","شهریار","مرکزی",152,1017,6,7,385,1415,40,1455
"تهران","شهریار","مرکزی",153,763,13,8,260,1044,20,1064
"تهران","شهریار","مرکزی",154,1113,14,5,432,1564,33,1597
"تهران","شهریار","مرکزی",155,977,3,3,229,1212,19,1231
"تهران","شهریار","مرکزی",156,858,6,3,258,1125,25,1150
"تهران","شهریار","مرکزی",157,962,14,6,335,1317,23,1340
"تهران","شهریار","مرکزی",158,873,6,7,410,1296,13,1309
"تهران","شهریار","مرکزی",159,832,5,2,213,1052,5,1057
"تهران","شهریار","مرکزی",160,609,5,2,222,838,18,856
"تهران","شهریار","مرکزی",161,442,9,0,153,604,8,612
"تهران","شهریار","مرکزی",162,535,14,1,224,774,7,781
"تهران","شهریار","مرکزی",163,926,13,3,287,1229,8,1237
"تهران","شهریار","مرکزی",164,801,12,2,292,1107,9,1116
"تهران","شهریار","مرکزی",165,791,15,11,368,1185,15,1200
"تهران","شهریار","مرکزی",166,656,8,11,316,991,17,1008
"تهران","شهریار","مرکزی",167,182,5,4,500,691,11,702
"تهران","شهریار","مرکزی",168,791,8,9,243,1051,17,1068
"تهران","شهریار","مرکزی",169,1109,9,5,290,1413,38,1451
"تهران","شهریار","مرکزی",170,841,4,5,224,1074,14,1088
"تهران","شهریار","مرکزی",171,823,8,0,271,1102,16,1118
"تهران","شهریار","مرکزی",172,642,5,2,149,798,6,804
"تهران","شهریار","مرکزی",173,640,4,2,328,974,19,993
"تهران","شهریار","مرکزی",174,914,8,4,321,1247,16,1263
"تهران","شهریار","مرکزی",175,1082,11,6,352,1451,16,1467
"تهران","شهریار","مرکزی",176,1035,23,3,307,1368,32,1400
"تهران","شهریار","مرکزی",177,1231,10,9,220,1470,29,1499
"تهران","شهریار","مرکزی",178,845,6,18,386,1255,17,1272
"تهران","شهریار","مرکزی",179,795,10,6,557,1368,15,1383
"تهران","شهریار","مرکزی",180,1048,17,7,501,1573,34,1607
"تهران","شهریار","مرکزی",181,1105,9,1,425,1540,29,1569
"تهران","شهریار","مرکزی",182,1045,8,1,227,1281,14,1295
"تهران","شهریار","مرکزی",183,950,7,2,285,1244,11,1255
"تهران","شهریار","مرکزی",184,914,9,15,302,1240,7,1247
"تهران","شهریار","مرکزی",185,632,2,0,201,835,9,844
"تهران","شهریار","مرکزی",186,615,8,5,298,926,2,928
"تهران","شهریار","مرکزی",187,515,6,1,214,736,10,746
"تهران","شهریار","مرکزی",188,225,8,1,71,305,3,308
"تهران","شهریار","مرکزی",189,338,5,0,101,444,7,451
"تهران","شهریار","مرکزی",190,990,21,16,394,1421,25,1446
"تهران","شهریار","مرکزی",191,740,6,6,334,1086,26,1112
"تهران","شهریار","مرکزی",192,501,6,1,252,760,6,766
"تهران","شهریار","مرکزی",193,277,2,0,62,341,5,346
"تهران","شهریار","مرکزی",194,844,17,7,311,1179,20,1199
"تهران","شهریار","مرکزی",195,945,14,7,276,1242,20,1262
"تهران","شهریار","مرکزی",196,817,13,4,414,1248,16,1264
"تهران","شهریار","مرکزی",197,903,22,3,413,1341,18,1359
"تهران","شهریار","مرکزی",198,379,9,0,260,648,11,659
"تهران","شهریار","مرکزی",199,655,13,2,164,834,10,844
"تهران","شهریار","مرکزی",200,375,10,3,184,572,6,578
"تهران","شهریار","مرکزی",201,295,6,1,237,539,3,542
"تهران","شهریار","مرکزی",202,350,1,1,142,494,7,501
"تهران","شهریار","مرکزی",203,370,1,2,106,479,18,497
"تهران","شهریار","مرکزی",204,446,6,0,211,663,10,673
"تهران","شهریار","مرکزی",205,262,2,5,138,407,7,414
"تهران","شهریار","ملارد",1,725,17,4,217,963,10,973
"تهران","شهریار","ملارد",2,1402,19,14,497,1932,43,1975
"تهران","شهریار","ملارد",3,1092,9,9,232,1342,12,1354
"تهران","شهریار","ملارد",4,992,19,17,511,1539,38,1577
"تهران","شهریار","ملارد",5,772,19,4,487,1282,21,1303
"تهران","شهریار","ملارد",6,663,19,1,364,1047,15,1062
"تهران","شهریار","ملارد",7,419,7,3,202,631,12,643
"تهران","شهریار","ملارد",8,467,2,1,142,612,11,623
"تهران","شهریار","ملارد",9,572,11,2,233,818,24,842
"تهران","شهریار","ملارد",10,855,11,5,210,1081,33,1114
"تهران","شهریار","ملارد",11,565,9,1,101,676,14,690
"تهران","شهریار","ملارد",12,1311,11,22,390,1734,53,1787
"تهران","شهریار","ملارد",13,678,10,6,326,1020,27,1047
"تهران","شهریار","ملارد",14,708,3,7,258,976,16,992
"تهران","شهریار","ملارد",15,1005,14,8,516,1543,17,1560
"تهران","شهریار","ملارد",16,831,18,17,386,1252,32,1284
"تهران","شهریار","ملارد",17,888,14,5,235,1142,27,1169
"تهران","شهریار","ملارد",18,1257,18,9,460,1744,33,1777
"تهران","شهریار","ملارد",19,1089,10,3,380,1482,0,1482
"تهران","شهریار","ملارد",20,904,14,22,251,1191,8,1199
"تهران","شهریار","ملارد",21,916,11,13,152,1092,25,1117
"تهران","شهریار","ملارد",22,643,5,14,367,1029,19,1048
"تهران","شهریار","ملارد",23,730,9,13,224,976,28,1004
"تهران","شهریار","ملارد",24,1268,18,16,540,1842,31,1873
"تهران","شهریار","ملارد",25,881,7,20,265,1173,11,1184
"تهران","شهریار","ملارد",26,819,13,11,355,1198,23,1221
"تهران","شهریار","ملارد",27,835,10,12,305,1162,23,1185
"تهران","شهریار","ملارد",28,1000,9,11,336,1356,22,1378
"تهران","شهریار","ملارد",29,1003,16,3,486,1508,21,1529
"تهران","شهریار","ملارد",30,1033,23,22,735,1813,36,1849
"تهران","شهریار","ملارد",31,910,22,17,588,1537,25,1562
"تهران","شهریار","ملارد",32,979,20,5,399,1403,27,1430
"تهران","شهریار","ملارد",33,867,23,8,566,1464,35,1499
"تهران","شهریار","ملارد",34,1178,25,23,551,1777,43,1820
"تهران","شهریار","ملارد",35,578,7,29,181,795,9,804
"تهران","شهریار","ملارد",36,956,22,14,450,1442,31,1473
"تهران","شهریار","ملارد",37,1063,8,15,272,1358,15,1373
"تهران","شهریار","ملارد",38,634,10,11,283,938,16,954
"تهران","شهریار","ملارد",39,848,19,11,325,1203,23,1226
"تهران","شهریار","ملارد",40,878,6,11,196,1091,15,1106
"تهران","شهریار","ملارد",41,829,13,20,453,1315,15,1330
"تهران","شهریار","ملارد",42,803,17,25,378,1223,28,1251
"تهران","شهریار","ملارد",43,1173,8,18,575,1774,33,1807
"تهران","شهریار","ملارد",44,776,26,8,350,1160,19,1179
"تهران","شهریار","ملارد",45,1023,17,14,282,1336,10,1346
"تهران","شهریار","ملارد",46,1025,12,34,319,1390,42,1432
"تهران","شهریار","ملارد",47,677,19,10,352,1058,22,1080
"تهران","شهریار","ملارد",48,788,15,9,224,1036,20,1056
"تهران","شهریار","ملارد",49,907,13,11,231,1162,20,1182
"تهران","شهریار","ملارد",50,573,7,1,302,883,14,897
"تهران","شهریار","ملارد",51,815,16,11,396,1238,26,1264
"تهران","شهریار","ملارد",52,812,18,8,405,1243,13,1256
"تهران","شهریار","ملارد",53,959,14,4,291,1268,32,1300
"تهران","شهریار","ملارد",54,1187,18,12,439,1656,64,1720
"تهران","شهریار","ملارد",55,989,12,1,174,1176,10,1186
"تهران","شهریار","ملارد",56,368,10,3,238,619,13,632
"تهران","شهریار","ملارد",57,1371,25,12,662,2070,37,2107
"تهران","شهریار","ملارد",58,1007,8,3,405,1423,34,1457
"تهران","شهریار","ملارد",59,827,37,23,641,1528,30,1558
"تهران","شهریار","ملارد",60,1052,20,8,441,1521,23,1544
"تهران","شهریار","ملارد",61,1073,12,5,297,1387,35,1422
"تهران","شهریار","ملارد",62,623,15,5,231,874,13,887
"تهران","شهریار","ملارد",63,444,1,6,153,604,15,619
"تهران","شهریار","ملارد",64,844,8,18,440,1310,15,1325
"تهران","شهریار","ملارد",65,1044,11,9,335,1399,29,1428
"تهران","شهریار","ملارد",66,673,21,13,638,1345,14,1359
"تهران","شهریار","ملارد",67,615,21,9,436,1081,30,1111
"تهران","شهریار","ملارد",68,980,26,11,1007,2024,27,2051
"تهران","شهریار","ملارد",69,1315,24,17,614,1970,33,2003
"تهران","شهریار","ملارد",70,765,23,27,832,1647,29,1676
"تهران","شهریار","ملارد",71,813,17,18,475,1323,19,1342
"تهران","شهریار","ملارد",72,961,27,12,847,1847,33,1880
"تهران","شهریار","ملارد",73,844,38,7,636,1525,19,1544
"تهران","شهریار","ملارد",74,1160,35,27,1249,2471,37,2508
"تهران","شهریار","ملارد",75,1398,35,15,809,2257,45,2302
"تهران","شهریار","ملارد",76,1276,36,4,627,1943,22,1965
"تهران","شهریار","ملارد",77,1081,16,7,388,1492,34,1526
"تهران","شهریار","ملارد",78,690,21,6,594,1311,18,1329
"تهران","شهریار","ملارد",79,710,28,14,586,1338,13,1351
"تهران","شهریار","ملارد",80,488,13,13,528,1042,22,1064
"تهران","شهریار","ملارد",81,441,5,4,249,699,16,715
"تهران","شهریار","ملارد",82,535,17,8,417,977,24,1001
"تهران","شهریار","ملارد",83,456,26,6,535,1023,29,1052
"تهران","شهریار","ملارد",84,654,9,2,318,983,17,1000
"تهران","شهریار","ملارد",85,947,11,4,347,1309,22,1331
"تهران","شهریار","ملارد",86,521,12,6,316,855,20,875
"تهران","شهریار","ملارد",87,286,15,0,209,510,7,517
"تهران","شهریار","ملارد",88,580,9,1,213,803,2,805
"تهران","شهریار","ملارد",89,647,7,9,420,1083,19,1102
"تهران","شهریار","ملارد",90,316,1,1,153,471,8,479
"تهران","شهریار","ملارد",91,740,3,0,473,1216,16,1232
"تهران","شهریار","ملارد",92,608,6,3,183,800,12,812
"تهران","شهریار","ملارد",93,215,5,1,94,315,7,322
"تهران","شهریار","ملارد",94,1286,13,10,512,1821,21,1842
"تهران","شهریار","ملارد",95,754,20,4,367,1145,20,1165
"تهران","شهریار","ملارد",96,1021,15,3,301,1340,19,1359
"تهران","شهریار","ملارد",97,826,23,0,341,1190,22,1212
"تهران","شهریار","ملارد",98,717,13,4,273,1007,14,1021
"تهران","شهریار","ملارد",99,794,4,2,142,942,21,963
"تهران","شهریار","ملارد",100,891,7,8,247,1153,33,1186
"تهران","شهریار","ملارد",101,420,6,8,253,687,7,694
"تهران","شهریار","ملارد",102,515,8,1,311,835,5,840
"تهران","شهریار","ملارد",103,318,4,2,240,564,3,567
"تهران","شهریار","ملارد",104,178,1,2,123,304,7,311
"تهران","شهریار","ملارد",105,240,3,6,148,397,5,402
"تهران","شهریار","ملارد",106,703,12,7,498,1220,17,1237
"تهران","شهریار","ملارد",107,920,21,12,480,1433,28,1461
"تهران","شهریار","ملارد",108,590,14,1,164,769,2,771
"تهران","شهریار","ملارد",109,592,18,3,338,951,20,971
"تهران","شهریار","ملارد",110,189,2,2,155,348,2,350
"تهران","شهریار","ملارد",111,672,10,3,292,977,17,994
"تهران","شهریار","ملارد",112,894,12,4,326,1236,20,1256
"تهران","شهریار","ملارد",113,564,23,3,272,862,12,874
"تهران","شهریار","ملارد",114,306,3,2,83,394,3,397
"تهران","شهریار","ملارد",115,294,0,2,88,384,5,389
"تهران","شهریار","ملارد",116,786,9,6,250,1051,12,1063
"تهران","شهریار","ملارد",117,858,4,3,181,1046,17,1063
"تهران","شهریار","ملارد",118,489,3,2,125,619,13,632
"تهران","شهریار","ملارد",119,799,13,2,299,1113,10,1123
"تهران","شهریار","ملارد",120,442,10,0,144,596,4,600
"تهران","شهریار","ملارد",121,151,1,0,40,192,4,196
"تهران","شهریار","ملارد",122,260,0,0,84,344,5,349
"تهران","شهریار","ملارد",123,236,2,2,98,338,1,339
"تهران","شهریار","ملارد",124,235,5,0,125,365,1,366
"تهران","شهریار","ملارد",125,192,1,3,103,299,3,302
"تهران","شهریار","ملارد",126,129,3,0,62,194,1,195
"تهران","شهریار","ملارد",127,536,1,0,22,559,7,566
"تهران","شهریار","ملارد",128,173,1,0,85,259,0,259
"تهران","شهریار","ملارد",129,301,2,0,13,316,4,320
"تهران","شهریار","ملارد",130,181,5,2,134,322,3,325
"تهران","شهریار","ملارد",131,120,0,1,23,144,1,145
"تهران","شهریار","ملارد",132,112,1,0,97,210,0,210
"تهران","شهریار","قدس",1,766,15,2,521,1304,13,1317
"تهران","شهریار","قدس",2,693,15,5,321,1034,16,1050
"تهران","شهریار","قدس",3,1086,2,17,353,1458,0,1458
"تهران","شهریار","قدس",4,757,21,7,505,1290,17,1307
"تهران","شهریار","قدس",5,1203,10,2,339,1554,24,1578
"تهران","شهریار","قدس",6,938,8,7,290,1243,14,1257
"تهران","شهریار","قدس",7,1222,20,9,468,1719,15,1734
"تهران","شهریار","قدس",8,947,14,7,353,1321,20,1341
"تهران","شهریار","قدس",9,1034,19,16,402,1471,13,1484
"تهران","شهریار","قدس",10,1062,26,7,389,1484,35,1519
"تهران","شهریار","قدس",11,824,12,6,336,1178,10,1188
"تهران","شهریار","قدس",12,765,12,8,481,1266,11,1277
"تهران","شهریار","قدس",13,665,16,3,343,1027,12,1039
"تهران","شهریار","قدس",14,914,13,9,473,1409,20,1429
"تهران","شهریار","قدس",15,1217,16,9,403,1645,21,1666
"تهران","شهریار","قدس",16,962,7,11,507,1487,23,1510
"تهران","شهریار","قدس",17,874,11,11,665,1561,35,1596
"تهران","شهریار","قدس",18,863,13,27,621,1524,17,1541
"تهران","شهریار","قدس",19,1153,11,15,388,1567,19,1586
"تهران","شهریار","قدس",20,1141,10,11,455,1617,19,1636
"تهران","شهریار","قدس",21,934,8,8,459,1409,8,1417
"تهران","شهریار","قدس",22,952,6,5,434,1397,13,1410
"تهران","شهریار","قدس",23,693,6,7,285,991,22,1013
"تهران","شهریار","قدس",24,943,11,4,486,1444,17,1461
"تهران","شهریار","قدس",25,1105,11,12,402,1530,21,1551
"تهران","شهریار","قدس",26,1010,13,7,386,1416,12,1428
"تهران","شهریار","قدس",27,1166,7,14,397,1584,28,1612
"تهران","شهریار","قدس",28,1147,18,7,407,1579,17,1596
"تهران","شهریار","قدس",29,867,5,13,266,1151,18,1169
"تهران","شهریار","قدس",30,990,12,7,321,1330,8,1338
"تهران","شهریار","قدس",31,769,5,6,220,1000,7,1007
"تهران","شهریار","قدس",32,653,6,0,313,972,8,980
"تهران","شهریار","قدس",33,1197,17,10,452,1676,18,1694
"تهران","شهریار","قدس",34,840,13,3,275,1131,13,1144
"تهران","شهریار","قدس",35,891,4,8,214,1117,28,1145
"تهران","شهریار","قدس",36,1105,15,15,336,1471,29,1500
"تهران","شهریار","قدس",37,1454,18,13,346,1831,18,1849
"تهران","شهریار","قدس",38,963,15,18,311,1307,18,1325
"تهران","شهریار","قدس",39,833,15,5,283,1136,9,1145
"تهران","شهریار","قدس",40,1151,20,15,623,1809,16,1825
"تهران","شهریار","قدس",41,925,13,16,360,1314,25,1339
"تهران","شهریار","قدس",42,885,17,15,277,1194,25,1219
"تهران","شهریار","قدس",43,796,16,8,495,1315,26,1341
"تهران","شهریار","قدس",44,923,16,13,570,1522,30,1552
"تهران","شهریار","قدس",45,825,17,5,461,1308,23,1331
"تهران","شهریار","قدس",46,1135,19,13,385,1552,29,1581
"تهران","شهریار","قدس",47,1129,31,21,459,1640,52,1692
"تهران","شهریار","قدس",48,824,15,16,395,1250,28,1278
"تهران","شهریار","قدس",49,663,25,15,683,1386,29,1415
"تهران","شهریار","قدس",50,626,18,12,348,1004,15,1019
"تهران","شهریار","قدس",51,852,22,13,336,1223,28,1251
"تهران","شهریار","قدس",52,1001,18,13,421,1453,40,1493
"تهران","شهریار","قدس",53,689,11,6,297,1003,8,1011
"تهران","شهریار","قدس",54,953,14,4,383,1354,20,1374
"تهران","شهریار","قدس",55,789,12,4,284,1089,15,1104
"تهران","شهریار","قدس",56,1075,16,18,413,1522,44,1566
"تهران","شهریار","قدس",57,746,7,1,308,1062,10,1072
"تهران","شهریار","قدس",58,781,12,21,464,1278,19,1297
"تهران","شهریار","قدس",59,1197,20,7,479,1703,29,1732
"تهران","شهریار","قدس",60,783,21,13,405,1222,22,1244
"تهران","شهریار","قدس",61,778,12,5,300,1095,9,1104
"تهران","شهریار","قدس",62,1124,17,9,410,1560,44,1604
"تهران","شهریار","قدس",63,752,7,15,236,1010,18,1028
"تهران","شهریار","قدس",64,982,10,10,214,1216,20,1236
"تهران","شهریار","قدس",65,864,15,56,357,1292,31,1323
"تهران","شهریار","قدس",66,1234,13,19,390,1656,8,1664
"تهران","شهریار","قدس",67,959,17,11,330,1317,21,1338
"تهران","شهریار","قدس",68,1149,10,9,412,1580,22,1602
"تهران","شهریار","قدس",69,834,6,12,384,1236,8,1244
"تهران","شهریار","قدس",70,1034,20,16,367,1437,29,1466
"تهران","شهریار","قدس",71,832,18,7,534,1391,30,1421
"تهران","شهریار","قدس",72,839,20,9,484,1352,11,1363
"تهران","شهریار","قدس",73,868,15,4,481,1368,26,1394
"تهران","شهریار","قدس",74,910,29,10,650,1599,29,1628
"تهران","شهریار","قدس",75,942,31,8,602,1583,24,1607
"تهران","شهریار","قدس",76,816,26,11,506,1359,21,1380
"تهران","شهریار","قدس",77,1015,30,22,579,1646,22,1668
"تهران","شهریار","قدس",78,594,16,5,429,1044,18,1062
"تهران","شهریار","قدس",79,899,24,9,564,1496,17,1513
"تهران","شهریار","قدس",80,686,21,14,485,1206,9,1215
"تهران","شهریار","قدس",81,1137,26,14,576,1753,22,1775
"تهران","شهریار","قدس",82,586,14,7,456,1063,19,1082
"تهران","شهریار","قدس",83,845,38,21,755,1659,16,1675
"تهران","شهریار","قدس",84,394,4,4,213,615,12,627
"تهران","شهریار","قدس",85,234,2,19,168,423,4,427
"تهران","شهریار","قدس",86,738,21,7,548,1314,16,1330
"تهران","شهریار","قدس",87,827,10,2,346,1185,5,1190
"تهران","شهریار","قدس",88,842,14,17,397,1270,15,1285
"تهران","شهریار","قدس",89,544,8,3,483,1038,5,1043
"تهران","شهریار","قدس",90,279,8,2,146,435,14,449
"تهران","فیروزکوه","مرکزی",1,653,6,4,344,1007,24,1031
"تهران","فیروزکوه","مرکزی",2,505,7,3,325,840,17,857
"تهران","فیروزکوه","مرکزی",3,460,7,5,316,788,22,810
"تهران","فیروزکوه","مرکزی",4,522,10,12,536,1080,14,1094
"تهران","فیروزکوه","مرکزی",5,367,3,1,190,561,9,570
"تهران","فیروزکوه","مرکزی",65,205,7,3,329,544,9,553
"تهران","فیروزکوه","مرکزی",7,318,8,3,341,670,10,680
"تهران","فیروزکوه","مرکزی",8,489,5,3,325,822,9,831
"تهران","فیروزکوه","مرکزی",9,369,7,0,232,608,18,626
"تهران","فیروزکوه","مرکزی",10,400,12,5,335,752,6,758
"تهران","فیروزکوه","مرکزی",11,222,1,0,122,345,1,346
"تهران","فیروزکوه","مرکزی",12,546,7,2,259,814,9,823
"تهران","فیروزکوه","مرکزی",13,414,11,12,455,892,18,910
"تهران","فیروزکوه","مرکزی",14,139,3,1,74,217,3,220
"تهران","فیروزکوه","مرکزی",15,139,1,0,82,222,0,222
"تهران","فیروزکوه","مرکزی",16,137,7,0,128,272,8,280
"تهران","فیروزکوه","مرکزی",17,226,1,2,81,310,2,312
"تهران","فیروزکوه","مرکزی",18,143,1,0,85,229,6,235
"تهران","فیروزکوه","مرکزی",19,244,1,0,17,262,4,266
"تهران","فیروزکوه","مرکزی",20,522,0,0,53,575,4,579
"تهران","فیروزکوه","مرکزی",21,400,4,0,53,457,10,467
"تهران","فیروزکوه","مرکزی",22,211,1,7,164,383,5,388
"تهران","فیروزکوه","مرکزی",23,265,6,2,139,412,8,420
"تهران","فیروزکوه","مرکزی",24,213,1,0,148,362,10,372
"تهران","فیروزکوه","مرکزی",25,325,4,3,184,516,8,524
"تهران","فیروزکوه","مرکزی",26,184,2,0,105,291,0,291
"تهران","فیروزکوه","مرکزی",27,338,13,2,165,518,10,528
"تهران","فیروزکوه","مرکزی",28,184,2,4,104,294,3,297
"تهران","فیروزکوه","مرکزی",29,266,7,2,110,385,3,388
"تهران","فیروزکوه","مرکزی",30,408,7,1,243,659,9,668
"تهران","فیروزکوه","مرکزی",31,395,6,0,265,666,8,674
"تهران","فیروزکوه","مرکزی",32,466,4,0,92,562,10,572
"تهران","فیروزکوه","مرکزی",33,248,6,0,82,336,6,342
"تهران","فیروزکوه","مرکزی",34,252,0,1,20,273,2,275
"تهران","فیروزکوه","ارجمند",1,241,5,0,126,372,2,374
"تهران","فیروزکوه","ارجمند",2,268,15,9,194,486,4,490
"تهران","فیروزکوه","ارجمند",3,260,1,0,81,342,4,346
"تهران","فیروزکوه","ارجمند",4,348,1,1,72,422,3,425
"تهران","فیروزکوه","ارجمند",5,175,1,0,81,257,3,260
"تهران","فیروزکوه","ارجمند",6,333,2,0,159,494,8,502
"تهران","فیروزکوه","ارجمند",7,246,7,0,84,337,6,343
"تهران","فیروزکوه","ارجمند",8,146,3,1,60,210,2,212
"تهران","فیروزکوه","ارجمند",9,542,1,1,109,653,26,679
"تهران","فیروزکوه","ارجمند",10,278,2,1,71,352,6,358
"تهران","کرج","مرکزی",1,349,45,23,1217,1634,14,1648
"تهران","کرج","مرکزی",2,507,24,31,1506,2068,17,2085
"تهران","کرج","مرکزی",3,631,72,25,957,1685,0,1685
"تهران","کرج","مرکزی",4,778,61,20,1083,1942,46,1988
"تهران","کرج","مرکزی",5,546,57,25,971,1599,10,1609
"تهران","کرج","مرکزی",6,606,18,15,873,1512,22,1534
"تهران","کرج","مرکزی",7,513,39,19,867,1438,21,1459
"تهران","کرج","مرکزی",8,283,32,45,1772,2132,26,2158
"تهران","کرج","مرکزی",9,469,63,43,1889,2464,30,2494
"تهران","کرج","مرکزی",10,313,36,34,882,1265,17,1282
"تهران","کرج","مرکزی",11,332,39,37,1072,1480,16,1496
"تهران","کرج","مرکزی",12,347,31,17,1290,1685,17,1702
"تهران","کرج","مرکزی",13,397,49,35,1433,1914,27,1941
"تهران","کرج","مرکزی",14,587,27,13,607,1234,27,1261
"تهران","کرج","مرکزی",15,549,12,14,387,962,15,977
"تهران","کرج","مرکزی",16,642,24,19,662,1347,12,1359
"تهران","کرج","مرکزی",17,1062,13,8,307,1390,25,1415
"تهران","کرج","مرکزی",18,1440,10,5,291,1746,23,1769
"تهران","کرج","مرکزی",19,1169,12,16,321,1518,28,1546
"تهران","کرج","مرکزی",20,618,24,3,303,948,23,971
"تهران","کرج","مرکزی",21,370,37,26,1197,1630,14,1644
"تهران","کرج","مرکزی",22,361,24,22,1107,1514,28,1542
"تهران","کرج","مرکزی",23,421,55,32,1492,2000,19,2019
"تهران","کرج","مرکزی",24,127,18,26,1626,1797,11,1808
"تهران","کرج","مرکزی",25,835,86,35,1282,2238,29,2267
"تهران","کرج","مرکزی",26,872,106,20,1128,2126,41,2167
"تهران","کرج","مرکزی",27,207,24,27,1209,1467,6,1473
"تهران","کرج","مرکزی",28,733,45,27,1050,1855,22,1877
"تهران","کرج","مرکزی",29,733,47,19,941,1740,56,1796
"تهران","کرج","مرکزی",30,976,30,16,563,1585,26,1611
"تهران","کرج","مرکزی",31,800,51,26,931,1808,24,1832
"تهران","کرج","مرکزی",32,817,38,15,739,1609,20,1629
"تهران","کرج","مرکزی",33,921,50,35,1076,2082,39,2121
"تهران","کرج","مرکزی",34,710,36,17,476,1239,16,1255
"تهران","کرج","مرکزی",35,508,43,24,1185,1760,20,1780
"تهران","کرج","مرکزی",36,604,23,7,752,1386,30,1416
"تهران","کرج","مرکزی",37,896,54,18,1030,1998,42,2040
"تهران","کرج","مرکزی",38,1006,50,23,976,2055,33,2088
"تهران","کرج","مرکزی",39,865,50,13,763,1691,35,1726
"تهران","کرج","مرکزی",40,284,34,33,1349,1700,18,1718
"تهران","کرج","مرکزی",41,328,57,29,1119,1533,17,1550
"تهران","کرج","مرکزی",42,382,35,26,1133,1576,15,1591
"تهران","کرج","مرکزی",43,749,15,7,374,1145,31,1176
"تهران","کرج","مرکزی",44,618,27,5,542,1192,25,1217
"تهران","کرج","مرکزی",45,409,22,4,376,811,11,822
"تهران","کرج","مرکزی",46,1097,19,10,436,1562,22,1584
"تهران","کرج","مرکزی",47,1201,28,4,293,1526,25,1551
"تهران","کرج","مرکزی",48,860,32,11,748,1651,23,1674
"تهران","کرج","مرکزی",49,1197,34,7,429,1667,19,1686
"تهران","کرج","مرکزی",50,196,2,2,94,294,9,303
"تهران","کرج","مرکزی",51,1332,23,17,591,1963,37,2000
"تهران","کرج","مرکزی",52,706,7,8,342,1063,20,1083
"تهران","کرج","مرکزی",53,1223,15,1,400,1639,44,1683
"تهران","کرج","مرکزی",54,685,30,8,463,1186,20,1206
"تهران","کرج","مرکزی",55,707,20,3,383,1113,24,1137
"تهران","کرج","مرکزی",56,922,18,3,349,1292,32,1324
"تهران","کرج","مرکزی",57,840,13,4,479,1336,21,1357
"تهران","کرج","مرکزی",58,806,24,11,490,1331,22,1353
"تهران","کرج","مرکزی",59,468,18,3,437,926,20,946
"تهران","کرج","مرکزی",60,467,9,9,486,971,22,993
"تهران","کرج","مرکزی",61,348,30,29,779,1186,17,1203
"تهران","کرج","مرکزی",62,796,34,33,567,1430,30,1460
"تهران","کرج","مرکزی",63,681,24,5,452,1162,17,1179
"تهران","کرج","مرکزی",64,691,12,4,285,992,16,1008
"تهران","کرج","مرکزی",65,879,31,14,721,1645,34,1679
"تهران","کرج","مرکزی",66,918,32,8,682,1640,32,1672
"تهران","کرج","مرکزی",67,756,27,4,406,1193,19,1212
"تهران","کرج","مرکزی",68,648,28,12,825,1513,18,1531
"تهران","کرج","مرکزی",69,701,27,14,666,1408,24,1432
"تهران","کرج","مرکزی",70,580,13,0,245,838,12,850
"تهران","کرج","مرکزی",71,774,32,11,617,1434,29,1463
"تهران","کرج","مرکزی",72,488,24,5,612,1129,14,1143
"تهران","کرج","مرکزی",73,428,29,5,608,1070,18,1088
"تهران","کرج","مرکزی",74,912,20,11,470,1413,29,1442
"تهران","کرج","مرکزی",75,904,14,3,268,1189,26,1215
"تهران","کرج","مرکزی",76,561,20,6,627,1214,22,1236
"تهران","کرج","مرکزی",77,1762,27,14,677,2480,26,2506
"تهران","کرج","مرکزی",78,702,20,9,397,1128,24,1152
"تهران","کرج","مرکزی",79,950,14,0,319,1283,38,1321
"تهران","کرج","مرکزی",80,885,38,15,618,1556,32,1588
"تهران","کرج","مرکزی",81,404,31,18,637,1090,17,1107
"تهران","کرج","مرکزی",82,606,18,11,471,1106,20,1126
"تهران","کرج","مرکزی",83,1044,28,13,802,1887,34,1921
"تهران","کرج","مرکزی",84,516,40,14,1049,1619,55,1674
"تهران","کرج","مرکزی",85,589,32,7,595,1223,20,1243
"تهران","کرج","مرکزی",86,741,27,4,483,1255,15,1270
"تهران","کرج","مرکزی",87,446,12,13,628,1099,13,1112
"تهران","کرج","مرکزی",88,1461,21,5,233,1720,31,1751
"تهران","کرج","مرکزی",89,1285,38,11,592,1926,38,1964
"تهران","کرج","مرکزی",90,411,29,4,537,981,17,998
"تهران","کرج","مرکزی",91,376,21,7,694,1098,14,1112
"تهران","کرج","مرکزی",92,221,28,18,1079,1346,18,1364
"تهران","کرج","مرکزی",93,890,30,9,534,1463,37,1500
"تهران","کرج","مرکزی",94,968,36,5,412,1421,34,1455
"تهران","کرج","مرکزی",95,500,19,7,580,1106,27,1133
"تهران","کرج","مرکزی",96,896,32,5,666,1599,0,1599
"تهران","کرج","مرکزی",97,868,22,4,490,1384,0,1384
"تهران","کرج","مرکزی",98,1244,38,6,607,1895,,1895
"تهران","کرج","مرکزی",99,876,26,12,619,1533,33,1566
"تهران","کرج","مرکزی",100,1039,34,13,560,1646,26,1672
"تهران","کرج","مرکزی",101,1441,38,6,965,2450,39,2489
"تهران","کرج","مرکزی",102,1454,37,8,740,2239,44,2283
"تهران","کرج","مرکزی",103,812,33,30,1807,2682,25,2707
"تهران","کرج","مرکزی",104,594,22,24,1338,1978,22,2000
"تهران","کرج","مرکزی",105,605,30,13,1322,1970,30,2000
"تهران","کرج","مرکزی",106,501,30,6,1144,1681,37,1718
"تهران","کرج","مرکزی",107,699,31,8,1071,1809,31,1840
"تهران","کرج","مرکزی",108,761,36,15,479,1291,24,1315
"تهران","کرج","مرکزی",109,1009,23,7,486,1525,25,1550
"تهران","کرج","مرکزی",110,1112,33,16,589,1750,34,1784
"تهران","کرج","مرکزی",111,541,20,4,411,976,20,996
"تهران","کرج","مرکزی",112,732,37,7,1131,1907,29,1936
"تهران","کرج","مرکزی",113,568,15,8,786,1377,29,1406
"تهران","کرج","مرکزی",114,1388,21,13,865,2287,12,2299
"تهران","کرج","مرکزی",115,908,39,1,640,1588,26,1614
"تهران","کرج","مرکزی",116,549,18,12,566,1145,20,1165
"تهران","کرج","مرکزی",117,702,20,5,572,1299,17,1316
"تهران","کرج","مرکزی",118,715,30,13,832,1590,33,1623
"تهران","کرج","مرکزی",119,788,24,8,697,1517,32,1549
"تهران","کرج","مرکزی",120,471,11,8,518,1008,20,1028
"تهران","کرج","مرکزی",121,613,27,28,742,1410,33,1443
"تهران","کرج","مرکزی",122,1063,51,8,1077,2199,38,2237
"تهران","کرج","مرکزی",123,479,22,4,555,1060,28,1088
"تهران","کرج","مرکزی",124,688,23,15,731,1457,16,1473
"تهران","کرج","مرکزی",125,703,17,7,733,1460,3,1463
"تهران","کرج","مرکزی",126,619,17,10,653,1299,16,1315
"تهران","کرج","مرکزی",127,457,23,11,456,947,24,971
"تهران","کرج","مرکزی",128,1741,56,19,647,2463,26,2489
"تهران","کرج","مرکزی",129,709,21,11,481,1222,25,1247
"تهران","کرج","مرکزی",130,749,27,17,515,1308,8,1316
"تهران","کرج","مرکزی",131,1080,29,29,733,1871,26,1897
"تهران","کرج","مرکزی",132,274,34,18,1330,1656,13,1669
"تهران","کرج","مرکزی",133,743,35,9,630,1417,23,1440
"تهران","کرج","مرکزی",134,797,26,12,799,1634,14,1648
"تهران","کرج","مرکزی",135,749,32,12,693,1486,14,1500
"تهران","کرج","مرکزی",136,1184,38,15,1015,2252,18,2270
"تهران","کرج","مرکزی",137,698,35,4,542,1279,21,1300
"تهران","کرج","مرکزی",138,641,30,23,913,1607,23,1630
"تهران","کرج","مرکزی",139,596,39,18,775,1428,17,1445
"تهران","کرج","مرکزی",140,528,46,9,521,1104,14,1118
"تهران","کرج","مرکزی",141,476,32,4,416,928,19,947
"تهران","کرج","مرکزی",142,473,31,31,999,1534,21,1555
"تهران","کرج","مرکزی",143,317,32,27,1144,1520,17,1537
"تهران","کرج","مرکزی",144,395,35,25,1164,1619,16,1635
"تهران","کرج","مرکزی",145,1279,51,17,640,1987,35,2022
"تهران","کرج","مرکزی",146,787,27,12,611,1437,33,1470
"تهران","کرج","مرکزی",147,303,16,6,883,1208,,1208
"تهران","کرج","مرکزی",148,416,21,12,1045,1494,53,1547
"تهران","کرج","مرکزی",149,411,40,11,980,1442,16,1458
"تهران","کرج","مرکزی",150,394,29,5,699,1127,25,1152
"تهران","کرج","مرکزی",151,355,12,4,391,762,20,782
"تهران","کرج","مرکزی",152,744,24,25,761,1554,25,1579
"تهران","کرج","مرکزی",153,430,21,16,638,1105,12,1117
"تهران","کرج","مرکزی",154,528,30,10,857,1425,32,1457
"تهران","کرج","مرکزی",155,643,15,7,409,1074,16,1090
"تهران","کرج","مرکزی",156,567,21,5,372,965,27,992
"تهران","کرج","مرکزی",157,972,9,4,517,1502,34,1536
"تهران","کرج","مرکزی",158,1057,8,8,313,1386,13,1399
"تهران","کرج","مرکزی",159,1116,30,8,399,1553,35,1588
"تهران","کرج","مرکزی",160,780,27,23,617,1447,41,1488
"تهران","کرج","مرکزی",161,807,20,6,492,1325,22,1347
"تهران","کرج","مرکزی",162,809,18,5,717,1549,35,1584
"تهران","کرج","مرکزی",163,708,11,1,435,1155,11,1166
"تهران","کرج","مرکزی",164,1072,2,0,266,1340,18,1358
"تهران","کرج","مرکزی",165,1187,9,2,278,1476,31,1507
"تهران","کرج","مرکزی",166,507,9,12,435,963,37,1000
"تهران","کرج","مرکزی",167,631,11,5,368,1015,15,1030
"تهران","کرج","مرکزی",168,758,14,5,585,1362,38,1400
"تهران","کرج","مرکزی",169,633,13,3,231,880,16,896
"تهران","کرج","مرکزی",170,726,30,18,662,1436,15,1451
"تهران","کرج","مرکزی",171,782,25,14,634,1455,27,1482
"تهران","کرج","مرکزی",172,534,21,8,748,1311,22,1333
"تهران","کرج","مرکزی",173,1011,20,4,457,1492,37,1529
"تهران","کرج","مرکزی",174,1051,13,4,266,1334,25,1359
"تهران","کرج","مرکزی",175,769,7,4,404,1184,17,1201
"تهران","کرج","مرکزی",176,677,4,3,208,892,20,912
"تهران","کرج","مرکزی",177,1013,20,8,397,1438,32,1470
"تهران","کرج","مرکزی",178,888,10,2,209,1109,15,1124
"تهران","کرج","مرکزی",179,861,5,4,409,1279,122,1401
"تهران","کرج","مرکزی",180,996,20,10,608,1634,26,1660
"تهران","کرج","مرکزی",181,1197,12,5,405,1619,33,1652
"تهران","کرج","مرکزی",182,663,4,6,206,879,11,890
"تهران","کرج","مرکزی",183,620,4,9,297,930,25,955
"تهران","کرج","مرکزی",184,1163,9,5,424,1601,25,1626
"تهران","کرج","مرکزی",185,741,46,24,1175,1986,50,2036
"تهران","کرج","مرکزی",186,455,20,9,761,1245,14,1259
"تهران","کرج","مرکزی",187,467,24,14,826,1331,21,1352
"تهران","کرج","مرکزی",188,555,33,22,841,1451,25,1476
"تهران","کرج","مرکزی",189,771,35,17,607,1430,31,1461
"تهران","کرج","مرکزی",190,900,27,15,603,1545,16,1561
"تهران","کرج","مرکزی",191,273,18,3,413,707,14,721
"تهران","کرج","مرکزی",192,783,26,6,575,1390,18,1408
"تهران","کرج","مرکزی",193,815,19,1,337,1172,22,1194
"تهران","کرج","مرکزی",194,340,27,14,752,1133,16,1149
"تهران","کرج","مرکزی",195,770,48,20,937,1775,28,1803
"تهران","کرج","مرکزی",196,266,16,32,1110,1424,26,1450
"تهران","کرج","مرکزی",197,264,18,33,1029,1344,13,1357
"تهران","کرج","مرکزی",198,349,35,47,1823,2254,46,2300
"تهران","کرج","مرکزی",199,223,22,32,1764,2041,18,2059
"تهران","کرج","مرکزی",200,251,15,29,1248,1543,13,1556
"تهران","کرج","مرکزی",201,236,15,15,1583,1849,7,1856
"تهران","کرج","مرکزی",202,478,45,44,1787,2354,15,2369
"تهران","کرج","مرکزی",203,321,26,29,1443,1819,21,1840
"تهران","کرج","مرکزی",204,993,47,14,1008,2062,,2062
"تهران","کرج","مرکزی",205,969,39,6,690,1704,16,1720
"تهران","کرج","مرکزی",206,630,12,10,322,974,19,993
"تهران","کرج","مرکزی",207,599,22,6,552,1179,21,1200
"تهران","کرج","مرکزی",208,659,17,5,446,1127,22,1149
"تهران","کرج","مرکزی",209,1162,27,3,603,1795,40,1835
"تهران","کرج","مرکزی",210,858,11,4,402,1275,34,1309
"تهران","کرج","مرکزی",211,702,24,24,1118,1868,28,1896
"تهران","کرج","مرکزی",212,463,28,8,813,1312,15,1327
"تهران","کرج","مرکزی",213,764,41,15,943,1763,3,1766
"تهران","کرج","مرکزی",214,683,58,4,1343,2088,22,2110
"تهران","کرج","مرکزی",215,731,42,27,919,1719,,1719
"تهران","کرج","مرکزی",216,843,42,18,1035,1938,40,1978
"تهران","کرج","مرکزی",217,738,36,23,1128,1925,40,1965
"تهران","کرج","مرکزی",218,545,29,9,1128,1711,27,1738
"تهران","کرج","مرکزی",219,1029,46,14,929,2018,34,2052
"تهران","کرج","مرکزی",220,554,35,25,1125,1739,18,1757
"تهران","کرج","مرکزی",221,470,15,10,623,1118,15,1133
"تهران","کرج","مرکزی",222,790,28,10,581,1409,37,1446
"تهران","کرج","مرکزی",223,849,25,5,401,1280,20,1300
"تهران","کرج","مرکزی",224,785,52,24,1329,2190,22,2212
"تهران","کرج","مرکزی",225,340,15,22,1317,1694,13,1707
"تهران","کرج","مرکزی",226,527,40,17,1071,1655,45,1700
"تهران","کرج","مرکزی",227,575,25,11,884,1495,30,1525
"تهران","کرج","مرکزی",228,988,34,1,498,1521,30,1551
"تهران","کرج","مرکزی",229,974,20,1,337,1332,20,1352
"تهران","کرج","مرکزی",230,945,31,4,562,1542,26,1568
"تهران","کرج","مرکزی",231,1204,30,2,433,1669,19,1688
"تهران","کرج","مرکزی",232,860,18,0,307,1185,21,1206
"تهران","کرج","مرکزی",233,1453,36,1,334,1824,29,1853
"تهران","کرج","مرکزی",234,1135,17,2,347,1501,19,1520
"تهران","کرج","مرکزی",235,704,33,4,444,1185,23,1208
"تهران","کرج","مرکزی",236,1152,25,6,588,1771,22,1793
"تهران","کرج","مرکزی",237,1029,10,1,347,1387,30,1417
"تهران","کرج","مرکزی",238,984,4,1,139,1128,12,1140
"تهران","کرج","مرکزی",239,885,5,10,320,1220,28,1248
"تهران","کرج","مرکزی",240,1169,16,2,196,1383,14,1397
"تهران","کرج","مرکزی",241,783,13,2,312,1110,14,1124
"تهران","کرج","مرکزی",242,683,11,0,175,869,11,880
"تهران","کرج","مرکزی",243,1171,14,7,316,1508,28,1536
"تهران","کرج","مرکزی",244,968,26,11,646,1651,34,1685
"تهران","کرج","مرکزی",245,1083,34,13,826,1956,27,1983
"تهران","کرج","مرکزی",246,1310,12,0,405,1727,24,1751
"تهران","کرج","مرکزی",247,1320,9,2,451,1782,17,1799
"تهران","کرج","مرکزی",248,1277,6,0,218,1501,12,1513
"تهران","کرج","مرکزی",249,941,11,5,240,1197,17,1214
"تهران","کرج","مرکزی",250,1072,8,4,149,1233,13,1246
"تهران","کرج","مرکزی",251,1098,17,7,478,1600,31,1631
"تهران","کرج","مرکزی",252,1274,14,1,262,1551,30,1581
"تهران","کرج","مرکزی",253,668,21,5,402,1096,25,1121
"تهران","کرج","مرکزی",254,641,10,0,217,868,14,882
"تهران","کرج","مرکزی",255,784,27,8,572,1391,2,1393
"تهران","کرج","مرکزی",256,816,23,4,341,1184,9,1193
"تهران","کرج","مرکزی",257,618,26,18,772,1434,15,1449
"تهران","کرج","مرکزی",258,853,31,19,891,1794,21,1815
"تهران","کرج","مرکزی",259,689,31,10,879,1609,28,1637
"تهران","کرج","مرکزی",260,748,33,19,799,1599,32,1631
"تهران","کرج","مرکزی",261,1267,38,28,1429,2762,32,2794
"تهران","کرج","مرکزی",262,955,37,33,1001,2026,36,2062
"تهران","کرج","مرکزی",263,731,21,11,418,1181,19,1200
"تهران","کرج","مرکزی",264,790,11,3,308,1112,20,1132
"تهران","کرج","مرکزی",265,958,46,8,613,1625,36,1661
"تهران","کرج","مرکزی",266,858,37,15,697,1607,34,1641
"تهران","کرج","مرکزی",267,968,30,1,535,1534,28,1562
"تهران","کرج","مرکزی",268,1145,39,17,977,2178,32,2210
"تهران","کرج","مرکزی",269,1208,41,6,603,1858,40,1898
"تهران","کرج","مرکزی",270,1265,26,8,410,1709,58,1767
"تهران","کرج","مرکزی",271,783,15,6,766,1570,38,1608
"تهران","کرج","مرکزی",272,1087,34,3,632,1756,27,1783
"تهران","کرج","مرکزی",273,1359,27,2,547,1935,22,1957
"تهران","کرج","مرکزی",274,503,19,8,526,1056,17,1073
"تهران","کرج","مرکزی",275,592,16,5,452,1065,14,1079
"تهران","کرج","مرکزی",276,915,27,11,643,1596,32,1628
"تهران","کرج","مرکزی",277,1155,24,9,518,1706,27,1733
"تهران","کرج","مرکزی",278,1026,28,19,666,1739,33,1772
"تهران","کرج","مرکزی",279,1278,20,8,448,1754,42,1796
"تهران","کرج","مرکزی",280,977,16,4,375,1372,27,1399
"تهران","کرج","مرکزی",281,972,26,2,351,1351,30,1381
"تهران","کرج","مرکزی",282,1071,16,5,260,1352,29,1381
"تهران","کرج","مرکزی",283,614,16,5,426,1061,26,1087
"تهران","کرج","مرکزی",284,808,17,5,348,1178,11,1189
"تهران","کرج","مرکزی",285,872,21,7,330,1230,38,1268
"تهران","کرج","مرکزی",286,1164,24,3,265,1456,35,1491
"تهران","کرج","مرکزی",287,1207,15,1,244,1467,33,1500
"تهران","کرج","مرکزی",288,912,25,11,422,1370,35,1405
"تهران","کرج","مرکزی",289,755,16,2,251,1024,20,1044
"تهران","کرج","مرکزی",290,559,16,10,418,1003,15,1018
"تهران","کرج","مرکزی",291,941,33,9,498,1481,26,1507
"تهران","کرج","مرکزی",292,1437,36,9,592,2074,51,2125
"تهران","کرج","مرکزی",293,1131,9,2,278,1420,20,1440
"تهران","کرج","مرکزی",294,1270,29,1,415,1715,27,1742
"تهران","کرج","مرکزی",295,957,21,18,734,1730,37,1767
"تهران","کرج","مرکزی",296,1005,26,10,503,1544,38,1582
"تهران","کرج","مرکزی",297,955,23,16,750,1744,27,1771
"تهران","کرج","مرکزی",298,1042,33,16,571,1662,36,1698
"تهران","کرج","مرکزی",299,804,17,6,276,1103,34,1137
"تهران","کرج","مرکزی",300,918,24,7,200,1149,25,1174
"تهران","کرج","مرکزی",301,687,52,101,967,1807,63,1870
"تهران","کرج","مرکزی",302,1116,46,16,1033,2211,24,2235
"تهران","کرج","مرکزی",303,869,28,28,805,1730,30,1760
"تهران","کرج","مرکزی",304,464,18,30,810,1322,13,1335
"تهران","کرج","مرکزی",305,507,23,24,823,1377,12,1389
"تهران","کرج","مرکزی",306,835,13,11,430,1289,25,1314
"تهران","کرج","مرکزی",307,748,46,22,1118,1934,26,1960
"تهران","کرج","مرکزی",308,825,28,22,1014,1889,40,1929
"تهران","کرج","مرکزی",309,599,28,13,1084,1724,3,1727
"تهران","کرج","مرکزی",310,349,56,52,1548,2005,21,2026
"تهران","کرج","مرکزی",311,372,22,31,1017,1442,20,1462
"تهران","کرج","مرکزی",312,385,28,34,1552,1999,23,2022
"تهران","کرج","مرکزی",313,344,41,23,1194,1602,14,1616
"تهران","کرج","مرکزی",314,355,39,31,1653,2078,12,2090
"تهران","کرج","مرکزی",315,339,50,40,1514,1943,42,1985
"تهران","کرج","مرکزی",316,319,17,33,1037,1406,14,1420
"تهران","کرج","مرکزی",317,745,49,9,892,1695,18,1713
"تهران","کرج","مرکزی",318,744,50,20,676,1490,28,1518
"تهران","کرج","مرکزی",319,375,54,28,1280,1737,17,1754
"تهران","کرج","مرکزی",320,283,25,47,1332,1687,14,1701
"تهران","کرج","مرکزی",321,359,30,34,1560,1983,17,2000
"تهران","کرج","مرکزی",322,437,58,33,1631,2159,23,2182
"تهران","کرج","مرکزی",323,436,47,28,1021,1532,20,1552
"تهران","کرج","مرکزی",324,431,29,21,1138,1619,21,1640
"تهران","کرج","مرکزی",325,1258,33,19,812,2122,30,2152
"تهران","کرج","مرکزی",326,311,15,12,652,990,22,1012
"تهران","کرج","مرکزی",327,553,23,18,647,1241,21,1262
"تهران","کرج","مرکزی",328,649,19,11,460,1139,23,1162
"تهران","کرج","مرکزی",329,660,6,23,479,1168,16,1184
"تهران","کرج","مرکزی",330,260,26,17,939,1242,21,1263
"تهران","کرج","مرکزی",331,212,36,18,1016,1282,12,1294
"تهران","کرج","مرکزی",332,753,21,25,758,1557,23,1580
"تهران","کرج","مرکزی",333,821,42,15,814,1692,37,1729
"تهران","کرج","مرکزی",334,666,41,10,590,1307,20,1327
"تهران","کرج","مرکزی",335,588,35,12,1281,1916,13,1929
"تهران","کرج","مرکزی",336,493,17,12,715,1237,21,1258
"تهران","کرج","مرکزی",337,778,25,14,358,1175,25,1200
"تهران","کرج","مرکزی",338,711,14,9,205,939,10,949
"تهران","کرج","مرکزی",339,798,28,22,526,1374,18,1392
"تهران","کرج","مرکزی",340,1691,62,24,972,2749,42,2791
"تهران","کرج","مرکزی",341,494,46,26,1080,1646,38,1684
"تهران","کرج","مرکزی",342,977,43,31,1245,2296,28,2324
"تهران","کرج","مرکزی",343,538,30,28,752,1348,14,1362
"تهران","کرج","مرکزی",344,534,23,17,586,1160,23,1183
"تهران","کرج","مرکزی",345,532,51,42,1498,2123,2,2125
"تهران","کرج","مرکزی",346,994,34,8,743,1779,30,1809
"تهران","کرج","مرکزی",347,673,34,18,1091,1816,21,1837
"تهران","کرج","مرکزی",348,733,50,14,858,1655,24,1679
"تهران","کرج","مرکزی",349,435,41,34,1042,1552,16,1568
"تهران","کرج","مرکزی",350,464,26,11,763,1264,13,1277
"تهران","کرج","مرکزی",351,319,33,23,879,1254,15,1269
"تهران","کرج","مرکزی",352,552,48,33,1208,1841,20,1861
"تهران","کرج","مرکزی",353,582,37,18,962,1599,23,1622
"تهران","کرج","مرکزی",354,958,53,23,938,1972,36,2008
"تهران","کرج","مرکزی",355,745,27,11,555,1338,17,1355
"تهران","کرج","مرکزی",356,417,14,7,372,810,17,827
"تهران","کرج","مرکزی",357,828,18,7,405,1258,30,1288
"تهران","کرج","مرکزی",358,1085,9,12,309,1415,22,1437
"تهران","کرج","مرکزی",359,934,67,14,1010,2025,29,2054
"تهران","کرج","مرکزی",360,703,46,17,1020,1786,25,1811
"تهران","کرج","مرکزی",361,306,33,13,708,1060,11,1071
"تهران","کرج","مرکزی",362,873,21,10,500,1404,21,1425
"تهران","کرج","مرکزی",363,927,34,4,475,1440,36,1476
"تهران","کرج","مرکزی",364,780,29,14,533,1356,38,1394
"تهران","کرج","مرکزی",365,385,15,8,350,758,17,775
"تهران","کرج","مرکزی",366,631,7,1,183,822,17,839
"تهران","کرج","مرکزی",367,366,6,6,180,558,9,567
"تهران","کرج","مرکزی",368,854,19,6,374,1253,13,1266
"تهران","کرج","مرکزی",369,850,11,2,224,1087,27,1114
"تهران","کرج","مرکزی",370,707,10,3,258,978,22,1000
"تهران","کرج","مرکزی",371,888,17,6,395,1306,21,1327
"تهران","کرج","مرکزی",372,378,8,4,153,543,7,550
"تهران","کرج","مرکزی",373,570,6,1,167,744,17,761
"تهران","کرج","مرکزی",374,214,5,6,101,326,6,332
"تهران","کرج","مرکزی",375,526,4,1,157,688,15,703
"تهران","کرج","مرکزی",376,679,17,3,334,1033,15,1048
"تهران","کرج","مرکزی",377,661,7,4,172,844,11,855
"تهران","کرج","مرکزی",378,720,8,4,109,841,16,857
"تهران","کرج","مرکزی",379,355,4,0,80,439,10,449
"تهران","کرج","مرکزی",380,727,6,4,197,934,22,956
"تهران","کرج","مرکزی",381,692,8,3,113,816,4,820
"تهران","کرج","مرکزی",382,785,6,7,305,1103,38,1141
"تهران","کرج","مرکزی",383,685,9,2,160,856,8,864
"تهران","کرج","مرکزی",384,925,6,0,211,1142,31,1173
"تهران","کرج","مرکزی",385,875,4,0,257,1136,38,1174
"تهران","کرج","مرکزی",386,1164,12,4,228,1408,12,1420
"تهران","کرج","مرکزی",387,582,0,1,134,717,14,731
"تهران","کرج","مرکزی",388,763,10,16,238,1027,32,1059
"تهران","کرج","مرکزی",389,571,14,14,498,1097,8,1105
"تهران","کرج","مرکزی",390,585,20,7,423,1035,22,1057
"تهران","کرج","مرکزی",391,545,10,3,308,866,21,887
"تهران","کرج","مرکزی",392,556,20,7,469,1052,26,1078
"تهران","کرج","مرکزی",393,721,21,3,583,1328,26,1354
"تهران","کرج","مرکزی",394,410,20,5,385,820,12,832
"تهران","کرج","مرکزی",395,615,21,16,666,1318,19,1337
"تهران","کرج","مرکزی",396,342,23,13,397,775,9,784
"تهران","کرج","مرکزی",397,574,38,12,546,1170,30,1200
"تهران","کرج","مرکزی",398,612,25,7,508,1152,0,1152
"تهران","کرج","مرکزی",399,687,34,17,619,1357,28,1385
"تهران","کرج","مرکزی",400,852,50,14,643,1559,31,1590
"تهران","کرج","مرکزی",401,349,29,22,993,1393,22,1415
"تهران","کرج","مرکزی",402,251,26,50,1462,1789,19,1808
"تهران","کرج","مرکزی",403,569,28,15,664,1276,17,1293
"تهران","کرج","مرکزی",404,641,30,6,533,1210,17,1227
"تهران","کرج","مرکزی",405,380,29,8,708,1125,14,1139
"تهران","کرج","مرکزی",406,666,21,13,729,1429,19,1448
"تهران","کرج","مرکزی",407,838,59,14,896,1807,28,1835
"تهران","کرج","مرکزی",408,856,49,3,644,1552,28,1580
"تهران","کرج","مرکزی",409,431,30,2,570,1033,10,1043
"تهران","کرج","مرکزی",410,306,17,60,563,946,15,961
"تهران","کرج","مرکزی",411,363,32,12,591,998,13,1011
"تهران","کرج","مرکزی",412,368,25,7,539,939,17,956
"تهران","کرج","مرکزی",413,529,24,21,715,1289,25,1314
"تهران","کرج","مرکزی",414,552,26,14,617,1209,13,1222
"تهران","کرج","مرکزی",415,492,35,88,533,1148,22,1170
"تهران","کرج","مرکزی",416,553,31,119,521,1224,15,1239
"تهران","کرج","مرکزی",417,1033,66,20,1010,2129,25,2154
"تهران","کرج","مرکزی",418,528,38,21,662,1249,18,1267
"تهران","کرج","مرکزی",419,590,46,11,565,1212,30,1242
"تهران","کرج","مرکزی",420,406,17,119,869,1411,21,1432
"تهران","کرج","مرکزی",421,706,31,10,522,1269,29,1298
"تهران","کرج","مرکزی",422,726,37,13,728,1504,14,1518
"تهران","کرج","مرکزی",423,754,57,18,585,1414,38,1452
"تهران","کرج","مرکزی",424,777,31,11,419,1238,21,1259
"تهران","کرج","مرکزی",425,855,43,22,687,1607,26,1633
"تهران","کرج","مرکزی",426,638,30,9,588,1265,30,1295
"تهران","کرج","مرکزی",427,657,28,29,848,1562,13,1575
"تهران","کرج","مرکزی",428,488,45,16,887,1436,18,1454
"تهران","کرج","مرکزی",429,682,38,32,810,1562,0,1562
"تهران","کرج","مرکزی",430,924,68,17,758,1767,233,2000
"تهران","کرج","مرکزی",431,828,45,9,569,1451,42,1493
"تهران","کرج","مرکزی",432,630,25,23,799,1477,16,1493
"تهران","کرج","مرکزی",433,1523,45,14,774,2356,30,2386
"تهران","کرج","مرکزی",434,921,36,5,568,1530,29,1559
"تهران","کرج","مرکزی",435,987,35,3,419,1444,21,1465
"تهران","کرج","مرکزی",436,596,15,7,384,1002,22,1024
"تهران","کرج","مرکزی",437,696,26,6,442,1170,2,1172
"تهران","کرج","مرکزی",438,965,27,10,693,1695,21,1716
"تهران","کرج","مرکزی",439,1167,21,5,621,1814,22,1836
"تهران","کرج","مرکزی",440,511,28,8,652,1199,15,1214
"تهران","کرج","مرکزی",441,407,13,1,294,715,7,722
"تهران","کرج","مرکزی",442,495,41,21,857,1414,26,1440
"تهران","کرج","مرکزی",443,644,44,21,873,1582,27,1609
"تهران","کرج","مرکزی",444,283,21,26,1380,1710,10,1720
"تهران","کرج","مرکزی",445,696,51,30,1173,1950,29,1979
"تهران","کرج","مرکزی",446,850,43,19,1336,2248,37,2285
"تهران","کرج","مرکزی",447,435,35,46,1040,1556,13,1569
"تهران","کرج","مرکزی",448,404,24,32,806,1266,19,1285
"تهران","کرج","مرکزی",449,431,46,33,1415,1925,26,1951
"تهران","کرج","مرکزی",450,377,41,37,1276,1731,25,1756
"تهران","کرج","مرکزی",451,872,40,8,505,1425,26,1451
"تهران","کرج","مرکزی",452,775,22,3,401,1201,20,1221
"تهران","کرج","مرکزی",453,262,19,3,468,752,9,761
"تهران","کرج","مرکزی",454,763,36,25,958,1782,37,1819
"تهران","کرج","مرکزی",455,768,29,10,554,1361,19,1380
"تهران","کرج","مرکزی",456,667,40,13,824,1544,24,1568
"تهران","کرج","مرکزی",457,787,45,12,675,1519,22,1541
"تهران","کرج","مرکزی",458,416,24,33,1023,1496,34,1530
"تهران","کرج","مرکزی",459,416,35,17,1049,1517,15,1532
"تهران","کرج","مرکزی",460,633,58,25,1072,1788,22,1810
"تهران","کرج","مرکزی",461,729,41,8,680,1458,28,1486
"تهران","کرج","مرکزی",462,752,41,4,578,1375,18,1393
"تهران","کرج","مرکزی",463,1403,48,11,902,2364,49,2413
"تهران","کرج","مرکزی",464,497,19,13,627,1156,17,1173
"تهران","کرج","مرکزی",465,608,33,5,817,1463,24,1487
"تهران","کرج","مرکزی",466,255,6,3,179,443,5,448
"تهران","کرج","مرکزی",467,996,30,7,751,1784,22,1806
"تهران","کرج","مرکزی",468,928,26,9,811,1774,30,1804
"تهران","کرج","مرکزی",469,906,36,11,881,1834,15,1849
"تهران","کرج","مرکزی",470,720,24,4,655,1403,24,1427
"تهران","کرج","مرکزی",471,625,20,13,799,1457,,1457
"تهران","کرج","مرکزی",472,650,19,13,868,1550,25,1575
"تهران","کرج","مرکزی",473,920,30,12,559,1521,27,1548
"تهران","کرج","مرکزی",474,671,29,12,727,1439,24,1463
"تهران","کرج","مرکزی",475,1367,22,16,722,2127,0,2127
"تهران","کرج","مرکزی",476,641,31,10,694,1376,19,1395
"تهران","کرج","مرکزی",477,638,24,7,842,1511,36,1547
"تهران","کرج","مرکزی",478,576,12,7,292,887,10,897
"تهران","کرج","مرکزی",479,1278,19,8,680,1985,40,2025
"تهران","کرج","مرکزی",480,931,31,6,693,1661,19,1680
"تهران","کرج","مرکزی",481,915,15,7,547,1484,34,1518
"تهران","کرج","مرکزی",482,477,18,5,502,1002,20,1022
"تهران","کرج","مرکزی",483,1043,24,15,832,1914,40,1954
"تهران","کرج","مرکزی",484,701,34,14,763,1512,32,1544
"تهران","کرج","مرکزی",485,614,22,4,449,1089,24,1113
"تهران","کرج","مرکزی",486,789,17,10,431,1247,38,1285
"تهران","کرج","مرکزی",487,703,15,7,491,1216,13,1229
"تهران","کرج","مرکزی",488,574,12,11,398,995,22,1017
"تهران","کرج","مرکزی",489,840,16,20,728,1604,24,1628
"تهران","کرج","مرکزی",490,869,22,17,639,1547,24,1571
"تهران","کرج","مرکزی",491,875,19,17,437,1348,33,1381
"تهران","کرج","مرکزی",492,1405,14,6,397,1822,29,1851
"تهران","کرج","مرکزی",493,623,19,7,502,1151,26,1177
"تهران","کرج","مرکزی",494,814,28,2,658,1502,6,1508
"تهران","کرج","مرکزی",495,828,26,6,544,1404,0,1404
"تهران","کرج","مرکزی",496,910,12,1,489,1412,30,1442
"تهران","کرج","مرکزی",497,865,17,13,620,1515,15,1530
"تهران","کرج","مرکزی",498,1369,24,9,720,2122,42,2164
"تهران","کرج","مرکزی",499,472,24,7,546,1049,21,1070
"تهران","کرج","مرکزی",500,1692,21,8,695,2416,35,2451
"تهران","کرج","مرکزی",501,647,16,4,616,1283,17,1300
"تهران","کرج","مرکزی",502,998,13,3,536,1550,27,1577
"تهران","کرج","مرکزی",503,1381,31,10,744,2166,40,2206
"تهران","کرج","مرکزی",504,1233,17,2,760,2012,35,2047
"تهران","کرج","مرکزی",505,899,13,1,419,1332,0,1332
"تهران","کرج","مرکزی",506,1055,14,1,580,1650,39,1689
"تهران","کرج","مرکزی",507,1170,12,8,483,1673,37,1710
"تهران","کرج","مرکزی",508,1055,22,7,627,1711,28,1739
"تهران","کرج","مرکزی",509,1090,14,2,538,1644,36,1680
"تهران","کرج","مرکزی",510,1598,11,7,585,2201,25,2226
"تهران","کرج","مرکزی",511,962,14,6,463,1445,17,1462
"تهران","کرج","مرکزی",512,1262,8,7,244,1521,8,1529
"تهران","کرج","مرکزی",513,815,13,4,401,1233,15,1248
"تهران","کرج","مرکزی",514,1134,9,1,292,1436,21,1457
"تهران","کرج","مرکزی",515,1378,24,19,431,1852,36,1888
"تهران","کرج","مرکزی",516,961,12,15,435,1423,25,1448
"تهران","کرج","مرکزی",517,1037,24,3,449,1513,37,1550
"تهران","کرج","مرکزی",518,914,11,6,431,1362,21,1383
"تهران","کرج","مرکزی",519,1316,15,11,483,1825,21,1846
"تهران","کرج","مرکزی",520,950,16,42,342,1350,22,1372
"تهران","کرج","مرکزی",521,1040,15,19,351,1425,16,1441
"تهران","کرج","مرکزی",522,930,14,5,164,1113,24,1137
"تهران","کرج","مرکزی",523,805,18,18,414,1255,16,1271
"تهران","کرج","مرکزی",524,1061,14,23,357,1455,27,1482
"تهران","کرج","مرکزی",525,1184,10,17,279,1490,37,1527
"تهران","کرج","مرکزی",526,949,7,29,250,1235,24,1259
"تهران","کرج","مرکزی",527,720,8,0,278,1006,14,1020
"تهران","کرج","مرکزی",528,784,8,7,274,1073,14,1087
"تهران","کرج","مرکزی",529,1061,24,9,776,1870,31,1901
"تهران","کرج","مرکزی",530,1332,18,11,350,1711,24,1735
"تهران","کرج","مرکزی",531,1293,9,12,405,1719,57,1776
"تهران","کرج","مرکزی",532,1302,26,7,560,1895,6,1901
"تهران","کرج","مرکزی",533,1051,13,1,219,1284,23,1307
"تهران","کرج","مرکزی",534,1520,36,18,615,2189,38,2227
"تهران","کرج","مرکزی",535,852,41,8,567,1468,26,1494
"تهران","کرج","مرکزی",536,706,21,15,422,1164,36,1200
"تهران","کرج","مرکزی",537,744,18,4,226,992,28,1020
"تهران","کرج","مرکزی",538,866,17,16,353,1252,21,1273
"تهران","کرج","مرکزی",539,994,17,14,226,1251,25,1276
"تهران","کرج","مرکزی",540,888,20,7,600,1515,37,1552
"تهران","کرج","مرکزی",541,1301,16,24,313,1654,29,1683
"تهران","کرج","مرکزی",542,1194,14,5,468,1681,33,1714
"تهران","کرج","مرکزی",543,702,16,48,455,1221,27,1248
"تهران","کرج","مرکزی",544,967,10,13,323,1313,30,1343
"تهران","کرج","مرکزی",545,791,2,2,304,1099,16,1115
"تهران","کرج","مرکزی",546,716,31,18,856,1621,26,1647
"تهران","کرج","مرکزی",547,1434,15,,294,1743,33,1776
"تهران","کرج","مرکزی",548,1491,11,2,349,1853,36,1889
"تهران","کرج","مرکزی",549,976,25,2,381,1384,21,1405
"تهران","کرج","مرکزی",550,939,12,2,263,1216,14,1230
"تهران","کرج","مرکزی",551,858,18,1,265,1142,16,1158
"تهران","کرج","مرکزی",552,561,16,5,470,1052,31,1083
"تهران","کرج","مرکزی",553,767,18,2,488,1275,25,1300
"تهران","کرج","مرکزی",554,928,16,3,369,1316,26,1342
"تهران","کرج","مرکزی",555,453,9,1,226,689,11,700
"تهران","کرج","مرکزی",556,710,3,1,278,992,11,1003
"تهران","کرج","مرکزی",557,849,13,2,514,1378,17,1395
"تهران","کرج","مرکزی",558,909,11,2,237,1159,40,1199
"تهران","کرج","مرکزی",559,889,17,5,338,1249,13,1262
"تهران","کرج","مرکزی",560,586,6,4,247,843,14,857
"تهران","کرج","مرکزی",561,617,13,9,392,1031,20,1051
"تهران","کرج","مرکزی",562,802,12,4,532,1350,22,1372
"تهران","کرج","مرکزی",563,1091,14,7,191,1303,33,1336
"تهران","کرج","مرکزی",564,1100,14,11,550,1675,32,1707
"تهران","کرج","مرکزی",565,976,13,7,423,1419,27,1446
"تهران","کرج","مرکزی",566,450,12,4,219,685,0,685
"تهران","کرج","مرکزی",567,1203,10,15,200,1428,40,1468
"تهران","کرج","مرکزی",568,1345,30,7,410,1792,22,1814
"تهران","کرج","مرکزی",569,1328,14,5,307,1654,31,1685
"تهران","کرج","مرکزی",570,823,59,6,1027,1915,25,1940
"تهران","کرج","مرکزی",571,894,13,2,434,1343,35,1378
"تهران","کرج","مرکزی",572,1170,14,2,303,1489,30,1519
"تهران","کرج","مرکزی",573,1623,14,5,269,1911,36,1947
"تهران","کرج","مرکزی",574,774,9,2,329,1114,13,1127
"تهران","کرج","مرکزی",575,1186,17,4,445,1652,24,1676
"تهران","کرج","مرکزی",576,1302,17,2,358,1679,19,1698
"تهران","کرج","مرکزی",577,1281,15,5,210,1511,30,1541
"تهران","کرج","مرکزی",578,1257,5,2,134,1398,21,1419
"تهران","کرج","مرکزی",579,884,8,4,220,1116,17,1133
"تهران","کرج","مرکزی",580,993,11,2,124,1130,14,1144
"تهران","کرج","مرکزی",581,1317,5,2,259,1583,36,1619
"تهران","کرج","مرکزی",582,1196,11,3,282,1492,23,1515
"تهران","کرج","مرکزی",583,1171,18,4,177,1370,16,1386
"تهران","کرج","مرکزی",584,1182,7,14,240,1443,23,1466
"تهران","کرج","مرکزی",585,732,16,3,440,1191,30,1221
"تهران","کرج","مرکزی",586,768,14,4,338,1124,22,1146
"تهران","کرج","مرکزی",587,630,11,3,489,1133,13,1146
"تهران","کرج","مرکزی",588,1501,14,11,419,1945,41,1986
"تهران","کرج","مرکزی",589,696,19,4,497,1216,22,1238
"تهران","کرج","مرکزی",590,1340,11,1,397,1749,39,1788
"تهران","کرج","مرکزی",591,760,11,4,246,1021,16,1037
"تهران","کرج","مرکزی",592,771,7,1,154,933,4,937
"تهران","کرج","مرکزی",593,796,10,12,323,1141,22,1163
"تهران","کرج","مرکزی",594,729,11,2,356,1098,17,1115
"تهران","کرج","مرکزی",595,1213,11,1,235,1460,25,1485
"تهران","کرج","مرکزی",596,899,14,5,201,1119,26,1145
"تهران","کرج","مرکزی",597,937,8,4,245,1194,20,1214
"تهران","کرج","مرکزی",598,911,12,1,262,1186,18,1204
"تهران","کرج","مرکزی",599,686,3,2,112,803,15,818
"تهران","کرج","مرکزی",600,890,16,6,287,1199,16,1215
"تهران","کرج","مرکزی",601,1025,15,0,250,1290,27,1317
"تهران","کرج","مرکزی",602,997,12,16,578,1603,31,1634
"تهران","کرج","مرکزی",603,612,9,5,163,789,18,807
"تهران","کرج","مرکزی",604,519,6,2,144,671,13,684
"تهران","کرج","مرکزی",605,821,21,15,459,1316,17,1333
"تهران","کرج","مرکزی",606,643,15,5,349,1012,17,1029
"تهران","کرج","مرکزی",607,538,15,14,254,821,12,833
"تهران","کرج","مرکزی",608,624,20,5,325,974,46,1020
"تهران","کرج","مرکزی",609,703,8,2,243,956,16,972
"تهران","کرج","مرکزی",610,497,13,4,332,846,20,866
"تهران","کرج","مرکزی",611,615,15,3,378,1011,14,1025
"تهران","کرج","مرکزی",612,541,7,0,193,741,19,760
"تهران","کرج","مرکزی",613,428,5,5,265,703,13,716
"تهران","کرج","مرکزی",614,965,10,3,308,1286,10,1296
"تهران","کرج","مرکزی",615,530,13,1,297,841,17,858
"تهران","کرج","مرکزی",616,306,12,6,367,691,8,699
"تهران","کرج","مرکزی",617,966,5,9,348,1328,20,1348
"تهران","کرج","مرکزی",618,939,7,1,183,1130,22,1152
"تهران","کرج","مرکزی",619,257,3,2,56,318,2,320
"تهران","کرج","مرکزی",620,774,11,2,164,951,10,961
"تهران","کرج","مرکزی",621,462,24,5,460,951,19,970
"تهران","کرج","مرکزی",622,293,3,0,29,325,4,329
"تهران","کرج","مرکزی",623,555,11,17,338,921,6,927
"تهران","کرج","مرکزی",624,802,20,15,428,1265,12,1277
"تهران","کرج","مرکزی",625,751,21,19,740,1531,21,1552
"تهران","کرج","مرکزی",626,151,9,0,142,302,15,317
"تهران","کرج","مرکزی",627,248,3,1,153,405,6,411
"تهران","کرج","مرکزی",628,432,9,2,214,657,15,672
"تهران","کرج","مرکزی",629,480,29,6,332,847,21,868
"تهران","کرج","مرکزی",630,148,21,2,157,328,3,331
"تهران","کرج","مرکزی",631,436,9,11,303,759,21,780
"تهران","کرج","مرکزی",632,249,15,6,162,432,9,441
"تهران","کرج","مرکزی",633,273,13,1,207,494,5,499
"تهران","کرج","مرکزی",634,279,4,2,147,432,6,438
"تهران","کرج","مرکزی",635,410,17,4,220,651,11,662
"تهران","کرج","مرکزی",636,424,18,4,337,783,16,799
"تهران","کرج","مرکزی",637,401,7,2,184,594,17,611
"تهران","کرج","مرکزی",638,108,5,0,70,183,7,190
"تهران","کرج","آسارا",1,212,12,1,261,486,14,500
"تهران","کرج","آسارا",2,477,23,0,181,681,19,700
"تهران","کرج","آسارا",3,567,14,1,92,674,7,681
"تهران","کرج","آسارا",4,225,16,5,303,549,6,555
"تهران","کرج","آسارا",5,367,12,4,286,669,4,673
"تهران","کرج","آسارا",6,228,5,3,214,450,6,456
"تهران","کرج","آسارا",7,199,4,1,223,427,5,432
"تهران","کرج","آسارا",8,183,13,1,144,341,14,355
"تهران","کرج","آسارا",9,190,5,1,166,362,9,371
"تهران","کرج","آسارا",10,642,20,3,426,1091,21,1112
"تهران","کرج","آسارا",11,381,6,4,166,557,4,561
"تهران","کرج","آسارا",12,174,11,1,164,350,4,354
"تهران","کرج","آسارا",13,239,6,0,43,288,6,294
"تهران","کرج","آسارا",14,303,11,2,177,493,7,500
"تهران","کرج","آسارا",15,370,12,4,319,705,11,716
"تهران","کرج","آسارا",16,388,6,0,96,490,9,499
"تهران","کرج","آسارا",17,471,2,1,69,543,2,545
"تهران","کرج","آسارا",18,433,15,4,333,785,6,791
"تهران","کرج","آسارا",19,308,8,1,106,423,8,431
"تهران","کرج","آسارا",20,367,2,0,49,418,1,419
"تهران","کرج","آسارا",21,382,19,7,444,852,11,863
"تهران","کرج","آسارا",22,154,4,0,64,222,2,224
"تهران","کرج","آسارا",23,377,4,0,79,460,1,461
"تهران","کرج","آسارا",24,144,2,0,83,229,1,230
"تهران","کرج","آسارا",25,640,7,0,168,815,11,826
"تهران","کرج","آسارا",26,301,4,0,61,366,5,371
"تهران","کرج","آسارا",27,440,6,1,95,542,7,549
"تهران","کرج","آسارا",28,509,7,1,90,607,7,614
"تهران","کرج","آسارا",29,344,4,0,40,388,3,391
"تهران","کرج","آسارا",30,505,5,0,70,580,14,594
"تهران","کرج","آسارا",31,504,17,5,168,694,10,704
"تهران","کرج","آسارا",32,361,2,0,114,477,0,477
"تهران","کرج","آسارا",33,402,17,4,389,812,7,819
"تهران","کرج","آسارا",34,244,19,6,325,594,6,600
"تهران","کرج","اشتهارد",1,424,22,1,213,660,18,678
"تهران","کرج","اشتهارد",2,434,12,4,126,576,26,602
"تهران","کرج","اشتهارد",3,418,13,0,151,582,18,600
"تهران","کرج","اشتهارد",4,316,20,8,195,539,17,556
"تهران","کرج","اشتهارد",5,669,20,15,236,940,21,961
"تهران","کرج","اشتهارد",6,605,14,11,328,958,27,985
"تهران","کرج","اشتهارد",7,726,26,9,322,1083,17,1100
"تهران","کرج","اشتهارد",8,576,11,4,136,727,11,738
"تهران","کرج","اشتهارد",9,680,23,4,272,979,23,1002
"تهران","کرج","اشتهارد",10,643,24,13,367,1047,29,1076
"تهران","کرج","اشتهارد",11,527,18,5,211,761,15,776
"تهران","کرج","اشتهارد",12,407,11,4,209,631,8,639
"تهران","کرج","اشتهارد",13,332,12,6,163,513,10,523
"تهران","کرج","اشتهارد",14,458,14,0,105,577,15,592
"تهران","کرج","اشتهارد",15,386,8,2,117,513,14,527
"تهران","کرج","اشتهارد",16,254,19,6,188,467,14,481
"تهران","کرج","اشتهارد",17,289,2,2,42,335,1,336
"تهران","کرج","اشتهارد",18,292,4,0,64,360,4,364
"تهران","کرج","اشتهارد",19,413,1,0,31,445,7,452
"تهران","کرج","اشتهارد",20,342,3,0,73,418,3,421
"تهران","کرج","اشتهارد",21,360,6,2,69,437,9,446
"تهران","کرج","اشتهارد",22,261,6,2,83,352,4,356
"تهران","کرج","اشتهارد",23,186,3,0,19,208,5,213
"تهران","کرج","اشتهارد",24,261,3,0,35,299,3,302
"تهران","کرج","اشتهارد",25,91,0,3,40,134,0,134
"تهران","کرج","اشتهارد",26,255,7,0,60,322,2,324
"تهران","نظرآباد","مرکزی",1,876,10,1,274,1161,21,1182
"تهران","نظرآباد","مرکزی",2,921,11,0,288,1220,15,1235
"تهران","نظرآباد","مرکزی",3,954,20,4,345,1323,17,1340
"تهران","نظرآباد","مرکزی",4,744,30,18,601,1393,34,1427
"تهران","نظرآباد","مرکزی",5,999,17,5,446,1467,21,1488
"تهران","نظرآباد","مرکزی",6,544,14,9,361,928,25,953
"تهران","نظرآباد","مرکزی",7,669,22,3,589,1283,26,1309
"تهران","نظرآباد","مرکزی",8,945,23,6,461,1435,27,1462
"تهران","نظرآباد","مرکزی",9,658,10,3,358,1029,19,1048
"تهران","نظرآباد","مرکزی",10,825,3,4,255,1087,25,1112
"تهران","نظرآباد","مرکزی",11,906,11,1,210,1128,15,1143
"تهران","نظرآباد","مرکزی",12,782,11,0,331,1124,21,1145
"تهران","نظرآباد","مرکزی",13,689,9,3,304,1005,15,1020
"تهران","نظرآباد","مرکزی",14,469,7,1,143,620,18,638
"تهران","نظرآباد","مرکزی",15,616,7,2,254,879,23,902
"تهران","نظرآباد","مرکزی",16,977,14,1,353,1345,15,1360
"تهران","نظرآباد","مرکزی",17,637,29,1,478,1145,22,1167
"تهران","نظرآباد","مرکزی",18,713,16,4,275,1008,12,1020
"تهران","نظرآباد","مرکزی",19,936,18,7,439,1400,12,1412
"تهران","نظرآباد","مرکزی",20,1137,12,4,271,1424,22,1446
"تهران","نظرآباد","مرکزی",21,956,5,6,230,1197,18,1215
"تهران","نظرآباد","مرکزی",22,635,7,1,194,837,19,856
"تهران","نظرآباد","مرکزی",23,788,1,0,216,1005,16,1021
"تهران","نظرآباد","مرکزی",24,1238,8,4,126,1376,14,1390
"تهران","نظرآباد","مرکزی",25,1114,6,2,122,1244,19,1263
"تهران","نظرآباد","مرکزی",26,680,6,0,257,943,17,960
"تهران","نظرآباد","مرکزی",27,789,13,1,252,1055,12,1067
"تهران","نظرآباد","مرکزی",28,1021,4,2,245,1272,11,1283
"تهران","نظرآباد","مرکزی",29,1317,7,2,434,1760,28,1788
"تهران","نظرآباد","مرکزی",30,887,10,2,311,1210,27,1237
"تهران","نظرآباد","مرکزی",31,831,2,2,210,1045,21,1066
"تهران","نظرآباد","مرکزی",32,1039,2,0,128,1169,10,1179
"تهران","نظرآباد","مرکزی",33,886,7,0,171,1064,31,1095
"تهران","نظرآباد","مرکزی",34,974,13,2,247,1236,11,1247
"تهران","نظرآباد","مرکزی",35,490,5,1,95,591,6,597
"تهران","نظرآباد","مرکزی",36,728,7,2,203,940,7,947
"تهران","نظرآباد","مرکزی",37,1279,21,1,231,1532,18,1550
"تهران","نظرآباد","مرکزی",38,1036,8,2,266,1312,14,1326
"تهران","نظرآباد","مرکزی",39,700,4,2,188,894,13,907
"تهران","نظرآباد","مرکزی",40,1488,14,0,464,1966,31,1997
"تهران","نظرآباد","مرکزی",41,478,13,3,127,621,9,630
"تهران","نظرآباد","مرکزی",42,665,7,0,131,803,7,810
"تهران","نظرآباد","مرکزی",43,1066,7,1,173,1247,16,1263
"تهران","نظرآباد","مرکزی",44,1115,5,3,208,1331,21,1352
"تهران","نظرآباد","مرکزی",45,598,7,1,198,804,16,820
"تهران","نظرآباد","مرکزی",46,859,3,1,131,994,11,1005
"تهران","نظرآباد","مرکزی",47,536,11,1,307,855,21,876
"تهران","نظرآباد","مرکزی",48,580,18,3,314,915,18,933
"تهران","نظرآباد","مرکزی",49,275,12,2,201,490,8,498
"تهران","نظرآباد","مرکزی",50,487,1,0,110,598,5,603
"تهران","نظرآباد","مرکزی",51,292,3,2,63,360,5,365
"تهران","نظرآباد","مرکزی",52,750,12,4,181,947,24,971
"تهران","نظرآباد","مرکزی",53,863,5,1,133,1002,17,1019
"تهران","نظرآباد","مرکزی",54,962,3,2,176,1143,16,1159
"تهران","نظرآباد","مرکزی",55,528,1,0,53,582,3,585
"تهران","نظرآباد","مرکزی",56,509,1,1,88,599,8,607
"تهران","نظرآباد","مرکزی",57,720,9,1,177,907,7,914
"تهران","نظرآباد","مرکزی",58,480,5,1,82,568,3,571
"تهران","نظرآباد","مرکزی",59,981,27,1,92,1101,10,1111
"تهران","نظرآباد","مرکزی",60,356,4,5,118,483,8,491
"تهران","نظرآباد","مرکزی",61,262,5,1,106,374,11,385
"تهران","نظرآباد","مرکزی",62,73,2,0,29,104,1,105
"تهران","نظرآباد","تتکمان",1,422,4,1,127,554,10,564
"تهران","نظرآباد","تتکمان",2,509,3,3,154,669,10,679
"تهران","نظرآباد","تتکمان",3,628,9,0,285,922,9,931
"تهران","نظرآباد","تتکمان",4,492,5,0,184,681,9,690
"تهران","نظرآباد","تتکمان",5,751,4,1,162,918,16,934
"تهران","نظرآباد","تتکمان",6,491,9,0,176,676,8,684
"تهران","نظرآباد","تتکمان",7,408,2,1,123,534,6,540
"تهران","نظرآباد","تتکمان",8,333,5,3,118,459,4,463
"تهران","نظرآباد","تتکمان",9,333,4,2,162,501,7,508
"تهران","نظرآباد","تتکمان",10,637,3,1,225,866,9,875
"تهران","نظرآباد","تتکمان",11,578,11,4,109,702,5,707
"تهران","نظرآباد","تتکمان",12,574,3,0,147,724,5,729
"تهران","نظرآباد","تتکمان",13,298,0,0,110,408,8,416
"تهران","نظرآباد","تتکمان",14,660,6,0,84,750,10,760
"تهران","نظرآباد","تتکمان",15,337,3,1,59,400,9,409
"تهران","نظرآباد","مرکزی",16,295,2,0,77,374,3,377
"تهران","ورامین","مرکزی",1,1278,18,3,286,1585,28,1613
"تهران","ورامین","مرکزی",2,474,10,3,133,620,11,631
"تهران","ورامین","مرکزی",3,624,4,1,155,784,7,791
"تهران","ورامین","مرکزی",4,933,7,9,159,1108,18,1126
"تهران","ورامین","مرکزی",5,761,6,1,148,916,8,924
"تهران","ورامین","مرکزی",6,750,9,5,208,972,19,991
"تهران","ورامین","مرکزی",7,653,9,4,248,914,20,934
"تهران","ورامین","مرکزی",8,1044,11,3,300,1358,28,1386
"تهران","ورامین","مرکزی",9,523,5,3,106,637,5,642
"تهران","ورامین","مرکزی",10,1249,11,2,345,1607,18,1625
"تهران","ورامین","مرکزی",11,1255,12,4,327,1598,34,1632
"تهران","ورامین","مرکزی",12,1018,18,5,384,1425,38,1463
"تهران","ورامین","مرکزی",13,835,15,5,279,1134,28,1162
"تهران","ورامین","مرکزی",14,975,16,1,263,1255,17,1272
"تهران","ورامین","مرکزی",15,686,13,5,251,955,11,966
"تهران","ورامین","مرکزی",16,261,4,2,104,371,13,384
"تهران","ورامین","مرکزی",17,1252,16,5,468,1741,24,1765
"تهران","ورامین","مرکزی",18,305,8,2,161,476,6,482
"تهران","ورامین","مرکزی",19,597,14,3,291,905,15,920
"تهران","ورامین","مرکزی",20,323,4,6,130,463,4,467
"تهران","ورامین","مرکزی",21,926,11,12,297,1246,16,1262
"تهران","ورامین","مرکزی",22,545,15,23,168,751,21,772
"تهران","ورامین","مرکزی",23,739,4,36,216,995,13,1008
"تهران","ورامین","مرکزی",24,664,14,1,224,903,15,918
"تهران","ورامین","مرکزی",25,864,23,22,409,1318,29,1347
"تهران","ورامین","مرکزی",26,682,14,6,245,947,11,958
"تهران","ورامین","مرکزی",27,783,25,2,391,1201,26,1227
"تهران","ورامین","مرکزی",28,515,15,6,262,798,20,818
"تهران","ورامین","مرکزی",29,701,20,8,447,1176,12,1188
"تهران","ورامین","مرکزی",30,904,22,2,280,1208,22,1230
"تهران","ورامین","مرکزی",31,372,14,4,401,791,20,811
"تهران","ورامین","مرکزی",32,273,8,3,311,595,9,604
"تهران","ورامین","مرکزی",33,619,26,2,622,1269,13,1282
"تهران","ورامین","مرکزی",34,291,9,2,243,545,21,566
"تهران","ورامین","مرکزی",35,443,13,1,367,824,15,839
"تهران","ورامین","مرکزی",36,519,20,2,264,805,14,819
"تهران","ورامین","مرکزی",37,429,12,0,172,613,5,618
"تهران","ورامین","مرکزی",38,744,30,3,551,1328,13,1341
"تهران","ورامین","مرکزی",39,727,19,9,702,1457,20,1477
"تهران","ورامین","مرکزی",40,295,10,5,282,592,4,596
"تهران","ورامین","مرکزی",41,553,22,5,510,1090,27,1117
"تهران","ورامین","مرکزی",42,913,33,4,535,1485,26,1511
"تهران","ورامین","مرکزی",43,411,7,1,226,645,19,664
"تهران","ورامین","مرکزی",44,536,20,4,394,954,12,966
"تهران","ورامین","مرکزی",45,544,19,4,390,957,13,970
"تهران","ورامین","مرکزی",46,541,13,2,333,889,20,909
"تهران","ورامین","مرکزی",47,796,33,6,657,1492,26,1518
"تهران","ورامین","مرکزی",48,765,20,0,274,1059,31,1090
"تهران","ورامین","مرکزی",49,951,8,3,407,1369,30,1399
"تهران","ورامین","مرکزی",50,1157,22,4,516,1699,29,1728
"تهران","ورامین","مرکزی",51,1187,23,1,360,1571,23,1594
"تهران","ورامین","مرکزی",52,715,18,3,235,971,8,979
"تهران","ورامین","مرکزی",53,1009,7,2,345,1363,15,1378
"تهران","ورامین","مرکزی",54,1023,9,2,235,1269,19,1288
"تهران","ورامین","مرکزی",55,635,5,0,196,836,5,841
"تهران","ورامین","مرکزی",56,488,5,3,130,626,6,632
"تهران","ورامین","مرکزی",57,677,2,1,113,793,13,806
"تهران","ورامین","مرکزی",58,1631,9,4,315,1959,29,1988
"تهران","ورامین","مرکزی",59,802,16,3,216,1037,8,1045
"تهران","ورامین","مرکزی",60,707,10,5,297,1019,15,1034
"تهران","ورامین","مرکزی",61,723,14,5,272,1014,28,1042
"تهران","ورامین","مرکزی",62,1157,15,2,437,1611,13,1624
"تهران","ورامین","مرکزی",63,712,6,1,216,935,27,962
"تهران","ورامین","مرکزی",64,764,11,2,217,994,20,1014
"تهران","ورامین","مرکزی",65,569,10,0,212,791,8,799
"تهران","ورامین","مرکزی",66,1112,13,4,272,1401,26,1427
"تهران","ورامین","مرکزی",67,613,3,1,167,784,10,794
"تهران","ورامین","مرکزی",68,1174,15,7,276,1472,18,1490
"تهران","ورامین","مرکزی",69,695,17,6,420,1138,18,1156
"تهران","ورامین","مرکزی",70,966,16,7,279,1268,21,1289
"تهران","ورامین","مرکزی",71,1118,10,3,362,1493,26,1519
"تهران","ورامین","مرکزی",72,1095,20,11,206,1332,16,1348
"تهران","ورامین","مرکزی",73,792,18,4,393,1207,15,1222
"تهران","ورامین","مرکزی",74,848,16,11,520,1395,20,1415
"تهران","ورامین","مرکزی",75,539,10,2,197,748,18,766
"تهران","ورامین","مرکزی",76,389,8,2,104,503,6,509
"تهران","ورامین","مرکزی",77,489,17,12,341,859,15,874
"تهران","ورامین","مرکزی",78,428,9,1,174,612,12,624
"تهران","ورامین","مرکزی",79,1116,23,7,269,1415,30,1445
"تهران","ورامین","مرکزی",80,1020,11,3,227,1261,26,1287
"تهران","ورامین","مرکزی",81,1290,16,4,249,1559,41,1600
"تهران","ورامین","مرکزی",82,609,6,2,110,727,11,738
"تهران","ورامین","مرکزی",83,932,11,2,210,1155,21,1176
"تهران","ورامین","مرکزی",84,1161,10,7,296,1474,0,1474
"تهران","ورامین","مرکزی",85,801,13,3,284,1101,23,1124
"تهران","ورامین","مرکزی",86,1195,16,3,185,1399,12,1411
"تهران","ورامین","مرکزی",87,1429,9,12,279,1729,18,1747
"تهران","ورامین","مرکزی",88,1040,8,23,328,1399,21,1420
"تهران","ورامین","مرکزی",89,667,6,2,207,882,13,895
"تهران","ورامین","مرکزی",90,798,11,7,268,1084,8,1092
"تهران","ورامین","مرکزی",91,420,8,5,138,571,14,585
"تهران","ورامین","مرکزی",92,317,9,4,125,455,11,466
"تهران","ورامین","مرکزی",93,558,3,3,164,728,8,736
"تهران","ورامین","مرکزی",94,666,8,1,163,838,7,845
"تهران","ورامین","مرکزی",95,949,9,2,256,1216,17,1233
"تهران","ورامین","مرکزی",96,1173,4,1,195,1373,31,1404
"تهران","ورامین","مرکزی",97,175,2,0,81,258,5,263
"تهران","ورامین","مرکزی",98,750,11,6,456,1223,22,1245
"تهران","ورامین","مرکزی",99,1036,4,3,195,1238,11,1249
"تهران","ورامین","مرکزی",100,1100,7,1,139,1247,32,1279
"تهران","ورامین","مرکزی",101,1133,12,13,226,1384,11,1395
"تهران","ورامین","مرکزی",102,287,4,0,58,349,1,350
"تهران","ورامین","مرکزی",103,212,1,0,50,263,5,268
"تهران","ورامین","مرکزی",104,783,3,3,115,904,21,925
"تهران","ورامین","قرچک",1,535,18,13,335,901,14,915
"تهران","ورامین","قرچک",2,593,7,3,202,805,11,816
"تهران","ورامین","قرچک",3,468,4,3,137,612,16,628
"تهران","ورامین","قرچک",4,746,13,4,290,1053,19,1072
"تهران","ورامین","قرچک",5,694,9,4,315,1022,15,1037
"تهران","ورامین","قرچک",6,557,14,14,269,854,8,862
"تهران","ورامین","قرچک",7,671,9,2,366,1048,15,1063
"تهران","ورامین","قرچک",8,756,16,8,336,1116,12,1128
"تهران","ورامین","قرچک",9,1500,27,6,476,2009,19,2028
"تهران","ورامین","قرچک",10,1030,13,3,290,1336,17,1353
"تهران","ورامین","قرچک",11,413,14,5,263,695,6,701
"تهران","ورامین","قرچک",12,934,8,3,316,1261,15,1276
"تهران","ورامین","قرچک",13,915,13,3,353,1284,18,1302
"تهران","ورامین","قرچک",14,868,10,8,380,1266,23,1289
"تهران","ورامین","قرچک",15,846,9,4,288,1147,10,1157
"تهران","ورامین","قرچک",16,607,1,3,196,807,13,820
"تهران","ورامین","قرچک",17,406,5,2,167,580,7,587
"تهران","ورامین","قرچک",18,746,16,2,301,1065,21,1086
"تهران","ورامین","قرچک",19,697,6,6,241,950,27,977
"تهران","ورامین","قرچک",20,321,7,4,238,570,21,591
"تهران","ورامین","قرچک",21,431,10,0,255,696,13,709
"تهران","ورامین","قرچک",22,1068,10,1,316,1395,16,1411
"تهران","ورامین","قرچک",23,300,11,1,175,487,6,493
"تهران","ورامین","قرچک",24,441,18,1,280,740,4,744
"تهران","ورامین","قرچک",25,877,6,1,320,1204,18,1222
"تهران","ورامین","قرچک",26,868,16,3,310,1197,23,1220
"تهران","ورامین","قرچک",27,924,14,1,412,1351,21,1372
"تهران","ورامین","قرچک",28,810,7,1,326,1144,10,1154
"تهران","ورامین","قرچک",29,694,7,4,380,1085,15,1100
"تهران","ورامین","قرچک",30,566,17,1,359,943,15,958
"تهران","ورامین","قرچک",31,557,13,3,270,843,20,863
"تهران","ورامین","قرچک",32,908,17,8,404,1337,22,1359
"تهران","ورامین","قرچک",33,544,11,7,291,853,11,864
"تهران","ورامین","قرچک",34,917,18,4,485,1424,9,1433
"تهران","ورامین","قرچک",35,517,10,9,297,833,18,851
"تهران","ورامین","قرچک",36,1113,19,4,629,1765,26,1791
"تهران","ورامین","قرچک",37,949,18,5,410,1382,20,1402
"تهران","ورامین","قرچک",38,419,14,4,320,757,11,768
"تهران","ورامین","قرچک",39,762,25,5,349,1141,20,1161
"تهران","ورامین","قرچک",40,1021,2,19,382,1424,23,1447
"تهران","ورامین","قرچک",41,918,20,5,256,1199,26,1225
"تهران","ورامین","قرچک",42,850,20,7,383,1260,13,1273
"تهران","ورامین","قرچک",43,970,14,5,429,1418,45,1463
"تهران","ورامین","قرچک",44,509,2,8,303,822,8,830
"تهران","ورامین","قرچک",45,1029,20,13,492,1554,24,1578
"تهران","ورامین","قرچک",46,561,5,9,316,891,11,902
"تهران","ورامین","قرچک",47,377,3,5,187,572,10,582
"تهران","ورامین","قرچک",48,973,12,17,410,1412,17,1429
"تهران","ورامین","قرچک",49,911,10,18,420,1359,16,1375
"تهران","ورامین","قرچک",50,706,9,8,241,964,21,985
"تهران","ورامین","قرچک",51,746,18,7,404,1175,21,1196
"تهران","ورامین","قرچک",52,661,13,11,337,1022,15,1037
"تهران","ورامین","قرچک",53,870,15,7,331,1223,21,1244
"تهران","ورامین","قرچک",54,753,12,12,312,1089,16,1105
"تهران","ورامین","قرچک",55,1060,17,20,375,1472,15,1487
"تهران","ورامین","قرچک",56,556,5,4,197,762,8,770
"تهران","ورامین","قرچک",57,550,8,2,223,783,15,798
"تهران","ورامین","قرچک",58,702,7,1,239,949,14,963
"تهران","ورامین","قرچک",59,789,17,7,373,1186,6,1192
"تهران","ورامین","قرچک",60,915,7,7,568,1497,31,1528
"تهران","ورامین","قرچک",61,667,14,13,298,992,19,1011
"تهران","ورامین","قرچک",62,603,13,6,333,955,11,966
"تهران","ورامین","قرچک",63,886,7,6,222,1121,12,1133
"تهران","ورامین","قرچک",64,842,20,2,221,1085,10,1095
"تهران","ورامین","قرچک",65,675,16,10,239,940,21,961
"تهران","ورامین","قرچک",66,985,12,2,158,1157,4,1161
"تهران","ورامین","قرچک",67,966,14,6,287,1273,8,1281
"تهران","ورامین","قرچک",68,1240,8,4,205,1457,15,1472
"تهران","ورامین","قرچک",69,716,20,7,247,990,13,1003
"تهران","ورامین","قرچک",70,1040,13,1,293,1347,19,1366
"تهران","ورامین","قرچک",71,845,18,3,262,1128,17,1145
"تهران","ورامین","قرچک",72,895,17,2,244,1158,22,1180
"تهران","ورامین","قرچک",73,547,8,2,226,783,11,794
"تهران","ورامین","قرچک",74,589,10,2,172,773,11,784
"تهران","ورامین","قرچک",75,428,5,2,148,583,28,611
"تهران","ورامین","قرچک",76,1139,16,1,416,1572,34,1606
"تهران","ورامین","قرچک",77,848,30,4,283,1165,19,1184
"تهران","ورامین","قرچک",78,254,4,0,114,372,6,378
"تهران","ورامین","قرچک",79,675,5,4,236,920,14,934
"تهران","ورامین","قرچک",80,741,23,6,207,977,19,996
"تهران","ورامین","قرچک",81,624,13,2,181,820,9,829
"تهران","ورامین","قرچک",82,321,4,1,86,412,7,419
"تهران","ورامین","قرچک",83,398,6,0,84,488,9,497
"تهران","ورامین","قرچک",84,762,2,1,339,1104,13,1117
"تهران","ورامین","قرچک",85,853,8,11,287,1159,7,1166
"تهران","ورامین","قرچک",86,759,9,10,240,1018,19,1037
"تهران","ورامین","قرچک",87,936,8,5,271,1220,23,1243
"تهران","ورامین","قرچک",88,1135,29,9,136,1309,23,1332
"تهران","ورامین","قرچک",89,1159,41,14,137,1351,37,1388
"تهران","ورامین","قرچک",90,651,1,2,128,782,9,791
"تهران","ورامین","قرچک",91,877,7,0,277,1161,1,1162
"تهران","ورامین","قرچک",92,798,6,3,250,1057,7,1064
"تهران","ورامین","قرچک",93,849,3,1,221,1074,22,1096
"تهران","ورامین","قرچک",94,931,12,9,125,1077,11,1088
"تهران","ورامین","قرچک",95,510,3,5,273,791,14,805
"تهران","ورامین","قرچک",96,827,1,0,180,1008,10,1018
"تهران","ورامین","قرچک",97,1119,4,3,242,1368,29,1397
"تهران","ورامین","قرچک",98,762,0,0,247,1009,17,1026
"تهران","ورامین","قرچک",99,453,2,1,160,616,5,621
"تهران","ورامین","قرچک",100,361,5,0,118,484,9,493
"تهران","ورامین","قرچک",101,228,3,0,92,323,12,335
"تهران","ورامین","قرچک",102,386,13,8,187,594,6,600
"تهران","ورامین","پیشوا",1,854,15,6,224,1099,17,1116
"تهران","ورامین","پیشوا",2,535,15,3,183,736,6,742
"تهران","ورامین","پیشوا",3,616,15,0,343,974,5,979
"تهران","ورامین","پیشوا",4,392,1,0,110,503,6,509
"تهران","ورامین","پیشوا",5,409,17,4,362,792,9,801
"تهران","ورامین","پیشوا",6,671,11,4,189,875,16,891
"تهران","ورامین","پیشوا",7,218,9,2,132,361,10,371
"تهران","ورامین","پیشوا",8,663,8,2,178,851,9,860
"تهران","ورامین","پیشوا",9,725,4,1,160,890,16,906
"تهران","ورامین","پیشوا",10,610,4,0,296,910,9,919
"تهران","ورامین","پیشوا",11,469,5,0,124,598,8,606
"تهران","ورامین","پیشوا",12,324,5,2,100,431,6,437
"تهران","ورامین","پیشوا",13,483,22,9,419,933,7,940
"تهران","ورامین","پیشوا",14,397,13,2,209,621,14,635
"تهران","ورامین","پیشوا",15,1049,19,2,332,1402,17,1419
"تهران","ورامین","پیشوا",16,567,6,1,260,834,10,844
"تهران","ورامین","پیشوا",17,586,7,3,142,738,11,749
"تهران","ورامین","پیشوا",18,852,13,1,150,1016,12,1028
"تهران","ورامین","پیشوا",19,975,20,4,296,1295,13,1308
"تهران","ورامین","پیشوا",20,483,13,1,181,678,9,687
"تهران","ورامین","پیشوا",21,464,12,2,213,691,7,698
"تهران","ورامین","پیشوا",22,706,15,4,313,1038,23,1061
"تهران","ورامین","پیشوا",23,1002,19,0,316,1337,17,1354
"تهران","ورامین","پیشوا",24,644,3,2,76,725,11,736
"تهران","ورامین","پیشوا",25,870,5,0,147,1022,15,1037
"تهران","ورامین","پیشوا",26,160,1,0,49,210,3,213
"تهران","ورامین","پیشوا",27,174,1,0,61,236,1,237
"تهران","ورامین","پیشوا",28,442,5,1,110,558,11,569
"تهران","ورامین","پیشوا",29,776,14,0,160,950,6,956
"تهران","ورامین","پیشوا",30,775,6,2,155,938,4,942
"تهران","ورامین","پیشوا",31,383,2,0,67,452,3,455
"تهران","ورامین","پیشوا",32,187,0,0,19,206,3,209
"تهران","ورامین","پیشوا",33,247,1,0,28,276,0,276
"تهران","ورامین","پیشوا",34,201,2,0,28,231,3,234
"تهران","ورامین","پیشوا",35,214,3,0,31,248,2,250
"تهران","ورامین","پیشوا",36,591,5,0,64,660,16,676
"تهران","ورامین","پیشوا",37,178,3,0,19,200,7,207
"تهران","ورامین","پیشوا",38,254,1,0,54,309,1,310
"تهران","ورامین","پیشوا",39,594,3,0,136,733,18,751
"تهران","ورامین","پیشوا",40,190,2,1,32,225,3,228
"تهران","ورامین","پیشوا",41,312,4,0,95,411,6,417
"تهران","ورامین","پیشوا",42,240,4,0,50,294,5,299
"تهران","ورامین","پیشوا",43,495,4,1,123,623,5,628
"تهران","ورامین","پیشوا",44,541,6,1,61,609,6,615
"تهران","ورامین","پیشوا",45,484,5,0,101,590,12,602
"تهران","ورامین","پیشوا",46,261,3,4,48,316,3,319
"تهران","ورامین","پیشوا",47,684,2,0,103,789,8,797
"تهران","ورامین","پیشوا",48,144,1,0,17,162,1,163
"تهران","ورامین","پیشوا",49,682,10,7,210,909,13,922
"تهران","ورامین","پیشوا",50,329,0,0,57,386,6,392
"تهران","ورامین","پیشوا",51,149,0,0,25,174,1,175
"تهران","ورامین","پیشوا",52,134,0,0,11,145,1,146
"تهران","ورامین","پیشوا",53,206,4,0,36,246,4,250
"تهران","ورامین","پیشوا",54,274,2,0,39,315,1,316
"تهران","ورامین","جوادآباد",1,423,2,0,108,533,4,537
"تهران","ورامین","جوادآباد",2,475,9,3,174,661,7,668
"تهران","ورامین","جوادآباد",3,202,4,0,105,311,6,317
"تهران","ورامین","جوادآباد",4,412,3,1,87,503,2,505
"تهران","ورامین","جوادآباد",5,691,14,1,253,959,24,983
"تهران","ورامین","جوادآباد",6,494,5,0,64,563,5,568
"تهران","ورامین","جوادآباد",7,494,2,2,54,552,6,558
"تهران","ورامین","جوادآباد",8,355,4,0,43,402,3,405
"تهران","ورامین","جوادآباد",9,620,16,2,177,815,14,829
"تهران","ورامین","جوادآباد",10,315,0,3,41,359,2,361
"تهران","ورامین","جوادآباد",11,425,2,0,91,518,4,522
"تهران","ورامین","جوادآباد",12,498,7,0,123,628,6,634
"تهران","ورامین","جوادآباد",13,249,7,2,82,340,6,346
"تهران","ورامین","جوادآباد",14,434,10,1,77,522,7,529
"تهران","ورامین","جوادآباد",15,280,0,0,30,310,3,313
"تهران","ورامین","جوادآباد",16,323,1,0,115,439,11,450
"تهران","ورامین","جوادآباد",17,438,6,0,128,572,10,582
"تهران","ورامین","جوادآباد",18,320,5,0,118,443,10,453
"تهران","ورامین","جوادآباد",19,166,1,0,37,204,2,206
"تهران","ورامین","جوادآباد",20,295,4,0,31,330,3,333
"تهران","ورامین","جوادآباد",21,89,2,0,19,110,1,111
"تهران","ورامین","جوادآباد",22,309,0,0,59,368,4,372
"تهران","ورامین","جوادآباد",23,428,0,0,45,473,1,474
"تهران","ورامین","جوادآباد",24,191,0,0,34,225,1,226
"تهران","ورامین","جوادآباد",25,235,1,0,26,262,2,264
"تهران","ورامین","جوادآباد",26,146,0,0,30,176,1,177
"تهران","ورامین","جوادآباد",27,121,0,0,30,151,3,154
"تهران","ورامین","جوادآباد",28,50,3,0,3,56,3,59
"خراسان_جنوبی","بشرویه","مرکزی",1,981,12,2,240,1235,17,1252
"خراسان_جنوبی","بشرویه","مرکزی",2,520,8,0,87,615,5,620
"خراسان_جنوبی","بشرویه","مرکزی",3,1097,4,2,119,1222,6,1228
"خراسان_جنوبی","بشرویه","مرکزی",4,801,2,1,52,856,4,860
"خراسان_جنوبی","بشرویه","مرکزی",5,609,3,1,70,683,2,685
"خراسان_جنوبی","بشرویه","مرکزی",6,649,12,3,219,883,18,901
"خراسان_جنوبی","بشرویه","مرکزی",7,701,11,2,297,1011,16,1027
"خراسان_جنوبی","بشرویه","مرکزی",8,336,5,1,86,428,4,432
"خراسان_جنوبی","بشرویه","مرکزی",9,631,10,2,310,953,8,961
"خراسان_جنوبی","بشرویه","مرکزی",10,455,7,0,94,556,8,564
"خراسان_جنوبی","بشرویه","مرکزی",11,524,0,0,18,542,0,542
"خراسان_جنوبی","بشرویه","مرکزی",12,736,1,0,34,771,0,771
"خراسان_جنوبی","بشرویه","مرکزی",13,433,3,0,22,458,0,458
"خراسان_جنوبی","بشرویه","مرکزی",14,236,0,0,12,248,0,248
"خراسان_جنوبی","بشرویه","مرکزی",15,377,1,0,28,406,0,406
"خراسان_جنوبی","بشرویه","مرکزی",16,139,0,0,14,153,0,153
"خراسان_جنوبی","بشرویه","ارسک",1,752,6,0,52,810,1,811
"خراسان_جنوبی","بشرویه","ارسک",2,688,9,1,39,737,1,738
"خراسان_جنوبی","بشرویه","ارسک",3,402,0,0,15,417,2,419
"خراسان_جنوبی","بشرویه","ارسک",4,278,1,0,15,294,0,294
"خراسان_جنوبی","بشرویه","ارسک",5,604,5,2,121,732,4,736
"خراسان_جنوبی","بشرویه","ارسک",6,393,2,0,22,417,2,419
"خراسان_جنوبی","بشرویه","ارسک",7,426,2,0,33,461,0,461
"خراسان_جنوبی","بیرجند","مرکزی",1,916,8,2,228,1154,4,1158
"خراسان_جنوبی","بیرجند","مرکزی",2,1367,13,7,254,1641,10,1651
"خراسان_جنوبی","بیرجند","مرکزی",3,878,12,1,214,1105,8,1113
"خراسان_جنوبی","بیرجند","مرکزی",4,1613,15,4,215,1847,4,1851
"خراسان_جنوبی","بیرجند","مرکزی",5,1242,5,0,212,1459,4,1463
"خراسان_جنوبی","بیرجند","مرکزی",6,1156,10,6,216,1388,3,1391
"خراسان_جنوبی","بیرجند","مرکزی",7,1393,20,3,410,1826,6,1832
"خراسان_جنوبی","بیرجند","مرکزی",8,1125,13,4,329,1471,11,1482
"خراسان_جنوبی","بیرجند","مرکزی",9,962,12,1,175,1150,2,1152
"خراسان_جنوبی","بیرجند","مرکزی",10,1619,15,4,380,2018,15,2033
"خراسان_جنوبی","بیرجند","مرکزی",11,1643,13,2,210,1868,9,1877
"خراسان_جنوبی","بیرجند","مرکزی",12,992,17,0,174,1183,8,1191
"خراسان_جنوبی","بیرجند","مرکزی",13,1138,21,4,431,1594,9,1603
"خراسان_جنوبی","بیرجند","مرکزی",14,861,15,0,297,1173,10,1183
"خراسان_جنوبی","بیرجند","مرکزی",15,782,20,4,321,1127,12,1139
"خراسان_جنوبی","بیرجند","مرکزی",16,1006,15,1,342,1364,11,1375
"خراسان_جنوبی","بیرجند","مرکزی",17,809,5,1,208,1023,9,1032
"خراسان_جنوبی","بیرجند","مرکزی",18,1544,30,4,398,1976,8,1984
"خراسان_جنوبی","بیرجند","مرکزی",19,819,31,6,677,1533,7,1540
"خراسان_جنوبی","بیرجند","مرکزی",20,684,32,10,492,1218,5,1223
"خراسان_جنوبی","بیرجند","مرکزی",21,864,30,6,439,1339,5,1344
"خراسان_جنوبی","بیرجند","مرکزی",22,521,44,11,556,1132,20,1152
"خراسان_جنوبی","بیرجند","مرکزی",23,982,33,14,510,1539,23,1562
"خراسان_جنوبی","بیرجند","مرکزی",24,295,17,6,593,911,8,919
"خراسان_جنوبی","بیرجند","مرکزی",25,637,26,11,603,1277,8,1285
"خراسان_جنوبی","بیرجند","مرکزی",26,1275,41,1,381,1698,8,1706
"خراسان_جنوبی","بیرجند","مرکزی",27,887,14,2,256,1159,5,1164
"خراسان_جنوبی","بیرجند","مرکزی",28,671,16,2,202,891,1,892
"خراسان_جنوبی","بیرجند","مرکزی",29,1125,22,5,564,1716,11,1727
"خراسان_جنوبی","بیرجند","مرکزی",30,712,17,4,346,1079,3,1082
"خراسان_جنوبی","بیرجند","مرکزی",31,1380,37,3,600,2020,18,2038
"خراسان_جنوبی","بیرجند","مرکزی",32,1169,37,4,536,1746,16,1762
"خراسان_جنوبی","بیرجند","مرکزی",33,857,25,3,572,1457,10,1467
"خراسان_جنوبی","بیرجند","مرکزی",34,1149,56,16,809,2030,13,2043
"خراسان_جنوبی","بیرجند","مرکزی",35,579,17,1,235,832,6,838
"خراسان_جنوبی","بیرجند","مرکزی",36,633,23,7,459,1122,8,1130
"خراسان_جنوبی","بیرجند","مرکزی",37,391,29,0,374,794,8,802
"خراسان_جنوبی","بیرجند","مرکزی",38,863,20,0,307,1190,10,1200
"خراسان_جنوبی","بیرجند","مرکزی",39,1105,35,8,585,1733,14,1747
"خراسان_جنوبی","بیرجند","مرکزی",40,969,29,9,540,1547,12,1559
"خراسان_جنوبی","بیرجند","مرکزی",41,1084,52,4,714,1854,15,1869
"خراسان_جنوبی","بیرجند","مرکزی",42,772,44,9,1257,2082,20,2102
"خراسان_جنوبی","بیرجند","مرکزی",43,1061,42,9,1113,2225,21,2246
"خراسان_جنوبی","بیرجند","مرکزی",44,619,30,3,480,1132,11,1143
"خراسان_جنوبی","بیرجند","مرکزی",45,1384,52,14,1055,2505,20,2525
"خراسان_جنوبی","بیرجند","مرکزی",46,700,42,8,708,1458,17,1475
"خراسان_جنوبی","بیرجند","مرکزی",47,812,32,6,754,1604,16,1620
"خراسان_جنوبی","بیرجند","مرکزی",48,958,52,3,877,1890,18,1908
"خراسان_جنوبی","بیرجند","مرکزی",49,760,16,3,249,1028,7,1035
"خراسان_جنوبی","بیرجند","مرکزی",50,1054,58,12,803,1927,14,1941
"خراسان_جنوبی","بیرجند","مرکزی",51,985,49,8,690,1732,10,1742
"خراسان_جنوبی","بیرجند","مرکزی",52,596,32,11,827,1466,9,1475
"خراسان_جنوبی","بیرجند","مرکزی",53,896,33,8,836,1773,20,1793
"خراسان_جنوبی","بیرجند","مرکزی",54,705,16,4,375,1100,10,1110
"خراسان_جنوبی","بیرجند","مرکزی",55,960,25,8,495,1488,6,1494
"خراسان_جنوبی","بیرجند","مرکزی",56,501,23,6,510,1040,10,1050
"خراسان_جنوبی","بیرجند","مرکزی",57,1350,52,14,841,2257,27,2284
"خراسان_جنوبی","بیرجند","مرکزی",58,344,20,6,404,774,8,782
"خراسان_جنوبی","بیرجند","مرکزی",59,907,40,7,811,1765,11,1776
"خراسان_جنوبی","بیرجند","مرکزی",60,735,35,8,804,1582,8,1590
"خراسان_جنوبی","بیرجند","مرکزی",61,781,31,3,712,1527,12,1539
"خراسان_جنوبی","بیرجند","مرکزی",62,574,25,4,672,1275,16,1291
"خراسان_جنوبی","بیرجند","مرکزی",63,510,43,22,1052,1627,7,1634
"خراسان_جنوبی","بیرجند","مرکزی",64,521,36,3,593,1153,4,1157
"خراسان_جنوبی","بیرجند","مرکزی",65,458,23,3,322,806,6,812
"خراسان_جنوبی","بیرجند","مرکزی",66,645,16,0,250,911,5,916
"خراسان_جنوبی","بیرجند","مرکزی",67,650,66,30,479,1225,37,1262
"خراسان_جنوبی","بیرجند","مرکزی",68,1515,47,5,622,2189,11,2200
"خراسان_جنوبی","بیرجند","مرکزی",69,566,8,4,385,963,8,971
"خراسان_جنوبی","بیرجند","مرکزی",70,556,11,2,269,838,10,848
"خراسان_جنوبی","بیرجند","مرکزی",71,611,13,4,169,797,8,805
"خراسان_جنوبی","بیرجند","مرکزی",72,460,14,0,148,622,3,625
"خراسان_جنوبی","بیرجند","مرکزی",73,332,13,2,216,563,10,573
"خراسان_جنوبی","بیرجند","مرکزی",74,358,7,1,99,465,5,470
"خراسان_جنوبی","بیرجند","مرکزی",75,278,10,1,175,464,8,472
"خراسان_جنوبی","بیرجند","مرکزی",76,792,28,4,370,1194,8,1202
"خراسان_جنوبی","بیرجند","مرکزی",77,279,22,1,246,548,23,571
"خراسان_جنوبی","بیرجند","مرکزی",78,688,14,1,159,862,5,867
"خراسان_جنوبی","بیرجند","مرکزی",79,600,11,0,94,705,1,706
"خراسان_جنوبی","بیرجند","مرکزی",80,615,8,1,262,886,4,890
"خراسان_جنوبی","بیرجند","مرکزی",81,368,5,1,100,474,0,474
"خراسان_جنوبی","بیرجند","مرکزی",82,480,4,3,151,638,0,638
"خراسان_جنوبی","بیرجند","مرکزی",83,313,1,1,44,359,0,359
"خراسان_جنوبی","بیرجند","مرکزی",84,612,4,0,155,771,1,772
"خراسان_جنوبی","بیرجند","مرکزی",85,471,7,0,116,594,0,594
"خراسان_جنوبی","بیرجند","مرکزی",86,1034,33,3,252,1322,4,1326
"خراسان_جنوبی","بیرجند","مرکزی",87,1250,8,1,187,1446,0,1446
"خراسان_جنوبی","بیرجند","مرکزی",88,343,3,1,31,378,1,379
"خراسان_جنوبی","بیرجند","مرکزی",89,220,1,0,79,300,0,300
"خراسان_جنوبی","بیرجند","مرکزی",90,850,7,1,71,929,1,930
"خراسان_جنوبی","بیرجند","مرکزی",91,391,0,0,41,432,0,432
"خراسان_جنوبی","بیرجند","مرکزی",92,638,2,1,60,701,4,705
"خراسان_جنوبی","بیرجند","مرکزی",93,586,0,2,72,660,6,666
"خراسان_جنوبی","بیرجند","مرکزی",94,565,8,0,72,645,0,645
"خراسان_جنوبی","بیرجند","مرکزی",95,689,2,0,41,732,4,736
"خراسان_جنوبی","بیرجند","مرکزی",96,597,5,2,385,989,0,989
"خراسان_جنوبی","بیرجند","مرکزی",97,678,5,2,86,771,6,777
"خراسان_جنوبی","بیرجند","مرکزی",98,592,4,1,129,726,2,728
"خراسان_جنوبی","بیرجند","مرکزی",99,617,1,1,112,731,2,733
"خراسان_جنوبی","بیرجند","مرکزی",100,693,6,2,133,834,3,837
"خراسان_جنوبی","بیرجند","مرکزی",101,468,6,0,62,536,10,546
"خراسان_جنوبی","بیرجند","مرکزی",102,270,3,0,27,300,1,301
"خراسان_جنوبی","بیرجند","مرکزی",103,285,1,0,50,336,0,336
"خراسان_جنوبی","بیرجند","مرکزی",104,540,2,2,91,635,2,637
"خراسان_جنوبی","بیرجند","مرکزی",105,499,0,0,32,531,0,531
"خراسان_جنوبی","بیرجند","مرکزی",106,923,4,1,54,982,1,983
"خراسان_جنوبی","بیرجند","مرکزی",107,338,0,0,42,380,1,381
"خراسان_جنوبی","بیرجند","مرکزی",108,1079,0,0,45,1124,1,1125
"خراسان_جنوبی","بیرجند","مرکزی",109,763,4,3,21,791,5,796
"خراسان_جنوبی","بیرجند","مرکزی",110,991,2,3,23,1019,0,1019
"خراسان_جنوبی","بیرجند","مرکزی",111,751,5,0,75,831,3,834
"خراسان_جنوبی","بیرجند","مرکزی",112,711,7,3,74,795,9,804
"خراسان_جنوبی","بیرجند","مرکزی",113,430,6,0,59,495,0,495
"خراسان_جنوبی","بیرجند","مرکزی",114,393,4,1,40,438,1,439
"خراسان_جنوبی","بیرجند","مرکزی",115,593,2,0,24,619,4,623
"خراسان_جنوبی","بیرجند","مرکزی",116,592,20,6,377,995,27,1022
"خراسان_جنوبی","بیرجند","مرکزی",117,740,6,0,67,813,3,816
"خراسان_جنوبی","بیرجند","خوسف",1,712,11,1,100,824,0,824
"خراسان_جنوبی","بیرجند","خوسف",2,1034,10,6,234,1284,8,1292
"خراسان_جنوبی","بیرجند","خوسف",3,371,1,0,14,386,1,387
"خراسان_جنوبی","بیرجند","خوسف",4,496,10,1,52,559,1,560
"خراسان_جنوبی","بیرجند","خوسف",5,585,3,1,40,629,4,633
"خراسان_جنوبی","بیرجند","خوسف",6,810,1,0,41,852,1,853
"خراسان_جنوبی","بیرجند","خوسف",7,139,4,0,25,168,0,168
"خراسان_جنوبی","بیرجند","خوسف",8,906,10,1,83,1000,0,1000
"خراسان_جنوبی","بیرجند","خوسف",9,677,3,0,109,789,2,791
"خراسان_جنوبی","بیرجند","خوسف",10,632,5,0,76,713,1,714
"خراسان_جنوبی","بیرجند","خوسف",11,575,1,0,101,677,4,681
"خراسان_جنوبی","بیرجند","خوسف",12,679,1,0,74,754,2,756
"خراسان_جنوبی","بیرجند","خوسف",13,412,1,0,34,447,0,447
"خراسان_جنوبی","بیرجند","خوسف",14,628,9,1,21,659,5,664
"خراسان_جنوبی","بیرجند","خوسف",15,550,3,1,48,602,4,606
"خراسان_جنوبی","بیرجند","خوسف",16,463,5,0,101,569,8,577
"خراسان_جنوبی","بیرجند","خوسف",17,469,12,0,62,543,4,547
"خراسان_جنوبی","بیرجند","خوسف",18,438,0,1,46,485,3,488
"خراسان_جنوبی","بیرجند","خوسف",19,487,9,0,99,595,3,598
"خراسان_جنوبی","بیرجند","خوسف",20,826,1,0,72,899,1,900
"خراسان_جنوبی","بیرجند","خوسف",21,344,0,0,54,398,2,400
"خراسان_جنوبی","بیرجند","خوسف",22,294,1,0,29,324,0,324
"خراسان_جنوبی","بیرجند","خوسف",23,165,2,0,7,174,0,174
"خراسان_جنوبی","بیرجند","خوسف",24,558,11,0,38,607,1,608
"خراسان_جنوبی","بیرجند","خوسف",25,1053,8,2,132,1195,4,1199
"خراسان_جنوبی","بیرجند","خوسف",26,295,3,0,27,325,0,325
"خراسان_جنوبی","بیرجند","خوسف",27,504,0,1,18,523,0,523
"خراسان_جنوبی","بیرجند","خوسف",28,231,6,0,58,295,1,296
"خراسان_جنوبی","درمیان","مرکزی",1,305,4,6,718,1033,4,1037
"خراسان_جنوبی","درمیان","مرکزی",2,355,3,10,827,1195,5,1200
"خراسان_جنوبی","درمیان","مرکزی",3,163,3,0,165,331,1,332
"خراسان_جنوبی","درمیان","مرکزی",4,293,1,2,670,966,12,978
"خراسان_جنوبی","درمیان","مرکزی",5,243,1,1,668,913,2,915
"خراسان_جنوبی","درمیان","مرکزی",6,174,5,2,646,827,4,831
"خراسان_جنوبی","درمیان","مرکزی",7,122,1,3,296,422,0,422
"خراسان_جنوبی","درمیان","مرکزی",8,152,2,2,94,250,0,250
"خراسان_جنوبی","درمیان","مرکزی",9,408,0,2,179,589,0,589
"خراسان_جنوبی","درمیان","مرکزی",10,130,4,0,630,764,9,773
"خراسان_جنوبی","درمیان","مرکزی",11,183,2,0,650,835,1,836
"خراسان_جنوبی","درمیان","مرکزی",12,110,0,0,427,537,2,539
"خراسان_جنوبی","درمیان","مرکزی",13,726,2,0,87,815,0,815
"خراسان_جنوبی","درمیان","مرکزی",14,1136,1,0,118,1255,5,1260
"خراسان_جنوبی","درمیان","مرکزی",15,277,2,1,486,766,0,766
"خراسان_جنوبی","درمیان","قهستان",1,742,8,2,90,842,7,849
"خراسان_جنوبی","درمیان","قهستان",2,1027,2,0,47,1076,3,1079
"خراسان_جنوبی","درمیان","قهستان",3,877,1,2,62,942,3,945
"خراسان_جنوبی","درمیان","قهستان",4,830,3,0,34,867,1,868
"خراسان_جنوبی","درمیان","قهستان",5,755,4,0,33,792,0,792
"خراسان_جنوبی","درمیان","قهستان",6,651,2,2,67,722,1,723
"خراسان_جنوبی","درمیان","قهستان",7,685,0,0,29,714,1,715
"خراسان_جنوبی","درمیان","قهستان",8,613,3,2,43,661,0,661
"خراسان_جنوبی","درمیان","قهستان",9,705,1,1,33,740,0,740
"خراسان_جنوبی","درمیان","قهستان",10,677,4,0,64,745,3,748
"خراسان_جنوبی","درمیان","قهستان",11,972,3,2,97,1074,0,1074
"خراسان_جنوبی","درمیان","قهستان",12,108,0,0,516,624,4,628
"خراسان_جنوبی","درمیان","گزیک",1,130,4,7,853,994,6,1000
"خراسان_جنوبی","درمیان","گزیک",2,310,7,2,434,753,5,758
"خراسان_جنوبی","درمیان","گزیک",3,85,2,4,777,868,1,869
"خراسان_جنوبی","درمیان","گزیک",4,65,0,0,547,612,2,614
"خراسان_جنوبی","درمیان","گزیک",5,42,1,1,385,429,0,429
"خراسان_جنوبی","درمیان","گزیک",6,80,11,6,759,856,9,865
"خراسان_جنوبی","درمیان","گزیک",7,168,0,13,675,856,6,862
"خراسان_جنوبی","درمیان","گزیک",8,57,3,0,320,380,2,382
"خراسان_جنوبی","درمیان","گزیک",9,368,3,1,472,844,0,844
"خراسان_جنوبی","درمیان","گزیک",10,189,2,1,611,803,9,812
"خراسان_جنوبی","درمیان","گزیک",11,129,2,0,108,239,1,240
"خراسان_جنوبی","سرایان","مرکز_شهرستان",1,657,6,5,436,1104,9,1113
"خراسان_جنوبی","سرایان","مرکز_شهرستان",2,769,14,3,643,1429,10,1439
"خراسان_جنوبی","سرایان","مرکز_شهرستان",3,695,8,8,348,1059,4,1063
"خراسان_جنوبی","سرایان","مرکز_شهرستان",4,752,15,6,457,1230,4,1234
"خراسان_جنوبی","سرایان","مرکز_شهرستان",5,359,9,0,153,521,4,525
"خراسان_جنوبی","سرایان","مرکز_شهرستان",6,494,12,4,360,870,0,870
"خراسان_جنوبی","سرایان","مرکز_شهرستان",7,593,17,11,334,955,4,959
"خراسان_جنوبی","سرایان","آیسک",8,357,4,0,78,439,0,439
"خراسان_جنوبی","سرایان","آیسک",9,643,7,1,247,898,7,905
"خراسان_جنوبی","سرایان","آیسک",10,715,4,4,200,923,5,928
"خراسان_جنوبی","سرایان","آیسک",11,572,7,1,139,719,2,721
"خراسان_جنوبی","سرایان","آیسک",12,656,4,1,44,705,0,705
"خراسان_جنوبی","سرایان","آیسک",13,713,10,1,74,798,0,798
"خراسان_جنوبی","سرایان","آیسک",14,479,4,1,33,517,2,519
"خراسان_جنوبی","سرایان","آیسک",15,192,0,1,17,210,0,210
"خراسان_جنوبی","سرایان","آیسک",16,607,2,0,55,664,4,668
"خراسان_جنوبی","سرایان","آیسک",17,545,3,0,71,619,3,622
"خراسان_جنوبی","سرایان","آیسک",18,184,5,0,59,248,0,248
"خراسان_جنوبی","سرایان","آیسک",19,559,1,0,133,693,2,695
"خراسان_جنوبی","سرایان","آیسک",20,226,4,1,63,294,0,294
"خراسان_جنوبی","سرایان","سه_قلعه",1,426,4,3,86,519,3,522
"خراسان_جنوبی","سرایان","سه_قلعه",2,784,4,1,111,900,0,900
"خراسان_جنوبی","سرایان","سه_قلعه",3,714,5,2,137,858,1,859
"خراسان_جنوبی","سرایان","سه_قلعه",4,330,1,1,46,378,1,379
"خراسان_جنوبی","سرایان","سه_قلعه",5,602,1,0,53,656,1,657
"خراسان_جنوبی","سرایان","سه_قلعه",6,458,1,1,35,495,0,495
"خراسان_جنوبی","سرایان","سه_قلعه",7,368,0,0,25,393,0,393
"خراسان_جنوبی","سرایان","سه_قلعه",8,271,7,0,19,297,2,299
"خراسان_جنوبی","سرایان","سه_قلعه",9,348,0,0,13,361,1,362
"خراسان_جنوبی","سرایان","سه_قلعه",10,248,0,0,14,262,0,262
"خراسان_جنوبی","سربیشه","مرکز_شهرستان",1,518,7,4,173,702,2,704
"خراسان_جنوبی","سربیشه","مرکز_شهرستان",2,654,13,4,156,827,2,829
"خراسان_جنوبی","سربیشه","مرکز_شهرستان",3,212,2,3,106,323,0,323
"خراسان_جنوبی","سربیشه","مرکز_شهرستان",4,322,1,1,157,481,1,482
"خراسان_جنوبی","سربیشه","مرکز_شهرستان",5,627,3,4,238,872,3,875
"خراسان_جنوبی","سربیشه","مرکز_شهرستان",6,432,9,4,156,601,4,605
"خراسان_جنوبی","سربیشه","مرکز_شهرستان",7,131,1,0,53,185,0,185
"خراسان_جنوبی","سربیشه","مرکز_شهرستان",8,228,1,0,73,302,0,302
"خراسان_جنوبی","سربیشه","مرکزی",9,362,1,0,93,456,1,457
"خراسان_جنوبی","سربیشه","مرکزی",10,239,1,0,33,273,0,273
"خراسان_جنوبی","سربیشه","مرکزی",11,682,0,1,14,697,0,697
"خراسان_جنوبی","سربیشه","مرکزی",12,474,3,3,85,565,1,566
"خراسان_جنوبی","سربیشه","مرکزی",13,351,4,0,149,504,2,506
"خراسان_جنوبی","سربیشه","مرکزی",14,736,0,0,46,782,3,785
"خراسان_جنوبی","سربیشه","مرکزی",15,399,1,1,38,439,0,439
"خراسان_جنوبی","سربیشه","مرکزی",16,179,0,1,27,207,0,207
"خراسان_جنوبی","سربیشه","مرکزی",17,220,1,0,53,274,0,274
"خراسان_جنوبی","سربیشه","مرکزی",18,361,0,0,105,466,0,466
"خراسان_جنوبی","سربیشه","مرکزی",19,500,3,0,135,638,2,640
"خراسان_جنوبی","سربیشه","مرکزی",20,1096,7,1,70,1174,2,1176
"خراسان_جنوبی","سربیشه","مرکزی",21,307,0,0,9,316,0,316
"خراسان_جنوبی","سربیشه","مرکزی",22,290,0,0,2,292,0,292
"خراسان_جنوبی","سربیشه","مرکزی",23,222,0,0,5,227,0,227
"خراسان_جنوبی","سربیشه","مرکزی",24,647,3,0,10,660,0,660
"خراسان_جنوبی","سربیشه","مرکزی",25,720,1,0,6,727,2,729
"خراسان_جنوبی","سربیشه","مرکزی",26,341,1,5,253,600,4,604
"خراسان_جنوبی","سربیشه","مرکزی",27,212,2,0,125,339,0,339
"خراسان_جنوبی","سربیشه","مرکزی",28,443,0,1,6,450,0,450
"خراسان_جنوبی","سربیشه","مرکزی",29,501,0,0,4,505,0,505
"خراسان_جنوبی","سربیشه","مرکزی",30,135,0,0,18,153,3,156
"خراسان_جنوبی","سربیشه","مود",1,647,6,0,155,808,3,811
"خراسان_جنوبی","سربیشه","مود",2,476,15,1,233,725,8,733
"خراسان_جنوبی","سربیشه","مود",3,334,9,1,180,524,3,527
"خراسان_جنوبی","سربیشه","مود",4,332,6,3,152,493,1,494
"خراسان_جنوبی","سربیشه","مود",5,716,10,1,69,796,4,800
"خراسان_جنوبی","سربیشه","مود",6,333,4,1,87,425,1,426
"خراسان_جنوبی","سربیشه","مود",7,697,3,0,54,754,2,756
"خراسان_جنوبی","سربیشه","مود",8,454,1,0,26,481,7,488
"خراسان_جنوبی","سربیشه","مود",9,778,2,0,66,846,0,846
"خراسان_جنوبی","سربیشه","مود",10,364,4,2,190,560,0,560
"خراسان_جنوبی","سربیشه","مود",11,568,3,3,46,620,2,622
"خراسان_جنوبی","سربیشه","مود",12,518,2,0,21,541,2,543
"خراسان_جنوبی","سربیشه","مود",13,129,0,0,10,139,0,139
"خراسان_جنوبی","سربیشه","مود",14,357,0,0,28,385,1,386
"خراسان_جنوبی","سربیشه","مود",15,252,0,1,10,263,1,264
"خراسان_جنوبی","سربیشه","مود",16,307,2,0,39,348,3,351
"خراسان_جنوبی","سربیشه","مود",17,306,1,0,36,343,0,343
"خراسان_جنوبی","فردوس","مرکزی",1,1166,19,5,423,1613,19,1632
"خراسان_جنوبی","فردوس","مرکزی",2,761,11,0,193,965,4,969
"خراسان_جنوبی","فردوس","مرکزی",3,846,7,2,112,967,5,972
"خراسان_جنوبی","فردوس","مرکزی",4,1029,17,6,383,1435,16,1451
"خراسان_جنوبی","فردوس","مرکزی",5,1411,36,10,654,2111,13,2124
"خراسان_جنوبی","فردوس","مرکزی",6,770,7,2,195,974,6,980
"خراسان_جنوبی","فردوس","مرکزی",7,612,14,3,305,934,4,938
"خراسان_جنوبی","فردوس","مرکزی",8,929,21,3,233,1186,9,1195
"خراسان_جنوبی","فردوس","مرکزی",9,706,12,2,327,1047,16,1063
"خراسان_جنوبی","فردوس","مرکزی",10,570,3,0,52,625,0,625
"خراسان_جنوبی","فردوس","مرکزی",11,551,4,0,56,611,3,614
"خراسان_جنوبی","فردوس","مرکزی",12,746,9,2,177,934,7,941
"خراسان_جنوبی","فردوس","مرکزی",13,223,1,0,87,311,2,313
"خراسان_جنوبی","فردوس","مرکزی",14,273,2,1,55,331,2,333
"خراسان_جنوبی","فردوس","مرکزی",15,309,8,3,85,405,1,406
"خراسان_جنوبی","فردوس","مرکزی",16,718,12,0,177,907,5,912
"خراسان_جنوبی","فردوس","مرکزی",17,642,4,2,84,732,3,735
"خراسان_جنوبی","فردوس","مرکزی",18,279,5,0,59,343,1,344
"خراسان_جنوبی","فردوس","مرکزی",19,308,6,0,86,400,2,402
"خراسان_جنوبی","فردوس","مرکزی",20,619,0,0,50,669,3,672
"خراسان_جنوبی","فردوس","مرکزی",21,810,12,1,196,1019,5,1024
"خراسان_جنوبی","فردوس","مرکزی",22,663,6,0,59,728,1,729
"خراسان_جنوبی","فردوس","مرکزی",23,774,7,1,100,882,8,890
"خراسان_جنوبی","فردوس","مرکزی",24,274,1,2,46,323,0,323
"خراسان_جنوبی","فردوس","مرکزی",25,504,3,2,112,621,3,624
"خراسان_جنوبی","فردوس","مرکزی",26,646,7,2,64,719,3,722
"خراسان_جنوبی","فردوس","مرکزی",27,671,8,1,44,724,1,725
"خراسان_جنوبی","فردوس","مرکزی",28,349,2,1,72,424,1,425
"خراسان_جنوبی","فردوس","مرکزی",29,741,4,1,55,801,1,802
"خراسان_جنوبی","فردوس","مرکزی",30,680,3,0,26,709,2,711
"خراسان_جنوبی","فردوس","مرکزی",31,680,2,2,46,730,1,731
"خراسان_جنوبی","فردوس","مرکزی",32,824,2,0,46,872,1,873
"خراسان_جنوبی","فردوس","مرکزی",33,499,0,0,35,534,1,535
"خراسان_جنوبی","فردوس","مرکزی",34,170,6,1,81,258,2,260
"خراسان_جنوبی","قائنات","نیمبلوک",1,1009,7,2,110,1128,2,1130
"خراسان_جنوبی","قائنات","نیمبلوک",2,476,6,1,86,569,4,573
"خراسان_جنوبی","قائنات","نیمبلوک",3,865,20,0,95,980,4,984
"خراسان_جنوبی","قائنات","نیمبلوک",4,597,2,0,105,704,1,705
"خراسان_جنوبی","قائنات","نیمبلوک",5,1020,7,0,83,1110,4,1114
"خراسان_جنوبی","قائنات","نیمبلوک",6,743,7,1,106,857,2,859
"خراسان_جنوبی","قائنات","نیمبلوک",7,433,5,0,39,477,1,478
"خراسان_جنوبی","قائنات","نیمبلوک",8,600,1,1,48,650,0,650
"خراسان_جنوبی","قائنات","نیمبلوک",9,198,0,0,3,201,0,201
"خراسان_جنوبی","قائنات","نیمبلوک",10,380,3,2,48,433,2,435
"خراسان_جنوبی","قائنات","نیمبلوک",11,516,5,0,60,581,2,583
"خراسان_جنوبی","قائنات","نیمبلوک",12,469,1,0,27,497,1,498
"خراسان_جنوبی","قائنات","نیمبلوک",13,760,6,4,141,911,2,913
"خراسان_جنوبی","قائنات","نیمبلوک",14,267,0,0,4,271,0,271
"خراسان_جنوبی","قائنات","نیمبلوک",15,605,2,0,23,630,2,632
"خراسان_جنوبی","قائنات","نیمبلوک",16,654,4,1,37,696,0,696
"خراسان_جنوبی","قائنات","نیمبلوک",17,488,1,1,43,533,2,535
"خراسان_جنوبی","قائنات","نیمبلوک",18,901,3,0,62,966,2,968
"خراسان_جنوبی","قائنات","سده",1,1300,12,2,321,1635,7,1642
"خراسان_جنوبی","قائنات","سده",2,369,6,0,132,507,0,507
"خراسان_جنوبی","قائنات","سده",3,790,5,2,122,919,2,921
"خراسان_جنوبی","قائنات","سده",4,733,1,3,28,765,0,765
"خراسان_جنوبی","قائنات","سده",5,307,1,0,20,328,1,329
"خراسان_جنوبی","قائنات","سده",6,1059,0,0,34,1093,1,1094
"خراسان_جنوبی","قائنات","سده",7,491,3,2,50,546,1,547
"خراسان_جنوبی","قائنات","سده",8,933,5,3,67,1008,2,1010
"خراسان_جنوبی","قائنات","سده",9,698,5,1,179,883,2,885
"خراسان_جنوبی","قائنات","سده",10,766,1,0,22,789,0,789
"خراسان_جنوبی","قائنات","سده",11,782,2,2,11,797,3,800
"خراسان_جنوبی","قائنات","سده",12,497,2,0,23,522,2,524
"خراسان_جنوبی","قائنات","سده",13,612,3,2,82,699,7,706
"خراسان_جنوبی","قائنات","سده",14,484,2,0,56,542,0,542
"خراسان_جنوبی","قائنات","سده",15,990,7,0,24,1021,0,1021
"خراسان_جنوبی","قائنات","سده",16,755,1,2,33,791,1,792
"خراسان_جنوبی","قائنات","زهان",1,196,0,0,47,243,0,243
"خراسان_جنوبی","قائنات","زهان",2,530,0,0,115,645,3,648
"خراسان_جنوبی","قائنات","زهان",3,396,2,3,109,510,1,511
"خراسان_جنوبی","قائنات","زهان",4,317,2,0,30,349,0,349
"خراسان_جنوبی","قائنات","زهان",5,692,1,0,223,916,4,920
"خراسان_جنوبی","قائنات","زهان",6,1037,10,0,46,1093,0,1093
"خراسان_جنوبی","قائنات","زهان",7,282,6,1,244,533,5,538
"خراسان_جنوبی","قائنات","زهان",8,324,1,5,81,411,0,411
"خراسان_جنوبی","قائنات","زهان",9,315,1,4,79,399,1,400
"خراسان_جنوبی","قائنات","زهان",10,266,2,0,40,308,2,310
"خراسان_جنوبی","قائنات","زهان",11,255,1,0,25,281,0,281
"خراسان_جنوبی","قائنات","زهان",12,290,2,0,29,321,0,321
"خراسان_جنوبی","قائنات","زهان",13,543,0,0,19,562,2,564
"خراسان_جنوبی","قائنات","زیرکوه",1,845,11,2,191,1049,3,1052
"خراسان_جنوبی","قائنات","زیرکوه",2,371,5,2,101,479,0,479
"خراسان_جنوبی","قائنات","زیرکوه",3,773,6,1,58,838,1,839
"خراسان_جنوبی","قائنات","زیرکوه",4,376,0,9,71,456,0,456
"خراسان_جنوبی","قائنات","زیرکوه",5,567,2,0,36,605,3,608
"خراسان_جنوبی","قائنات","زیرکوه",6,714,2,0,18,734,0,734
"خراسان_جنوبی","قائنات","زیرکوه",7,436,2,1,134,573,1,574
"خراسان_جنوبی","قائنات","زیرکوه",8,749,6,2,137,894,3,897
"خراسان_جنوبی","قائنات","زیرکوه",9,565,2,0,101,668,1,669
"خراسان_جنوبی","قائنات","زیرکوه",10,491,2,1,302,796,4,800
"خراسان_جنوبی","قائنات","زیرکوه",11,296,0,1,123,420,1,421
"خراسان_جنوبی","قائنات","زیرکوه",12,441,0,0,189,630,1,631
"خراسان_جنوبی","قائنات","زیرکوه",13,587,0,1,12,600,0,600
"خراسان_جنوبی","قائنات","زیرکوه",14,303,0,0,12,315,0,315
"خراسان_جنوبی","قائنات","زیرکوه",15,354,1,0,55,410,1,411
"خراسان_جنوبی","قائنات","زیرکوه",16,464,1,0,21,486,0,486
"خراسان_جنوبی","قائنات","زیرکوه",17,133,1,1,566,701,2,703
"خراسان_جنوبی","قائنات","زیرکوه",18,136,1,6,549,692,6,698
"خراسان_جنوبی","قائنات","زیرکوه",19,763,5,0,85,853,1,854
"خراسان_جنوبی","قائنات","زیرکوه",20,368,1,0,108,477,4,481
"خراسان_جنوبی","قائنات","زیرکوه",21,795,0,0,39,834,0,834
"خراسان_جنوبی","قائنات","زیرکوه",22,340,2,0,77,419,2,421
"خراسان_جنوبی","قائنات","زیرکوه",23,659,13,0,32,704,1,705
"خراسان_جنوبی","قائنات","زیرکوه",24,127,0,1,24,152,1,153
"خراسان_جنوبی","قائنات","مرکزی",1,253,2,0,66,321,4,325
"خراسان_جنوبی","قائنات","مرکزی",2,548,5,0,131,684,3,687
"خراسان_جنوبی","قائنات","مرکزی",3,524,3,0,20,547,2,549
"خراسان_جنوبی","قائنات","مرکزی",4,1403,16,0,72,1491,0,1491
"خراسان_جنوبی","قائنات","مرکزی",5,330,1,0,8,339,0,339
"خراسان_جنوبی","قائنات","مرکزی",6,768,0,1,50,819,0,819
"خراسان_جنوبی","قائنات","مرکزی",7,498,2,0,17,517,0,517
"خراسان_جنوبی","قائنات","مرکزی",8,331,1,1,26,359,2,361
"خراسان_جنوبی","قائنات","مرکزی",9,1089,7,1,177,1274,3,1277
"خراسان_جنوبی","قائنات","مرکزی",10,633,2,1,36,672,3,675
"خراسان_جنوبی","قائنات","مرکزی",11,432,0,0,13,445,1,446
"خراسان_جنوبی","قائنات","مرکزی",12,625,2,0,32,659,1,660
"خراسان_جنوبی","قائنات","مرکزی",13,518,14,3,31,566,1,567
"خراسان_جنوبی","قائنات","مرکزی",14,606,0,1,53,660,0,660
"خراسان_جنوبی","قائنات","مرکزی",15,680,3,0,54,737,1,738
"خراسان_جنوبی","قائنات","مرکزی",16,559,3,0,267,829,4,833
"خراسان_جنوبی","قائنات","مرکزی",17,1313,2,1,148,1464,0,1464
"خراسان_جنوبی","قائنات","مرکزی",18,903,0,0,25,928,1,929
"خراسان_جنوبی","قائنات","مرکزی",19,789,17,1,145,952,6,958
"خراسان_جنوبی","قائنات","مرکزی",20,734,3,0,16,753,2,755
"خراسان_جنوبی","قائنات","مرکزی",21,789,0,1,33,823,1,824
"خراسان_جنوبی","قائنات","مرکزی",22,978,0,0,20,998,1,999
"خراسان_جنوبی","قائنات","مرکزی",23,930,2,0,47,979,2,981
"خراسان_جنوبی","قائنات","مرکزی",24,736,0,0,15,751,0,751
"خراسان_جنوبی","قائنات","مرکزی",25,472,2,7,35,516,0,516
"خراسان_جنوبی","قائنات","مرکزی",26,282,2,1,10,295,1,296
"خراسان_جنوبی","قائنات","مرکزی",27,337,2,1,6,346,2,348
"خراسان_جنوبی","قائنات","مرکزی",1,521,26,3,296,846,6,852
"خراسان_جنوبی","قائنات","مرکزی",2,424,5,0,149,578,6,584
"خراسان_جنوبی","قائنات","مرکزی",3,561,21,3,427,1012,10,1022
"خراسان_جنوبی","قائنات","مرکزی",4,724,34,7,432,1197,21,1218
"خراسان_جنوبی","قائنات","مرکزی",5,701,3,4,467,1175,18,1193
"خراسان_جنوبی","قائنات","مرکزی",6,757,21,3,344,1125,9,1134
"خراسان_جنوبی","قائنات","مرکزی",7,710,19,2,345,1076,9,1085
"خراسان_جنوبی","قائنات","مرکزی",8,744,22,4,549,1319,19,1338
"خراسان_جنوبی","قائنات","مرکزی",9,226,9,2,206,443,6,449
"خراسان_جنوبی","قائنات","مرکزی",10,347,10,5,224,586,6,592
"خراسان_جنوبی","قائنات","مرکزی",11,535,12,3,244,794,6,800
"خراسان_جنوبی","قائنات","مرکزی",12,1120,26,3,285,1434,7,1441
"خراسان_جنوبی","قائنات","مرکزی",13,686,13,4,451,1154,12,1166
"خراسان_جنوبی","قائنات","مرکزی",14,548,29,1,424,1002,9,1011
"خراسان_جنوبی","قائنات","مرکزی",15,701,26,1,369,1097,17,1114
"خراسان_جنوبی","قائنات","مرکزی",16,330,18,1,243,592,5,597
"خراسان_جنوبی","قائنات","مرکزی",17,569,27,1,297,894,6,900
"خراسان_جنوبی","قائنات","مرکزی",18,276,4,2,123,405,5,410
"خراسان_جنوبی","قائنات","مرکزی",19,154,1,0,31,186,1,187
"خراسان_جنوبی","قائنات","مرکزی",20,714,9,2,180,905,10,915
"خراسان_جنوبی","قائنات","مرکزی",21,482,13,3,244,742,9,751
"خراسان_جنوبی","نهبندان","مرکزی",1,791,4,3,317,1115,2,1117
"خراسان_جنوبی","نهبندان","مرکزی",2,760,9,5,347,1121,6,1127
"خراسان_جنوبی","نهبندان","مرکزی",3,767,10,1,296,1074,9,1083
"خراسان_جنوبی","نهبندان","مرکزی",4,695,5,1,152,853,0,853
"خراسان_جنوبی","نهبندان","مرکزی",5,327,4,1,76,408,1,409
"خراسان_جنوبی","نهبندان","مرکزی",6,813,8,4,257,1082,3,1085
"خراسان_جنوبی","نهبندان","مرکزی",7,321,11,4,120,456,1,457
"خراسان_جنوبی","نهبندان","مرکزی",8,507,5,2,226,740,6,746
"خراسان_جنوبی","نهبندان","مرکزی",9,618,6,10,256,890,3,893
"خراسان_جنوبی","نهبندان","مرکزی",10,155,3,0,35,193,0,193
"خراسان_جنوبی","نهبندان","مرکزی",11,507,5,2,260,774,3,777
"خراسان_جنوبی","نهبندان","مرکزی",12,129,2,0,49,180,1,181
"خراسان_جنوبی","نهبندان","مرکزی",13,576,2,1,26,605,0,605
"خراسان_جنوبی","نهبندان","مرکزی",14,1109,3,0,122,1234,3,1237
"خراسان_جنوبی","نهبندان","مرکزی",15,185,3,0,16,204,0,204
"خراسان_جنوبی","نهبندان","مرکزی",16,182,3,3,24,212,0,212
"خراسان_جنوبی","نهبندان","مرکزی",17,227,2,0,147,376,2,378
"خراسان_جنوبی","نهبندان","مرکزی",18,480,2,0,45,527,0,527
"خراسان_جنوبی","نهبندان","مرکزی",19,573,14,0,277,864,1,865
"خراسان_جنوبی","نهبندان","مرکزی",20,117,0,0,26,143,1,144
"خراسان_جنوبی","نهبندان","مرکزی",21,476,1,0,10,487,1,488
"خراسان_جنوبی","نهبندان","مرکزی",22,409,1,0,11,421,0,421
"خراسان_جنوبی","نهبندان","مرکزی",23,189,0,0,4,193,0,193
"خراسان_جنوبی","نهبندان","مرکزی",24,360,0,0,40,400,1,401
"خراسان_جنوبی","نهبندان","مرکزی",25,269,1,0,10,280,0,280
"خراسان_جنوبی","نهبندان","مرکزی",26,813,4,2,116,935,0,935
"خراسان_جنوبی","نهبندان","مرکزی",27,158,0,0,41,199,0,199
"خراسان_جنوبی","نهبندان","مرکزی",28,194,0,0,3,197,0,197
"خراسان_جنوبی","نهبندان","مرکزی",29,377,1,0,15,393,1,394
"خراسان_جنوبی","نهبندان","مرکزی",30,446,7,0,13,466,0,466
"خراسان_جنوبی","نهبندان","مرکزی",31,395,2,0,9,406,0,406
"خراسان_جنوبی","نهبندان","مرکزی",32,513,1,1,16,531,0,531
"خراسان_جنوبی","نهبندان","مرکزی",33,348,2,1,7,358,2,360
"خراسان_جنوبی","نهبندان","مرکزی",34,477,1,0,10,488,7,495
"خراسان_جنوبی","نهبندان","مرکزی",35,434,0,0,8,442,1,443
"خراسان_جنوبی","نهبندان","مرکزی",36,777,1,0,52,830,5,835
"خراسان_جنوبی","نهبندان","مرکزی",37,760,1,0,25,786,1,787
"خراسان_جنوبی","نهبندان","مرکزی",38,790,2,1,62,855,0,855
"خراسان_جنوبی","نهبندان","شوسف",1,372,6,2,142,522,1,523
"خراسان_جنوبی","نهبندان","شوسف",2,635,1,1,117,754,1,755
"خراسان_جنوبی","نهبندان","شوسف",3,120,0,0,61,181,2,183
"خراسان_جنوبی","نهبندان","شوسف",4,275,2,0,34,311,0,311
"خراسان_جنوبی","نهبندان","شوسف",5,386,2,0,10,398,0,398
"خراسان_جنوبی","نهبندان","شوسف",6,250,1,1,29,281,5,286
"خراسان_جنوبی","نهبندان","شوسف",7,284,1,0,18,303,0,303
"خراسان_جنوبی","نهبندان","شوسف",8,380,0,7,108,495,0,495
"خراسان_جنوبی","نهبندان","شوسف",9,371,1,0,6,378,0,378
"خراسان_جنوبی","نهبندان","شوسف",10,433,1,0,14,448,1,449
"خراسان_جنوبی","نهبندان","شوسف",11,221,3,1,34,259,1,260
"خراسان_جنوبی","نهبندان","شوسف",12,229,0,0,18,247,0,247
"خراسان_جنوبی","نهبندان","شوسف",13,242,0,0,17,259,0,259
"خراسان_جنوبی","نهبندان","شوسف",14,290,0,0,86,376,1,377
"خراسان_جنوبی","نهبندان","شوسف",15,421,0,0,38,459,1,460
"خراسان_جنوبی","نهبندان","شوسف",16,177,1,0,23,201,0,201
"خراسان_جنوبی","نهبندان","شوسف",17,238,0,0,37,275,0,275
"خراسان_جنوبی","نهبندان","شوسف",18,412,2,0,32,446,0,446
"خراسان_جنوبی","نهبندان","شوسف",19,264,1,0,22,287,2,289
"خراسان_جنوبی","نهبندان","شوسف",20,312,0,1,12,325,0,325
"خراسان_جنوبی","نهبندان","شوسف",21,257,2,1,7,267,0,267
"خراسان_جنوبی","نهبندان","شوسف",22,331,1,0,8,340,0,340
"خراسان_جنوبی","نهبندان","شوسف",23,268,1,0,33,302,2,304
"خراسان_رضوی","بجستان","مركزی",1,1015,7,2,283,1307,7,1314
"خراسان_رضوی","بجستان","مركزی",2,946,4,3,460,1413,7,1420
"خراسان_رضوی","بجستان","مركزی",3,602,13,8,308,931,3,934
"خراسان_رضوی","بجستان","مركزی",4,606,3,2,242,853,6,859
"خراسان_رضوی","بجستان","مركزی",5,626,9,2,402,1039,2,1041
"خراسان_رضوی","بجستان","مركزی",6,825,3,0,123,951,11,962
"خراسان_رضوی","بجستان","مركزی",7,344,1,0,28,373,2,375
"خراسان_رضوی","بجستان","مركزی",8,544,2,0,14,560,0,560
"خراسان_رضوی","بجستان","مركزی",9,992,1,1,142,1136,3,1139
"خراسان_رضوی","بجستان","مركزی",10,283,1,0,60,344,1,345
"خراسان_رضوی","بجستان","مركزی",11,622,2,3,47,674,6,680
"خراسان_رضوی","بجستان","مركزی",12,308,0,0,34,342,0,342
"خراسان_رضوی","بجستان","مركزی",13,58,3,0,14,75,0,75
"خراسان_رضوی","بجستان","مركزی",14,273,0,1,91,365,1,366
"خراسان_رضوی","بجستان","مركزی",15,407,1,3,29,440,0,440
"خراسان_رضوی","بجستان","مركزی",16,238,1,0,45,284,2,286
"خراسان_رضوی","بجستان","مركزی",17,684,10,3,133,830,3,833
"خراسان_رضوی","بجستان","یونسی",1,1029,9,2,300,1340,2,1342
"خراسان_رضوی","بجستان","یونسی",2,729,10,2,225,966,4,970
"خراسان_رضوی","بجستان","یونسی",3,578,2,4,77,661,1,662
"خراسان_رضوی","بجستان","یونسی",4,800,3,2,101,906,6,912
"خراسان_رضوی","بجستان","یونسی",5,604,3,3,175,785,1,786
"خراسان_رضوی","بجستان","یونسی",6,814,3,2,300,1119,6,1125
"خراسان_رضوی","بجستان","یونسی",7,391,0,1,32,424,0,424
"خراسان_رضوی","بردسکن","مرکزی",1,665,16,6,481,1168,0,1168
"خراسان_رضوی","بردسکن","مرکزی",2,452,20,1,318,791,9,800
"خراسان_رضوی","بردسکن","مرکزی",3,1001,20,1,546,1568,9,1577
"خراسان_رضوی","بردسکن","مرکزی",4,688,12,1,596,1297,11,1308
"خراسان_رضوی","بردسکن","مرکزی",5,901,11,2,578,1492,8,1500
"خراسان_رضوی","بردسکن","مرکزی",6,854,23,4,504,1385,14,1399
"خراسان_رضوی","بردسکن","مرکزی",7,686,19,3,704,1412,11,1423
"خراسان_رضوی","بردسکن","مرکزی",8,716,2,2,262,982,7,989
"خراسان_رضوی","بردسکن","مرکزی",9,243,4,0,132,379,1,380
"خراسان_رضوی","بردسکن","مرکزی",10,652,30,2,662,1346,14,1360
"خراسان_رضوی","بردسکن","مرکزی",11,382,9,1,271,663,4,667
"خراسان_رضوی","بردسکن","مرکزی",12,135,4,0,67,206,3,209
"خراسان_رضوی","بردسکن","مرکزی",13,492,1,0,158,651,1,652
"خراسان_رضوی","بردسکن","مرکزی",14,488,5,2,236,731,8,739
"خراسان_رضوی","بردسکن","مرکزی",15,403,2,2,146,553,4,557
"خراسان_رضوی","بردسکن","مرکزی",16,189,2,0,46,237,0,237
"خراسان_رضوی","بردسکن","مرکزی",17,609,4,1,73,687,3,690
"خراسان_رضوی","بردسکن","مرکزی",18,103,2,0,45,150,0,150
"خراسان_رضوی","بردسکن","مرکزی",19,192,0,0,35,227,0,227
"خراسان_رضوی","بردسکن","مرکزی",20,208,0,0,18,226,2,228
"خراسان_رضوی","بردسکن","مرکزی",21,257,0,0,63,320,2,322
"خراسان_رضوی","بردسکن","مرکزی",22,489,2,1,44,536,5,541
"خراسان_رضوی","بردسکن","مرکزی",23,176,1,0,88,265,6,271
"خراسان_رضوی","بردسکن","مرکزی",24,378,1,0,70,449,1,450
"خراسان_رضوی","بردسکن","مرکزی",25,199,2,0,27,228,3,231
"خراسان_رضوی","بردسکن","مرکزی",26,197,1,0,7,205,0,205
"خراسان_رضوی","بردسکن","مرکزی",27,148,4,1,38,191,1,192
"خراسان_رضوی","بردسکن","مرکزی",28,523,1,0,62,586,2,588
"خراسان_رضوی","بردسکن","مرکزی",29,336,1,0,45,382,0,382
"خراسان_رضوی","بردسکن","مرکزی",30,90,3,0,35,128,2,130
"خراسان_رضوی","بردسکن","مرکزی",31,337,2,0,122,461,0,461
"خراسان_رضوی","بردسکن","مرکزی",32,701,0,0,68,769,0,769
"خراسان_رضوی","بردسکن","مرکزی",33,444,0,0,285,729,0,729
"خراسان_رضوی","بردسکن","انابد",1,1021,4,1,207,1233,1,1234
"خراسان_رضوی","بردسکن","انابد",2,683,10,0,217,910,3,913
"خراسان_رضوی","بردسکن","انابد",3,490,5,1,100,596,2,598
"خراسان_رضوی","بردسکن","انابد",4,302,2,0,70,374,1,375
"خراسان_رضوی","بردسکن","انابد",5,315,0,0,50,365,0,365
"خراسان_رضوی","بردسکن","انابد",6,647,3,2,66,718,1,719
"خراسان_رضوی","بردسکن","انابد",7,452,9,3,179,643,1,644
"خراسان_رضوی","بردسکن","انابد",8,551,4,1,107,663,1,664
"خراسان_رضوی","بردسکن","انابد",9,698,4,2,86,790,1,791
"خراسان_رضوی","بردسکن","انابد",10,280,0,0,31,311,1,312
"خراسان_رضوی","بردسکن","انابد",11,364,2,0,61,427,4,431
"خراسان_رضوی","بردسکن","انابد",12,417,6,0,44,467,3,470
"خراسان_رضوی","بردسکن","انابد",13,358,9,0,67,434,6,440
"خراسان_رضوی","بردسکن","انابد",14,200,4,0,89,293,1,294
"خراسان_رضوی","بردسکن","انابد",15,207,1,1,30,239,0,239
"خراسان_رضوی","بردسکن","انابد",16,111,0,0,79,190,0,190
"خراسان_رضوی","بردسکن","انابد",17,248,1,0,10,259,0,259
"خراسان_رضوی","بردسکن","انابد",18,162,0,0,45,207,0,207
"خراسان_رضوی","بردسکن","انابد",19,282,6,0,44,332,0,332
"خراسان_رضوی","بردسکن","انابد",20,367,2,0,55,424,0,424
"خراسان_رضوی","بردسکن","انابد",21,407,2,2,24,435,1,436
"خراسان_رضوی","بردسکن","انابد",22,124,0,0,10,134,0,134
"خراسان_رضوی","بردسکن","انابد",23,202,2,0,11,215,0,215
"خراسان_رضوی","بردسکن","انابد",24,141,2,0,22,165,0,165
"خراسان_رضوی","بردسکن","انابد",25,192,2,1,25,220,0,220
"خراسان_رضوی","بردسکن","انابد",26,211,0,0,27,238,1,239
"خراسان_رضوی","بردسکن","انابد",27,74,0,0,17,91,0,91
"خراسان_رضوی","بردسکن","شهراباد",1,673,5,3,62,743,1,744
"خراسان_رضوی","بردسکن","شهراباد",2,519,9,4,102,634,2,636
"خراسان_رضوی","بردسکن","شهراباد",3,892,9,1,210,1112,1,1113
"خراسان_رضوی","بردسکن","شهراباد",4,942,9,3,57,1011,3,1014
"خراسان_رضوی","بردسکن","شهراباد",5,122,0,0,28,150,1,151
"خراسان_رضوی","بردسکن","شهراباد",6,408,0,0,62,470,0,470
"خراسان_رضوی","بردسکن","شهراباد",7,549,3,2,189,743,2,745
"خراسان_رضوی","بردسکن","شهراباد",8,440,2,0,170,612,0,612
"خراسان_رضوی","بردسکن","شهراباد",9,416,9,2,251,678,4,682
"خراسان_رضوی","بردسکن","شهراباد",10,288,3,0,82,373,2,375
"خراسان_رضوی","بردسکن","شهراباد",11,519,2,1,80,602,1,603
"خراسان_رضوی","بردسکن","شهراباد",12,399,0,5,34,438,1,439
"خراسان_رضوی","بردسکن","شهراباد",13,601,1,1,170,773,6,779
"خراسان_رضوی","بردسکن","شهراباد",14,463,6,2,45,516,5,521
"خراسان_رضوی","بردسکن","شهراباد",15,106,1,0,38,145,1,146
"خراسان_رضوی","بردسکن","شهراباد",16,497,3,1,35,536,0,536
"خراسان_رضوی","بردسکن","شهراباد",17,661,1,0,37,699,1,700
"خراسان_رضوی","بردسکن","شهراباد",18,798,2,0,60,860,6,866
"خراسان_رضوی","بردسکن","شهراباد",19,526,7,0,47,580,3,583
"خراسان_رضوی","بردسکن","شهراباد",20,92,1,1,29,123,1,124
"خراسان_رضوی","بردسکن","شهراباد",21,70,0,0,10,80,0,80
"خراسان_رضوی","بینالود","طرقبه",1,1175,38,7,922,2142,18,2160
"خراسان_رضوی","بینالود","طرقبه",2,1198,48,4,936,2186,14,2200
"خراسان_رضوی","بینالود","طرقبه",3,989,56,16,846,1907,10,1917
"خراسان_رضوی","بینالود","طرقبه",4,944,32,8,520,1504,14,1518
"خراسان_رضوی","بینالود","طرقبه",5,1000,39,14,868,1921,17,1938
"خراسان_رضوی","بینالود","طرقبه",6,614,28,9,304,955,9,964
"خراسان_رضوی","بینالود","طرقبه",7,705,40,8,527,1280,11,1291
"خراسان_رضوی","بینالود","طرقبه",8,849,42,13,1079,1983,22,2005
"خراسان_رضوی","بینالود","طرقبه",9,471,25,6,336,838,7,845
"خراسان_رضوی","بینالود","طرقبه",10,640,42,6,675,1363,12,1375
"خراسان_رضوی","بینالود","طرقبه",11,638,25,13,711,1387,14,1401
"خراسان_رضوی","بینالود","طرقبه",12,516,29,3,567,1115,10,1125
"خراسان_رضوی","بینالود","طرقبه",13,895,52,14,1102,2063,21,2084
"خراسان_رضوی","بینالود","طرقبه",14,548,18,7,258,831,4,835
"خراسان_رضوی","بینالود","طرقبه",15,1195,24,4,473,1696,7,1703
"خراسان_رضوی","بینالود","طرقبه",16,1236,24,2,490,1752,12,1764
"خراسان_رضوی","بینالود","طرقبه",17,592,3,1,65,661,4,665
"خراسان_رضوی","بینالود","طرقبه",18,1358,36,10,571,1975,26,2001
"خراسان_رضوی","بینالود","طرقبه",19,730,15,1,103,849,11,860
"خراسان_رضوی","بینالود","طرقبه",20,614,8,1,96,719,2,721
"خراسان_رضوی","بینالود","طرقبه",21,1086,36,1,764,1887,29,1916
"خراسان_رضوی","بینالود","طرقبه",22,861,5,1,172,1039,7,1046
"خراسان_رضوی","بینالود","طرقبه",23,423,11,4,200,638,1,639
"خراسان_رضوی","بینالود","طرقبه",24,665,8,0,263,936,7,943
"خراسان_رضوی","بینالود","طرقبه",25,332,0,0,72,404,2,406
"خراسان_رضوی","بینالود","طرقبه",26,617,0,0,71,688,2,690
"خراسان_رضوی","بینالود","طرقبه",27,511,4,0,88,603,3,606
"خراسان_رضوی","بینالود","طرقبه",28,362,5,0,80,447,0,447
"خراسان_رضوی","بینالود","شاندیز",1,1002,45,6,790,1843,22,1865
"خراسان_رضوی","بینالود","شاندیز",2,916,31,5,972,1924,22,1946
"خراسان_رضوی","بینالود","شاندیز",3,1047,27,1,687,1762,19,1781
"خراسان_رضوی","بینالود","شاندیز",4,984,59,9,624,1676,11,1687
"خراسان_رضوی","بینالود","شاندیز",5,887,29,4,538,1458,12,1470
"خراسان_رضوی","بینالود","شاندیز",6,570,27,5,336,938,10,948
"خراسان_رضوی","بینالود","شاندیز",7,507,20,1,404,932,11,943
"خراسان_رضوی","بینالود","شاندیز",8,389,14,1,199,603,2,605
"خراسان_رضوی","بینالود","شاندیز",9,870,16,1,354,1241,18,1259
"خراسان_رضوی","بینالود","شاندیز",10,709,18,2,303,1032,9,1041
"خراسان_رضوی","بینالود","شاندیز",11,850,26,7,485,1368,8,1376
"خراسان_رضوی","بینالود","شاندیز",12,1197,30,3,416,1646,8,1654
"خراسان_رضوی","بینالود","شاندیز",13,980,49,11,886,1926,19,1945
"خراسان_رضوی","بینالود","شاندیز",14,599,16,2,313,930,12,942
"خراسان_رضوی","بینالود","شاندیز",15,388,5,0,132,525,7,532
"خراسان_رضوی","بینالود","شاندیز",16,1190,19,3,472,1684,16,1700
"خراسان_رضوی","بینالود","شاندیز",17,733,15,4,355,1107,4,1111
"خراسان_رضوی","بینالود","شاندیز",18,1167,17,6,403,1593,18,1611
"خراسان_رضوی","بینالود","شاندیز",19,416,7,0,163,586,9,595
"خراسان_رضوی","تایباد","مرکزی",1,298,6,12,1047,1363,8,1371
"خراسان_رضوی","تایباد","مرکزی",2,489,3,3,439,934,3,937
"خراسان_رضوی","تایباد","مرکزی",3,218,3,4,624,849,12,861
"خراسان_رضوی","تایباد","مرکزی",4,311,12,5,679,1007,2,1009
"خراسان_رضوی","تایباد","مرکزی",5,372,5,7,539,923,1,924
"خراسان_رضوی","تایباد","مرکزی",6,1148,8,7,784,1947,0,1947
"خراسان_رضوی","تایباد","مرکزی",7,722,6,5,867,1600,3,1603
"خراسان_رضوی","تایباد","مرکزی",8,343,7,7,887,1244,12,1256
"خراسان_رضوی","تایباد","مرکزی",9,177,3,1,426,607,5,612
"خراسان_رضوی","تایباد","مرکزی",10,283,3,2,494,782,0,782
"خراسان_رضوی","تایباد","مرکزی",11,369,7,5,753,1134,4,1138
"خراسان_رضوی","تایباد","مرکزی",12,245,1,8,529,783,8,791
"خراسان_رضوی","تایباد","مرکزی",13,486,4,6,776,1272,7,1279
"خراسان_رضوی","تایباد","مرکزی",14,314,4,3,388,709,8,717
"خراسان_رضوی","تایباد","مرکزی",15,205,5,7,522,739,3,742
"خراسان_رضوی","تایباد","مرکزی",16,381,9,9,628,1027,7,1034
"خراسان_رضوی","تایباد","مرکزی",17,560,2,6,217,785,1,786
"خراسان_رضوی","تایباد","مرکزی",18,403,3,2,638,1046,8,1054
"خراسان_رضوی","تایباد","مرکزی",19,605,9,0,129,743,1,744
"خراسان_رضوی","تایباد","مرکزی",20,206,5,7,350,568,3,571
"خراسان_رضوی","تایباد","مرکزی",21,191,9,3,389,592,1,593
"خراسان_رضوی","تایباد","مرکزی",22,531,9,3,257,800,4,804
"خراسان_رضوی","تایباد","مرکزی",23,378,10,10,690,1088,6,1094
"خراسان_رضوی","تایباد","مرکزی",24,456,5,1,146,608,35,643
"خراسان_رضوی","تایباد","مرکزی",25,204,9,1,303,517,0,517
"خراسان_رضوی","تایباد","مرکزی",26,335,5,0,537,877,12,889
"خراسان_رضوی","تایباد","مرکزی",27,1055,6,1,24,1086,0,1086
"خراسان_رضوی","تایباد","مرکزی",28,262,2,2,578,844,7,851
"خراسان_رضوی","تایباد","مرکزی",29,373,4,0,17,394,1,395
"خراسان_رضوی","تایباد","مرکزی",30,356,2,3,346,707,8,715
"خراسان_رضوی","تایباد","مرکزی",31,1402,1,0,3,1406,0,1406
"خراسان_رضوی","تایباد","مرکزی",32,243,4,4,410,661,5,666
"خراسان_رضوی","تایباد","مرکزی",33,396,2,24,546,968,4,972
"خراسان_رضوی","تایباد","مرکزی",34,389,1,2,246,638,0,638
"خراسان_رضوی","تایباد","مرکزی",35,211,3,7,342,563,8,571
"خراسان_رضوی","تایباد","مرکزی",36,100,2,0,213,315,0,315
"خراسان_رضوی","تایباد","مرکزی",37,398,6,5,572,981,0,981
"خراسان_رضوی","تایباد","مرکزی",38,808,12,4,808,1632,3,1635
"خراسان_رضوی","تایباد","مرکزی",39,277,1,2,381,661,1,662
"خراسان_رضوی","تایباد","مرکزی",40,612,7,3,209,831,5,836
"خراسان_رضوی","تایباد","مرکزی",41,238,5,1,227,471,0,471
"خراسان_رضوی","تایباد","باخرز",1,200,1,4,452,657,12,669
"خراسان_رضوی","تایباد","باخرز",2,289,2,11,898,1200,6,1206
"خراسان_رضوی","تایباد","باخرز",3,51,2,5,753,811,7,818
"خراسان_رضوی","تایباد","باخرز",4,119,0,6,1043,1168,17,1185
"خراسان_رضوی","تایباد","باخرز",5,981,2,1,11,995,7,1002
"خراسان_رضوی","تایباد","باخرز",6,727,5,1,376,1109,1,1110
"خراسان_رضوی","تایباد","باخرز",7,206,6,6,987,1205,13,1218
"خراسان_رضوی","تایباد","باخرز",8,151,3,0,707,861,5,866
"خراسان_رضوی","تایباد","باخرز",9,974,0,0,48,1022,14,1036
"خراسان_رضوی","تایباد","باخرز",10,684,2,1,251,938,5,943
"خراسان_رضوی","تایباد","باخرز",11,261,3,4,727,995,3,998
"خراسان_رضوی","تایباد","باخرز",12,453,1,11,409,874,2,876
"خراسان_رضوی","تایباد","باخرز",13,272,0,0,400,672,5,677
"خراسان_رضوی","تایباد","باخرز",14,287,0,5,252,544,13,557
"خراسان_رضوی","تایباد","باخرز",1,1036,5,0,149,1190,0,1190
"خراسان_رضوی","تایباد","باخرز",2,582,2,5,260,849,1,850
"خراسان_رضوی","تایباد","باخرز",3,465,2,2,146,615,2,617
"خراسان_رضوی","تایباد","باخرز",4,158,3,0,563,724,3,727
"خراسان_رضوی","تایباد","باخرز",5,177,3,1,712,893,11,904
"خراسان_رضوی","تایباد","باخرز",6,623,3,1,173,800,0,800
"خراسان_رضوی","تایباد","باخرز",7,652,4,0,72,728,3,731
"خراسان_رضوی","تایباد","باخرز",8,1584,4,0,12,1600,0,1600
"خراسان_رضوی","تایباد","باخرز",9,643,1,1,336,981,0,981
"خراسان_رضوی","تایباد","باخرز",10,298,4,0,128,430,8,438
"خراسان_رضوی","تایباد","باخرز",11,1030,0,2,10,1042,0,1042
"خراسان_رضوی","تایباد","باخرز",12,859,4,2,86,951,5,956
"خراسان_رضوی","تایباد","باخرز",13,699,3,0,46,748,1,749
"خراسان_رضوی","تایباد","باخرز",14,968,1,0,64,1033,4,1037
"خراسان_رضوی","تایباد","باخرز",15,1414,2,1,41,1458,1,1459
"خراسان_رضوی","تایباد","باخرز",16,1011,4,1,33,1049,1,1050
"خراسان_رضوی","تایباد","باخرز",17,1243,5,0,50,1298,2,1300
"خراسان_رضوی","تایباد","باخرز",18,433,3,0,178,614,3,617
"خراسان_رضوی","تایباد","باخرز",19,277,2,0,33,312,1,313
"خراسان_رضوی","تایباد","باخرز",20,781,1,1,40,823,3,826
"خراسان_رضوی","تایباد","باخرز",21,1034,4,3,54,1095,5,1100
"خراسان_رضوی","تایباد","باخرز",22,822,2,0,71,895,5,900
"خراسان_رضوی","تایباد","باخرز",23,744,1,1,138,884,6,890
"خراسان_رضوی","تایباد","باخرز",24,810,4,1,35,850,0,850
"خراسان_رضوی","تایباد","باخرز",25,781,4,0,178,963,4,967
"خراسان_رضوی","تایباد","باخرز",26,301,0,2,194,497,3,500
"خراسان_رضوی","تایباد","باخرز",27,342,1,3,190,536,1,537
"خراسان_رضوی","تایباد","باخرز",28,269,1,2,163,435,3,438
"خراسان_رضوی","تایباد","باخرز",29,802,2,0,97,901,0,901
"خراسان_رضوی","تایباد","باخرز",30,617,3,1,188,809,0,809
"خراسان_رضوی","تخت_جلگه","مرکزی",1,796,9,10,240,1055,7,1062
"خراسان_رضوی","تخت_جلگه","مرکزی",2,475,4,1,111,591,7,598
"خراسان_رضوی","تخت_جلگه","مرکزی",3,349,3,1,105,458,6,464
"خراسان_رضوی","تخت_جلگه","مرکزی",4,908,9,10,206,1133,4,1137
"خراسان_رضوی","تخت_جلگه","مرکزی",5,692,9,3,52,756,2,758
"خراسان_رضوی","تخت_جلگه","مرکزی",6,341,4,1,35,381,0,381
"خراسان_رضوی","تخت_جلگه","مرکزی",7,653,4,1,59,717,5,722
"خراسان_رضوی","تخت_جلگه","مرکزی",8,458,7,5,73,543,3,546
"خراسان_رضوی","تخت_جلگه","مرکزی",9,861,6,2,139,1008,8,1016
"خراسان_رضوی","تخت_جلگه","مرکزی",10,801,2,1,29,833,0,833
"خراسان_رضوی","تخت_جلگه","مرکزی",11,699,2,10,76,787,3,790
"خراسان_رضوی","تخت_جلگه","مرکزی",12,576,6,0,113,695,6,701
"خراسان_رضوی","تخت_جلگه","مرکزی",13,720,8,2,100,830,3,833
"خراسان_رضوی","تخت_جلگه","مرکزی",14,440,0,8,55,503,3,506
"خراسان_رضوی","تخت_جلگه","مرکزی",15,873,2,17,106,998,1,999
"خراسان_رضوی","تخت_جلگه","مرکزی",16,484,2,1,56,543,7,550
"خراسان_رضوی","تخت_جلگه","مرکزی",17,291,1,0,14,306,1,307
"خراسان_رضوی","تخت_جلگه","مرکزی",18,701,1,0,62,764,2,766
"خراسان_رضوی","تخت_جلگه","طاغنکوه",1,655,1,1,38,695,2,697
"خراسان_رضوی","تخت_جلگه","طاغنکوه",2,437,5,4,102,548,0,548
"خراسان_رضوی","تخت_جلگه","طاغنکوه",3,358,2,1,58,419,0,419
"خراسان_رضوی","تخت_جلگه","طاغنکوه",4,834,6,5,156,1001,3,1004
"خراسان_رضوی","تخت_جلگه","طاغنکوه",5,861,16,9,270,1156,4,1160
"خراسان_رضوی","تخت_جلگه","طاغنکوه",6,261,0,0,13,274,2,276
"خراسان_رضوی","تخت_جلگه","طاغنکوه",7,848,10,0,96,954,3,957
"خراسان_رضوی","تخت_جلگه","طاغنکوه",8,211,2,8,26,247,0,247
"خراسان_رضوی","تخت_جلگه","طاغنکوه",9,570,0,0,15,585,1,586
"خراسان_رضوی","تخت_جلگه","طاغنکوه",10,763,4,1,31,799,1,800
"خراسان_رضوی","تخت_جلگه","طاغنکوه",11,621,5,1,98,725,3,728
"خراسان_رضوی","تخت_جلگه","طاغنکوه",12,403,0,1,30,434,3,437
"خراسان_رضوی","تخت_جلگه","طاغنکوه",13,466,2,0,30,498,1,499
"خراسان_رضوی","تخت_جلگه","طاغنکوه",14,385,2,1,46,434,3,437
"خراسان_رضوی","تخت_جلگه","طاغنکوه",15,237,2,0,54,293,0,293
"خراسان_رضوی","تخت_جلگه","طاغنکوه",16,618,3,0,108,729,8,737
"خراسان_رضوی","تخت_جلگه","طاغنکوه",17,532,1,1,57,591,6,597
"خراسان_رضوی","تخت_جلگه","طاغنکوه",18,547,4,2,26,579,1,580
"خراسان_رضوی","تخت_جلگه","طاغنکوه",19,298,0,3,19,320,0,320
"خراسان_رضوی","تخت_جلگه","طاغنکوه",20,479,0,0,42,521,0,521
"خراسان_رضوی","تخت_جلگه","طاغنکوه",21,121,0,0,12,133,1,134
"خراسان_رضوی","تخت_جلگه","طاغنکوه",22,696,4,0,31,731,1,732
"خراسان_رضوی","تخت_جلگه","طاغنکوه",23,537,3,0,81,621,6,627
"خراسان_رضوی","تربت_جام","مرکزی",1,675,18,8,654,1355,3,1358
"خراسان_رضوی","تربت_جام","مرکزی",2,546,8,6,597,1157,8,1165
"خراسان_رضوی","تربت_جام","مرکزی",3,490,6,9,481,986,9,995
"خراسان_رضوی","تربت_جام","مرکزی",4,279,3,3,711,996,5,1001
"خراسان_رضوی","تربت_جام","مرکزی",5,480,8,3,603,1094,5,1099
"خراسان_رضوی","تربت_جام","مرکزی",6,598,4,11,789,1402,5,1407
"خراسان_رضوی","تربت_جام","مرکزی",7,313,4,1,857,1175,10,1185
"خراسان_رضوی","تربت_جام","مرکزی",8,243,3,4,348,598,1,599
"خراسان_رضوی","تربت_جام","مرکزی",9,716,12,1,535,1264,8,1272
"خراسان_رضوی","تربت_جام","مرکزی",10,499,8,8,845,1360,10,1370
"خراسان_رضوی","تربت_جام","مرکزی",11,222,6,5,538,771,5,776
"خراسان_رضوی","تربت_جام","مرکزی",12,425,6,9,1021,1461,10,1471
"خراسان_رضوی","تربت_جام","مرکزی",13,279,1,7,650,937,13,950
"خراسان_رضوی","تربت_جام","مرکزی",14,850,13,3,592,1458,2,1460
"خراسان_رضوی","تربت_جام","مرکزی",15,644,13,1,402,1060,7,1067
"خراسان_رضوی","تربت_جام","مرکزی",16,561,9,6,691,1267,7,1274
"خراسان_رضوی","تربت_جام","مرکزی",17,450,7,3,364,824,4,828
"خراسان_رضوی","تربت_جام","مرکزی",18,426,8,4,702,1140,6,1146
"خراسان_رضوی","تربت_جام","مرکزی",19,602,17,6,732,1357,10,1367
"خراسان_رضوی","تربت_جام","مرکزی",20,625,22,4,424,1075,5,1080
"خراسان_رضوی","تربت_جام","مرکزی",21,375,9,4,406,794,4,798
"خراسان_رضوی","تربت_جام","مرکزی",22,517,7,13,680,1217,7,1224
"خراسان_رضوی","تربت_جام","مرکزی",23,563,12,5,737,1317,6,1323
"خراسان_رضوی","تربت_جام","مرکزی",24,274,2,10,716,1002,5,1007
"خراسان_رضوی","تربت_جام","مرکزی",25,505,12,1,183,701,6,707
"خراسان_رضوی","تربت_جام","مرکزی",26,386,9,1,347,743,5,748
"خراسان_رضوی","تربت_جام","مرکزی",27,260,7,1,202,470,5,475
"خراسان_رضوی","تربت_جام","مرکزی",28,375,6,3,956,1340,5,1345
"خراسان_رضوی","تربت_جام","مرکزی",29,426,9,8,792,1235,8,1243
"خراسان_رضوی","تربت_جام","مرکزی",30,330,5,8,630,973,4,977
"خراسان_رضوی","تربت_جام","مرکزی",31,390,3,2,483,878,3,881
"خراسان_رضوی","تربت_جام","مرکزی",32,365,5,7,717,1094,3,1097
"خراسان_رضوی","تربت_جام","مرکزی",33,255,16,4,739,1014,5,1019
"خراسان_رضوی","تربت_جام","مرکزی",34,439,7,2,658,1106,6,1112
"خراسان_رضوی","تربت_جام","مرکزی",35,316,6,11,677,1010,5,1015
"خراسان_رضوی","تربت_جام","مرکزی",36,358,4,6,522,890,7,897
"خراسان_رضوی","تربت_جام","مرکزی",37,311,3,3,595,912,11,923
"خراسان_رضوی","تربت_جام","مرکزی",38,246,1,1,593,841,4,845
"خراسان_رضوی","تربت_جام","مرکزی",39,358,6,5,303,672,4,676
"خراسان_رضوی","تربت_جام","مرکزی",40,144,2,3,310,459,1,460
"خراسان_رضوی","تربت_جام","مرکزی",41,450,4,3,275,732,3,735
"خراسان_رضوی","تربت_جام","مرکزی",42,255,6,6,579,846,7,853
"خراسان_رضوی","تربت_جام","مرکزی",43,851,7,8,449,1315,28,1343
"خراسان_رضوی","تربت_جام","مرکزی",44,198,7,1,192,398,2,400
"خراسان_رضوی","تربت_جام","مرکزی",45,719,3,2,447,1171,4,1175
"خراسان_رضوی","تربت_جام","مرکزی",46,223,1,1,356,581,0,581
"خراسان_رضوی","تربت_جام","مرکزی",47,1009,2,1,256,1268,3,1271
"خراسان_رضوی","تربت_جام","مرکزی",48,455,2,1,235,693,0,693
"خراسان_رضوی","تربت_جام","مرکزی",49,939,5,2,290,1236,4,1240
"خراسان_رضوی","تربت_جام","مرکزی",50,1169,4,0,29,1202,1,1203
"خراسان_رضوی","تربت_جام","مرکزی",51,647,3,0,199,849,3,852
"خراسان_رضوی","تربت_جام","مرکزی",52,183,2,0,236,421,1,422
"خراسان_رضوی","تربت_جام","مرکزی",53,321,2,1,178,502,3,505
"خراسان_رضوی","تربت_جام","مرکزی",54,177,7,2,391,577,4,581
"خراسان_رضوی","تربت_جام","مرکزی",55,401,2,0,591,994,1,995
"خراسان_رضوی","تربت_جام","مرکزی",56,668,5,3,300,976,0,976
"خراسان_رضوی","تربت_جام","مرکزی",57,785,8,0,41,834,0,834
"خراسان_رضوی","تربت_جام","مرکزی",58,932,2,0,55,989,3,992
"خراسان_رضوی","تربت_جام","مرکزی",59,202,3,3,330,538,1,539
"خراسان_رضوی","تربت_جام","مرکزی",60,203,4,0,359,566,2,568
"خراسان_رضوی","تربت_جام","مرکزی",61,294,2,0,423,719,13,732
"خراسان_رضوی","تربت_جام","مرکزی",62,253,1,1,386,641,2,643
"خراسان_رضوی","تربت_جام","مرکزی",63,256,7,4,300,567,6,573
"خراسان_رضوی","تربت_جام","مرکزی",64,285,1,0,265,551,1,552
"خراسان_رضوی","تربت_جام","مرکزی",65,547,2,5,443,997,1,998
"خراسان_رضوی","تربت_جام","مرکزی",66,118,0,0,10,128,2,130
"خراسان_رضوی","تربت_جام","مرکزی",67,170,2,0,92,264,1,265
"خراسان_رضوی","تربت_جام","مرکزی",68,522,1,5,339,867,14,881
"خراسان_رضوی","تربت_جام","مرکزی",69,214,2,0,351,567,1,568
"خراسان_رضوی","تربت_جام","مرکزی",70,259,0,6,115,380,0,380
"خراسان_رضوی","تربت_جام","نصرآباد",1,970,6,2,113,1091,0,1091
"خراسان_رضوی","تربت_جام","نصرآباد",2,849,13,0,201,1063,2,1065
"خراسان_رضوی","تربت_جام","نصرآباد",3,928,6,0,90,1024,2,1026
"خراسان_رضوی","تربت_جام","نصرآباد",4,649,7,0,48,704,1,705
"خراسان_رضوی","تربت_جام","نصرآباد",5,938,1,0,19,958,0,958
"خراسان_رضوی","تربت_جام","نصرآباد",6,1147,2,0,25,1174,3,1177
"خراسان_رضوی","تربت_جام","نصرآباد",7,858,1,0,67,926,2,928
"خراسان_رضوی","تربت_جام","نصرآباد",8,783,5,0,61,849,0,849
"خراسان_رضوی","تربت_جام","نصرآباد",9,813,2,1,49,865,0,865
"خراسان_رضوی","تربت_جام","نصرآباد",10,824,3,0,62,889,1,890
"خراسان_رضوی","تربت_جام","نصرآباد",11,1011,12,1,273,1297,0,1297
"خراسان_رضوی","تربت_جام","نصرآباد",12,1233,11,0,84,1328,3,1331
"خراسان_رضوی","تربت_جام","نصرآباد",13,923,3,0,13,939,4,943
"خراسان_رضوی","تربت_جام","نصرآباد",14,694,4,2,48,748,2,750
"خراسان_رضوی","تربت_جام","نصرآباد",15,820,5,0,31,856,1,857
"خراسان_رضوی","تربت_جام","نصرآباد",16,697,9,0,53,759,4,763
"خراسان_رضوی","تربت_جام","نصرآباد",17,592,1,0,15,608,5,613
"خراسان_رضوی","تربت_جام","نصرآباد",18,455,2,0,7,464,2,466
"خراسان_رضوی","تربت_جام","نصرآباد",19,550,0,0,83,633,3,636
"خراسان_رضوی","تربت_جام","نصرآباد",20,204,1,0,25,230,1,231
"خراسان_رضوی","تربت_جام","نصرآباد",21,587,4,0,38,629,0,629
"خراسان_رضوی","تربت_جام","نصرآباد",22,1375,1,0,18,1394,2,1396
"خراسان_رضوی","تربت_جام","نصرآباد",23,1048,0,3,50,1101,4,1105
"خراسان_رضوی","تربت_جام","نصرآباد",24,595,7,0,15,617,3,620
"خراسان_رضوی","تربت_جام","نصرآباد",25,416,2,0,12,430,1,431
"خراسان_رضوی","تربت_جام","نصرآباد",26,395,0,4,439,838,3,841
"خراسان_رضوی","تربت_جام","بوژگان",1,147,0,3,623,773,3,776
"خراسان_رضوی","تربت_جام","بوژگان",2,94,1,0,359,454,0,454
"خراسان_رضوی","تربت_جام","بوژگان",3,246,1,2,586,835,1,836
"خراسان_رضوی","تربت_جام","بوژگان",4,289,9,2,640,940,7,947
"خراسان_رضوی","تربت_جام","بوژگان",5,99,1,1,146,247,3,250
"خراسان_رضوی","تربت_جام","بوژگان",6,250,2,6,640,898,2,900
"خراسان_رضوی","تربت_جام","بوژگان",7,320,5,2,575,902,2,904
"خراسان_رضوی","تربت_جام","بوژگان",8,159,6,3,398,566,3,569
"خراسان_رضوی","تربت_جام","بوژگان",9,217,4,2,376,599,5,604
"خراسان_رضوی","تربت_جام","بوژگان",10,158,1,2,358,519,0,519
"خراسان_رضوی","تربت_جام","بوژگان",11,160,3,0,312,475,1,476
"خراسان_رضوی","تربت_جام","بوژگان",12,113,1,0,409,523,9,532
"خراسان_رضوی","تربت_جام","بوژگان",13,77,0,0,366,443,4,447
"خراسان_رضوی","تربت_جام","بوژگان",14,122,8,1,103,234,3,237
"خراسان_رضوی","تربت_جام","پایین_جام",1,648,2,0,302,952,1,953
"خراسان_رضوی","تربت_جام","پایین_جام",2,250,2,10,241,503,6,509
"خراسان_رضوی","تربت_جام","پایین_جام",3,458,1,1,354,814,2,816
"خراسان_رضوی","تربت_جام","پایین_جام",4,78,2,2,283,365,1,366
"خراسان_رضوی","تربت_جام","پایین_جام",5,112,1,0,330,443,0,443
"خراسان_رضوی","تربت_جام","پایین_جام",6,395,1,0,244,640,4,644
"خراسان_رضوی","تربت_جام","پایین_جام",7,97,1,1,339,438,2,440
"خراسان_رضوی","تربت_جام","پایین_جام",8,258,1,1,549,809,5,814
"خراسان_رضوی","تربت_جام","پایین_جام",9,206,1,1,217,425,5,430
"خراسان_رضوی","تربت_جام","پایین_جام",10,452,1,8,278,739,6,745
"خراسان_رضوی","تربت_جام","پایین_جام",11,345,3,4,412,764,8,772
"خراسان_رضوی","تربت_جام","پایین_جام",12,248,1,3,381,633,1,634
"خراسان_رضوی","تربت_جام","صالح_آباد",1,254,3,4,682,943,3,946
"خراسان_رضوی","تربت_جام","صالح_آباد",2,319,1,2,304,626,7,633
"خراسان_رضوی","تربت_جام","صالح_آباد",3,352,0,3,214,569,0,569
"خراسان_رضوی","تربت_جام","صالح_آباد",4,298,5,1,319,623,2,625
"خراسان_رضوی","تربت_جام","صالح_آباد",5,213,1,0,85,299,2,301
"خراسان_رضوی","تربت_جام","صالح_آباد",6,217,5,1,340,563,4,567
"خراسان_رضوی","تربت_جام","صالح_آباد",7,556,2,2,218,778,3,781
"خراسان_رضوی","تربت_جام","صالح_آباد",8,152,0,6,344,502,1,503
"خراسان_رضوی","تربت_جام","صالح_آباد",9,332,2,0,370,704,8,712
"خراسان_رضوی","تربت_جام","صالح_آباد",10,205,5,5,607,822,6,828
"خراسان_رضوی","تربت_جام","صالح_آباد",11,151,3,2,580,736,4,740
"خراسان_رضوی","تربت_جام","صالح_آباد",12,325,2,4,238,569,1,570
"خراسان_رضوی","تربت_جام","صالح_آباد",13,358,2,4,250,614,0,614
"خراسان_رضوی","تربت_جام","صالح_آباد",14,216,4,0,313,533,3,536
"خراسان_رضوی","تربت_جام","صالح_آباد",15,109,4,0,356,469,6,475
"خراسان_رضوی","تربت_جام","صالح_آباد",16,141,1,1,425,568,7,575
"خراسان_رضوی","تربت_جام","صالح_آباد",17,178,1,5,96,280,0,280
"خراسان_رضوی","تربت_جام","صالح_آباد",18,165,1,2,326,494,3,497
"خراسان_رضوی","تربت_جام","صالح_آباد",19,47,1,0,316,364,3,367
"خراسان_رضوی","تربت_جام","صالح_آباد",20,28,0,1,478,507,2,509
"خراسان_رضوی","تربت_جام","صالح_آباد",21,132,0,1,231,364,0,364
"خراسان_رضوی","تربت_جام","صالح_آباد",22,126,0,0,349,475,0,475
"خراسان_رضوی","تربت_جام","صالح_آباد",23,60,0,0,69,129,0,129
"خراسان_رضوی","تربت_جام","صالح_آباد",24,249,1,2,387,639,9,648
"خراسان_رضوی","تربت_جام","صالح_آباد",25,330,0,2,337,669,9,678
"خراسان_رضوی","تربت_جام","صالح_آباد",26,95,0,0,246,341,4,345
"خراسان_رضوی","تربت_جام","صالح_آباد",27,140,3,2,319,464,3,467
"خراسان_رضوی","تربت_جام","صالح_آباد",28,213,0,3,551,767,6,773
"خراسان_رضوی","تربت_جام","صالح_آباد",29,349,1,2,366,718,2,720
"خراسان_رضوی","تربت_جام","صالح_آباد",30,319,4,2,88,413,1,414
"خراسان_رضوی","تربت_جام","صالح_آباد",31,566,4,0,215,785,0,785
"خراسان_رضوی","تربت_جام","صالح_آباد",32,484,3,1,250,738,3,741
"خراسان_رضوی","تربت_حیدریه","مرکزی",1,1016,24,11,585,1636,14,1650
"خراسان_رضوی","تربت_حیدریه","مرکزی",2,770,12,4,413,1199,20,1219
"خراسان_رضوی","تربت_حیدریه","مرکزی",3,1083,25,0,670,1778,22,1800
"خراسان_رضوی","تربت_حیدریه","مرکزی",4,615,24,2,427,1068,12,1080
"خراسان_رضوی","تربت_حیدریه","مرکزی",5,465,9,2,348,824,6,830
"خراسان_رضوی","تربت_حیدریه","مرکزی",6,949,33,7,350,1339,11,1350
"خراسان_رضوی","تربت_حیدریه","مرکزی",7,913,14,9,217,1153,7,1160
"خراسان_رضوی","تربت_حیدریه","مرکزی",8,902,8,3,291,1204,7,1211
"خراسان_رضوی","تربت_حیدریه","مرکزی",9,1099,21,5,526,1651,12,1663
"خراسان_رضوی","تربت_حیدریه","مرکزی",10,260,17,3,269,549,12,561
"خراسان_رضوی","تربت_حیدریه","مرکزی",11,460,16,4,212,692,11,703
"خراسان_رضوی","تربت_حیدریه","مرکزی",12,816,13,6,306,1141,21,1162
"خراسان_رضوی","تربت_حیدریه","مرکزی",13,658,27,5,408,1098,15,1113
"خراسان_رضوی","تربت_حیدریه","مرکزی",14,522,10,10,384,926,9,935
"خراسان_رضوی","تربت_حیدریه","مرکزی",15,597,41,10,563,1211,36,1247
"خراسان_رضوی","تربت_حیدریه","مرکزی",16,1095,42,9,574,1720,22,1742
"خراسان_رضوی","تربت_حیدریه","مرکزی",17,771,44,9,577,1401,20,1421
"خراسان_رضوی","تربت_حیدریه","مرکزی",18,294,15,4,312,625,13,638
"خراسان_رضوی","تربت_حیدریه","مرکزی",19,504,12,2,429,947,19,966
"خراسان_رضوی","تربت_حیدریه","مرکزی",20,777,24,12,499,1312,10,1322
"خراسان_رضوی","تربت_حیدریه","مرکزی",21,828,20,4,317,1169,9,1178
"خراسان_رضوی","تربت_حیدریه","مرکزی",22,885,28,6,288,1207,7,1214
"خراسان_رضوی","تربت_حیدریه","مرکزی",23,296,10,2,92,400,3,403
"خراسان_رضوی","تربت_حیدریه","مرکزی",24,313,16,8,433,770,8,778
"خراسان_رضوی","تربت_حیدریه","مرکزی",25,540,28,15,825,1408,18,1426
"خراسان_رضوی","تربت_حیدریه","مرکزی",26,814,16,8,569,1407,15,1422
"خراسان_رضوی","تربت_حیدریه","مرکزی",27,1294,19,14,459,1786,0,1786
"خراسان_رضوی","تربت_حیدریه","مرکزی",28,949,20,6,418,1393,5,1398
"خراسان_رضوی","تربت_حیدریه","مرکزی",29,963,3,1,159,1126,10,1136
"خراسان_رضوی","تربت_حیدریه","مرکزی",30,1193,5,2,284,1484,11,1495
"خراسان_رضوی","تربت_حیدریه","مرکزی",31,410,7,4,269,690,10,700
"خراسان_رضوی","تربت_حیدریه","مرکزی",32,743,13,3,334,1093,7,1100
"خراسان_رضوی","تربت_حیدریه","مرکزی",33,150,8,8,85,251,5,256
"خراسان_رضوی","تربت_حیدریه","مرکزی",34,633,22,5,384,1044,15,1059
"خراسان_رضوی","تربت_حیدریه","مرکزی",35,368,7,0,182,557,8,565
"خراسان_رضوی","تربت_حیدریه","مرکزی",36,800,2,2,124,928,0,928
"خراسان_رضوی","تربت_حیدریه","مرکزی",37,646,31,6,504,1187,12,1199
"خراسان_رضوی","تربت_حیدریه","مرکزی",38,319,18,7,238,582,17,599
"خراسان_رضوی","تربت_حیدریه","مرکزی",39,1038,15,10,524,1587,11,1598
"خراسان_رضوی","تربت_حیدریه","مرکزی",40,413,16,7,325,761,8,769
"خراسان_رضوی","تربت_حیدریه","مرکزی",41,529,4,2,120,655,5,660
"خراسان_رضوی","تربت_حیدریه","مرکزی",42,469,7,0,144,620,3,623
"خراسان_رضوی","تربت_حیدریه","مرکزی",43,497,6,3,185,691,9,700
"خراسان_رضوی","تربت_حیدریه","مرکزی",44,785,18,6,271,1080,17,1097
"خراسان_رضوی","تربت_حیدریه","مرکزی",45,743,12,4,198,957,8,965
"خراسان_رضوی","تربت_حیدریه","مرکزی",46,527,12,2,293,834,3,837
"خراسان_رضوی","تربت_حیدریه","مرکزی",47,287,5,0,151,443,10,453
"خراسان_رضوی","تربت_حیدریه","مرکزی",48,797,38,9,536,1380,19,1399
"خراسان_رضوی","تربت_حیدریه","مرکزی",49,765,31,15,585,1396,12,1408
"خراسان_رضوی","تربت_حیدریه","مرکزی",50,853,24,7,397,1281,15,1296
"خراسان_رضوی","تربت_حیدریه","مرکزی",51,560,6,2,196,764,9,773
"خراسان_رضوی","تربت_حیدریه","مرکزی",52,464,32,8,530,1034,20,1054
"خراسان_رضوی","تربت_حیدریه","مرکزی",53,267,9,1,261,538,13,551
"خراسان_رضوی","تربت_حیدریه","مرکزی",54,1137,37,7,693,1874,26,1900
"خراسان_رضوی","تربت_حیدریه","مرکزی",55,733,31,15,782,1561,25,1586
"خراسان_رضوی","تربت_حیدریه","مرکزی",56,250,16,1,443,710,10,720
"خراسان_رضوی","تربت_حیدریه","مرکزی",57,290,18,4,450,762,6,768
"خراسان_رضوی","تربت_حیدریه","مرکزی",58,869,37,18,852,1776,16,1792
"خراسان_رضوی","تربت_حیدریه","مرکزی",59,568,30,4,619,1221,20,1241
"خراسان_رضوی","تربت_حیدریه","مرکزی",60,1052,7,3,349,1411,12,1423
"خراسان_رضوی","تربت_حیدریه","مرکزی",61,559,3,1,167,730,5,735
"خراسان_رضوی","تربت_حیدریه","مرکزی",62,876,11,2,218,1107,8,1115
"خراسان_رضوی","تربت_حیدریه","مرکزی",63,719,2,2,114,837,7,844
"خراسان_رضوی","تربت_حیدریه","مرکزی",64,385,10,0,123,518,4,522
"خراسان_رضوی","تربت_حیدریه","مرکزی",65,250,4,1,104,359,4,363
"خراسان_رضوی","تربت_حیدریه","مرکزی",66,545,0,1,52,598,2,600
"خراسان_رضوی","تربت_حیدریه","مرکزی",67,627,2,2,53,684,0,684
"خراسان_رضوی","تربت_حیدریه","مرکزی",68,654,2,1,72,729,2,731
"خراسان_رضوی","تربت_حیدریه","مرکزی",69,971,7,1,112,1091,5,1096
"خراسان_رضوی","تربت_حیدریه","مرکزی",70,1051,6,0,109,1166,5,1171
"خراسان_رضوی","تربت_حیدریه","مرکزی",71,889,1,1,97,988,12,1000
"خراسان_رضوی","تربت_حیدریه","مرکزی",72,835,9,3,98,945,4,949
"خراسان_رضوی","تربت_حیدریه","مرکزی",73,499,1,0,36,536,5,541
"خراسان_رضوی","تربت_حیدریه","مرکزی",74,547,2,2,81,632,3,635
"خراسان_رضوی","تربت_حیدریه","مرکزی",75,971,8,3,113,1095,3,1098
"خراسان_رضوی","تربت_حیدریه","مرکزی",76,745,5,0,46,796,2,798
"خراسان_رضوی","تربت_حیدریه","مرکزی",77,601,2,5,59,667,5,672
"خراسان_رضوی","تربت_حیدریه","مرکزی",78,330,4,0,42,376,0,376
"خراسان_رضوی","تربت_حیدریه","مرکزی",79,437,1,0,87,525,1,526
"خراسان_رضوی","تربت_حیدریه","مرکزی",80,524,0,3,79,606,1,607
"خراسان_رضوی","تربت_حیدریه","مرکزی",81,750,1,3,124,878,0,878
"خراسان_رضوی","تربت_حیدریه","مرکزی",82,716,2,0,82,800,0,800
"خراسان_رضوی","تربت_حیدریه","مرکزی",83,651,3,2,126,782,4,786
"خراسان_رضوی","تربت_حیدریه","مرکزی",84,590,7,1,154,752,6,758
"خراسان_رضوی","تربت_حیدریه","مرکزی",85,1146,13,3,115,1277,5,1282
"خراسان_رضوی","تربت_حیدریه","مرکزی",86,408,3,1,48,460,5,465
"خراسان_رضوی","تربت_حیدریه","مرکزی",87,452,2,0,41,495,0,495
"خراسان_رضوی","تربت_حیدریه","مرکزی",88,933,13,1,186,1133,13,1146
"خراسان_رضوی","تربت_حیدریه","مرکزی",89,1046,24,4,214,1288,11,1299
"خراسان_رضوی","تربت_حیدریه","مرکزی",90,700,7,9,70,786,2,788
"خراسان_رضوی","تربت_حیدریه","بایگ",1,485,6,2,266,759,6,765
"خراسان_رضوی","تربت_حیدریه","بایگ",2,424,6,2,130,562,4,566
"خراسان_رضوی","تربت_حیدریه","بایگ",3,256,3,3,99,361,5,366
"خراسان_رضوی","تربت_حیدریه","بایگ",4,383,4,2,233,622,4,626
"خراسان_رضوی","تربت_حیدریه","بایگ",5,258,8,4,96,366,0,366
"خراسان_رضوی","تربت_حیدریه","بایگ",6,545,0,0,110,655,3,658
"خراسان_رضوی","تربت_حیدریه","بایگ",7,268,2,1,34,305,0,305
"خراسان_رضوی","تربت_حیدریه","بایگ",8,654,5,2,92,753,3,756
"خراسان_رضوی","تربت_حیدریه","بایگ",9,499,0,0,76,575,2,577
"خراسان_رضوی","تربت_حیدریه","بایگ",10,329,0,0,21,350,0,350
"خراسان_رضوی","تربت_حیدریه","بایگ",11,302,0,1,37,340,0,340
"خراسان_رضوی","تربت_حیدریه","جلگه_رخ",1,371,2,0,142,515,4,519
"خراسان_رضوی","تربت_حیدریه","جلگه_رخ",2,398,5,0,76,479,6,485
"خراسان_رضوی","تربت_حیدریه","جلگه_رخ",3,213,2,0,16,231,1,232
"خراسان_رضوی","تربت_حیدریه","جلگه_رخ",4,595,1,1,35,632,1,633
"خراسان_رضوی","تربت_حیدریه","جلگه_رخ",5,488,3,1,15,507,3,510
"خراسان_رضوی","تربت_حیدریه","جلگه_رخ",6,449,4,0,15,468,3,471
"خراسان_رضوی","تربت_حیدریه","جلگه_رخ",7,338,0,0,13,351,0,351
"خراسان_رضوی","تربت_حیدریه","جلگه_رخ",8,676,7,0,39,722,0,722
"خراسان_رضوی","تربت_حیدریه","جلگه_رخ",9,438,0,0,34,472,0,472
"خراسان_رضوی","تربت_حیدریه","جلگه_رخ",10,370,0,1,15,386,1,387
"خراسان_رضوی","تربت_حیدریه","جلگه_رخ",11,375,3,1,32,411,5,416
"خراسان_رضوی","تربت_حیدریه","جلگه_رخ",12,464,5,0,29,498,1,499
"خراسان_رضوی","تربت_حیدریه","جلگه_رخ",13,459,0,1,20,480,1,481
"خراسان_رضوی","تربت_حیدریه","جلگه_رخ",14,643,10,1,30,684,9,693
"خراسان_رضوی","تربت_حیدریه","جلگه_رخ",15,657,1,0,23,681,2,683
"خراسان_رضوی","تربت_حیدریه","جلگه_رخ",16,557,4,6,37,604,1,605
"خراسان_رضوی","تربت_حیدریه","جلگه_رخ",17,414,2,1,32,449,5,454
"خراسان_رضوی","تربت_حیدریه","جلگه_رخ",18,238,4,0,22,264,2,266
"خراسان_رضوی","تربت_حیدریه","جلگه_رخ",19,467,8,0,40,515,1,516
"خراسان_رضوی","تربت_حیدریه","جلگه_رخ",20,636,0,0,28,664,2,666
"خراسان_رضوی","تربت_حیدریه","جلگه_رخ",21,433,0,0,67,500,1,501
"خراسان_رضوی","تربت_حیدریه","جلگه_رخ",22,553,1,0,54,608,0,608
"خراسان_رضوی","تربت_حیدریه","جلگه_رخ",23,727,6,0,61,794,1,795
"خراسان_رضوی","تربت_حیدریه","جلگه_رخ",24,840,4,0,24,868,3,871
"خراسان_رضوی","تربت_حیدریه","جلگه_رخ",25,422,0,0,50,472,0,472
"خراسان_رضوی","تربت_حیدریه","جلگه_رخ",26,181,1,0,14,196,0,196
"خراسان_رضوی","تربت_حیدریه","جلگه_رخ",27,405,2,0,20,427,0,427
"خراسان_رضوی","تربت_حیدریه","جلگه_رخ",28,227,0,1,55,283,2,285
"خراسان_رضوی","تربت_حیدریه","جلگه_رخ",29,439,0,0,17,456,0,456
"خراسان_رضوی","تربت_حیدریه","جلگه_رخ",30,453,3,0,70,526,0,526
"خراسان_رضوی","تربت_حیدریه","جلگه_رخ",31,504,0,0,21,525,0,525
"خراسان_رضوی","تربت_حیدریه","کدکن",32,405,3,0,27,435,1,436
"خراسان_رضوی","تربت_حیدریه","کدکن",1,706,4,1,158,869,6,875
"خراسان_رضوی","تربت_حیدریه","کدکن",2,832,5,1,120,958,1,959
"خراسان_رضوی","تربت_حیدریه","کدکن",3,267,1,1,38,307,2,309
"خراسان_رضوی","تربت_حیدریه","کدکن",4,422,1,0,35,458,0,458
"خراسان_رضوی","تربت_حیدریه","کدکن",5,541,0,0,24,565,1,566
"خراسان_رضوی","تربت_حیدریه","کدکن",6,454,1,0,21,476,2,478
"خراسان_رضوی","تربت_حیدریه","کدکن",7,668,4,0,42,714,0,714
"خراسان_رضوی","تربت_حیدریه","کدکن",8,348,1,0,33,382,2,384
"خراسان_رضوی","تربت_حیدریه","کدکن",9,437,3,0,24,464,2,466
"خراسان_رضوی","تربت_حیدریه","کدکن",10,255,1,0,15,271,1,272
"خراسان_رضوی","تربت_حیدریه","کدکن",11,301,0,0,11,312,1,313
"خراسان_رضوی","تربت_حیدریه","کدکن",12,289,1,0,10,300,1,301
"خراسان_رضوی","تربت_حیدریه","کدکن",13,328,1,0,8,337,2,339
"خراسان_رضوی","تربت_حیدریه","کدکن",14,402,0,1,28,431,0,431
"خراسان_رضوی","تربت_حیدریه","کدکن",15,297,3,1,31,332,1,333
"خراسان_رضوی","تربت_حیدریه","کدکن",16,225,0,0,4,229,1,230
"خراسان_رضوی","تربت_حیدریه","کدکن",17,282,0,0,5,287,1,288
"خراسان_رضوی","جغتای","مرکزی",1,633,7,10,189,839,2,841
"خراسان_رضوی","جغتای","مرکزی",2,723,10,6,170,909,2,911
"خراسان_رضوی","جغتای","مرکزی",3,669,12,17,279,977,2,979
"خراسان_رضوی","جغتای","مرکزی",4,537,16,7,164,724,3,727
"خراسان_رضوی","جغتای","مرکزی",5,367,13,4,115,499,6,505
"خراسان_رضوی","جغتای","مرکزی",6,321,4,0,27,352,4,356
"خراسان_رضوی","جغتای","مرکزی",7,697,2,0,19,718,0,718
"خراسان_رضوی","جغتای","مرکزی",8,350,8,2,46,406,1,407
"خراسان_رضوی","جغتای","مرکزی",9,434,5,0,44,483,0,483
"خراسان_رضوی","جغتای","مرکزی",10,474,15,3,73,565,5,570
"خراسان_رضوی","جغتای","مرکزی",11,640,2,1,90,733,0,733
"خراسان_رضوی","جغتای","مرکزی",12,302,2,0,53,357,0,357
"خراسان_رضوی","جغتای","مرکزی",13,366,0,0,11,377,0,377
"خراسان_رضوی","جغتای","مرکزی",14,552,6,0,21,579,0,579
"خراسان_رضوی","جغتای","مرکزی",15,450,3,0,22,475,0,475
"خراسان_رضوی","جغتای","مرکزی",16,719,3,0,79,801,0,801
"خراسان_رضوی","جغتای","مرکزی",17,208,1,0,35,244,0,244
"خراسان_رضوی","جغتای","مرکزی",18,789,5,0,65,859,0,859
"خراسان_رضوی","جغتای","مرکزی",19,341,4,0,68,413,2,415
"خراسان_رضوی","جغتای","مرکزی",20,777,13,1,83,874,5,879
"خراسان_رضوی","جغتای","مرکزی",21,557,6,3,259,825,5,830
"خراسان_رضوی","جغتای","مرکزی",22,399,2,2,155,558,2,560
"خراسان_رضوی","جغتای","هلالی",1,450,0,0,35,485,0,485
"خراسان_رضوی","جغتای","هلالی",2,364,6,3,26,399,3,402
"خراسان_رضوی","جغتای","هلالی",3,568,9,0,85,662,1,663
"خراسان_رضوی","جغتای","هلالی",4,410,2,0,89,501,2,503
"خراسان_رضوی","جغتای","هلالی",5,692,5,0,74,771,4,775
"خراسان_رضوی","جغتای","هلالی",6,567,11,1,38,617,1,618
"خراسان_رضوی","جغتای","هلالی",7,329,7,0,19,355,4,359
"خراسان_رضوی","جغتای","هلالی",8,431,0,0,60,491,1,492
"خراسان_رضوی","جغتای","هلالی",9,556,11,3,196,766,4,770
"خراسان_رضوی","جغتای","هلالی",10,272,2,0,16,290,0,290
"خراسان_رضوی","جغتای","هلالی",11,667,4,1,60,732,5,737
"خراسان_رضوی","جغتای","هلالی",12,360,3,0,36,399,1,400
"خراسان_رضوی","جغتای","هلالی",13,681,1,0,57,739,3,742
"خراسان_رضوی","جغتای","هلالی",14,634,5,0,108,747,8,755
"خراسان_رضوی","جغتای","هلالی",15,296,5,0,92,393,2,395
"خراسان_رضوی","جغتای","هلالی",16,829,7,2,191,1029,6,1035
"خراسان_رضوی","جغتای","هلالی",17,408,3,0,110,521,1,522
"خراسان_رضوی","جغتای","هلالی",18,521,14,0,136,671,2,673
"خراسان_رضوی","جغتای","هلالی",19,491,4,2,89,586,3,589
"خراسان_رضوی","جغتای","هلالی",20,276,3,1,161,441,2,443
"خراسان_رضوی","جغتای","هلالی",21,389,2,0,68,459,1,460
"خراسان_رضوی","جغتای","هلالی",22,293,0,0,16,309,4,313
"خراسان_رضوی","جغتای","هلالی",23,197,1,0,18,216,1,217
"خراسان_رضوی","جغتای","هلالی",24,361,4,0,25,390,0,390
"خراسان_رضوی","جغتای","هلالی",25,239,2,2,52,295,1,296
"خراسان_رضوی","جغتای","هلالی",26,178,0,0,29,207,1,208
"خراسان_رضوی","جغتای","هلالی",27,421,2,0,17,440,1,441
"خراسان_رضوی","جغتای","هلالی",28,191,1,0,53,245,2,247
"خراسان_رضوی","جوین","مرکزی",1,1071,18,6,502,1597,4,1601
"خراسان_رضوی","جوین","مرکزی",2,358,12,2,201,573,0,573
"خراسان_رضوی","جوین","مرکزی",3,920,18,0,249,1187,2,1189
"خراسان_رضوی","جوین","مرکزی",4,432,8,0,109,549,0,549
"خراسان_رضوی","جوین","مرکزی",5,901,7,1,114,1023,3,1026
"خراسان_رضوی","جوین","مرکزی",6,502,12,3,60,577,0,577
"خراسان_رضوی","جوین","مرکزی",7,434,3,2,60,499,0,499
"خراسان_رضوی","جوین","مرکزی",8,766,5,0,137,908,3,911
"خراسان_رضوی","جوین","مرکزی",9,200,4,1,83,288,3,291
"خراسان_رضوی","جوین","مرکزی",10,968,5,2,125,1100,2,1102
"خراسان_رضوی","جوین","مرکزی",11,589,12,5,129,735,3,738
"خراسان_رضوی","جوین","مرکزی",12,590,2,0,216,808,2,810
"خراسان_رضوی","جوین","مرکزی",13,1024,7,3,156,1190,14,1204
"خراسان_رضوی","جوین","مرکزی",14,453,2,0,43,498,2,500
"خراسان_رضوی","جوین","مرکزی",15,941,12,2,201,1156,8,1164
"خراسان_رضوی","جوین","مرکزی",16,898,3,1,130,1032,0,1032
"خراسان_رضوی","جوین","مرکزی",17,608,4,1,98,711,1,712
"خراسان_رضوی","جوین","مرکزی",18,537,7,2,265,811,2,813
"خراسان_رضوی","جوین","مرکزی",19,306,5,0,108,419,1,420
"خراسان_رضوی","جوین","مرکزی",20,463,4,1,90,558,1,559
"خراسان_رضوی","جوین","مرکزی",21,744,3,2,125,874,1,875
"خراسان_رضوی","جوین","مرکزی",22,554,6,0,43,603,0,603
"خراسان_رضوی","جوین","مرکزی",23,339,5,2,48,394,1,395
"خراسان_رضوی","جوین","مرکزی",24,543,1,2,102,648,0,648
"خراسان_رضوی","جوین","مرکزی",25,509,8,0,62,579,1,580
"خراسان_رضوی","جوین","مرکزی",26,409,8,0,70,487,0,487
"خراسان_رضوی","جوین","مرکزی",27,1047,14,30,119,1210,10,1220
"خراسان_رضوی","جوین","مرکزی",28,227,6,0,37,270,4,274
"خراسان_رضوی","جوین","عطاملک",1,750,15,2,270,1037,7,1044
"خراسان_رضوی","جوین","عطاملک",2,761,11,0,225,997,1,998
"خراسان_رضوی","جوین","عطاملک",3,642,6,0,90,738,4,742
"خراسان_رضوی","جوین","عطاملک",4,494,1,0,36,531,1,532
"خراسان_رضوی","جوین","عطاملک",5,598,1,0,85,684,6,690
"خراسان_رضوی","جوین","عطاملک",6,613,2,0,89,704,0,704
"خراسان_رضوی","جوین","عطاملک",7,706,10,0,136,852,3,855
"خراسان_رضوی","جوین","عطاملک",8,429,4,0,69,502,1,503
"خراسان_رضوی","جوین","عطاملک",9,478,0,1,50,529,1,530
"خراسان_رضوی","جوین","عطاملک",10,462,0,2,74,538,2,540
"خراسان_رضوی","جوین","عطاملک",11,789,5,0,164,958,0,958
"خراسان_رضوی","جوین","عطاملک",12,563,7,0,95,665,8,673
"خراسان_رضوی","چناران","مرکزی",1,631,2,5,114,752,5,757
"خراسان_رضوی","چناران","مرکزی",2,851,5,0,166,1022,6,1028
"خراسان_رضوی","چناران","مرکزی",3,1182,18,6,254,1460,4,1464
"خراسان_رضوی","چناران","مرکزی",4,659,7,1,133,800,3,803
"خراسان_رضوی","چناران","مرکزی",5,844,17,1,198,1060,7,1067
"خراسان_رضوی","چناران","مرکزی",6,949,15,1,230,1195,6,1201
"خراسان_رضوی","چناران","مرکزی",7,800,12,2,204,1018,7,1025
"خراسان_رضوی","چناران","مرکزی",8,329,13,0,199,541,7,548
"خراسان_رضوی","چناران","مرکزی",9,1238,13,4,350,1605,11,1616
"خراسان_رضوی","چناران","مرکزی",10,1034,30,8,421,1493,11,1504
"خراسان_رضوی","چناران","مرکزی",11,1192,9,2,178,1381,6,1387
"خراسان_رضوی","چناران","مرکزی",12,943,4,1,234,1182,3,1185
"خراسان_رضوی","چناران","مرکزی",13,836,3,1,124,964,2,966
"خراسان_رضوی","چناران","مرکزی",14,417,9,1,230,657,3,660
"خراسان_رضوی","چناران","مرکزی",15,80,2,0,76,158,2,160
"خراسان_رضوی","چناران","مرکزی",16,710,25,4,291,1030,11,1041
"خراسان_رضوی","چناران","مرکزی",17,279,5,1,165,450,2,452
"خراسان_رضوی","چناران","مرکزی",18,1044,27,4,388,1463,11,1474
"خراسان_رضوی","چناران","مرکزی",19,505,9,2,384,900,12,912
"خراسان_رضوی","چناران","مرکزی",20,1207,28,8,475,1718,18,1736
"خراسان_رضوی","چناران","مرکزی",21,1038,18,1,325,1382,3,1385
"خراسان_رضوی","چناران","مرکزی",22,667,17,6,204,894,5,899
"خراسان_رضوی","چناران","مرکزی",23,931,26,4,528,1489,11,1500
"خراسان_رضوی","چناران","مرکزی",24,123,2,0,61,186,0,186
"خراسان_رضوی","چناران","مرکزی",25,130,2,0,38,170,9,179
"خراسان_رضوی","چناران","مرکزی",26,645,15,5,223,888,0,888
"خراسان_رضوی","چناران","مرکزی",27,368,0,0,37,405,2,407
"خراسان_رضوی","چناران","مرکزی",28,241,12,1,52,306,0,306
"خراسان_رضوی","چناران","مرکزی",29,532,2,0,60,594,1,595
"خراسان_رضوی","چناران","مرکزی",30,800,28,2,145,975,4,979
"خراسان_رضوی","چناران","مرکزی",31,244,0,1,34,279,1,280
"خراسان_رضوی","چناران","مرکزی",32,359,5,0,56,420,0,420
"خراسان_رضوی","چناران","مرکزی",33,437,7,1,98,543,1,544
"خراسان_رضوی","چناران","مرکزی",34,617,1,1,71,690,3,693
"خراسان_رضوی","چناران","مرکزی",35,572,8,0,43,623,1,624
"خراسان_رضوی","چناران","مرکزی",36,1072,5,2,170,1249,5,1254
"خراسان_رضوی","چناران","مرکزی",37,1208,6,2,182,1398,4,1402
"خراسان_رضوی","چناران","مرکزی",38,262,4,1,82,349,0,349
"خراسان_رضوی","چناران","مرکزی",39,368,0,2,70,440,0,440
"خراسان_رضوی","چناران","مرکزی",40,415,5,2,63,485,1,486
"خراسان_رضوی","چناران","مرکزی",41,857,6,3,21,887,2,889
"خراسان_رضوی","چناران","مرکزی",42,850,7,3,231,1091,9,1100
"خراسان_رضوی","چناران","مرکزی",43,292,5,0,77,374,2,376
"خراسان_رضوی","چناران","مرکزی",44,203,3,0,48,254,1,255
"خراسان_رضوی","چناران","مرکزی",45,271,2,0,81,354,1,355
"خراسان_رضوی","چناران","مرکزی",46,522,6,0,52,580,6,586
"خراسان_رضوی","چناران","مرکزی",47,283,2,0,11,296,0,296
"خراسان_رضوی","چناران","مرکزی",48,309,0,0,43,352,1,353
"خراسان_رضوی","چناران","مرکزی",49,579,5,1,59,644,0,644
"خراسان_رضوی","چناران","مرکزی",50,550,6,1,59,616,5,621
"خراسان_رضوی","چناران","مرکزی",51,110,0,0,8,118,0,118
"خراسان_رضوی","چناران","مرکزی",52,559,5,2,63,629,2,631
"خراسان_رضوی","چناران","مرکزی",53,826,2,0,94,922,5,927
"خراسان_رضوی","چناران","مرکزی",54,182,0,0,37,219,0,219
"خراسان_رضوی","چناران","مرکزی",55,506,2,0,43,551,2,553
"خراسان_رضوی","چناران","مرکزی",56,531,1,0,42,574,3,577
"خراسان_رضوی","چناران","مرکزی",57,197,1,0,7,205,1,206
"خراسان_رضوی","چناران","مرکزی",58,392,4,0,17,413,1,414
"خراسان_رضوی","چناران","مرکزی",59,379,1,0,28,408,1,409
"خراسان_رضوی","چناران","گلبهار",1,736,19,4,474,1233,3,1236
"خراسان_رضوی","چناران","گلبهار",2,1057,35,2,493,1587,10,1597
"خراسان_رضوی","چناران","گلبهار",3,778,24,6,372,1180,0,1180
"خراسان_رضوی","چناران","گلبهار",4,631,17,6,387,1041,10,1051
"خراسان_رضوی","چناران","گلبهار",5,274,6,2,178,460,1,461
"خراسان_رضوی","چناران","گلبهار",6,822,19,4,381,1226,4,1230
"خراسان_رضوی","چناران","گلبهار",7,1182,14,0,129,1325,10,1335
"خراسان_رضوی","چناران","گلبهار",8,1284,12,4,146,1446,7,1453
"خراسان_رضوی","چناران","گلبهار",9,642,7,4,217,870,5,875
"خراسان_رضوی","چناران","گلبهار",10,497,6,9,308,820,6,826
"خراسان_رضوی","چناران","گلبهار",11,699,9,1,282,991,3,994
"خراسان_رضوی","چناران","گلبهار",12,271,3,0,71,345,0,345
"خراسان_رضوی","چناران","گلبهار",13,913,20,0,525,1458,10,1468
"خراسان_رضوی","چناران","گلبهار",14,732,17,1,275,1025,8,1033
"خراسان_رضوی","چناران","گلبهار",15,806,14,2,286,1108,4,1112
"خراسان_رضوی","چناران","گلبهار",16,296,11,3,84,394,3,397
"خراسان_رضوی","چناران","گلبهار",17,574,2,1,47,624,2,626
"خراسان_رضوی","چناران","گلبهار",18,748,3,0,210,961,2,963
"خراسان_رضوی","چناران","گلبهار",19,601,7,1,124,733,2,735
"خراسان_رضوی","چناران","گلبهار",20,355,3,2,45,405,0,405
"خراسان_رضوی","چناران","گلبهار",21,605,4,0,45,654,1,655
"خراسان_رضوی","چناران","گلبهار",22,784,4,1,162,951,1,952
"خراسان_رضوی","چناران","گلبهار",23,454,2,1,69,526,0,526
"خراسان_رضوی","چناران","گلبهار",24,802,17,3,260,1082,2,1084
"خراسان_رضوی","چناران","گلبهار",25,524,7,0,138,669,4,673
"خراسان_رضوی","چناران","گلبهار",26,356,4,1,85,446,0,446
"خراسان_رضوی","چناران","گلبهار",27,712,1,0,61,774,6,780
"خراسان_رضوی","چناران","گلبهار",28,343,1,1,91,436,4,440
"خراسان_رضوی","چناران","گلبهار",29,396,3,1,64,464,0,464
"خراسان_رضوی","چناران","گلبهار",30,435,13,0,75,523,2,525
"خراسان_رضوی","چناران","گلبهار",31,662,6,1,57,726,7,733
"خراسان_رضوی","خلیل_آباد","مرکزی",1,700,8,5,318,1031,9,1040
"خراسان_رضوی","خلیل_آباد","مرکزی",2,911,10,5,266,1192,2,1194
"خراسان_رضوی","خلیل_آباد","مرکزی",3,591,13,0,198,802,3,805
"خراسان_رضوی","خلیل_آباد","مرکزی",4,778,7,2,262,1049,10,1059
"خراسان_رضوی","خلیل_آباد","مرکزی",5,752,17,3,318,1090,10,1100
"خراسان_رضوی","خلیل_آباد","مرکزی",6,415,2,0,144,561,2,563
"خراسان_رضوی","خلیل_آباد","مرکزی",7,1096,3,3,102,1204,7,1211
"خراسان_رضوی","خلیل_آباد","مرکزی",8,1219,7,1,78,1305,5,1310
"خراسان_رضوی","خلیل_آباد","مرکزی",9,565,2,0,123,690,2,692
"خراسان_رضوی","خلیل_آباد","مرکزی",10,559,2,1,107,669,2,671
"خراسان_رضوی","خلیل_آباد","مرکزی",11,720,5,0,89,814,3,817
"خراسان_رضوی","خلیل_آباد","مرکزی",12,495,3,0,126,624,1,625
"خراسان_رضوی","خلیل_آباد","مرکزی",13,532,2,0,152,686,2,688
"خراسان_رضوی","خلیل_آباد","مرکزی",14,670,4,0,87,761,3,764
"خراسان_رضوی","خلیل_آباد","مرکزی",15,323,4,1,115,443,2,445
"خراسان_رضوی","خلیل_آباد","مرکزی",16,530,1,0,109,640,1,641
"خراسان_رضوی","خلیل_آباد","مرکزی",17,811,1,1,60,873,3,876
"خراسان_رضوی","خلیل_آباد","مرکزی",18,819,7,1,78,905,3,908
"خراسان_رضوی","خلیل_آباد","مرکزی",19,551,1,2,47,601,0,601
"خراسان_رضوی","خلیل_آباد","مرکزی",20,288,1,0,59,348,3,351
"خراسان_رضوی","خلیل_آباد","مرکزی",21,358,0,1,27,386,1,387
"خراسان_رضوی","خلیل_آباد","مرکزی",22,377,3,1,66,447,2,449
"خراسان_رضوی","خلیل_آباد","مرکزی",23,382,2,0,60,444,0,444
"خراسان_رضوی","خلیل_آباد","مرکزی",24,200,1,2,247,450,1,451
"خراسان_رضوی","خلیل_آباد","ششطراز",1,866,2,4,193,1065,1,1066
"خراسان_رضوی","خلیل_آباد","ششطراز",2,881,1,2,124,1008,0,1008
"خراسان_رضوی","خلیل_آباد","ششطراز",3,653,3,4,187,847,7,854
"خراسان_رضوی","خلیل_آباد","ششطراز",4,471,2,1,102,576,1,577
"خراسان_رضوی","خلیل_آباد","ششطراز",5,277,0,2,75,354,1,355
"خراسان_رضوی","خلیل_آباد","ششطراز",6,755,3,0,168,926,2,928
"خراسان_رضوی","خلیل_آباد","ششطراز",7,818,7,3,137,965,0,965
"خراسان_رضوی","خلیل_آباد","ششطراز",8,736,2,1,83,822,0,822
"خراسان_رضوی","خلیل_آباد","ششطراز",9,666,3,3,82,754,7,761
"خراسان_رضوی","خلیل_آباد","ششطراز",10,240,3,0,67,310,1,311
"خراسان_رضوی","خلیل_آباد","ششطراز",11,648,4,0,91,743,2,745
"خراسان_رضوی","خلیل_آباد","ششطراز",12,477,1,1,113,592,1,593
"خراسان_رضوی","خلیل_آباد","ششطراز",13,613,4,0,98,715,2,717
"خراسان_رضوی","خلیل_آباد","ششطراز",14,638,15,1,140,794,0,794
"خراسان_رضوی","خلیل_آباد","ششطراز",15,501,0,0,67,568,2,570
"خراسان_رضوی","خلیل_آباد","ششطراز",16,217,1,0,28,246,0,246
"خراسان_رضوی","خلیل_آباد","ششطراز",17,175,0,0,54,229,1,230
"خراسان_رضوی","خلیل_آباد","ششطراز",18,66,0,0,19,85,0,85
"خراسان_رضوی","خلیل_آباد","ششطراز",19,295,0,1,90,386,0,386
"خراسان_رضوی","خواف","مرکزی",1,49,0,5,478,532,5,537
"خراسان_رضوی","خواف","مرکزی",2,81,0,5,925,1011,2,1013
"خراسان_رضوی","خواف","مرکزی",3,106,4,13,1022,1145,6,1151
"خراسان_رضوی","خواف","مرکزی",4,116,2,5,674,797,11,808
"خراسان_رضوی","خواف","مرکزی",5,207,5,9,824,1045,6,1051
"خراسان_رضوی","خواف","مرکزی",6,83,1,9,866,959,3,962
"خراسان_رضوی","خواف","مرکزی",7,76,2,8,785,871,13,884
"خراسان_رضوی","خواف","مرکزی",8,204,2,14,1300,1520,5,1525
"خراسان_رضوی","خواف","مرکزی",9,113,0,1,576,690,5,695
"خراسان_رضوی","خواف","مرکزی",10,280,8,4,619,911,4,915
"خراسان_رضوی","خواف","مرکزی",11,44,0,5,617,666,7,673
"خراسان_رضوی","خواف","مرکزی",12,130,2,1,481,614,6,620
"خراسان_رضوی","خواف","مرکزی",13,125,1,2,683,811,12,823
"خراسان_رضوی","خواف","مرکزی",14,65,1,2,653,721,1,722
"خراسان_رضوی","خواف","مرکزی",15,189,3,1,71,264,0,264
"خراسان_رضوی","خواف","مرکزی",16,45,0,1,903,949,1,950
"خراسان_رضوی","خواف","مرکزی",17,57,1,1,1137,1196,3,1199
"خراسان_رضوی","خواف","مرکزی",18,31,1,7,885,924,1,925
"خراسان_رضوی","خواف","مرکزی",19,113,3,8,625,749,5,754
"خراسان_رضوی","خواف","مرکزی",20,262,4,1,424,691,2,693
"خراسان_رضوی","خواف","مرکزی",21,132,1,0,537,670,3,673
"خراسان_رضوی","خواف","مرکزی",22,59,0,1,533,593,1,594
"خراسان_رضوی","خواف","مرکزی",23,40,1,0,441,482,1,483
"خراسان_رضوی","خواف","مرکزی",24,59,0,1,434,494,1,495
"خراسان_رضوی","خواف","مرکزی",25,111,1,1,453,566,2,568
"خراسان_رضوی","خواف","جلگه_زوزن",1,457,6,1,215,679,1,680
"خراسان_رضوی","خواف","جلگه_زوزن",2,698,13,2,185,898,3,901
"خراسان_رضوی","خواف","جلگه_زوزن",3,572,3,1,161,737,4,741
"خراسان_رضوی","خواف","جلگه_زوزن",4,442,7,2,91,542,1,543
"خراسان_رضوی","خواف","جلگه_زوزن",5,556,3,1,110,670,0,670
"خراسان_رضوی","خواف","جلگه_زوزن",6,712,5,0,15,732,2,734
"خراسان_رضوی","خواف","جلگه_زوزن",7,723,2,1,305,1031,3,1034
"خراسان_رضوی","خواف","جلگه_زوزن",8,510,2,0,392,904,8,912
"خراسان_رضوی","خواف","جلگه_زوزن",9,502,0,0,333,835,1,836
"خراسان_رضوی","خواف","جلگه_زوزن",10,621,0,0,386,1007,6,1013
"خراسان_رضوی","خواف","جلگه_زوزن",11,1108,0,1,22,1131,0,1131
"خراسان_رضوی","خواف","جلگه_زوزن",12,1176,1,3,110,1290,9,1299
"خراسان_رضوی","خواف","سلامی",1,729,0,1,368,1098,3,1101
"خراسان_رضوی","خواف","سلامی",2,605,4,0,308,917,0,917
"خراسان_رضوی","خواف","سلامی",3,306,1,2,203,512,1,513
"خراسان_رضوی","خواف","سلامی",4,421,2,1,392,816,3,819
"خراسان_رضوی","خواف","سلامی",5,718,4,1,242,965,3,968
"خراسان_رضوی","خواف","سلامی",6,795,0,1,268,1064,1,1065
"خراسان_رضوی","خواف","سلامی",7,1526,1,1,61,1589,5,1594
"خراسان_رضوی","خواف","سلامی",8,281,1,1,602,885,0,885
"خراسان_رضوی","خواف","سلامی",9,526,0,2,405,933,0,933
"خراسان_رضوی","خواف","سلامی",10,211,1,0,631,843,2,845
"خراسان_رضوی","خواف","سلامی",11,479,5,1,670,1155,0,1155
"خراسان_رضوی","خواف","سلامی",12,465,3,4,287,759,0,759
"خراسان_رضوی","خواف","سلامی",13,873,2,4,70,949,0,949
"خراسان_رضوی","خواف","سلامی",14,382,1,3,218,604,7,611
"خراسان_رضوی","خواف","سلامی",15,615,1,4,210,830,2,832
"خراسان_رضوی","خواف","سلامی",16,139,1,1,697,838,3,841
"خراسان_رضوی","خواف","سلامی",17,162,3,6,718,889,3,892
"خراسان_رضوی","خواف","سنگان",1,116,6,13,702,837,12,849
"خراسان_رضوی","خواف","سنگان",2,941,8,14,661,1624,11,1635
"خراسان_رضوی","خواف","سنگان",3,240,3,16,836,1095,8,1103
"خراسان_رضوی","خواف","سنگان",4,319,4,3,361,687,5,692
"خراسان_رضوی","خواف","سنگان",5,704,2,0,19,725,1,726
"خراسان_رضوی","خواف","سنگان",6,1352,4,3,320,1679,2,1681
"خراسان_رضوی","خواف","سنگان",7,398,1,1,571,971,49,1020
"خراسان_رضوی","خواف","سنگان",8,312,1,0,105,418,0,418
"خراسان_رضوی","خواف","سنگان",9,1113,0,0,67,1180,0,1180
"خراسان_رضوی","خواف","سنگان",10,184,2,2,694,882,7,889
"خراسان_رضوی","خواف","سنگان",11,151,2,10,444,607,4,611
"خراسان_رضوی","خواف","سنگان",12,378,2,10,395,785,5,790
"خراسان_رضوی","خواف","سنگان",13,982,1,0,20,1003,0,1003
"خراسان_رضوی","خواف","سنگان",14,1216,0,2,19,1237,6,1243
"خراسان_رضوی","درگز","مرکزی",1,809,26,9,426,1270,9,1279
"خراسان_رضوی","درگز","مرکزی",2,904,18,8,474,1404,8,1412
"خراسان_رضوی","درگز","مرکزی",3,1076,12,7,353,1448,5,1453
"خراسان_رضوی","درگز","مرکزی",4,976,12,13,504,1505,14,1519
"خراسان_رضوی","درگز","مرکزی",5,506,10,3,293,812,3,815
"خراسان_رضوی","درگز","مرکزی",6,921,14,5,508,1448,13,1461
"خراسان_رضوی","درگز","مرکزی",7,414,2,2,162,580,3,583
"خراسان_رضوی","درگز","مرکزی",8,841,2,15,354,1212,14,1226
"خراسان_رضوی","درگز","مرکزی",9,829,7,8,289,1133,4,1137
"خراسان_رضوی","درگز","مرکزی",10,1079,3,2,90,1174,5,1179
"خراسان_رضوی","درگز","مرکزی",11,1104,5,6,285,1400,3,1403
"خراسان_رضوی","درگز","مرکزی",12,854,9,8,511,1382,10,1392
"خراسان_رضوی","درگز","مرکزی",13,482,6,4,337,829,1,830
"خراسان_رضوی","درگز","مرکزی",14,962,10,8,374,1354,5,1359
"خراسان_رضوی","درگز","مرکزی",15,756,12,13,472,1253,8,1261
"خراسان_رضوی","درگز","مرکزی",16,588,10,2,388,988,7,995
"خراسان_رضوی","درگز","مرکزی",17,480,1,2,106,589,2,591
"خراسان_رضوی","درگز","مرکزی",18,445,6,8,132,591,4,595
"خراسان_رضوی","درگز","مرکزی",19,534,2,4,109,649,1,650
"خراسان_رضوی","درگز","مرکزی",20,639,2,3,148,792,11,803
"خراسان_رضوی","درگز","مرکزی",21,819,1,3,87,910,3,913
"خراسان_رضوی","درگز","چاپشلو",1,690,4,2,169,865,10,875
"خراسان_رضوی","درگز","چاپشلو",2,719,1,2,101,823,4,827
"خراسان_رضوی","درگز","چاپشلو",3,879,4,2,59,944,4,948
"خراسان_رضوی","درگز","چاپشلو",4,464,0,0,58,522,4,526
"خراسان_رضوی","درگز","چاپشلو",5,376,0,0,35,411,0,411
"خراسان_رضوی","درگز","چاپشلو",6,522,3,0,49,574,0,574
"خراسان_رضوی","درگز","چاپشلو",7,441,0,0,50,491,3,494
"خراسان_رضوی","درگز","چاپشلو",8,502,3,3,95,603,0,603
"خراسان_رضوی","درگز","چاپشلو",9,286,2,1,62,351,2,353
"خراسان_رضوی","درگز","چاپشلو",10,356,0,0,11,367,1,368
"خراسان_رضوی","درگز","چاپشلو",11,851,0,0,52,903,1,904
"خراسان_رضوی","درگز","لطف_آباد",1,462,3,11,208,684,4,688
"خراسان_رضوی","درگز","لطف_آباد",2,401,1,3,133,538,4,542
"خراسان_رضوی","درگز","لطف_آباد",3,445,4,1,123,573,1,574
"خراسان_رضوی","درگز","لطف_آباد",4,343,2,1,38,384,1,385
"خراسان_رضوی","درگز","لطف_آباد",5,283,0,0,74,357,4,361
"خراسان_رضوی","درگز","لطف_آباد",6,738,0,1,113,852,1,853
"خراسان_رضوی","درگز","لطف_آباد",7,687,6,2,39,734,1,735
"خراسان_رضوی","درگز","لطف_آباد",8,753,0,2,36,791,1,792
"خراسان_رضوی","درگز","لطف_آباد",9,809,1,1,4,815,0,815
"خراسان_رضوی","درگز","نوخندان",1,473,7,7,306,793,5,798
"خراسان_رضوی","درگز","نوخندان",2,636,4,4,246,890,1,891
"خراسان_رضوی","درگز","نوخندان",3,718,2,5,83,808,0,808
"خراسان_رضوی","درگز","نوخندان",4,736,3,0,85,824,3,827
"خراسان_رضوی","درگز","نوخندان",5,567,1,1,59,628,3,631
"خراسان_رضوی","درگز","نوخندان",6,616,1,0,49,666,3,669
"خراسان_رضوی","درگز","نوخندان",7,528,2,0,213,743,0,743
"خراسان_رضوی","درگز","نوخندان",8,628,0,3,123,754,0,754
"خراسان_رضوی","درگز","نوخندان",9,183,5,15,209,412,0,412
"خراسان_رضوی","رشتخوار","مرکزی",1,696,9,16,254,975,9,984
"خراسان_رضوی","رشتخوار","مرکزی",2,777,7,12,260,1056,5,1061
"خراسان_رضوی","رشتخوار","مرکزی",3,350,4,12,195,561,6,567
"خراسان_رضوی","رشتخوار","مرکزی",4,512,5,12,116,645,2,647
"خراسان_رضوی","رشتخوار","مرکزی",5,1054,2,0,94,1150,2,1152
"خراسان_رضوی","رشتخوار","مرکزی",6,582,2,1,67,652,0,652
"خراسان_رضوی","رشتخوار","مرکزی",7,490,0,1,63,554,0,554
"خراسان_رضوی","رشتخوار","مرکزی",8,727,1,0,17,745,0,745
"خراسان_رضوی","رشتخوار","مرکزی",9,1076,4,1,67,1148,0,1148
"خراسان_رضوی","رشتخوار","مرکزی",10,456,0,1,45,502,2,504
"خراسان_رضوی","رشتخوار","مرکزی",11,643,8,0,98,749,2,751
"خراسان_رضوی","رشتخوار","مرکزی",12,1060,18,4,183,1265,9,1274
"خراسان_رضوی","رشتخوار","مرکزی",13,1133,2,2,104,1241,6,1247
"خراسان_رضوی","رشتخوار","مرکزی",14,994,3,1,56,1054,3,1057
"خراسان_رضوی","رشتخوار","مرکزی",15,1232,4,2,124,1362,3,1365
"خراسان_رضوی","رشتخوار","مرکزی",16,831,2,2,242,1077,2,1079
"خراسان_رضوی","رشتخوار","مرکزی",17,867,2,4,100,973,0,973
"خراسان_رضوی","رشتخوار","مرکزی",18,797,1,0,111,909,1,910
"خراسان_رضوی","رشتخوار","مرکزی",19,669,6,0,175,850,1,851
"خراسان_رضوی","رشتخوار","مرکزی",20,695,3,0,73,771,5,776
"خراسان_رضوی","رشتخوار","مرکزی",21,1091,5,0,80,1176,0,1176
"خراسان_رضوی","رشتخوار","مرکزی",22,691,0,0,18,709,1,710
"خراسان_رضوی","رشتخوار","مرکزی",23,916,1,0,73,990,0,990
"خراسان_رضوی","رشتخوار","مرکزی",24,918,4,2,90,1014,0,1014
"خراسان_رضوی","رشتخوار","مرکزی",25,387,2,1,38,428,0,428
"خراسان_رضوی","رشتخوار","مرکزی",26,506,2,0,90,598,2,600
"خراسان_رضوی","رشتخوار","مرکزی",27,515,1,1,51,568,0,568
"خراسان_رضوی","رشتخوار","مرکزی",28,506,0,0,83,589,0,589
"خراسان_رضوی","رشتخوار","مرکزی",29,619,2,1,43,665,1,666
"خراسان_رضوی","رشتخوار","جنگل",30,581,4,1,315,901,0,901
"خراسان_رضوی","رشتخوار","جنگل",31,612,5,0,155,772,0,772
"خراسان_رضوی","رشتخوار","جنگل",32,484,1,2,284,771,0,771
"خراسان_رضوی","رشتخوار","جنگل",33,709,8,5,131,853,0,853
"خراسان_رضوی","رشتخوار","جنگل",34,806,4,1,155,966,0,966
"خراسان_رضوی","رشتخوار","جنگل",35,438,0,1,29,468,1,469
"خراسان_رضوی","رشتخوار","جنگل",36,655,5,1,110,771,3,774
"خراسان_رضوی","رشتخوار","جنگل",37,579,0,6,19,604,0,604
"خراسان_رضوی","رشتخوار","جنگل",38,546,0,0,26,572,3,575
"خراسان_رضوی","رشتخوار","جنگل",39,496,3,0,29,528,2,530
"خراسان_رضوی","رشتخوار","جنگل",40,564,1,1,44,610,1,611
"خراسان_رضوی","زاوه","مرکزی",1,1091,5,2,316,1414,7,1421
"خراسان_رضوی","زاوه","مرکزی",2,1049,6,2,168,1225,1,1226
"خراسان_رضوی","زاوه","مرکزی",3,739,3,2,175,919,2,921
"خراسان_رضوی","زاوه","مرکزی",4,728,6,2,121,857,3,860
"خراسان_رضوی","زاوه","مرکزی",5,478,2,0,98,578,1,579
"خراسان_رضوی","زاوه","مرکزی",6,88,0,0,23,111,1,112
"خراسان_رضوی","زاوه","مرکزی",7,945,4,0,68,1017,1,1018
"خراسان_رضوی","زاوه","مرکزی",8,286,1,0,16,303,1,304
"خراسان_رضوی","زاوه","مرکزی",9,707,4,5,100,816,0,816
"خراسان_رضوی","زاوه","مرکزی",10,827,3,1,82,913,2,915
"خراسان_رضوی","زاوه","مرکزی",11,403,0,0,52,455,0,455
"خراسان_رضوی","زاوه","مرکزی",12,682,0,0,17,699,1,700
"خراسان_رضوی","زاوه","مرکزی",13,783,1,1,32,817,2,819
"خراسان_رضوی","زاوه","مرکزی",14,839,2,0,27,868,0,868
"خراسان_رضوی","زاوه","مرکزی",15,648,6,0,11,665,0,665
"خراسان_رضوی","زاوه","مرکزی",16,391,1,0,43,435,4,439
"خراسان_رضوی","زاوه","مرکزی",17,809,3,1,37,850,3,853
"خراسان_رضوی","زاوه","مرکزی",18,624,2,0,64,690,4,694
"خراسان_رضوی","زاوه","مرکزی",19,681,0,3,65,749,1,750
"خراسان_رضوی","زاوه","مرکزی",20,365,3,0,41,409,10,419
"خراسان_رضوی","زاوه","مرکزی",21,464,3,4,30,501,1,502
"خراسان_رضوی","زاوه","مرکزی",22,424,0,0,38,462,1,463
"خراسان_رضوی","زاوه","مرکزی",23,505,0,2,39,546,0,546
"خراسان_رضوی","زاوه","مرکزی",24,919,8,1,59,987,1,988
"خراسان_رضوی","زاوه","مرکزی",25,701,8,1,61,771,2,773
"خراسان_رضوی","زاوه","مرکزی",26,543,1,0,55,599,0,599
"خراسان_رضوی","زاوه","مرکزی",27,1039,6,2,106,1153,1,1154
"خراسان_رضوی","زاوه","مرکزی",28,331,1,0,37,369,0,369
"خراسان_رضوی","زاوه","مرکزی",29,891,2,0,40,933,0,933
"خراسان_رضوی","زاوه","مرکزی",30,779,1,0,20,800,0,800
"خراسان_رضوی","زاوه","سلیمان",1,683,2,1,22,708,2,710
"خراسان_رضوی","زاوه","سلیمان",2,562,7,1,19,589,0,589
"خراسان_رضوی","زاوه","سلیمان",3,578,1,0,40,619,1,620
"خراسان_رضوی","زاوه","سلیمان",4,543,1,0,25,569,1,570
"خراسان_رضوی","زاوه","سلیمان",5,572,0,0,26,598,4,602
"خراسان_رضوی","زاوه","سلیمان",6,870,2,1,27,900,0,900
"خراسان_رضوی","زاوه","سلیمان",7,943,0,2,20,965,3,968
"خراسان_رضوی","زاوه","سلیمان",8,863,3,3,46,915,2,917
"خراسان_رضوی","زاوه","سلیمان",9,820,2,0,136,958,7,965
"خراسان_رضوی","زاوه","سلیمان",10,841,1,0,117,959,1,960
"خراسان_رضوی","زاوه","سلیمان",11,851,0,1,42,894,0,894
"خراسان_رضوی","زاوه","سلیمان",12,924,5,1,52,982,4,986
"خراسان_رضوی","زاوه","سلیمان",13,945,3,0,42,990,8,998
"خراسان_رضوی","زاوه","سلیمان",14,870,0,0,33,903,0,903
"خراسان_رضوی","زاوه","سلیمان",15,645,1,1,32,679,0,679
"خراسان_رضوی","زاوه","سلیمان",16,873,6,1,23,903,0,903
"خراسان_رضوی","زاوه","سلیمان",17,472,0,1,151,624,0,624
"خراسان_رضوی","زاوه","سلیمان",18,505,0,0,16,521,0,521
"خراسان_رضوی","زاوه","سلیمان",19,704,1,0,22,727,0,727
"خراسان_رضوی","سبزوار","روداب",1,676,4,0,199,879,8,887
"خراسان_رضوی","سبزوار","روداب",2,637,6,1,150,794,0,794
"خراسان_رضوی","سبزوار","روداب",3,408,4,0,63,475,0,475
"خراسان_رضوی","سبزوار","روداب",4,395,3,0,55,453,2,455
"خراسان_رضوی","سبزوار","روداب",5,330,6,1,70,407,1,408
"خراسان_رضوی","سبزوار","روداب",6,329,1,0,40,370,1,371
"خراسان_رضوی","سبزوار","روداب",7,515,2,0,73,590,3,593
"خراسان_رضوی","سبزوار","روداب",8,339,1,0,31,371,0,371
"خراسان_رضوی","سبزوار","روداب",9,325,1,0,16,342,2,344
"خراسان_رضوی","سبزوار","روداب",10,177,1,1,110,289,0,289
"خراسان_رضوی","سبزوار","روداب",11,440,3,0,62,505,0,505
"خراسان_رضوی","سبزوار","روداب",12,293,0,0,33,326,0,326
"خراسان_رضوی","سبزوار","روداب",13,312,0,1,14,327,1,328
"خراسان_رضوی","سبزوار","روداب",14,320,0,2,47,369,0,369
"خراسان_رضوی","سبزوار","روداب",15,321,0,0,59,380,3,383
"خراسان_رضوی","سبزوار","روداب",16,182,0,0,10,192,0,192
"خراسان_رضوی","سبزوار","روداب",17,311,3,0,39,353,1,354
"خراسان_رضوی","سبزوار","روداب",18,69,0,0,27,96,0,96
"خراسان_رضوی","سبزوار","روداب",19,199,5,0,20,224,0,224
"خراسان_رضوی","سبزوار","روداب",20,100,1,0,19,120,2,122
"خراسان_رضوی","سبزوار","روداب",21,267,2,0,18,287,0,287
"خراسان_رضوی","سبزوار","روداب",22,227,0,0,9,236,0,236
"خراسان_رضوی","سبزوار","روداب",23,135,0,0,9,144,0,144
"خراسان_رضوی","سبزوار","روداب",24,184,0,0,23,207,0,207
"خراسان_رضوی","سبزوار","روداب",25,179,1,0,26,206,0,206
"خراسان_رضوی","سبزوار","روداب",26,182,2,0,36,220,0,220
"خراسان_رضوی","سبزوار","روداب",27,291,4,0,39,334,4,338
"خراسان_رضوی","سبزوار","خوشاب",1,629,6,0,195,830,2,832
"خراسان_رضوی","سبزوار","خوشاب",2,335,1,0,85,421,1,422
"خراسان_رضوی","سبزوار","خوشاب",3,820,2,2,332,1156,7,1163
"خراسان_رضوی","سبزوار","خوشاب",4,333,2,1,135,471,2,473
"خراسان_رضوی","سبزوار","خوشاب",5,547,11,1,315,874,5,879
"خراسان_رضوی","سبزوار","خوشاب",6,483,3,0,116,602,1,603
"خراسان_رضوی","سبزوار","خوشاب",7,238,3,1,57,299,0,299
"خراسان_رضوی","سبزوار","خوشاب",8,132,2,0,31,165,1,166
"خراسان_رضوی","سبزوار","خوشاب",9,589,1,0,111,701,1,702
"خراسان_رضوی","سبزوار","خوشاب",10,644,17,3,189,853,8,861
"خراسان_رضوی","سبزوار","خوشاب",11,668,5,4,225,902,3,905
"خراسان_رضوی","سبزوار","خوشاب",12,513,1,0,35,549,1,550
"خراسان_رضوی","سبزوار","خوشاب",13,244,2,18,38,302,2,304
"خراسان_رضوی","سبزوار","خوشاب",14,326,4,0,48,378,2,380
"خراسان_رضوی","سبزوار","خوشاب",15,423,0,0,31,454,0,454
"خراسان_رضوی","سبزوار","خوشاب",16,680,5,1,107,793,7,800
"خراسان_رضوی","سبزوار","خوشاب",17,581,6,1,58,646,4,650
"خراسان_رضوی","سبزوار","خوشاب",18,409,3,0,38,450,1,451
"خراسان_رضوی","سبزوار","خوشاب",19,265,4,0,43,312,2,314
"خراسان_رضوی","سبزوار","خوشاب",20,538,0,2,112,652,0,652
"خراسان_رضوی","سبزوار","خوشاب",21,193,1,0,16,210,2,212
"خراسان_رضوی","سبزوار","خوشاب",22,126,0,0,11,137,1,138
"خراسان_رضوی","سبزوار","خوشاب",23,417,1,0,23,441,4,445
"خراسان_رضوی","سبزوار","خوشاب",24,366,0,0,30,396,0,396
"خراسان_رضوی","سبزوار","خوشاب",25,222,1,0,15,238,0,238
"خراسان_رضوی","سبزوار","خوشاب",26,452,2,0,46,500,0,500
"خراسان_رضوی","سبزوار","خوشاب",27,330,0,1,21,352,0,352
"خراسان_رضوی","سبزوار","خوشاب",28,312,0,0,16,328,1,329
"خراسان_رضوی","سبزوار","خوشاب",29,266,0,0,23,289,0,289
"خراسان_رضوی","سبزوار","خوشاب",30,333,0,1,56,390,2,392
"خراسان_رضوی","سبزوار","خوشاب",31,510,2,2,68,582,1,583
"خراسان_رضوی","سبزوار","خوشاب",32,618,2,1,189,810,5,815
"خراسان_رضوی","سبزوار","خوشاب",33,211,0,5,73,289,2,291
"خراسان_رضوی","سبزوار","خوشاب",34,545,1,1,46,593,3,596
"خراسان_رضوی","سبزوار","خوشاب",35,376,3,1,44,424,0,424
"خراسان_رضوی","سبزوار","خوشاب",36,517,0,0,38,555,3,558
"خراسان_رضوی","سبزوار","خوشاب",37,791,5,2,36,834,4,838
"خراسان_رضوی","سبزوار","خوشاب",38,436,2,0,53,491,1,492
"خراسان_رضوی","سبزوار","خوشاب",39,417,6,1,30,454,0,454
"خراسان_رضوی","سبزوار","خوشاب",40,500,9,0,24,533,5,538
"خراسان_رضوی","سبزوار","خوشاب",41,430,1,0,27,458,3,461
"خراسان_رضوی","سبزوار","خوشاب",42,419,1,0,30,450,1,451
"خراسان_رضوی","سبزوار","خوشاب",43,428,7,1,22,458,2,460
"خراسان_رضوی","سبزوار","شهر",1,808,33,5,380,1226,10,1236
"خراسان_رضوی","سبزوار","شهر",2,958,36,21,644,1659,29,1688
"خراسان_رضوی","سبزوار","شهر",3,862,36,19,746,1663,33,1696
"خراسان_رضوی","سبزوار","شهر",4,661,32,8,486,1187,22,1209
"خراسان_رضوی","سبزوار","شهر",5,513,11,7,348,879,10,889
"خراسان_رضوی","سبزوار","شهر",6,1230,26,9,456,1721,17,1738
"خراسان_رضوی","سبزوار","شهر",7,942,9,6,163,1120,9,1129
"خراسان_رضوی","سبزوار","شهر",8,698,11,5,297,1011,10,1021
"خراسان_رضوی","سبزوار","شهر",9,1216,7,11,271,1505,14,1519
"خراسان_رضوی","سبزوار","شهر",10,914,26,8,548,1496,14,1510
"خراسان_رضوی","سبزوار","شهر",11,434,18,3,309,764,10,774
"خراسان_رضوی","سبزوار","شهر",12,810,26,4,399,1239,14,1253
"خراسان_رضوی","سبزوار","شهر",13,461,14,6,261,742,6,748
"خراسان_رضوی","سبزوار","شهر",14,545,10,3,302,860,8,868
"خراسان_رضوی","سبزوار","شهر",15,1374,19,7,350,1750,7,1757
"خراسان_رضوی","سبزوار","شهر",16,1083,26,4,455,1568,7,1575
"خراسان_رضوی","سبزوار","شهر",17,1104,15,4,277,1400,9,1409
"خراسان_رضوی","سبزوار","شهر",18,791,16,2,249,1058,7,1065
"خراسان_رضوی","سبزوار","شهر",19,1061,18,4,394,1477,11,1488
"خراسان_رضوی","سبزوار","شهر",20,1122,17,7,265,1411,8,1419
"خراسان_رضوی","سبزوار","شهر",21,636,59,16,1436,2147,20,2167
"خراسان_رضوی","سبزوار","شهر",22,1211,41,18,919,2189,11,2200
"خراسان_رضوی","سبزوار","شهر",23,432,17,0,287,736,4,740
"خراسان_رضوی","سبزوار","شهر",24,926,39,19,583,1567,18,1585
"خراسان_رضوی","سبزوار","شهر",25,600,38,6,633,1277,18,1295
"خراسان_رضوی","سبزوار","شهر",26,1083,22,8,432,1545,6,1551
"خراسان_رضوی","سبزوار","شهر",27,1516,25,4,501,2046,0,2046
"خراسان_رضوی","سبزوار","شهر",28,1159,35,5,483,1682,18,1700
"خراسان_رضوی","سبزوار","شهر",29,1447,30,6,539,2022,14,2036
"خراسان_رضوی","سبزوار","شهر",30,923,11,0,362,1296,14,1310
"خراسان_رضوی","سبزوار","شهر",31,512,1,3,157,673,1,674
"خراسان_رضوی","سبزوار","شهر",32,353,27,8,527,915,17,932
"خراسان_رضوی","سبزوار","شهر",33,536,38,26,1104,1704,17,1721
"خراسان_رضوی","سبزوار","شهر",34,796,38,17,767,1618,17,1635
"خراسان_رضوی","سبزوار","شهر",35,361,44,5,677,1087,17,1104
"خراسان_رضوی","سبزوار","شهر",36,773,36,20,966,1795,23,1818
"خراسان_رضوی","سبزوار","شهر",37,265,16,7,328,616,12,628
"خراسان_رضوی","سبزوار","شهر",38,782,33,17,662,1494,20,1514
"خراسان_رضوی","سبزوار","شهر",39,1002,30,8,545,1585,15,1600
"خراسان_رضوی","سبزوار","شهر",40,1045,27,0,427,1499,18,1517
"خراسان_رضوی","سبزوار","شهر",41,701,4,0,221,926,7,933
"خراسان_رضوی","سبزوار","شهر",42,640,4,3,296,943,7,950
"خراسان_رضوی","سبزوار","شهر",43,838,8,2,217,1065,3,1068
"خراسان_رضوی","سبزوار","شهر",44,696,40,6,586,1328,12,1340
"خراسان_رضوی","سبزوار","شهر",45,715,19,5,264,1003,12,1015
"خراسان_رضوی","سبزوار","شهر",46,380,9,1,292,682,7,689
"خراسان_رضوی","سبزوار","شهر",47,878,74,14,1066,2032,68,2100
"خراسان_رضوی","سبزوار","شهر",48,1099,38,16,845,1998,20,2018
"خراسان_رضوی","سبزوار","شهر",49,814,31,9,480,1334,16,1350
"خراسان_رضوی","سبزوار","شهر",50,890,46,11,668,1615,13,1628
"خراسان_رضوی","سبزوار","شهر",51,998,46,11,700,1755,23,1778
"خراسان_رضوی","سبزوار","شهر",52,964,26,13,444,1447,11,1458
"خراسان_رضوی","سبزوار","شهر",53,1040,69,39,891,2039,35,2074
"خراسان_رضوی","سبزوار","شهر",54,455,24,7,483,969,13,982
"خراسان_رضوی","سبزوار","شهر",55,696,61,18,804,1579,20,1599
"خراسان_رضوی","سبزوار","شهر",56,674,47,18,1224,1963,32,1995
"خراسان_رضوی","سبزوار","شهر",57,1038,28,8,754,1828,20,1848
"خراسان_رضوی","سبزوار","شهر",58,677,28,3,490,1198,22,1220
"خراسان_رضوی","سبزوار","شهر",59,1389,22,15,734,2160,24,2184
"خراسان_رضوی","سبزوار","شهر",60,1077,7,2,265,1351,20,1371
"خراسان_رضوی","سبزوار","شهر",61,1386,29,5,592,2012,10,2022
"خراسان_رضوی","سبزوار","شهر",62,674,9,1,204,888,2,890
"خراسان_رضوی","سبزوار","شهر",63,1117,18,7,618,1760,13,1773
"خراسان_رضوی","سبزوار","شهر",64,1286,14,5,302,1607,6,1613
"خراسان_رضوی","سبزوار","شهر",65,701,27,2,524,1254,17,1271
"خراسان_رضوی","سبزوار","شهر",66,1256,21,4,496,1777,20,1797
"خراسان_رضوی","سبزوار","شهر",67,928,42,12,584,1566,15,1581
"خراسان_رضوی","سبزوار","شهر",68,1599,21,8,618,2246,18,2264
"خراسان_رضوی","سبزوار","شهر",69,1250,11,3,372,1636,6,1642
"خراسان_رضوی","سبزوار","شهر",70,1157,14,2,190,1363,9,1372
"خراسان_رضوی","سبزوار","شهر",71,485,2,0,135,622,8,630
"خراسان_رضوی","سبزوار","شهر",72,597,64,18,1362,2041,22,2063
"خراسان_رضوی","سبزوار","شهر",73,790,50,11,968,1819,17,1836
"خراسان_رضوی","سبزوار","شهر",74,706,34,18,1068,1826,23,1849
"خراسان_رضوی","سبزوار","شهر",75,553,24,3,693,1273,13,1286
"خراسان_رضوی","سبزوار","شهر",76,1084,37,7,410,1538,7,1545
"خراسان_رضوی","سبزوار","شهر",77,890,27,9,440,1366,12,1378
"خراسان_رضوی","سبزوار","شهر",78,512,8,2,168,690,6,696
"خراسان_رضوی","سبزوار","شهر",79,550,21,3,433,1007,5,1012
"خراسان_رضوی","سبزوار","شهر",80,739,62,16,411,1228,34,1262
"خراسان_رضوی","سبزوار","شهر",81,377,6,2,123,508,3,511
"خراسان_رضوی","سبزوار","شهر",82,466,13,0,181,660,4,664
"خراسان_رضوی","سبزوار","شهر",83,315,10,2,147,474,0,474
"خراسان_رضوی","سبزوار","ششتمد",1,347,12,1,247,607,8,615
"خراسان_رضوی","سبزوار","ششتمد",2,378,7,1,192,578,3,581
"خراسان_رضوی","سبزوار","ششتمد",3,468,5,4,212,689,2,691
"خراسان_رضوی","سبزوار","ششتمد",4,513,2,0,111,626,1,627
"خراسان_رضوی","سبزوار","ششتمد",5,645,18,1,221,885,7,892
"خراسان_رضوی","سبزوار","ششتمد",6,263,7,2,80,352,0,352
"خراسان_رضوی","سبزوار","ششتمد",7,281,3,1,48,333,1,334
"خراسان_رضوی","سبزوار","ششتمد",8,540,4,1,142,687,8,695
"خراسان_رضوی","سبزوار","ششتمد",9,551,3,2,98,654,3,657
"خراسان_رضوی","سبزوار","ششتمد",10,354,2,0,56,412,1,413
"خراسان_رضوی","سبزوار","ششتمد",11,342,10,1,74,427,2,429
"خراسان_رضوی","سبزوار","ششتمد",12,395,5,6,109,515,0,515
"خراسان_رضوی","سبزوار","ششتمد",13,490,6,0,107,603,0,603
"خراسان_رضوی","سبزوار","ششتمد",14,373,4,0,38,415,0,415
"خراسان_رضوی","سبزوار","ششتمد",15,757,3,1,104,865,0,865
"خراسان_رضوی","سبزوار","ششتمد",16,105,0,0,7,112,0,112
"خراسان_رضوی","سبزوار","ششتمد",17,758,1,0,26,785,0,785
"خراسان_رضوی","سبزوار","ششتمد",18,588,1,0,47,636,5,641
"خراسان_رضوی","سبزوار","ششتمد",19,331,1,0,12,344,2,346
"خراسان_رضوی","سبزوار","ششتمد",20,703,3,0,45,751,3,754
"خراسان_رضوی","سبزوار","ششتمد",21,468,1,0,10,479,0,479
"خراسان_رضوی","سبزوار","ششتمد",22,600,2,0,45,647,2,649
"خراسان_رضوی","سبزوار","ششتمد",23,358,2,0,22,382,0,382
"خراسان_رضوی","سبزوار","ششتمد",24,640,5,1,100,746,0,746
"خراسان_رضوی","سبزوار","ششتمد",25,549,7,0,81,637,2,639
"خراسان_رضوی","سبزوار","ششتمد",26,652,3,0,47,702,1,703
"خراسان_رضوی","سبزوار","ششتمد",27,760,3,0,33,796,4,800
"خراسان_رضوی","سبزوار","ششتمد",28,672,8,0,64,744,3,747
"خراسان_رضوی","سبزوار","ششتمد",29,732,2,0,29,763,2,765
"خراسان_رضوی","سبزوار","داورزن",1,721,15,0,158,894,6,900
"خراسان_رضوی","سبزوار","داورزن",2,441,8,0,73,522,5,527
"خراسان_رضوی","سبزوار","داورزن",3,568,12,6,175,761,2,763
"خراسان_رضوی","سبزوار","داورزن",4,433,9,0,120,562,0,562
"خراسان_رضوی","سبزوار","داورزن",5,362,10,0,69,441,1,442
"خراسان_رضوی","سبزوار","داورزن",6,518,1,1,10,530,2,532
"خراسان_رضوی","سبزوار","داورزن",7,621,2,1,93,717,3,720
"خراسان_رضوی","سبزوار","داورزن",8,558,2,1,12,573,0,573
"خراسان_رضوی","سبزوار","داورزن",9,502,1,0,16,519,0,519
"خراسان_رضوی","سبزوار","داورزن",10,723,2,1,50,776,0,776
"خراسان_رضوی","سبزوار","داورزن",11,514,0,4,173,691,2,693
"خراسان_رضوی","سبزوار","داورزن",12,518,6,4,259,787,1,788
"خراسان_رضوی","سبزوار","داورزن",13,474,0,0,21,495,5,500
"خراسان_رضوی","سبزوار","داورزن",14,725,8,0,181,914,4,918
"خراسان_رضوی","سبزوار","داورزن",15,271,1,2,62,336,3,339
"خراسان_رضوی","سبزوار","داورزن",16,673,5,0,132,810,3,813
"خراسان_رضوی","سبزوار","داورزن",17,761,3,0,172,936,5,941
"خراسان_رضوی","سبزوار","داورزن",18,426,0,1,26,453,4,457
"خراسان_رضوی","سبزوار","داورزن",19,636,5,0,148,789,5,794
"خراسان_رضوی","سبزوار","داورزن",20,186,0,0,41,227,1,228
"خراسان_رضوی","سبزوار","داورزن",21,341,4,0,36,381,0,381
"خراسان_رضوی","سبزوار","داورزن",22,765,4,0,84,853,0,853
"خراسان_رضوی","سبزوار","داورزن",23,631,2,0,77,710,5,715
"خراسان_رضوی","سبزوار","داورزن",24,425,3,1,53,482,1,483
"خراسان_رضوی","سبزوار","داورزن",25,399,0,3,65,467,4,471
"خراسان_رضوی","سبزوار","مرکزی",84,509,7,2,106,624,3,627
"خراسان_رضوی","سبزوار","مرکزی",85,526,8,3,226,763,10,773
"خراسان_رضوی","سبزوار","مرکزی",86,746,1,3,233,983,14,997
"خراسان_رضوی","سبزوار","مرکزی",87,423,4,0,139,566,0,566
"خراسان_رضوی","سبزوار","مرکزی",88,287,5,0,137,429,1,430
"خراسان_رضوی","سبزوار","مرکزی",89,646,5,1,138,790,8,798
"خراسان_رضوی","سبزوار","مرکزی",90,543,4,7,421,975,4,979
"خراسان_رضوی","سبزوار","مرکزی",91,707,5,1,170,883,4,887
"خراسان_رضوی","سبزوار","مرکزی",92,709,2,0,28,739,0,739
"خراسان_رضوی","سبزوار","مرکزی",93,541,3,3,272,819,5,824
"خراسان_رضوی","سبزوار","مرکزی",94,323,5,1,62,391,6,397
"خراسان_رضوی","سبزوار","مرکزی",95,473,10,2,130,615,7,622
"خراسان_رضوی","سبزوار","مرکزی",96,233,7,3,338,581,3,584
"خراسان_رضوی","سبزوار","مرکزی",97,572,9,1,168,750,4,754
"خراسان_رضوی","سبزوار","مرکزی",98,451,14,0,229,694,7,701
"خراسان_رضوی","سبزوار","مرکزی",99,765,4,1,177,947,4,951
"خراسان_رضوی","سبزوار","مرکزی",100,513,5,6,174,698,2,700
"خراسان_رضوی","سبزوار","مرکزی",101,599,8,1,146,754,5,759
"خراسان_رضوی","سبزوار","مرکزی",102,422,3,2,90,517,4,521
"خراسان_رضوی","سبزوار","مرکزی",103,506,4,1,77,588,2,590
"خراسان_رضوی","سبزوار","مرکزی",104,681,18,1,94,794,1,795
"خراسان_رضوی","سبزوار","مرکزی",105,460,4,0,47,511,2,513
"خراسان_رضوی","سبزوار","مرکزی",106,462,0,2,25,489,1,490
"خراسان_رضوی","سبزوار","مرکزی",107,302,1,0,35,338,2,340
"خراسان_رضوی","سبزوار","مرکزی",108,326,3,0,37,366,0,366
"خراسان_رضوی","سبزوار","مرکزی",109,545,3,1,137,686,10,696
"خراسان_رضوی","سبزوار","مرکزی",110,801,6,1,46,854,8,862
"خراسان_رضوی","سبزوار","مرکزی",111,682,11,0,48,741,0,741
"خراسان_رضوی","سبزوار","مرکزی",112,394,5,0,105,504,1,505
"خراسان_رضوی","سبزوار","مرکزی",113,551,7,2,139,699,7,706
"خراسان_رضوی","سبزوار","مرکزی",114,206,2,1,91,300,1,301
"خراسان_رضوی","سبزوار","مرکزی",115,217,4,0,33,254,1,255
"خراسان_رضوی","سرخس","مرکزی",1,986,5,1,410,1402,6,1408
"خراسان_رضوی","سرخس","مرکزی",2,907,4,1,342,1254,7,1261
"خراسان_رضوی","سرخس","مرکزی",3,1092,11,5,285,1393,5,1398
"خراسان_رضوی","سرخس","مرکزی",4,1824,17,2,390,2233,6,2239
"خراسان_رضوی","سرخس","مرکزی",5,1267,10,2,191,1470,5,1475
"خراسان_رضوی","سرخس","مرکزی",6,368,2,1,134,505,2,507
"خراسان_رضوی","سرخس","مرکزی",7,1077,7,0,190,1274,9,1283
"خراسان_رضوی","سرخس","مرکزی",8,597,28,4,331,960,10,970
"خراسان_رضوی","سرخس","مرکزی",9,779,10,3,304,1096,2,1098
"خراسان_رضوی","سرخس","مرکزی",10,298,3,0,86,387,0,387
"خراسان_رضوی","سرخس","مرکزی",11,1061,10,1,247,1319,6,1325
"خراسان_رضوی","سرخس","مرکزی",12,197,2,0,71,270,3,273
"خراسان_رضوی","سرخس","مرکزی",13,1073,1,4,103,1181,4,1185
"خراسان_رضوی","سرخس","مرکزی",14,979,8,3,367,1357,3,1360
"خراسان_رضوی","سرخس","مرکزی",15,395,4,1,37,437,1,438
"خراسان_رضوی","سرخس","مرکزی",16,884,8,3,295,1190,8,1198
"خراسان_رضوی","سرخس","مرکزی",17,450,7,1,148,606,3,609
"خراسان_رضوی","سرخس","مرکزی",18,352,8,2,127,489,4,493
"خراسان_رضوی","سرخس","مرکزی",19,812,2,5,380,1199,0,1199
"خراسان_رضوی","سرخس","مرکزی",20,578,0,0,18,596,3,599
"خراسان_رضوی","سرخس","مرکزی",21,499,2,0,41,542,0,542
"خراسان_رضوی","سرخس","مرکزی",22,1128,0,0,63,1191,2,1193
"خراسان_رضوی","سرخس","مرکزی",23,622,0,0,33,655,0,655
"خراسان_رضوی","سرخس","مرکزی",24,651,3,6,197,857,5,862
"خراسان_رضوی","سرخس","مرکزی",25,1195,1,1,35,1232,2,1234
"خراسان_رضوی","سرخس","مرکزی",26,784,3,0,148,935,1,936
"خراسان_رضوی","سرخس","مرکزی",27,801,2,1,212,1016,2,1018
"خراسان_رضوی","سرخس","مرکزی",28,386,0,1,240,627,1,628
"خراسان_رضوی","سرخس","مرکزی",29,894,3,6,170,1073,15,1088
"خراسان_رضوی","سرخس","مرکزی",30,997,1,1,33,1032,4,1036
"خراسان_رضوی","سرخس","مرکزی",31,969,1,0,115,1085,2,1087
"خراسان_رضوی","سرخس","مرکزی",32,726,2,0,43,771,1,772
"خراسان_رضوی","سرخس","مرکزی",33,282,2,0,407,691,3,694
"خراسان_رضوی","سرخس","مرکزی",34,282,1,0,13,296,0,296
"خراسان_رضوی","سرخس","مرکزی",35,1328,1,1,87,1417,1,1418
"خراسان_رضوی","سرخس","مرکزی",36,908,2,1,206,1117,4,1121
"خراسان_رضوی","سرخس","مرکزی",37,197,1,1,109,308,1,309
"خراسان_رضوی","سرخس","مرکزی",38,796,1,0,231,1028,8,1036
"خراسان_رضوی","سرخس","مرکزی",39,124,3,1,83,211,1,212
"خراسان_رضوی","سرخس","مرکزی",40,475,0,0,33,508,1,509
"خراسان_رضوی","سرخس","مرزداران",1,600,9,6,247,862,8,870
"خراسان_رضوی","سرخس","مرزداران",2,724,1,1,65,791,0,791
"خراسان_رضوی","سرخس","مرزداران",3,782,6,0,220,1008,3,1011
"خراسان_رضوی","سرخس","مرزداران",4,405,2,0,105,512,0,512
"خراسان_رضوی","سرخس","مرزداران",5,107,4,0,20,131,2,133
"خراسان_رضوی","سرخس","مرزداران",6,208,0,0,7,215,0,215
"خراسان_رضوی","سرخس","مرزداران",7,421,0,1,71,493,1,494
"خراسان_رضوی","سرخس","مرزداران",8,305,1,1,24,331,10,341
"خراسان_رضوی","سرخس","مرزداران",9,417,1,0,52,470,2,472
"خراسان_رضوی","سرخس","مرزداران",10,680,4,0,207,891,3,894
"خراسان_رضوی","سرخس","مرزداران",11,306,4,0,224,534,9,543
"خراسان_رضوی","سرخس","مرزداران",12,236,1,0,200,437,1,438
"خراسان_رضوی","سرخس","مرزداران",13,67,0,0,163,230,1,231
"خراسان_رضوی","سرخس","مرزداران",14,267,7,0,152,426,0,426
"خراسان_رضوی","سرخس","مرزداران",15,346,0,0,39,385,3,388
"خراسان_رضوی","سرخس","مرزداران",16,195,1,0,24,220,0,220
"خراسان_رضوی","سرخس","مرزداران",17,618,1,0,81,700,2,702
"خراسان_رضوی","فریمان","مرکزی",1,1236,16,3,517,1772,9,1781
"خراسان_رضوی","فریمان","مرکزی",2,495,3,0,174,672,1,673
"خراسان_رضوی","فریمان","مرکزی",3,637,9,1,370,1017,10,1027
"خراسان_رضوی","فریمان","مرکزی",4,685,13,0,288,986,6,992
"خراسان_رضوی","فریمان","مرکزی",5,550,3,0,199,752,6,758
"خراسان_رضوی","فریمان","مرکزی",6,835,20,2,699,1556,12,1568
"خراسان_رضوی","فریمان","مرکزی",7,348,10,0,192,550,2,552
"خراسان_رضوی","فریمان","مرکزی",8,448,10,2,320,780,7,787
"خراسان_رضوی","فریمان","مرکزی",9,966,10,1,390,1367,6,1373
"خراسان_رضوی","فریمان","مرکزی",10,1373,16,7,733,2129,10,2139
"خراسان_رضوی","فریمان","مرکزی",11,653,12,8,406,1079,9,1088
"خراسان_رضوی","فریمان","مرکزی",12,781,8,1,218,1008,5,1013
"خراسان_رضوی","فریمان","مرکزی",13,771,19,3,363,1156,11,1167
"خراسان_رضوی","فریمان","مرکزی",14,940,24,1,495,1460,9,1469
"خراسان_رضوی","فریمان","مرکزی",15,665,30,1,354,1050,6,1056
"خراسان_رضوی","فریمان","مرکزی",16,539,4,4,221,768,3,771
"خراسان_رضوی","فریمان","مرکزی",17,881,15,1,461,1358,7,1365
"خراسان_رضوی","فریمان","مرکزی",18,211,5,0,112,328,2,330
"خراسان_رضوی","فریمان","مرکزی",19,459,4,0,117,580,3,583
"خراسان_رضوی","فریمان","مرکزی",20,172,12,0,61,245,0,245
"خراسان_رضوی","فریمان","مرکزی",21,411,2,1,35,449,0,449
"خراسان_رضوی","فریمان","مرکزی",22,729,5,2,113,849,2,851
"خراسان_رضوی","فریمان","مرکزی",23,541,7,0,79,627,0,627
"خراسان_رضوی","فریمان","مرکزی",24,804,9,0,28,841,0,841
"خراسان_رضوی","فریمان","مرکزی",25,750,8,0,45,803,2,805
"خراسان_رضوی","فریمان","مرکزی",26,423,0,0,57,480,2,482
"خراسان_رضوی","فریمان","مرکزی",27,266,8,0,58,332,1,333
"خراسان_رضوی","فریمان","مرکزی",28,379,6,3,4,392,1,393
"خراسان_رضوی","فریمان","مرکزی",29,473,1,0,235,709,5,714
"خراسان_رضوی","فریمان","مرکزی",30,321,1,0,79,401,2,403
"خراسان_رضوی","فریمان","مرکزی",31,950,3,0,35,988,0,988
"خراسان_رضوی","فریمان","مرکزی",32,623,4,1,20,648,3,651
"خراسان_رضوی","فریمان","مرکزی",33,847,2,1,48,898,4,902
"خراسان_رضوی","فریمان","مرکزی",34,1118,9,1,180,1308,2,1310
"خراسان_رضوی","فریمان","مرکزی",35,630,6,3,158,797,3,800
"خراسان_رضوی","فریمان","مرکزی",36,767,7,1,64,839,2,841
"خراسان_رضوی","فریمان","مرکزی",37,540,1,1,33,575,0,575
"خراسان_رضوی","فریمان","مرکزی",38,281,10,1,96,388,2,390
"خراسان_رضوی","فریمان","مرکزی",39,371,5,1,40,417,2,419
"خراسان_رضوی","فریمان","مرکزی",40,449,4,0,62,515,3,518
"خراسان_رضوی","فریمان","مرکزی",41,726,6,1,28,761,2,763
"خراسان_رضوی","فریمان","مرکزی",42,985,1,0,57,1043,1,1044
"خراسان_رضوی","فریمان","مرکزی",43,933,2,2,48,985,1,986
"خراسان_رضوی","فریمان","مرکزی",44,340,6,0,30,376,0,376
"خراسان_رضوی","فریمان","مرکزی",45,545,5,3,47,600,0,600
"خراسان_رضوی","فریمان","مرکزی",46,556,5,0,39,600,1,601
"خراسان_رضوی","فریمان","مرکزی",47,677,8,0,42,727,1,728
"خراسان_رضوی","فریمان","قلندرآباد",1,992,24,0,65,1081,4,1085
"خراسان_رضوی","فریمان","قلندرآباد",2,438,4,0,69,511,1,512
"خراسان_رضوی","فریمان","قلندرآباد",3,208,8,0,20,236,1,237
"خراسان_رضوی","فریمان","قلندرآباد",4,221,10,1,49,281,2,283
"خراسان_رضوی","فریمان","قلندرآباد",5,862,3,1,157,1023,4,1027
"خراسان_رضوی","فریمان","قلندرآباد",6,798,1,2,145,946,3,949
"خراسان_رضوی","فریمان","قلندرآباد",7,720,0,0,146,866,0,866
"خراسان_رضوی","فریمان","قلندرآباد",8,481,5,0,19,505,3,508
"خراسان_رضوی","فریمان","قلندرآباد",9,329,4,0,29,362,0,362
"خراسان_رضوی","فریمان","قلندرآباد",10,1458,0,0,48,1506,4,1510
"خراسان_رضوی","فریمان","قلندرآباد",11,830,4,0,34,868,0,868
"خراسان_رضوی","فریمان","قلندرآباد",12,829,17,3,109,958,1,959
"خراسان_رضوی","فریمان","قلندرآباد",13,1266,7,2,153,1428,0,1428
"خراسان_رضوی","فریمان","قلندرآباد",14,684,0,9,192,885,3,888
"خراسان_رضوی","فریمان","قلندرآباد",15,505,1,1,102,609,2,611
"خراسان_رضوی","فریمان","قلندرآباد",16,207,0,1,5,213,0,213
"خراسان_رضوی","فریمان","قلندرآباد",17,945,1,0,13,959,2,961
"خراسان_رضوی","فریمان","قلندرآباد",18,466,1,1,61,529,5,534
"خراسان_رضوی","فریمان","قلندرآباد",19,364,0,0,36,400,0,400
"خراسان_رضوی","فریمان","قلندرآباد",20,132,1,0,29,162,0,162
"خراسان_رضوی","قوچان","مرکزی",1,810,26,2,331,1169,22,1191
"خراسان_رضوی","قوچان","مرکزی",2,628,19,10,356,1013,22,1035
"خراسان_رضوی","قوچان","مرکزی",3,681,26,7,445,1159,18,1177
"خراسان_رضوی","قوچان","مرکزی",4,593,12,7,255,867,19,886
"خراسان_رضوی","قوچان","مرکزی",5,797,1,5,113,916,13,929
"خراسان_رضوی","قوچان","مرکزی",6,568,19,13,386,986,27,1013
"خراسان_رضوی","قوچان","مرکزی",7,615,11,10,216,852,23,875
"خراسان_رضوی","قوچان","مرکزی",8,436,12,7,290,745,19,764
"خراسان_رضوی","قوچان","مرکزی",9,572,13,7,173,765,12,777
"خراسان_رضوی","قوچان","مرکزی",10,387,11,10,318,726,19,745
"خراسان_رضوی","قوچان","مرکزی",11,535,13,6,289,843,0,843
"خراسان_رضوی","قوچان","مرکزی",12,510,7,7,273,797,13,810
"خراسان_رضوی","قوچان","مرکزی",13,654,10,2,256,922,14,936
"خراسان_رضوی","قوچان","مرکزی",14,751,13,11,286,1061,15,1076
"خراسان_رضوی","قوچان","مرکزی",15,726,21,3,226,976,16,992
"خراسان_رضوی","قوچان","مرکزی",16,926,9,7,283,1225,35,1260
"خراسان_رضوی","قوچان","مرکزی",17,642,6,4,176,828,9,837
"خراسان_رضوی","قوچان","مرکزی",18,684,7,13,283,987,13,1000
"خراسان_رضوی","قوچان","مرکزی",19,465,11,1,199,676,13,689
"خراسان_رضوی","قوچان","مرکزی",20,613,9,2,131,755,13,768
"خراسان_رضوی","قوچان","مرکزی",21,802,16,11,447,1276,24,1300
"خراسان_رضوی","قوچان","مرکزی",22,642,13,2,267,924,19,943
"خراسان_رضوی","قوچان","مرکزی",23,302,8,9,297,616,11,627
"خراسان_رضوی","قوچان","مرکزی",24,330,6,7,198,541,8,549
"خراسان_رضوی","قوچان","مرکزی",25,626,21,7,437,1091,9,1100
"خراسان_رضوی","قوچان","مرکزی",26,483,30,11,291,815,22,837
"خراسان_رضوی","قوچان","مرکزی",27,458,23,8,230,719,14,733
"خراسان_رضوی","قوچان","مرکزی",28,462,17,13,489,981,25,1006
"خراسان_رضوی","قوچان","مرکزی",29,462,13,12,259,746,12,758
"خراسان_رضوی","قوچان","مرکزی",30,354,22,13,511,900,19,919
"خراسان_رضوی","قوچان","مرکزی",31,368,17,4,353,742,14,756
"خراسان_رضوی","قوچان","مرکزی",32,423,18,21,338,800,11,811
"خراسان_رضوی","قوچان","مرکزی",33,624,11,10,302,947,14,961
"خراسان_رضوی","قوچان","مرکزی",34,579,12,7,339,937,14,951
"خراسان_رضوی","قوچان","مرکزی",35,724,16,5,253,998,10,1008
"خراسان_رضوی","قوچان","مرکزی",36,496,20,7,367,890,27,917
"خراسان_رضوی","قوچان","مرکزی",37,708,18,4,311,1041,11,1052
"خراسان_رضوی","قوچان","مرکزی",38,511,21,5,293,830,18,848
"خراسان_رضوی","قوچان","مرکزی",39,644,9,5,216,874,7,881
"خراسان_رضوی","قوچان","مرکزی",40,829,8,4,289,1130,16,1146
"خراسان_رضوی","قوچان","مرکزی",41,501,7,5,154,667,4,671
"خراسان_رضوی","قوچان","مرکزی",42,390,4,4,156,554,5,559
"خراسان_رضوی","قوچان","مرکزی",43,415,21,20,332,788,12,800
"خراسان_رضوی","قوچان","مرکزی",44,626,8,12,339,985,16,1001
"خراسان_رضوی","قوچان","مرکزی",45,732,16,6,279,1033,16,1049
"خراسان_رضوی","قوچان","مرکزی",46,372,10,4,194,580,7,587
"خراسان_رضوی","قوچان","مرکزی",47,528,10,8,172,718,7,725
"خراسان_رضوی","قوچان","مرکزی",48,631,4,6,296,937,17,954
"خراسان_رضوی","قوچان","مرکزی",49,506,14,16,379,915,18,933
"خراسان_رضوی","قوچان","مرکزی",50,520,10,8,304,842,15,857
"خراسان_رضوی","قوچان","مرکزی",51,236,11,14,463,724,17,741
"خراسان_رضوی","قوچان","مرکزی",52,309,10,13,416,748,9,757
"خراسان_رضوی","قوچان","مرکزی",53,224,10,12,229,475,6,481
"خراسان_رضوی","قوچان","مرکزی",54,316,10,2,203,531,5,536
"خراسان_رضوی","قوچان","مرکزی",55,375,6,0,143,524,14,538
"خراسان_رضوی","قوچان","مرکزی",56,869,16,15,400,1300,29,1329
"خراسان_رضوی","قوچان","مرکزی",57,528,11,9,206,754,3,757
"خراسان_رضوی","قوچان","مرکزی",58,784,18,4,373,1179,17,1196
"خراسان_رضوی","قوچان","مرکزی",59,929,9,4,118,1060,13,1073
"خراسان_رضوی","قوچان","مرکزی",60,697,7,2,157,863,17,880
"خراسان_رضوی","قوچان","مرکزی",61,978,13,12,216,1219,31,1250
"خراسان_رضوی","قوچان","مرکزی",62,386,18,3,307,714,15,729
"خراسان_رضوی","قوچان","مرکزی",63,512,13,2,235,762,10,772
"خراسان_رضوی","قوچان","مرکزی",64,146,5,1,57,209,1,210
"خراسان_رضوی","قوچان","مرکزی",65,218,5,3,85,311,4,315
"خراسان_رضوی","قوچان","مرکزی",66,795,8,3,107,913,27,940
"خراسان_رضوی","قوچان","مرکزی",67,1113,18,6,143,1280,20,1300
"خراسان_رضوی","قوچان","مرکزی",68,406,1,1,78,486,3,489
"خراسان_رضوی","قوچان","مرکزی",69,441,0,2,25,468,9,477
"خراسان_رضوی","قوچان","مرکزی",70,563,1,2,26,592,6,598
"خراسان_رضوی","قوچان","مرکزی",71,583,2,0,50,635,0,635
"خراسان_رضوی","قوچان","مرکزی",72,333,2,1,34,370,12,382
"خراسان_رضوی","قوچان","مرکزی",73,706,3,1,46,756,44,800
"خراسان_رضوی","قوچان","مرکزی",74,634,2,2,28,666,10,676
"خراسان_رضوی","قوچان","مرکزی",75,886,2,0,48,936,10,946
"خراسان_رضوی","قوچان","مرکزی",76,872,0,3,48,923,19,942
"خراسان_رضوی","قوچان","مرکزی",77,517,6,0,59,582,18,600
"خراسان_رضوی","قوچان","مرکزی",78,405,1,2,23,431,11,442
"خراسان_رضوی","قوچان","مرکزی",79,378,3,0,37,418,14,432
"خراسان_رضوی","قوچان","مرکزی",80,406,5,0,38,449,6,455
"خراسان_رضوی","قوچان","مرکزی",81,359,5,1,25,390,2,392
"خراسان_رضوی","قوچان","مرکزی",82,488,4,3,34,529,4,533
"خراسان_رضوی","قوچان","مرکزی",83,441,0,0,65,506,5,511
"خراسان_رضوی","قوچان","مرکزی",84,446,2,2,57,507,5,512
"خراسان_رضوی","قوچان","مرکزی",85,510,3,1,113,627,16,643
"خراسان_رضوی","قوچان","مرکزی",86,270,1,0,104,375,4,379
"خراسان_رضوی","قوچان","مرکزی",87,843,6,8,58,915,17,932
"خراسان_رضوی","قوچان","مرکزی",88,835,6,4,80,925,17,942
"خراسان_رضوی","قوچان","مرکزی",89,651,3,0,179,833,12,845
"خراسان_رضوی","قوچان","مرکزی",90,486,2,2,67,557,7,564
"خراسان_رضوی","قوچان","مرکزی",91,719,3,1,69,792,8,800
"خراسان_رضوی","قوچان","مرکزی",92,705,10,0,72,787,18,805
"خراسان_رضوی","قوچان","مرکزی",93,636,3,0,72,711,15,726
"خراسان_رضوی","قوچان","مرکزی",94,277,0,0,41,318,9,327
"خراسان_رضوی","قوچان","مرکزی",95,644,7,0,52,703,7,710
"خراسان_رضوی","قوچان","مرکزی",96,510,2,1,73,586,11,597
"خراسان_رضوی","قوچان","مرکزی",97,676,2,0,40,718,14,732
"خراسان_رضوی","قوچان","مرکزی",98,463,2,0,97,562,7,569
"خراسان_رضوی","قوچان","مرکزی",99,293,1,0,49,343,2,345
"خراسان_رضوی","قوچان","مرکزی",100,246,0,0,28,274,21,295
"خراسان_رضوی","قوچان","مرکزی",101,249,2,1,31,283,1,284
"خراسان_رضوی","قوچان","مرکزی",102,975,5,1,91,1072,24,1096
"خراسان_رضوی","قوچان","مرکزی",103,621,4,2,79,706,25,731
"خراسان_رضوی","قوچان","مرکزی",104,615,10,5,65,695,10,705
"خراسان_رضوی","قوچان","مرکزی",105,714,4,3,141,862,12,874
"خراسان_رضوی","قوچان","مرکزی",106,411,0,4,28,443,7,450
"خراسان_رضوی","قوچان","مرکزی",107,405,2,0,42,449,15,464
"خراسان_رضوی","قوچان","مرکزی",108,515,0,0,67,582,17,599
"خراسان_رضوی","قوچان","مرکزی",109,343,0,2,98,443,11,454
"خراسان_رضوی","قوچان","مرکزی",110,655,1,4,129,789,11,800
"خراسان_رضوی","قوچان","مرکزی",111,215,0,0,18,233,1,234
"خراسان_رضوی","قوچان","مرکزی",112,305,1,0,26,332,4,336
"خراسان_رضوی","قوچان","مرکزی",113,369,3,0,15,387,1,388
"خراسان_رضوی","قوچان","مرکزی",114,254,1,0,19,274,7,281
"خراسان_رضوی","قوچان","مرکزی",115,356,0,0,34,390,3,393
"خراسان_رضوی","قوچان","مرکزی",116,730,2,2,130,864,21,885
"خراسان_رضوی","قوچان","مرکزی",117,290,1,0,35,326,5,331
"خراسان_رضوی","قوچان","مرکزی",118,242,2,0,14,258,4,262
"خراسان_رضوی","قوچان","مرکزی",119,504,0,2,43,549,6,555
"خراسان_رضوی","قوچان","مرکزی",120,256,5,0,13,274,5,279
"خراسان_رضوی","قوچان","مرکزی",121,641,4,0,53,698,26,724
"خراسان_رضوی","قوچان","مرکزی",122,431,1,0,41,473,4,477
"خراسان_رضوی","قوچان","مرکزی",123,391,1,7,59,458,3,461
"خراسان_رضوی","قوچان","مرکزی",124,609,2,1,58,670,14,684
"خراسان_رضوی","قوچان","مرکزی",125,140,1,1,29,171,0,171
"خراسان_رضوی","قوچان","مرکزی",126,168,1,0,12,181,2,183
"خراسان_رضوی","قوچان","مرکزی",127,276,1,6,31,314,2,316
"خراسان_رضوی","قوچان","مرکزی",128,289,2,0,55,346,3,349
"خراسان_رضوی","قوچان","مرکزی",129,137,0,0,12,149,0,149
"خراسان_رضوی","قوچان","مرکزی",130,597,3,0,82,682,5,687
"خراسان_رضوی","قوچان","مرکزی",131,296,1,1,31,329,1,330
"خراسان_رضوی","قوچان","مرکزی",132,272,3,0,59,334,6,340
"خراسان_رضوی","قوچان","مرکزی",133,245,1,3,40,289,8,297
"خراسان_رضوی","قوچان","مرکزی",134,359,1,3,85,448,39,487
"خراسان_رضوی","قوچان","مرکزی",135,141,4,2,73,220,6,226
"خراسان_رضوی","قوچان","مرکزی",136,103,3,0,45,151,3,154
"خراسان_رضوی","قوچان","مرکزی",137,188,1,0,46,235,1,236
"خراسان_رضوی","قوچان","باجگیران",1,408,6,1,114,529,3,532
"خراسان_رضوی","قوچان","باجگیران",2,129,0,1,20,150,0,150
"خراسان_رضوی","قوچان","باجگیران",3,348,1,1,64,414,8,422
"خراسان_رضوی","قوچان","باجگیران",4,218,0,0,13,231,0,231
"خراسان_رضوی","قوچان","باجگیران",5,329,1,0,25,355,6,361
"خراسان_رضوی","قوچان","باجگیران",6,429,5,2,98,534,16,550
"خراسان_رضوی","قوچان","باجگیران",7,133,0,1,31,165,2,167
"خراسان_رضوی","قوچان","باجگیران",8,285,0,2,26,313,2,315
"خراسان_رضوی","قوچان","باجگیران",9,330,0,0,55,385,11,396
"خراسان_رضوی","قوچان","باجگیران",10,459,0,1,26,486,3,489
"خراسان_رضوی","قوچان","باجگیران",11,392,1,1,23,417,3,420
"خراسان_رضوی","قوچان","باجگیران",12,250,3,0,33,286,2,288
"خراسان_رضوی","قوچان","باجگیران",13,343,1,1,79,424,4,428
"خراسان_رضوی","قوچان","باجگیران",14,238,4,0,12,254,2,256
"خراسان_رضوی","قوچان","باجگیران",15,486,1,0,16,503,2,505
"خراسان_رضوی","قوچان","باجگیران",16,113,0,0,25,138,0,138
"خراسان_رضوی","کاشمر","مرکزی",1,642,16,3,481,1142,12,1154
"خراسان_رضوی","کاشمر","مرکزی",2,447,22,8,514,991,17,1008
"خراسان_رضوی","کاشمر","مرکزی",3,789,20,15,735,1559,13,1572
"خراسان_رضوی","کاشمر","مرکزی",4,686,22,9,616,1333,0,1333
"خراسان_رضوی","کاشمر","مرکزی",5,1039,25,2,516,1582,16,1598
"خراسان_رضوی","کاشمر","مرکزی",6,673,17,5,287,982,14,996
"خراسان_رضوی","کاشمر","مرکزی",7,947,14,8,453,1422,5,1427
"خراسان_رضوی","کاشمر","مرکزی",8,880,8,9,218,1115,9,1124
"خراسان_رضوی","کاشمر","مرکزی",9,824,5,2,266,1097,12,1109
"خراسان_رضوی","کاشمر","مرکزی",10,1181,16,2,239,1438,18,1456
"خراسان_رضوی","کاشمر","مرکزی",11,868,8,2,301,1179,7,1186
"خراسان_رضوی","کاشمر","مرکزی",12,667,12,4,323,1006,10,1016
"خراسان_رضوی","کاشمر","مرکزی",13,888,18,6,495,1407,11,1418
"خراسان_رضوی","کاشمر","مرکزی",14,563,16,5,319,903,13,916
"خراسان_رضوی","کاشمر","مرکزی",15,980,16,4,353,1353,10,1363
"خراسان_رضوی","کاشمر","مرکزی",16,337,12,4,185,538,9,547
"خراسان_رضوی","کاشمر","مرکزی",17,1267,23,4,654,1948,25,1973
"خراسان_رضوی","کاشمر","مرکزی",18,989,20,12,490,1511,17,1528
"خراسان_رضوی","کاشمر","مرکزی",19,1154,12,2,371,1539,9,1548
"خراسان_رضوی","کاشمر","مرکزی",20,1239,24,9,588,1860,12,1872
"خراسان_رضوی","کاشمر","مرکزی",21,669,15,6,410,1100,16,1116
"خراسان_رضوی","کاشمر","مرکزی",22,770,10,3,336,1119,5,1124
"خراسان_رضوی","کاشمر","مرکزی",23,1060,24,7,400,1491,9,1500
"خراسان_رضوی","کاشمر","مرکزی",24,370,23,1,379,773,14,787
"خراسان_رضوی","کاشمر","مرکزی",25,506,25,10,540,1081,16,1097
"خراسان_رضوی","کاشمر","مرکزی",26,1045,33,11,735,1824,13,1837
"خراسان_رضوی","کاشمر","مرکزی",27,1233,25,4,619,1881,16,1897
"خراسان_رضوی","کاشمر","مرکزی",28,945,28,12,628,1613,19,1632
"خراسان_رضوی","کاشمر","مرکزی",29,966,38,4,647,1655,15,1670
"خراسان_رضوی","کاشمر","مرکزی",30,982,51,5,609,1647,13,1660
"خراسان_رضوی","کاشمر","مرکزی",31,633,32,7,505,1177,11,1188
"خراسان_رضوی","کاشمر","مرکزی",32,640,26,3,611,1280,18,1298
"خراسان_رضوی","کاشمر","مرکزی",33,896,17,1,264,1178,13,1191
"خراسان_رضوی","کاشمر","مرکزی",34,1026,43,3,605,1677,13,1690
"خراسان_رضوی","کاشمر","مرکزی",35,1011,15,5,379,1410,8,1418
"خراسان_رضوی","کاشمر","مرکزی",36,841,29,4,270,1144,8,1152
"خراسان_رضوی","کاشمر","مرکزی",37,562,30,7,569,1168,14,1182
"خراسان_رضوی","کاشمر","مرکزی",38,179,5,3,83,270,3,273
"خراسان_رضوی","کاشمر","مرکزی",39,162,2,1,89,254,3,257
"خراسان_رضوی","کاشمر","مرکزی",40,840,2,8,135,985,10,995
"خراسان_رضوی","کاشمر","مرکزی",41,770,5,0,95,870,2,872
"خراسان_رضوی","کاشمر","مرکزی",42,511,2,1,60,574,1,575
"خراسان_رضوی","کاشمر","مرکزی",43,1107,5,5,101,1218,6,1224
"خراسان_رضوی","کاشمر","مرکزی",44,911,2,0,52,965,3,968
"خراسان_رضوی","کاشمر","مرکزی",45,1085,12,3,115,1215,3,1218
"خراسان_رضوی","کاشمر","مرکزی",46,656,3,0,45,704,1,705
"خراسان_رضوی","کاشمر","مرکزی",47,736,2,0,150,888,2,890
"خراسان_رضوی","کاشمر","مرکزی",48,908,5,7,162,1082,6,1088
"خراسان_رضوی","کاشمر","مرکزی",49,1128,2,2,235,1367,13,1380
"خراسان_رضوی","کاشمر","مرکزی",50,939,5,4,170,1118,16,1134
"خراسان_رضوی","کاشمر","مرکزی",51,706,2,0,135,843,8,851
"خراسان_رضوی","کاشمر","مرکزی",52,875,4,3,86,968,7,975
"خراسان_رضوی","کاشمر","مرکزی",53,1429,7,11,67,1514,7,1521
"خراسان_رضوی","کاشمر","مرکزی",54,979,3,1,107,1090,4,1094
"خراسان_رضوی","کاشمر","مرکزی",55,1038,2,2,108,1150,2,1152
"خراسان_رضوی","کاشمر","مرکزی",56,412,0,0,62,474,1,475
"خراسان_رضوی","کاشمر","مرکزی",57,1241,3,0,130,1374,6,1380
"خراسان_رضوی","کاشمر","مرکزی",58,804,2,1,116,923,6,929
"خراسان_رضوی","کاشمر","مرکزی",59,405,5,0,63,473,1,474
"خراسان_رضوی","کاشمر","مرکزی",60,311,3,0,36,350,1,351
"خراسان_رضوی","کاشمر","مرکزی",61,755,8,1,96,860,2,862
"خراسان_رضوی","کاشمر","مرکزی",62,854,2,1,87,944,2,946
"خراسان_رضوی","کاشمر","مرکزی",63,665,6,1,60,732,1,733
"خراسان_رضوی","کاشمر","مرکزی",64,874,1,6,73,954,4,958
"خراسان_رضوی","کاشمر","مرکزی",65,545,5,2,153,705,2,707
"خراسان_رضوی","کاشمر","مرکزی",66,503,3,3,104,613,0,613
"خراسان_رضوی","کاشمر","کوهسرخ",1,1146,8,3,104,1261,8,1269
"خراسان_رضوی","کاشمر","کوهسرخ",2,849,7,2,147,1005,4,1009
"خراسان_رضوی","کاشمر","کوهسرخ",3,543,4,2,157,706,6,712
"خراسان_رضوی","کاشمر","کوهسرخ",4,1146,4,2,85,1237,3,1240
"خراسان_رضوی","کاشمر","کوهسرخ",5,488,0,0,63,551,1,552
"خراسان_رضوی","کاشمر","کوهسرخ",6,627,2,2,51,682,2,684
"خراسان_رضوی","کاشمر","کوهسرخ",7,332,0,0,25,357,1,358
"خراسان_رضوی","کاشمر","کوهسرخ",8,311,1,2,37,351,1,352
"خراسان_رضوی","کاشمر","کوهسرخ",9,1234,4,4,48,1290,3,1293
"خراسان_رضوی","کاشمر","کوهسرخ",10,1193,3,1,66,1263,1,1264
"خراسان_رضوی","کاشمر","کوهسرخ",11,1322,3,1,50,1376,5,1381
"خراسان_رضوی","کاشمر","کوهسرخ",12,500,5,3,143,651,5,656
"خراسان_رضوی","کاشمر","کوهسرخ",13,750,5,3,22,780,4,784
"خراسان_رضوی","کاشمر","کوهسرخ",14,687,3,3,54,747,4,751
"خراسان_رضوی","کاشمر","کوهسرخ",15,982,2,5,113,1102,1,1103
"خراسان_رضوی","کاشمر","کوهسرخ",16,713,2,1,23,739,0,739
"خراسان_رضوی","کاشمر","کوهسرخ",17,858,4,2,55,919,0,919
"خراسان_رضوی","کاشمر","کوهسرخ",18,701,2,3,51,757,1,758
"خراسان_رضوی","کاشمر","کوهسرخ",19,297,0,2,21,320,2,322
"خراسان_رضوی","کاشمر","کوهسرخ",20,646,2,0,55,703,1,704
"خراسان_رضوی","کاشمر","کوهسرخ",21,254,2,1,45,302,2,304
"خراسان_رضوی","کلات","مرکزی",1,535,1,4,255,795,3,798
"خراسان_رضوی","کلات","مرکزی",2,298,0,2,50,350,1,351
"خراسان_رضوی","کلات","مرکزی",3,480,9,0,245,734,4,738
"خراسان_رضوی","کلات","مرکزی",4,539,4,0,199,742,5,747
"خراسان_رضوی","کلات","مرکزی",5,410,1,0,52,463,2,465
"خراسان_رضوی","کلات","مرکزی",6,347,0,0,19,366,1,367
"خراسان_رضوی","کلات","مرکزی",7,157,7,0,68,232,3,235
"خراسان_رضوی","کلات","مرکزی",8,346,1,1,62,410,5,415
"خراسان_رضوی","کلات","مرکزی",9,422,0,1,52,475,1,476
"خراسان_رضوی","کلات","مرکزی",10,469,3,0,187,659,3,662
"خراسان_رضوی","کلات","مرکزی",11,614,9,0,151,774,0,774
"خراسان_رضوی","کلات","مرکزی",12,400,1,1,71,473,0,473
"خراسان_رضوی","کلات","مرکزی",13,441,0,2,18,461,2,463
"خراسان_رضوی","کلات","مرکزی",14,497,0,3,29,529,0,529
"خراسان_رضوی","کلات","مرکزی",15,211,1,0,18,230,1,231
"خراسان_رضوی","کلات","مرکزی",16,373,3,0,30,406,3,409
"خراسان_رضوی","کلات","مرکزی",17,194,0,0,9,203,0,203
"خراسان_رضوی","کلات","مرکزی",18,586,1,0,42,629,2,631
"خراسان_رضوی","کلات","مرکزی",19,191,0,0,28,219,2,221
"خراسان_رضوی","کلات","مرکزی",20,472,3,1,20,496,0,496
"خراسان_رضوی","کلات","مرکزی",21,301,1,1,41,344,3,347
"خراسان_رضوی","کلات","مرکزی",22,615,1,0,14,630,0,630
"خراسان_رضوی","کلات","مرکزی",23,274,1,0,17,292,0,292
"خراسان_رضوی","کلات","مرکزی",24,287,3,0,43,333,0,333
"خراسان_رضوی","کلات","مرکزی",25,195,1,1,59,256,1,257
"خراسان_رضوی","کلات","مرکزی",26,434,4,1,51,490,3,493
"خراسان_رضوی","کلات","مرکزی",27,313,1,0,66,380,0,380
"خراسان_رضوی","کلات","مرکزی",28,483,2,2,78,565,1,566
"خراسان_رضوی","کلات","مرکزی",1,605,5,0,83,693,6,699
"خراسان_رضوی","کلات","زاوین",2,741,1,0,66,808,2,810
"خراسان_رضوی","کلات","زاوین",3,757,1,1,40,799,0,799
"خراسان_رضوی","کلات","زاوین",4,551,4,0,122,677,1,678
"خراسان_رضوی","کلات","زاوین",5,83,0,2,11,96,0,96
"خراسان_رضوی","کلات","زاوین",6,847,12,0,87,946,6,952
"خراسان_رضوی","کلات","زاوین",7,426,1,1,4,432,1,433
"خراسان_رضوی","کلات","زاوین",8,625,2,1,28,656,0,656
"خراسان_رضوی","کلات","زاوین",9,699,1,0,13,713,0,713
"خراسان_رضوی","کلات","زاوین",10,559,1,0,6,566,0,566
"خراسان_رضوی","کلات","زاوین",11,253,0,0,5,258,1,259
"خراسان_رضوی","کلات","زاوین",12,103,0,0,15,118,0,118
"خراسان_رضوی","کلات","زاوین",13,717,0,1,73,791,0,791
"خراسان_رضوی","کلات","زاوین",14,304,3,2,18,327,2,329
"خراسان_رضوی","کلات","زاوین",15,196,0,0,5,201,0,201
"خراسان_رضوی","کلات","زاوین",16,421,1,0,22,444,2,446
"خراسان_رضوی","کلات","زاوین",17,314,1,3,62,380,0,380
"خراسان_رضوی","کلات","زاوین",18,559,3,0,43,605,0,605
"خراسان_رضوی","گناباد","مرکزی",1,1002,34,5,604,1645,12,1657
"خراسان_رضوی","گناباد","مرکزی",2,733,15,1,321,1070,2,1072
"خراسان_رضوی","گناباد","مرکزی",3,128,1,4,91,224,0,224
"خراسان_رضوی","گناباد","مرکزی",4,352,10,0,279,641,10,651
"خراسان_رضوی","گناباد","مرکزی",5,363,8,1,236,608,9,617
"خراسان_رضوی","گناباد","مرکزی",6,520,12,3,322,857,5,862
"خراسان_رضوی","گناباد","مرکزی",7,551,13,1,244,809,7,816
"خراسان_رضوی","گناباد","مرکزی",8,425,0,0,50,475,4,479
"خراسان_رضوی","گناباد","مرکزی",9,734,8,4,337,1083,7,1090
"خراسان_رضوی","گناباد","مرکزی",10,547,8,4,127,686,6,692
"خراسان_رضوی","گناباد","مرکزی",11,375,33,7,487,902,11,913
"خراسان_رضوی","گناباد","مرکزی",12,373,12,1,178,564,5,569
"خراسان_رضوی","گناباد","مرکزی",13,615,24,3,412,1054,4,1058
"خراسان_رضوی","گناباد","مرکزی",14,863,23,3,523,1412,7,1419
"خراسان_رضوی","گناباد","مرکزی",15,962,8,5,415,1390,5,1395
"خراسان_رضوی","گناباد","مرکزی",16,435,11,1,176,623,5,628
"خراسان_رضوی","گناباد","مرکزی",17,350,10,5,210,575,2,577
"خراسان_رضوی","گناباد","مرکزی",18,387,8,4,256,655,2,657
"خراسان_رضوی","گناباد","مرکزی",19,725,13,0,133,871,5,876
"خراسان_رضوی","گناباد","مرکزی",20,573,18,2,447,1040,19,1059
"خراسان_رضوی","گناباد","مرکزی",21,609,4,2,186,801,5,806
"خراسان_رضوی","گناباد","مرکزی",22,560,10,6,266,842,4,846
"خراسان_رضوی","گناباد","مرکزی",23,591,16,5,464,1076,5,1081
"خراسان_رضوی","گناباد","مرکزی",24,863,11,5,565,1444,11,1455
"خراسان_رضوی","گناباد","مرکزی",25,672,6,4,233,915,4,919
"خراسان_رضوی","گناباد","مرکزی",26,208,2,1,64,275,4,279
"خراسان_رضوی","گناباد","مرکزی",27,340,13,495,675,1523,3,1526
"خراسان_رضوی","گناباد","مرکزی",28,707,18,330,553,1608,2,1610
"خراسان_رضوی","گناباد","مرکزی",29,778,11,1,102,892,1,893
"خراسان_رضوی","گناباد","مرکزی",30,802,2,0,169,973,1,974
"خراسان_رضوی","گناباد","مرکزی",31,820,20,2,135,977,3,980
"خراسان_رضوی","گناباد","مرکزی",32,1222,10,2,139,1373,4,1377
"خراسان_رضوی","گناباد","مرکزی",33,724,4,0,52,780,4,784
"خراسان_رضوی","گناباد","مرکزی",34,658,5,0,77,740,3,743
"خراسان_رضوی","گناباد","مرکزی",35,911,16,8,222,1157,7,1164
"خراسان_رضوی","گناباد","مرکزی",36,759,6,8,180,953,6,959
"خراسان_رضوی","گناباد","مرکزی",37,672,6,1,160,839,5,844
"خراسان_رضوی","گناباد","مرکزی",38,910,3,0,89,1002,4,1006
"خراسان_رضوی","گناباد","مرکزی",39,982,13,4,162,1161,1,1162
"خراسان_رضوی","گناباد","مرکزی",40,957,6,4,112,1079,1,1080
"خراسان_رضوی","گناباد","مرکزی",41,691,6,2,66,765,1,766
"خراسان_رضوی","گناباد","مرکزی",42,292,1,15,100,408,0,408
"خراسان_رضوی","گناباد","مرکزی",43,1159,2,0,26,1187,3,1190
"خراسان_رضوی","گناباد","مرکزی",44,913,1,2,52,968,2,970
"خراسان_رضوی","گناباد","مرکزی",45,399,0,0,10,409,0,409
"خراسان_رضوی","گناباد","مرکزی",46,85,0,2,17,104,0,104
"خراسان_رضوی","گناباد","مرکزی",47,176,0,0,11,187,1,188
"خراسان_رضوی","گناباد","کاخک",1,724,11,2,245,982,6,988
"خراسان_رضوی","گناباد","کاخک",2,511,11,1,132,655,4,659
"خراسان_رضوی","گناباد","کاخک",3,1038,12,3,253,1306,11,1317
"خراسان_رضوی","گناباد","کاخک",4,355,4,1,24,384,0,384
"خراسان_رضوی","گناباد","کاخک",5,376,4,2,84,466,1,467
"خراسان_رضوی","گناباد","کاخک",6,223,0,0,20,243,1,244
"خراسان_رضوی","گناباد","کاخک",7,313,2,2,62,379,5,384
"خراسان_رضوی","گناباد","کاخک",8,249,7,4,128,388,0,388
"خراسان_رضوی","گناباد","کاخک",9,280,3,1,46,330,0,330
"خراسان_رضوی","گناباد","کاخک",10,186,1,0,27,214,7,221
"خراسان_رضوی","گناباد","کاخک",11,642,4,2,60,708,7,715
"خراسان_رضوی","گناباد","کاخک",12,623,2,1,71,697,2,699
"خراسان_رضوی","گناباد","کاخک",13,734,3,0,166,903,1,904
"خراسان_رضوی","گناباد","کاخک",14,512,0,0,40,552,1,553
"خراسان_رضوی","گناباد","کاخک",15,745,9,0,72,826,5,831
"خراسان_رضوی","گناباد","کاخک",16,453,8,0,44,505,5,510
"خراسان_رضوی","گناباد","کاخک",17,374,2,0,38,414,0,414
"خراسان_رضوی","مشهد","احمدآباد",1,734,6,3,123,866,4,870
"خراسان_رضوی","مشهد","احمدآباد",2,1097,23,1,317,1438,18,1456
"خراسان_رضوی","مشهد","احمدآباد",3,1026,15,1,281,1323,8,1331
"خراسان_رضوی","مشهد","احمدآباد",4,470,4,1,159,634,2,636
"خراسان_رضوی","مشهد","احمدآباد",5,546,2,0,29,577,0,577
"خراسان_رضوی","مشهد","احمدآباد",6,620,17,4,250,891,9,900
"خراسان_رضوی","مشهد","احمدآباد",7,690,13,3,134,840,1,841
"خراسان_رضوی","مشهد","احمدآباد",8,396,3,0,89,488,4,492
"خراسان_رضوی","مشهد","احمدآباد",9,550,1,0,38,589,2,591
"خراسان_رضوی","مشهد","احمدآباد",10,509,3,1,20,533,0,533
"خراسان_رضوی","مشهد","احمدآباد",11,494,2,2,150,648,0,648
"خراسان_رضوی","مشهد","احمدآباد",12,736,6,0,203,945,5,950
"خراسان_رضوی","مشهد","احمدآباد",13,994,7,2,299,1302,2,1304
"خراسان_رضوی","مشهد","احمدآباد",14,523,5,2,76,606,2,608
"خراسان_رضوی","مشهد","احمدآباد",15,658,5,0,48,711,2,713
"خراسان_رضوی","مشهد","احمدآباد",16,1173,5,0,133,1311,2,1313
"خراسان_رضوی","مشهد","احمدآباد",17,1108,11,0,44,1163,0,1163
"خراسان_رضوی","مشهد","احمدآباد",18,405,0,0,72,477,1,478
"خراسان_رضوی","مشهد","احمدآباد",19,163,6,0,63,232,1,233
"خراسان_رضوی","مشهد","احمدآباد",20,353,2,1,188,544,0,544
"خراسان_رضوی","مشهد","احمدآباد",21,548,8,2,157,715,5,720
"خراسان_رضوی","مشهد","احمدآباد",22,318,1,0,28,347,1,348
"خراسان_رضوی","مشهد","احمدآباد",23,503,3,0,72,578,1,579
"خراسان_رضوی","مشهد","احمدآباد",24,888,2,0,118,1008,2,1010
"خراسان_رضوی","مشهد","احمدآباد",25,912,10,3,174,1099,11,1110
"خراسان_رضوی","مشهد","احمدآباد",26,155,1,1,227,384,1,385
"خراسان_رضوی","مشهد","احمدآباد",27,99,1,0,12,112,2,114
"خراسان_رضوی","مشهد","احمدآباد",28,399,1,0,42,442,2,444
"خراسان_رضوی","مشهد","احمدآباد",29,562,3,0,44,609,2,611
"خراسان_رضوی","مشهد","احمدآباد",30,714,9,0,117,840,2,842
"خراسان_رضوی","مشهد","احمدآباد",31,575,3,1,15,594,0,594
"خراسان_رضوی","مشهد","احمدآباد",32,660,7,0,58,725,4,729
"خراسان_رضوی","مشهد","احمدآباد",33,222,5,1,126,354,4,358
"خراسان_رضوی","مشهد","رضویه",1,672,3,1,22,698,0,698
"خراسان_رضوی","مشهد","رضویه",2,1006,2,0,135,1143,1,1144
"خراسان_رضوی","مشهد","رضویه",3,381,1,0,21,403,1,404
"خراسان_رضوی","مشهد","رضویه",4,1013,14,1,193,1221,3,1224
"خراسان_رضوی","مشهد","رضویه",5,1000,16,2,111,1129,3,1132
"خراسان_رضوی","مشهد","رضویه",6,1514,8,3,84,1609,2,1611
"خراسان_رضوی","مشهد","رضویه",7,894,8,0,70,972,5,977
"خراسان_رضوی","مشهد","رضویه",8,1170,11,0,148,1329,7,1336
"خراسان_رضوی","مشهد","رضویه",9,1064,2,0,61,1127,1,1128
"خراسان_رضوی","مشهد","رضویه",10,785,5,1,24,815,0,815
"خراسان_رضوی","مشهد","رضویه",11,919,8,1,95,1023,7,1030
"خراسان_رضوی","مشهد","رضویه",12,577,1,0,24,602,0,602
"خراسان_رضوی","مشهد","رضویه",13,982,4,3,394,1383,4,1387
"خراسان_رضوی","مشهد","رضویه",14,1021,9,3,185,1218,3,1221
"خراسان_رضوی","مشهد","رضویه",15,1091,3,0,127,1221,5,1226
"خراسان_رضوی","مشهد","رضویه",16,447,1,1,418,867,7,874
"خراسان_رضوی","مشهد","رضویه",17,727,7,3,242,979,3,982
"خراسان_رضوی","مشهد","رضویه",18,253,5,4,354,616,1,617
"خراسان_رضوی","مشهد","رضویه",19,513,2,0,19,534,0,534
"خراسان_رضوی","مشهد","رضویه",20,596,0,0,25,621,3,624
"خراسان_رضوی","مشهد","رضویه",21,773,3,1,56,833,2,835
"خراسان_رضوی","مشهد","رضویه",22,653,2,0,94,749,4,753
"خراسان_رضوی","مشهد","رضویه",23,961,6,0,43,1010,0,1010
"خراسان_رضوی","مشهد","رضویه",24,331,2,3,465,801,4,805
"خراسان_رضوی","مشهد","رضویه",25,862,1,0,73,936,0,936
"خراسان_رضوی","مشهد","رضویه",26,441,1,3,77,522,0,522
"خراسان_رضوی","مشهد","رضویه",27,532,0,1,33,566,4,570
"خراسان_رضوی","مشهد","رضویه",28,908,9,1,33,951,1,952
"خراسان_رضوی","مشهد","رضویه",29,653,1,0,33,687,1,688
"خراسان_رضوی","مشهد","رضویه",30,241,0,0,3,244,1,245
"خراسان_رضوی","مشهد","شهر_مشهد",1,622,34,5,261,922,12,934
"خراسان_رضوی","مشهد","شهر_مشهد",2,503,36,6,349,894,15,909
"خراسان_رضوی","مشهد","شهر_مشهد",3,1059,74,11,994,2138,25,2163
"خراسان_رضوی","مشهد","شهر_مشهد",4,1234,56,14,845,2149,16,2165
"خراسان_رضوی","مشهد","شهر_مشهد",5,1020,46,9,937,2012,25,2037
"خراسان_رضوی","مشهد","شهر_مشهد",6,1176,72,11,794,2053,23,2076
"خراسان_رضوی","مشهد","شهر_مشهد",7,668,70,35,1461,2234,14,2248
"خراسان_رضوی","مشهد","شهر_مشهد",8,926,86,24,1202,2238,31,2269
"خراسان_رضوی","مشهد","شهر_مشهد",9,482,55,21,1283,1841,12,1853
"خراسان_رضوی","مشهد","شهر_مشهد",10,636,70,27,1183,1916,20,1936
"خراسان_رضوی","مشهد","شهر_مشهد",11,525,61,37,1092,1715,5,1720
"خراسان_رضوی","مشهد","شهر_مشهد",12,844,76,28,1224,2172,30,2202
"خراسان_رضوی","مشهد","شهر_مشهد",13,1227,81,12,847,2167,26,2193
"خراسان_رضوی","مشهد","شهر_مشهد",14,803,52,19,1105,1979,38,2017
"خراسان_رضوی","مشهد","شهر_مشهد",15,1002,57,23,1064,2146,15,2161
"خراسان_رضوی","مشهد","شهر_مشهد",16,573,70,26,1378,2047,25,2072
"خراسان_رضوی","مشهد","شهر_مشهد",17,562,69,29,1502,2162,32,2194
"خراسان_رضوی","مشهد","شهر_مشهد",18,748,53,9,1068,1878,23,1901
"خراسان_رضوی","مشهد","شهر_مشهد",19,696,71,32,1346,2145,25,2170
"خراسان_رضوی","مشهد","شهر_مشهد",20,424,60,17,1116,1617,14,1631
"خراسان_رضوی","مشهد","شهر_مشهد",21,359,51,26,1503,1939,15,1954
"خراسان_رضوی","مشهد","شهر_مشهد",22,717,62,18,906,1703,10,1713
"خراسان_رضوی","مشهد","شهر_مشهد",23,727,69,18,1228,2042,26,2068
"خراسان_رضوی","مشهد","شهر_مشهد",24,823,66,18,1125,2032,33,2065
"خراسان_رضوی","مشهد","شهر_مشهد",25,969,109,20,1267,2365,33,2398
"خراسان_رضوی","مشهد","شهر_مشهد",26,491,48,24,1426,1989,14,2003
"خراسان_رضوی","مشهد","شهر_مشهد",27,439,47,35,1377,1898,21,1919
"خراسان_رضوی","مشهد","شهر_مشهد",28,847,100,16,767,1730,22,1752
"خراسان_رضوی","مشهد","شهر_مشهد",29,909,123,26,1082,2140,20,2160
"خراسان_رضوی","مشهد","شهر_مشهد",30,1150,69,19,875,2113,25,2138
"خراسان_رضوی","مشهد","شهر_مشهد",31,1030,78,15,962,2085,23,2108
"خراسان_رضوی","مشهد","شهر_مشهد",32,840,67,17,1120,2044,22,2066
"خراسان_رضوی","مشهد","شهر_مشهد",33,1150,76,11,715,1952,21,1973
"خراسان_رضوی","مشهد","شهر_مشهد",34,590,60,26,1324,2000,15,2015
"خراسان_رضوی","مشهد","شهر_مشهد",35,669,56,22,1344,2091,21,2112
"خراسان_رضوی","مشهد","شهر_مشهد",36,627,65,11,1233,1936,15,1951
"خراسان_رضوی","مشهد","شهر_مشهد",37,1204,64,12,1017,2297,18,2315
"خراسان_رضوی","مشهد","شهر_مشهد",38,989,54,24,1137,2204,17,2221
"خراسان_رضوی","مشهد","شهر_مشهد",39,605,72,31,1703,2411,21,2432
"خراسان_رضوی","مشهد","شهر_مشهد",40,794,82,25,1177,2078,29,2107
"خراسان_رضوی","مشهد","شهر_مشهد",41,709,68,35,1407,2219,24,2243
"خراسان_رضوی","مشهد","شهر_مشهد",42,571,41,23,1062,1697,8,1705
"خراسان_رضوی","مشهد","شهر_مشهد",43,406,48,18,1474,1946,20,1966
"خراسان_رضوی","مشهد","شهر_مشهد",44,648,57,20,1407,2132,20,2152
"خراسان_رضوی","مشهد","شهر_مشهد",45,646,55,39,1555,2295,15,2310
"خراسان_رضوی","مشهد","شهر_مشهد",46,673,66,28,1527,2294,25,2319
"خراسان_رضوی","مشهد","شهر_مشهد",47,854,103,47,2188,3192,31,3223
"خراسان_رضوی","مشهد","شهر_مشهد",48,351,34,64,2587,3036,17,3053
"خراسان_رضوی","مشهد","شهر_مشهد",49,297,36,48,2102,2483,14,2497
"خراسان_رضوی","مشهد","شهر_مشهد",50,284,26,31,1937,2278,22,2300
"خراسان_رضوی","مشهد","شهر_مشهد",51,254,33,50,1803,2140,19,2159
"خراسان_رضوی","مشهد","شهر_مشهد",52,1401,43,15,696,2155,21,2176
"خراسان_رضوی","مشهد","شهر_مشهد",53,324,44,40,1888,2296,19,2315
"خراسان_رضوی","مشهد","شهر_مشهد",54,433,28,5,364,830,24,854
"خراسان_رضوی","مشهد","شهر_مشهد",55,399,41,20,652,1112,9,1121
"خراسان_رضوی","مشهد","شهر_مشهد",56,695,40,7,664,1406,8,1414
"خراسان_رضوی","مشهد","شهر_مشهد",57,1098,81,5,876,2060,13,2073
"خراسان_رضوی","مشهد","شهر_مشهد",58,343,35,16,1220,1614,29,1643
"خراسان_رضوی","مشهد","شهر_مشهد",59,631,61,10,1041,1743,16,1759
"خراسان_رضوی","مشهد","شهر_مشهد",60,1144,48,5,560,1757,42,1799
"خراسان_رضوی","مشهد","شهر_مشهد",61,684,38,1,259,982,18,1000
"خراسان_رضوی","مشهد","شهر_مشهد",62,1268,37,5,481,1791,19,1810
"خراسان_رضوی","مشهد","شهر_مشهد",63,980,40,6,437,1463,36,1499
"خراسان_رضوی","مشهد","شهر_مشهد",64,1446,49,9,578,2082,25,2107
"خراسان_رضوی","مشهد","شهر_مشهد",65,1233,45,9,454,1741,37,1778
"خراسان_رضوی","مشهد","شهر_مشهد",66,806,43,6,408,1263,37,1300
"خراسان_رضوی","مشهد","شهر_مشهد",67,862,28,3,289,1182,11,1193
"خراسان_رضوی","مشهد","شهر_مشهد",68,1609,59,26,549,2243,25,2268
"خراسان_رضوی","مشهد","شهر_مشهد",69,1222,40,2,424,1688,19,1707
"خراسان_رضوی","مشهد","شهر_مشهد",70,1061,43,7,559,1670,29,1699
"خراسان_رضوی","مشهد","شهر_مشهد",71,1149,38,2,288,1477,25,1502
"خراسان_رضوی","مشهد","شهر_مشهد",72,1570,37,1,364,1972,17,1989
"خراسان_رضوی","مشهد","شهر_مشهد",73,1449,40,3,378,1870,18,1888
"خراسان_رضوی","مشهد","شهر_مشهد",74,1534,35,3,432,2004,27,2031
"خراسان_رضوی","مشهد","شهر_مشهد",75,1343,20,5,351,1719,13,1732
"خراسان_رضوی","مشهد","شهر_مشهد",76,1545,53,4,634,2236,18,2254
"خراسان_رضوی","مشهد","شهر_مشهد",77,2012,54,6,487,2559,23,2582
"خراسان_رضوی","مشهد","شهر_مشهد",78,965,42,9,406,1422,19,1441
"خراسان_رضوی","مشهد","شهر_مشهد",79,1496,77,4,612,2189,31,2220
"خراسان_رضوی","مشهد","شهر_مشهد",80,1227,69,10,839,2145,21,2166
"خراسان_رضوی","مشهد","شهر_مشهد",81,1348,69,2,586,2005,21,2026
"خراسان_رضوی","مشهد","شهر_مشهد",82,981,26,8,419,1434,21,1455
"خراسان_رضوی","مشهد","شهر_مشهد",83,1027,38,2,409,1476,28,1504
"خراسان_رضوی","مشهد","شهر_مشهد",84,1272,64,3,444,1783,23,1806
"خراسان_رضوی","مشهد","شهر_مشهد",85,1286,40,2,523,1851,17,1868
"خراسان_رضوی","مشهد","شهر_مشهد",86,1658,75,10,884,2627,27,2654
"خراسان_رضوی","مشهد","شهر_مشهد",87,1281,45,8,555,1889,16,1905
"خراسان_رضوی","مشهد","شهر_مشهد",88,1256,41,3,445,1745,20,1765
"خراسان_رضوی","مشهد","شهر_مشهد",89,1432,40,7,434,1913,7,1920
"خراسان_رضوی","مشهد","شهر_مشهد",90,1494,44,4,318,1860,62,1922
"خراسان_رضوی","مشهد","شهر_مشهد",91,1314,47,5,538,1904,13,1917
"خراسان_رضوی","مشهد","شهر_مشهد",92,1359,30,5,478,1872,8,1880
"خراسان_رضوی","مشهد","شهر_مشهد",93,1126,28,5,448,1607,14,1621
"خراسان_رضوی","مشهد","شهر_مشهد",94,1240,28,5,304,1577,20,1597
"خراسان_رضوی","مشهد","شهر_مشهد",95,1332,23,2,539,1896,23,1919
"خراسان_رضوی","مشهد","شهر_مشهد",96,1500,52,6,776,2334,28,2362
"خراسان_رضوی","مشهد","شهر_مشهد",97,1834,30,7,504,2375,21,2396
"خراسان_رضوی","مشهد","شهر_مشهد",98,1263,35,2,437,1737,16,1753
"خراسان_رضوی","مشهد","شهر_مشهد",99,1851,45,4,692,2592,22,2614
"خراسان_رضوی","مشهد","شهر_مشهد",100,1488,42,8,701,2239,17,2256
"خراسان_رضوی","مشهد","شهر_مشهد",101,1658,55,6,429,2148,23,2171
"خراسان_رضوی","مشهد","شهر_مشهد",102,1273,39,6,633,1951,19,1970
"خراسان_رضوی","مشهد","شهر_مشهد",103,1301,43,1,406,1751,22,1773
"خراسان_رضوی","مشهد","شهر_مشهد",104,1347,51,9,608,2015,18,2033
"خراسان_رضوی","مشهد","شهر_مشهد",105,1434,42,4,326,1806,11,1817
"خراسان_رضوی","مشهد","شهر_مشهد",106,1457,20,10,566,2053,25,2078
"خراسان_رضوی","مشهد","شهر_مشهد",107,1483,32,4,341,1860,16,1876
"خراسان_رضوی","مشهد","شهر_مشهد",108,1193,23,2,439,1657,19,1676
"خراسان_رضوی","مشهد","شهر_مشهد",109,1499,19,3,353,1874,20,1894
"خراسان_رضوی","مشهد","شهر_مشهد",110,1780,26,5,481,2292,17,2309
"خراسان_رضوی","مشهد","شهر_مشهد",111,1372,41,6,619,2038,20,2058
"خراسان_رضوی","مشهد","شهر_مشهد",112,1248,44,7,632,1931,15,1946
"خراسان_رضوی","مشهد","شهر_مشهد",113,1286,48,15,722,2071,20,2091
"خراسان_رضوی","مشهد","شهر_مشهد",114,1301,24,5,434,1764,15,1779
"خراسان_رضوی","مشهد","شهر_مشهد",115,1298,48,4,487,1837,14,1851
"خراسان_رضوی","مشهد","شهر_مشهد",116,1248,26,9,420,1703,17,1720
"خراسان_رضوی","مشهد","شهر_مشهد",117,1312,28,4,642,1986,14,2000
"خراسان_رضوی","مشهد","شهر_مشهد",118,1482,27,2,397,1908,14,1922
"خراسان_رضوی","مشهد","شهر_مشهد",119,2059,31,8,629,2727,15,2742
"خراسان_رضوی","مشهد","شهر_مشهد",120,1228,29,6,508,1771,12,1783
"خراسان_رضوی","مشهد","شهر_مشهد",121,1550,29,4,346,1929,8,1937
"خراسان_رضوی","مشهد","شهر_مشهد",122,1572,30,4,438,2044,12,2056
"خراسان_رضوی","مشهد","شهر_مشهد",123,1325,18,4,397,1744,9,1753
"خراسان_رضوی","مشهد","شهر_مشهد",124,1636,28,2,443,2109,23,2132
"خراسان_رضوی","مشهد","شهر_مشهد",125,1290,21,11,490,1812,11,1823
"خراسان_رضوی","مشهد","شهر_مشهد",126,1458,15,5,310,1788,17,1805
"خراسان_رضوی","مشهد","شهر_مشهد",127,1078,52,9,574,1713,19,1732
"خراسان_رضوی","مشهد","شهر_مشهد",128,813,26,8,330,1177,20,1197
"خراسان_رضوی","مشهد","شهر_مشهد",129,394,37,18,912,1361,14,1375
"خراسان_رضوی","مشهد","شهر_مشهد",130,1197,49,6,535,1787,25,1812
"خراسان_رضوی","مشهد","شهر_مشهد",131,1369,28,8,463,1868,9,1877
"خراسان_رضوی","مشهد","شهر_مشهد",132,725,80,20,1339,2164,21,2185
"خراسان_رضوی","مشهد","شهر_مشهد",133,730,71,16,1361,2178,19,2197
"خراسان_رضوی","مشهد","شهر_مشهد",134,984,75,11,1351,2421,28,2449
"خراسان_رضوی","مشهد","شهر_مشهد",135,548,56,31,1721,2356,22,2378
"خراسان_رضوی","مشهد","شهر_مشهد",136,671,47,25,1540,2283,31,2314
"خراسان_رضوی","مشهد","شهر_مشهد",137,1106,99,33,2064,3302,22,3324
"خراسان_رضوی","مشهد","شهر_مشهد",138,895,49,11,981,1936,16,1952
"خراسان_رضوی","مشهد","شهر_مشهد",139,1085,72,13,922,2092,25,2117
"خراسان_رضوی","مشهد","شهر_مشهد",140,1479,66,17,952,2514,30,2544
"خراسان_رضوی","مشهد","شهر_مشهد",141,432,44,11,669,1156,20,1176
"خراسان_رضوی","مشهد","شهر_مشهد",142,682,27,8,489,1206,11,1217
"خراسان_رضوی","مشهد","شهر_مشهد",143,536,15,0,185,736,5,741
"خراسان_رضوی","مشهد","شهر_مشهد",144,603,19,3,371,996,4,1000
"خراسان_رضوی","مشهد","شهر_مشهد",145,488,38,6,572,1104,13,1117
"خراسان_رضوی","مشهد","شهر_مشهد",146,940,12,0,202,1154,16,1170
"خراسان_رضوی","مشهد","شهر_مشهد",147,914,17,6,249,1186,4,1190
"خراسان_رضوی","مشهد","شهر_مشهد",148,1846,16,1,203,2066,15,2081
"خراسان_رضوی","مشهد","شهر_مشهد",149,1743,40,4,443,2230,20,2250
"خراسان_رضوی","مشهد","شهر_مشهد",150,1480,39,2,455,1976,23,1999
"خراسان_رضوی","مشهد","شهر_مشهد",151,1275,44,8,540,1867,29,1896
"خراسان_رضوی","مشهد","شهر_مشهد",152,1138,52,5,552,1747,24,1771
"خراسان_رضوی","مشهد","شهر_مشهد",153,836,29,3,267,1135,23,1158
"خراسان_رضوی","مشهد","شهر_مشهد",154,1217,34,6,492,1749,27,1776
"خراسان_رضوی","مشهد","شهر_مشهد",155,919,60,3,619,1601,19,1620
"خراسان_رضوی","مشهد","شهر_مشهد",156,1025,46,8,425,1504,17,1521
"خراسان_رضوی","مشهد","شهر_مشهد",157,1188,71,8,486,1753,23,1776
"خراسان_رضوی","مشهد","شهر_مشهد",158,707,38,2,242,989,11,1000
"خراسان_رضوی","مشهد","شهر_مشهد",159,689,38,4,388,1119,23,1142
"خراسان_رضوی","مشهد","شهر_مشهد",160,1101,63,11,523,1698,28,1726
"خراسان_رضوی","مشهد","شهر_مشهد",161,1545,66,11,826,2448,37,2485
"خراسان_رضوی","مشهد","شهر_مشهد",162,1156,49,6,421,1632,21,1653
"خراسان_رضوی","مشهد","شهر_مشهد",163,967,43,16,573,1599,23,1622
"خراسان_رضوی","مشهد","شهر_مشهد",164,1192,37,5,559,1793,25,1818
"خراسان_رضوی","مشهد","شهر_مشهد",165,1345,44,4,398,1791,9,1800
"خراسان_رضوی","مشهد","شهر_مشهد",166,1505,49,4,519,2077,33,2110
"خراسان_رضوی","مشهد","شهر_مشهد",167,1562,21,4,388,1975,19,1994
"خراسان_رضوی","مشهد","شهر_مشهد",168,1321,9,1,219,1550,10,1560
"خراسان_رضوی","مشهد","شهر_مشهد",169,1353,25,8,403,1789,17,1806
"خراسان_رضوی","مشهد","شهر_مشهد",170,1171,45,7,317,1540,15,1555
"خراسان_رضوی","مشهد","شهر_مشهد",171,1437,47,5,554,2043,17,2060
"خراسان_رضوی","مشهد","شهر_مشهد",172,1465,44,6,684,2199,19,2218
"خراسان_رضوی","مشهد","شهر_مشهد",173,1471,37,1,480,1989,25,2014
"خراسان_رضوی","مشهد","شهر_مشهد",174,1134,22,4,402,1562,11,1573
"خراسان_رضوی","مشهد","شهر_مشهد",175,1251,22,1,218,1492,11,1503
"خراسان_رضوی","مشهد","شهر_مشهد",176,1513,29,1,433,1976,23,1999
"خراسان_رضوی","مشهد","شهر_مشهد",177,1543,47,8,416,2014,13,2027
"خراسان_رضوی","مشهد","شهر_مشهد",178,875,44,1,358,1278,11,1289
"خراسان_رضوی","مشهد","شهر_مشهد",179,1596,47,4,391,2038,24,2062
"خراسان_رضوی","مشهد","شهر_مشهد",180,1892,58,6,525,2481,21,2502
"خراسان_رضوی","مشهد","شهر_مشهد",181,1449,25,6,397,1877,16,1893
"خراسان_رضوی","مشهد","شهر_مشهد",182,1513,21,3,435,1972,11,1983
"خراسان_رضوی","مشهد","شهر_مشهد",183,1294,34,1,210,1539,6,1545
"خراسان_رضوی","مشهد","شهر_مشهد",184,1267,35,4,221,1527,6,1533
"خراسان_رضوی","مشهد","شهر_مشهد",185,1297,36,6,345,1684,13,1697
"خراسان_رضوی","مشهد","شهر_مشهد",186,1535,45,6,512,2098,18,2116
"خراسان_رضوی","مشهد","شهر_مشهد",187,1270,23,5,301,1599,14,1613
"خراسان_رضوی","مشهد","شهر_مشهد",188,1427,28,7,333,1795,12,1807
"خراسان_رضوی","مشهد","شهر_مشهد",189,1482,41,6,443,1972,22,1994
"خراسان_رضوی","مشهد","شهر_مشهد",190,1388,22,1,228,1639,2,1641
"خراسان_رضوی","مشهد","شهر_مشهد",191,1290,37,8,380,1715,12,1727
"خراسان_رضوی","مشهد","شهر_مشهد",192,1881,42,5,430,2358,22,2380
"خراسان_رضوی","مشهد","شهر_مشهد",193,1264,15,1,318,1598,14,1612
"خراسان_رضوی","مشهد","شهر_مشهد",194,1635,23,3,363,2024,10,2034
"خراسان_رضوی","مشهد","شهر_مشهد",195,1612,12,4,332,1960,21,1981
"خراسان_رضوی","مشهد","شهر_مشهد",196,1486,35,5,414,1940,13,1953
"خراسان_رضوی","مشهد","شهر_مشهد",197,1501,24,2,266,1793,6,1799
"خراسان_رضوی","مشهد","شهر_مشهد",198,1355,16,9,295,1675,14,1689
"خراسان_رضوی","مشهد","شهر_مشهد",199,1325,22,7,365,1719,15,1734
"خراسان_رضوی","مشهد","شهر_مشهد",200,2125,26,0,342,2493,18,2511
"خراسان_رضوی","مشهد","شهر_مشهد",201,1304,30,5,539,1878,16,1894
"خراسان_رضوی","مشهد","شهر_مشهد",202,1833,15,2,203,2053,10,2063
"خراسان_رضوی","مشهد","شهر_مشهد",203,1004,30,4,270,1308,12,1320
"خراسان_رضوی","مشهد","شهر_مشهد",204,1367,23,4,450,1844,15,1859
"خراسان_رضوی","مشهد","شهر_مشهد",205,1351,25,0,265,1641,11,1652
"خراسان_رضوی","مشهد","شهر_مشهد",206,1632,17,3,333,1985,15,2000
"خراسان_رضوی","مشهد","شهر_مشهد",207,1744,12,5,225,1986,10,1996
"خراسان_رضوی","مشهد","شهر_مشهد",208,1590,5,2,154,1751,6,1757
"خراسان_رضوی","مشهد","شهر_مشهد",209,1538,16,5,333,1892,8,1900
"خراسان_رضوی","مشهد","شهر_مشهد",210,1509,10,6,280,1805,14,1819
"خراسان_رضوی","مشهد","شهر_مشهد",211,1644,9,5,146,1804,5,1809
"خراسان_رضوی","مشهد","شهر_مشهد",212,1424,24,2,361,1811,11,1822
"خراسان_رضوی","مشهد","شهر_مشهد",213,1410,11,4,208,1633,8,1641
"خراسان_رضوی","مشهد","شهر_مشهد",214,1270,15,4,163,1452,9,1461
"خراسان_رضوی","مشهد","شهر_مشهد",215,1795,9,4,218,2026,4,2030
"خراسان_رضوی","مشهد","شهر_مشهد",216,1415,22,4,214,1655,7,1662
"خراسان_رضوی","مشهد","شهر_مشهد",217,1429,8,0,136,1573,13,1586
"خراسان_رضوی","مشهد","شهر_مشهد",218,1586,11,2,167,1766,8,1774
"خراسان_رضوی","مشهد","شهر_مشهد",219,1725,9,2,243,1979,12,1991
"خراسان_رضوی","مشهد","شهر_مشهد",220,2102,19,0,307,2428,19,2447
"خراسان_رضوی","مشهد","شهر_مشهد",221,1653,16,2,270,1941,14,1955
"خراسان_رضوی","مشهد","شهر_مشهد",222,2126,11,1,276,2414,10,2424
"خراسان_رضوی","مشهد","شهر_مشهد",223,1421,20,2,197,1640,11,1651
"خراسان_رضوی","مشهد","شهر_مشهد",224,1279,19,5,375,1678,19,1697
"خراسان_رضوی","مشهد","شهر_مشهد",225,1356,19,0,275,1650,12,1662
"خراسان_رضوی","مشهد","شهر_مشهد",226,1656,19,8,362,2045,8,2053
"خراسان_رضوی","مشهد","شهر_مشهد",227,1805,21,3,193,2022,9,2031
"خراسان_رضوی","مشهد","شهر_مشهد",228,1596,31,4,361,1992,102,2094
"خراسان_رضوی","مشهد","شهر_مشهد",229,1693,14,5,212,1924,6,1930
"خراسان_رضوی","مشهد","شهر_مشهد",230,2175,24,0,313,2512,12,2524
"خراسان_رضوی","مشهد","شهر_مشهد",231,1422,28,8,450,1908,19,1927
"خراسان_رضوی","مشهد","شهر_مشهد",232,599,6,3,143,751,9,760
"خراسان_رضوی","مشهد","شهر_مشهد",233,239,15,1,120,375,13,388
"خراسان_رضوی","مشهد","شهر_مشهد",234,830,13,1,151,995,5,1000
"خراسان_رضوی","مشهد","شهر_مشهد",235,1240,14,1,187,1442,6,1448
"خراسان_رضوی","مشهد","شهر_مشهد",236,717,7,0,131,855,15,870
"خراسان_رضوی","مشهد","شهر_مشهد",237,809,13,3,206,1031,9,1040
"خراسان_رضوی","مشهد","شهر_مشهد",238,880,15,0,101,996,4,1000
"خراسان_رضوی","مشهد","شهر_مشهد",239,1004,31,6,355,1396,13,1409
"خراسان_رضوی","مشهد","شهر_مشهد",240,1060,63,4,486,1613,17,1630
"خراسان_رضوی","مشهد","شهر_مشهد",241,1318,50,1,361,1730,14,1744
"خراسان_رضوی","مشهد","شهر_مشهد",242,1349,40,2,247,1638,5,1643
"خراسان_رضوی","مشهد","شهر_مشهد",243,1232,29,1,255,1517,12,1529
"خراسان_رضوی","مشهد","شهر_مشهد",244,1135,43,6,400,1584,11,1595
"خراسان_رضوی","مشهد","شهر_مشهد",245,1367,20,7,258,1652,6,1658
"خراسان_رضوی","مشهد","شهر_مشهد",246,1271,36,5,459,1771,16,1787
"خراسان_رضوی","مشهد","شهر_مشهد",247,1292,41,9,492,1834,16,1850
"خراسان_رضوی","مشهد","شهر_مشهد",248,937,44,2,419,1402,12,1414
"خراسان_رضوی","مشهد","شهر_مشهد",249,1167,33,10,326,1536,14,1550
"خراسان_رضوی","مشهد","شهر_مشهد",250,882,26,4,291,1203,17,1220
"خراسان_رضوی","مشهد","شهر_مشهد",251,1667,61,7,722,2457,26,2483
"خراسان_رضوی","مشهد","شهر_مشهد",252,1321,45,8,367,1741,8,1749
"خراسان_رضوی","مشهد","شهر_مشهد",253,1079,37,5,411,1532,14,1546
"خراسان_رضوی","مشهد","شهر_مشهد",254,1434,35,2,183,1654,10,1664
"خراسان_رضوی","مشهد","شهر_مشهد",255,1129,33,6,380,1548,12,1560
"خراسان_رضوی","مشهد","شهر_مشهد",256,1786,33,2,294,2115,32,2147
"خراسان_رضوی","مشهد","شهر_مشهد",257,1469,35,7,413,1924,9,1933
"خراسان_رضوی","مشهد","شهر_مشهد",258,1356,32,5,337,1730,11,1741
"خراسان_رضوی","مشهد","شهر_مشهد",259,1551,37,1,207,1796,13,1809
"خراسان_رضوی","مشهد","شهر_مشهد",260,1469,49,2,416,1936,21,1957
"خراسان_رضوی","مشهد","شهر_مشهد",261,1405,40,2,267,1714,33,1747
"خراسان_رضوی","مشهد","شهر_مشهد",262,1057,32,7,369,1465,17,1482
"خراسان_رضوی","مشهد","شهر_مشهد",263,1113,36,6,381,1536,15,1551
"خراسان_رضوی","مشهد","شهر_مشهد",264,1383,36,2,300,1721,12,1733
"خراسان_رضوی","مشهد","شهر_مشهد",265,1016,16,11,253,1296,11,1307
"خراسان_رضوی","مشهد","شهر_مشهد",266,1198,28,6,224,1456,12,1468
"خراسان_رضوی","مشهد","شهر_مشهد",267,1095,40,10,442,1587,13,1600
"خراسان_رضوی","مشهد","شهر_مشهد",268,1115,32,7,430,1584,19,1603
"خراسان_رضوی","مشهد","شهر_مشهد",269,1051,24,0,231,1306,12,1318
"خراسان_رضوی","مشهد","شهر_مشهد",270,1253,43,7,313,1616,14,1630
"خراسان_رضوی","مشهد","شهر_مشهد",271,1108,33,4,492,1637,12,1649
"خراسان_رضوی","مشهد","شهر_مشهد",272,1878,47,7,550,2482,24,2506
"خراسان_رضوی","مشهد","شهر_مشهد",273,1056,44,5,380,1485,20,1505
"خراسان_رضوی","مشهد","شهر_مشهد",274,2016,31,4,217,2268,12,2280
"خراسان_رضوی","مشهد","شهر_مشهد",275,1744,21,3,236,2004,8,2012
"خراسان_رضوی","مشهد","شهر_مشهد",276,1180,18,0,293,1491,8,1499
"خراسان_رضوی","مشهد","شهر_مشهد",277,1663,10,2,137,1812,1,1813
"خراسان_رضوی","مشهد","شهر_مشهد",278,1791,9,4,285,2089,16,2105
"خراسان_رضوی","مشهد","شهر_مشهد",279,1885,15,2,176,2078,12,2090
"خراسان_رضوی","مشهد","شهر_مشهد",280,1965,29,7,347,2348,15,2363
"خراسان_رضوی","مشهد","شهر_مشهد",281,1441,14,1,222,1678,13,1691
"خراسان_رضوی","مشهد","شهر_مشهد",282,1571,12,5,137,1725,10,1735
"خراسان_رضوی","مشهد","شهر_مشهد",283,1484,13,2,321,1820,5,1825
"خراسان_رضوی","مشهد","شهر_مشهد",284,1848,19,0,232,2099,16,2115
"خراسان_رضوی","مشهد","شهر_مشهد",285,2124,26,7,354,2511,19,2530
"خراسان_رضوی","مشهد","شهر_مشهد",286,1876,24,4,248,2152,7,2159
"خراسان_رضوی","مشهد","شهر_مشهد",287,1495,26,7,376,1904,17,1921
"خراسان_رضوی","مشهد","شهر_مشهد",288,1910,19,3,259,2191,9,2200
"خراسان_رضوی","مشهد","شهر_مشهد",289,1681,27,4,218,1930,11,1941
"خراسان_رضوی","مشهد","شهر_مشهد",290,1360,32,10,354,1756,11,1767
"خراسان_رضوی","مشهد","شهر_مشهد",291,1537,18,3,166,1724,14,1738
"خراسان_رضوی","مشهد","شهر_مشهد",292,1425,14,6,316,1761,19,1780
"خراسان_رضوی","مشهد","شهر_مشهد",293,1345,14,3,256,1618,7,1625
"خراسان_رضوی","مشهد","شهر_مشهد",294,1349,9,3,202,1563,5,1568
"خراسان_رضوی","مشهد","شهر_مشهد",295,1756,22,6,196,1980,17,1997
"خراسان_رضوی","مشهد","شهر_مشهد",296,1535,21,7,275,1838,0,1838
"خراسان_رضوی","مشهد","شهر_مشهد",297,1775,18,4,221,2018,15,2033
"خراسان_رضوی","مشهد","شهر_مشهد",298,1172,14,3,212,1401,5,1406
"خراسان_رضوی","مشهد","شهر_مشهد",299,641,5,2,142,790,10,800
"خراسان_رضوی","مشهد","شهر_مشهد",300,469,3,1,88,561,4,565
"خراسان_رضوی","مشهد","شهر_مشهد",301,610,14,5,210,839,4,843
"خراسان_رضوی","مشهد","شهر_مشهد",302,1170,13,5,120,1308,0,1308
"خراسان_رضوی","مشهد","شهر_مشهد",303,1293,12,2,150,1457,13,1470
"خراسان_رضوی","مشهد","شهر_مشهد",304,1253,12,3,153,1421,3,1424
"خراسان_رضوی","مشهد","شهر_مشهد",305,1190,39,4,296,1529,20,1549
"خراسان_رضوی","مشهد","شهر_مشهد",306,1193,23,2,193,1411,11,1422
"خراسان_رضوی","مشهد","شهر_مشهد",307,1519,26,9,337,1891,12,1903
"خراسان_رضوی","مشهد","شهر_مشهد",308,1215,20,8,496,1739,25,1764
"خراسان_رضوی","مشهد","شهر_مشهد",309,1212,33,4,517,1766,11,1777
"خراسان_رضوی","مشهد","شهر_مشهد",310,984,36,4,328,1352,46,1398
"خراسان_رضوی","مشهد","شهر_مشهد",311,999,28,4,381,1412,8,1420
"خراسان_رضوی","مشهد","شهر_مشهد",312,1115,26,2,341,1484,17,1501
"خراسان_رضوی","مشهد","شهر_مشهد",313,1161,28,5,363,1557,22,1579
"خراسان_رضوی","مشهد","شهر_مشهد",314,635,13,3,193,844,6,850
"خراسان_رضوی","مشهد","شهر_مشهد",315,976,10,3,301,1290,15,1305
"خراسان_رضوی","مشهد","شهر_مشهد",316,1239,33,5,344,1621,21,1642
"خراسان_رضوی","مشهد","شهر_مشهد",317,1117,23,4,322,1466,32,1498
"خراسان_رضوی","مشهد","شهر_مشهد",318,1063,35,15,343,1456,15,1471
"خراسان_رضوی","مشهد","شهر_مشهد",319,861,31,2,272,1166,13,1179
"خراسان_رضوی","مشهد","شهر_مشهد",320,1448,24,4,247,1723,8,1731
"خراسان_رضوی","مشهد","شهر_مشهد",321,1093,28,6,382,1509,12,1521
"خراسان_رضوی","مشهد","شهر_مشهد",322,1137,19,7,277,1440,17,1457
"خراسان_رضوی","مشهد","شهر_مشهد",323,1059,18,5,216,1298,101,1399
"خراسان_رضوی","مشهد","شهر_مشهد",324,1713,25,8,340,2086,13,2099
"خراسان_رضوی","مشهد","شهر_مشهد",325,1449,31,3,304,1787,14,1801
"خراسان_رضوی","مشهد","شهر_مشهد",326,642,18,0,294,954,9,963
"خراسان_رضوی","مشهد","شهر_مشهد",327,1191,9,2,295,1497,3,1500
"خراسان_رضوی","مشهد","شهر_مشهد",328,781,10,3,279,1073,4,1077
"خراسان_رضوی","مشهد","شهر_مشهد",329,1476,45,9,481,2011,14,2025
"خراسان_رضوی","مشهد","شهر_مشهد",330,1828,43,4,539,2414,14,2428
"خراسان_رضوی","مشهد","شهر_مشهد",331,1145,27,6,267,1445,11,1456
"خراسان_رضوی","مشهد","شهر_مشهد",332,1221,28,2,292,1543,15,1558
"خراسان_رضوی","مشهد","شهر_مشهد",333,1215,31,2,209,1457,41,1498
"خراسان_رضوی","مشهد","شهر_مشهد",334,1183,32,1,368,1584,15,1599
"خراسان_رضوی","مشهد","شهر_مشهد",335,1390,32,0,337,1759,12,1771
"خراسان_رضوی","مشهد","شهر_مشهد",336,1704,41,2,512,2259,20,2279
"خراسان_رضوی","مشهد","شهر_مشهد",337,1033,25,9,390,1457,16,1473
"خراسان_رضوی","مشهد","شهر_مشهد",338,1090,19,4,302,1415,8,1423
"خراسان_رضوی","مشهد","شهر_مشهد",339,1128,24,4,447,1603,11,1614
"خراسان_رضوی","مشهد","شهر_مشهد",340,931,13,3,270,1217,14,1231
"خراسان_رضوی","مشهد","شهر_مشهد",341,910,12,11,163,1096,8,1104
"خراسان_رضوی","مشهد","شهر_مشهد",342,1284,24,5,277,1590,15,1605
"خراسان_رضوی","مشهد","شهر_مشهد",343,1011,35,4,299,1349,4,1353
"خراسان_رضوی","مشهد","شهر_مشهد",344,792,29,7,382,1210,24,1234
"خراسان_رضوی","مشهد","شهر_مشهد",345,409,4,6,92,511,2,513
"خراسان_رضوی","مشهد","شهر_مشهد",346,1180,25,2,251,1458,5,1463
"خراسان_رضوی","مشهد","شهر_مشهد",347,1437,21,7,482,1947,10,1957
"خراسان_رضوی","مشهد","شهر_مشهد",348,1313,17,2,238,1570,11,1581
"خراسان_رضوی","مشهد","شهر_مشهد",349,1093,11,1,161,1266,6,1272
"خراسان_رضوی","مشهد","شهر_مشهد",350,1165,5,1,113,1284,5,1289
"خراسان_رضوی","مشهد","شهر_مشهد",351,1741,27,1,370,2139,11,2150
"خراسان_رضوی","مشهد","شهر_مشهد",352,811,18,0,593,1422,10,1432
"خراسان_رضوی","مشهد","شهر_مشهد",353,1185,26,2,171,1384,5,1389
"خراسان_رضوی","مشهد","شهر_مشهد",354,461,10,3,196,670,0,670
"خراسان_رضوی","مشهد","شهر_مشهد",355,290,12,0,81,383,2,385
"خراسان_رضوی","مشهد","شهر_مشهد",356,1551,41,5,386,1983,16,1999
"خراسان_رضوی","مشهد","شهر_مشهد",357,1037,10,2,246,1295,9,1304
"خراسان_رضوی","مشهد","شهر_مشهد",358,446,9,1,196,652,6,658
"خراسان_رضوی","مشهد","شهر_مشهد",359,1544,30,5,407,1986,11,1997
"خراسان_رضوی","مشهد","شهر_مشهد",360,1464,15,3,237,1719,11,1730
"خراسان_رضوی","مشهد","شهر_مشهد",361,1717,26,4,334,2081,18,2099
"خراسان_رضوی","مشهد","شهر_مشهد",362,1469,16,0,351,1836,8,1844
"خراسان_رضوی","مشهد","شهر_مشهد",363,1333,23,2,231,1589,9,1598
"خراسان_رضوی","مشهد","شهر_مشهد",364,1708,36,1,367,2112,23,2135
"خراسان_رضوی","مشهد","شهر_مشهد",365,1342,30,1,419,1792,6,1798
"خراسان_رضوی","مشهد","شهر_مشهد",366,1553,31,8,284,1876,14,1890
"خراسان_رضوی","مشهد","شهر_مشهد",367,1420,36,7,449,1912,12,1924
"خراسان_رضوی","مشهد","شهر_مشهد",368,1412,21,11,412,1856,11,1867
"خراسان_رضوی","مشهد","شهر_مشهد",369,1287,18,5,258,1568,35,1603
"خراسان_رضوی","مشهد","شهر_مشهد",370,1112,13,5,408,1538,6,1544
"خراسان_رضوی","مشهد","شهر_مشهد",371,1541,18,4,268,1831,11,1842
"خراسان_رضوی","مشهد","شهر_مشهد",372,1259,20,4,410,1693,21,1714
"خراسان_رضوی","مشهد","شهر_مشهد",373,1163,16,3,310,1492,8,1500
"خراسان_رضوی","مشهد","شهر_مشهد",374,1239,27,12,541,1819,8,1827
"خراسان_رضوی","مشهد","شهر_مشهد",375,1270,20,0,297,1587,7,1594
"خراسان_رضوی","مشهد","شهر_مشهد",376,1061,35,7,416,1519,17,1536
"خراسان_رضوی","مشهد","شهر_مشهد",377,1376,38,6,356,1776,20,1796
"خراسان_رضوی","مشهد","شهر_مشهد",378,1219,45,4,483,1751,17,1768
"خراسان_رضوی","مشهد","شهر_مشهد",379,970,24,5,429,1428,10,1438
"خراسان_رضوی","مشهد","شهر_مشهد",380,1665,27,3,354,2049,6,2055
"خراسان_رضوی","مشهد","شهر_مشهد",381,2112,15,7,206,2340,16,2356
"خراسان_رضوی","مشهد","شهر_مشهد",382,1432,16,2,204,1654,10,1664
"خراسان_رضوی","مشهد","شهر_مشهد",383,1261,11,2,266,1540,10,1550
"خراسان_رضوی","مشهد","شهر_مشهد",384,1465,11,1,159,1636,0,1636
"خراسان_رضوی","مشهد","شهر_مشهد",385,1237,6,3,178,1424,4,1428
"خراسان_رضوی","مشهد","شهر_مشهد",386,717,5,2,111,835,6,841
"خراسان_رضوی","مشهد","شهر_مشهد",387,1696,22,1,273,1992,8,2000
"خراسان_رضوی","مشهد","شهر_مشهد",388,1481,17,4,240,1742,16,1758
"خراسان_رضوی","مشهد","شهر_مشهد",389,1439,17,5,237,1698,11,1709
"خراسان_رضوی","مشهد","شهر_مشهد",390,1186,14,6,257,1463,8,1471
"خراسان_رضوی","مشهد","شهر_مشهد",391,1254,20,10,295,1579,12,1591
"خراسان_رضوی","مشهد","شهر_مشهد",392,1946,25,1,438,2410,15,2425
"خراسان_رضوی","مشهد","شهر_مشهد",393,1625,14,7,273,1919,5,1924
"خراسان_رضوی","مشهد","شهر_مشهد",394,1198,14,3,222,1437,8,1445
"خراسان_رضوی","مشهد","شهر_مشهد",395,1655,14,6,359,2034,9,2043
"خراسان_رضوی","مشهد","شهر_مشهد",396,1679,12,0,248,1939,7,1946
"خراسان_رضوی","مشهد","شهر_مشهد",397,1744,12,1,281,2038,12,2050
"خراسان_رضوی","مشهد","شهر_مشهد",398,1892,4,6,278,2180,6,2186
"خراسان_رضوی","مشهد","شهر_مشهد",399,1598,16,2,225,1841,0,1841
"خراسان_رضوی","مشهد","شهر_مشهد",400,1477,1,2,204,1684,7,1691
"خراسان_رضوی","مشهد","شهر_مشهد",401,1557,18,6,370,1951,10,1961
"خراسان_رضوی","مشهد","شهر_مشهد",402,1891,32,4,361,2288,13,2301
"خراسان_رضوی","مشهد","شهر_مشهد",403,1732,4,3,223,1962,13,1975
"خراسان_رضوی","مشهد","شهر_مشهد",404,1128,6,3,149,1286,2,1288
"خراسان_رضوی","مشهد","شهر_مشهد",405,1774,9,3,303,2089,7,2096
"خراسان_رضوی","مشهد","شهر_مشهد",406,1439,13,0,222,1674,3,1677
"خراسان_رضوی","مشهد","شهر_مشهد",407,1724,20,4,225,1973,8,1981
"خراسان_رضوی","مشهد","شهر_مشهد",408,1431,10,1,177,1619,6,1625
"خراسان_رضوی","مشهد","شهر_مشهد",409,1523,5,3,240,1771,4,1775
"خراسان_رضوی","مشهد","شهر_مشهد",410,973,7,0,498,1478,6,1484
"خراسان_رضوی","مشهد","شهر_مشهد",411,1645,14,1,221,1881,39,1920
"خراسان_رضوی","مشهد","شهر_مشهد",412,1578,3,3,151,1735,5,1740
"خراسان_رضوی","مشهد","شهر_مشهد",413,1716,6,0,232,1954,1,1955
"خراسان_رضوی","مشهد","شهر_مشهد",414,1533,13,2,152,1700,6,1706
"خراسان_رضوی","مشهد","شهر_مشهد",415,556,10,2,141,709,4,713
"خراسان_رضوی","مشهد","شهر_مشهد",416,523,8,2,159,692,13,705
"خراسان_رضوی","مشهد","شهر_مشهد",417,420,7,0,87,514,4,518
"خراسان_رضوی","مشهد","شهر_مشهد",418,728,4,3,194,929,5,934
"خراسان_رضوی","مشهد","شهر_مشهد",419,371,3,1,257,632,1,633
"خراسان_رضوی","مشهد","شهر_مشهد",420,1226,6,5,217,1454,13,1467
"خراسان_رضوی","مشهد","شهر_مشهد",421,1240,49,6,676,1971,24,1995
"خراسان_رضوی","مشهد","شهر_مشهد",422,1537,55,4,719,2315,31,2346
"خراسان_رضوی","مشهد","شهر_مشهد",423,1474,70,15,916,2475,13,2488
"خراسان_رضوی","مشهد","شهر_مشهد",424,1301,59,4,543,1907,15,1922
"خراسان_رضوی","مشهد","شهر_مشهد",425,1068,51,9,678,1806,22,1828
"خراسان_رضوی","مشهد","شهر_مشهد",426,956,28,2,395,1381,13,1394
"خراسان_رضوی","مشهد","شهر_مشهد",427,1237,40,6,523,1806,15,1821
"خراسان_رضوی","مشهد","شهر_مشهد",428,1136,25,13,476,1650,18,1668
"خراسان_رضوی","مشهد","شهر_مشهد",429,1060,25,4,427,1516,18,1534
"خراسان_رضوی","مشهد","شهر_مشهد",430,1234,24,7,575,1840,29,1869
"خراسان_رضوی","مشهد","شهر_مشهد",431,1349,39,6,774,2168,21,2189
"خراسان_رضوی","مشهد","شهر_مشهد",432,1353,56,9,658,2076,25,2101
"خراسان_رضوی","مشهد","شهر_مشهد",433,1332,18,5,322,1677,12,1689
"خراسان_رضوی","مشهد","شهر_مشهد",434,1134,23,12,507,1676,16,1692
"خراسان_رضوی","مشهد","شهر_مشهد",435,1453,37,10,375,1875,9,1884
"خراسان_رضوی","مشهد","شهر_مشهد",436,1340,22,14,383,1759,10,1769
"خراسان_رضوی","مشهد","شهر_مشهد",437,1600,47,11,563,2221,25,2246
"خراسان_رضوی","مشهد","شهر_مشهد",438,1530,46,6,686,2268,21,2289
"خراسان_رضوی","مشهد","شهر_مشهد",439,1343,39,5,629,2016,27,2043
"خراسان_رضوی","مشهد","شهر_مشهد",440,1251,22,1,361,1635,14,1649
"خراسان_رضوی","مشهد","شهر_مشهد",441,820,21,0,420,1261,19,1280
"خراسان_رضوی","مشهد","شهر_مشهد",442,1404,37,9,323,1773,9,1782
"خراسان_رضوی","مشهد","شهر_مشهد",443,1088,33,4,481,1606,16,1622
"خراسان_رضوی","مشهد","شهر_مشهد",444,1370,19,1,219,1609,11,1620
"خراسان_رضوی","مشهد","شهر_مشهد",445,1344,29,2,416,1791,17,1808
"خراسان_رضوی","مشهد","شهر_مشهد",446,1304,15,2,187,1508,8,1516
"خراسان_رضوی","مشهد","شهر_مشهد",447,1081,18,4,300,1403,11,1414
"خراسان_رضوی","مشهد","شهر_مشهد",448,1459,25,3,332,1819,14,1833
"خراسان_رضوی","مشهد","شهر_مشهد",449,1378,31,7,313,1729,11,1740
"خراسان_رضوی","مشهد","شهر_مشهد",450,1185,21,8,472,1686,11,1697
"خراسان_رضوی","مشهد","شهر_مشهد",451,1782,31,10,364,2187,12,2199
"خراسان_رضوی","مشهد","شهر_مشهد",452,1100,20,0,387,1507,12,1519
"خراسان_رضوی","مشهد","شهر_مشهد",453,1680,24,12,372,2088,13,2101
"خراسان_رضوی","مشهد","شهر_مشهد",454,1440,5,1,158,1604,5,1609
"خراسان_رضوی","مشهد","شهر_مشهد",455,1367,15,6,292,1680,8,1688
"خراسان_رضوی","مشهد","شهر_مشهد",456,1684,18,1,262,1965,11,1976
"خراسان_رضوی","مشهد","شهر_مشهد",457,1499,25,3,442,1969,26,1995
"خراسان_رضوی","مشهد","شهر_مشهد",458,1889,29,2,489,2409,15,2424
"خراسان_رضوی","مشهد","شهر_مشهد",459,1605,23,2,326,1956,16,1972
"خراسان_رضوی","مشهد","شهر_مشهد",460,1872,17,2,374,2265,11,2276
"خراسان_رضوی","مشهد","شهر_مشهد",461,1370,10,6,177,1563,5,1568
"خراسان_رضوی","مشهد","شهر_مشهد",462,1465,22,9,369,1865,8,1873
"خراسان_رضوی","مشهد","شهر_مشهد",463,1893,21,3,279,2196,3,2199
"خراسان_رضوی","مشهد","شهر_مشهد",464,1624,21,0,231,1876,4,1880
"خراسان_رضوی","مشهد","شهر_مشهد",465,1375,24,3,314,1716,10,1726
"خراسان_رضوی","مشهد","شهر_مشهد",466,1677,31,4,439,2151,9,2160
"خراسان_رضوی","مشهد","شهر_مشهد",467,1638,55,6,619,2318,13,2331
"خراسان_رضوی","مشهد","شهر_مشهد",468,1939,15,9,216,2179,7,2186
"خراسان_رضوی","مشهد","شهر_مشهد",469,1634,7,9,260,1910,1,1911
"خراسان_رضوی","مشهد","شهر_مشهد",470,1290,8,1,165,1464,11,1475
"خراسان_رضوی","مشهد","شهر_مشهد",471,1067,9,3,89,1168,11,1179
"خراسان_رضوی","مشهد","شهر_مشهد",472,1100,10,6,189,1305,7,1312
"خراسان_رضوی","مشهد","شهر_مشهد",473,2013,25,4,167,2209,10,2219
"خراسان_رضوی","مشهد","شهر_مشهد",474,2081,10,2,270,2363,17,2380
"خراسان_رضوی","مشهد","شهر_مشهد",475,1027,17,1,277,1322,11,1333
"خراسان_رضوی","مشهد","شهر_مشهد",476,994,17,5,441,1457,15,1472
"خراسان_رضوی","مشهد","شهر_مشهد",477,1246,76,24,1213,2559,35,2594
"خراسان_رضوی","مشهد","شهر_مشهد",478,1073,25,2,347,1447,10,1457
"خراسان_رضوی","مشهد","شهر_مشهد",479,968,28,1,210,1207,16,1223
"خراسان_رضوی","مشهد","شهر_مشهد",480,921,33,2,334,1290,13,1303
"خراسان_رضوی","مشهد","شهر_مشهد",481,687,32,7,441,1167,20,1187
"خراسان_رضوی","مشهد","شهر_مشهد",482,664,6,4,186,860,18,878
"خراسان_رضوی","مشهد","شهر_مشهد",483,845,22,2,333,1202,10,1212
"خراسان_رضوی","مشهد","شهر_مشهد",484,1098,17,3,195,1313,5,1318
"خراسان_رضوی","مشهد","شهر_مشهد",485,800,18,5,262,1085,5,1090
"خراسان_رضوی","مشهد","شهر_مشهد",486,1605,13,5,230,1853,14,1867
"خراسان_رضوی","مشهد","شهر_مشهد",487,1670,44,6,390,2110,19,2129
"خراسان_رضوی","مشهد","شهر_مشهد",488,1262,48,7,530,1847,22,1869
"خراسان_رضوی","مشهد","شهر_مشهد",489,1578,63,6,863,2510,29,2539
"خراسان_رضوی","مشهد","شهر_مشهد",490,1657,70,5,845,2577,26,2603
"خراسان_رضوی","مشهد","شهر_مشهد",491,858,65,2,397,1322,23,1345
"خراسان_رضوی","مشهد","شهر_مشهد",492,1023,69,8,605,1705,26,1731
"خراسان_رضوی","مشهد","شهر_مشهد",493,1440,60,22,821,2343,26,2369
"خراسان_رضوی","مشهد","شهر_مشهد",494,1250,78,7,833,2168,30,2198
"خراسان_رضوی","مشهد","شهر_مشهد",495,1387,73,13,720,2193,40,2233
"خراسان_رضوی","مشهد","شهر_مشهد",496,713,37,6,430,1186,8,1194
"خراسان_رضوی","مشهد","شهر_مشهد",497,994,46,14,483,1537,21,1558
"خراسان_رضوی","مشهد","شهر_مشهد",498,1243,46,9,624,1922,186,2108
"خراسان_رضوی","مشهد","شهر_مشهد",499,1210,43,11,813,2077,20,2097
"خراسان_رضوی","مشهد","شهر_مشهد",500,1271,42,12,771,2096,19,2115
"خراسان_رضوی","مشهد","شهر_مشهد",501,992,37,2,394,1425,15,1440
"خراسان_رضوی","مشهد","شهر_مشهد",502,984,15,8,562,1569,42,1611
"خراسان_رضوی","مشهد","شهر_مشهد",503,1144,43,17,871,2075,27,2102
"خراسان_رضوی","مشهد","شهر_مشهد",504,1122,52,19,912,2105,21,2126
"خراسان_رضوی","مشهد","شهر_مشهد",505,786,83,17,654,1540,25,1565
"خراسان_رضوی","مشهد","شهر_مشهد",506,1684,110,13,1203,3010,50,3060
"خراسان_رضوی","مشهد","شهر_مشهد",507,1122,52,5,480,1659,28,1687
"خراسان_رضوی","مشهد","شهر_مشهد",508,1288,68,3,593,1952,28,1980
"خراسان_رضوی","مشهد","شهر_مشهد",509,1200,69,9,635,1913,41,1954
"خراسان_رضوی","مشهد","شهر_مشهد",510,404,24,11,294,733,18,751
"خراسان_رضوی","مشهد","شهر_مشهد",511,736,58,10,462,1266,29,1295
"خراسان_رضوی","مشهد","شهر_مشهد",512,700,40,8,459,1207,21,1228
"خراسان_رضوی","مشهد","شهر_مشهد",513,536,21,3,295,855,9,864
"خراسان_رضوی","مشهد","شهر_مشهد",514,681,54,8,372,1115,18,1133
"خراسان_رضوی","مشهد","شهر_مشهد",515,1094,60,25,987,2166,36,2202
"خراسان_رضوی","مشهد","شهر_مشهد",516,1015,68,14,646,1743,30,1773
"خراسان_رضوی","مشهد","شهر_مشهد",517,525,50,21,940,1536,12,1548
"خراسان_رضوی","مشهد","شهر_مشهد",518,803,50,8,819,1680,15,1695
"خراسان_رضوی","مشهد","شهر_مشهد",519,1144,66,10,962,2182,15,2197
"خراسان_رضوی","مشهد","شهر_مشهد",520,657,70,8,793,1528,22,1550
"خراسان_رضوی","مشهد","شهر_مشهد",521,969,79,19,912,1979,17,1996
"خراسان_رضوی","مشهد","شهر_مشهد",522,751,58,4,800,1613,17,1630
"خراسان_رضوی","مشهد","شهر_مشهد",523,1554,66,21,969,2610,29,2639
"خراسان_رضوی","مشهد","شهر_مشهد",524,744,37,10,842,1633,11,1644
"خراسان_رضوی","مشهد","شهر_مشهد",525,925,48,12,1005,1990,25,2015
"خراسان_رضوی","مشهد","شهر_مشهد",526,1211,28,11,568,1818,25,1843
"خراسان_رضوی","مشهد","شهر_مشهد",527,1036,45,13,684,1778,22,1800
"خراسان_رضوی","مشهد","شهر_مشهد",528,1281,51,25,935,2292,21,2313
"خراسان_رضوی","مشهد","شهر_مشهد",529,1450,49,8,743,2250,18,2268
"خراسان_رضوی","مشهد","شهر_مشهد",530,946,23,0,461,1430,27,1457
"خراسان_رضوی","مشهد","شهر_مشهد",531,724,43,8,635,1410,23,1433
"خراسان_رضوی","مشهد","شهر_مشهد",532,345,11,1,211,568,6,574
"خراسان_رضوی","مشهد","شهر_مشهد",533,765,16,4,411,1196,13,1209
"خراسان_رضوی","مشهد","شهر_مشهد",534,474,33,4,247,758,12,770
"خراسان_رضوی","مشهد","شهر_مشهد",535,635,323,37,1,996,54,1050
"خراسان_رضوی","مشهد","شهر_مشهد",536,1280,52,5,414,1751,17,1768
"خراسان_رضوی","مشهد","شهر_مشهد",537,484,16,2,208,710,6,716
"خراسان_رضوی","مشهد","شهر_مشهد",538,1349,40,15,750,2154,20,2174
"خراسان_رضوی","مشهد","شهر_مشهد",539,1236,77,22,1163,2498,23,2521
"خراسان_رضوی","مشهد","شهر_مشهد",540,652,66,26,1311,2055,21,2076
"خراسان_رضوی","مشهد","شهر_مشهد",541,1042,50,10,1087,2189,12,2201
"خراسان_رضوی","مشهد","شهر_مشهد",542,776,56,20,997,1849,0,1849
"خراسان_رضوی","مشهد","شهر_مشهد",543,1270,74,12,862,2218,26,2244
"خراسان_رضوی","مشهد","شهر_مشهد",544,1087,79,22,1288,2476,17,2493
"خراسان_رضوی","مشهد","شهر_مشهد",545,920,53,18,1429,2420,8,2428
"خراسان_رضوی","مشهد","شهر_مشهد",546,743,56,19,855,1673,26,1699
"خراسان_رضوی","مشهد","شهر_مشهد",547,1062,79,95,1125,2361,48,2409
"خراسان_رضوی","مشهد","شهر_مشهد",548,885,78,28,1161,2152,19,2171
"خراسان_رضوی","مشهد","شهر_مشهد",549,2064,101,28,1433,3626,35,3661
"خراسان_رضوی","مشهد","شهر_مشهد",550,1343,45,9,682,2079,19,2098
"خراسان_رضوی","مشهد","شهر_مشهد",551,1444,50,10,875,2379,21,2400
"خراسان_رضوی","مشهد","شهر_مشهد",552,1412,39,11,824,2286,14,2300
"خراسان_رضوی","مشهد","شهر_مشهد",553,1999,44,3,628,2674,0,2674
"خراسان_رضوی","مشهد","شهر_مشهد",554,1569,58,9,928,2564,36,2600
"خراسان_رضوی","مشهد","شهر_مشهد",555,628,52,36,1687,2403,33,2436
"خراسان_رضوی","مشهد","شهر_مشهد",556,507,63,46,1693,2309,26,2335
"خراسان_رضوی","مشهد","شهر_مشهد",557,1376,57,23,968,2424,19,2443
"خراسان_رضوی","مشهد","شهر_مشهد",558,1486,35,5,761,2287,13,2300
"خراسان_رضوی","مشهد","شهر_مشهد",559,1191,28,9,956,2184,16,2200
"خراسان_رضوی","مشهد","شهر_مشهد",560,557,52,24,1804,2437,18,2455
"خراسان_رضوی","مشهد","شهر_مشهد",561,1135,78,35,1943,3191,29,3220
"خراسان_رضوی","مشهد","شهر_مشهد",562,666,60,29,1887,2642,36,2678
"خراسان_رضوی","مشهد","شهر_مشهد",563,1159,55,14,886,2114,28,2142
"خراسان_رضوی","مشهد","شهر_مشهد",564,985,64,22,1009,2080,20,2100
"خراسان_رضوی","مشهد","شهر_مشهد",565,682,48,22,1643,2395,26,2421
"خراسان_رضوی","مشهد","شهر_مشهد",566,1182,81,47,1973,3283,44,3327
"خراسان_رضوی","مشهد","شهر_مشهد",567,1027,73,27,2102,3229,32,3261
"خراسان_رضوی","مشهد","شهر_مشهد",568,809,49,24,1338,2220,34,2254
"خراسان_رضوی","مشهد","شهر_مشهد",569,713,48,23,1347,2131,9,2140
"خراسان_رضوی","مشهد","شهر_مشهد",570,1066,31,13,1011,2121,19,2140
"خراسان_رضوی","مشهد","شهر_مشهد",571,836,69,26,1314,2245,0,2245
"خراسان_رضوی","مشهد","شهر_مشهد",572,979,51,38,1011,2079,18,2097
"خراسان_رضوی","مشهد","شهر_مشهد",573,1841,64,23,800,2728,24,2752
"خراسان_رضوی","مشهد","شهر_مشهد",574,1668,10,2,379,2059,7,2066
"خراسان_رضوی","مشهد","شهر_مشهد",575,1250,56,31,1375,2712,26,2738
"خراسان_رضوی","مشهد","شهر_مشهد",576,998,50,26,1215,2289,11,2300
"خراسان_رضوی","مشهد","شهر_مشهد",577,956,50,16,1042,2064,15,2079
"خراسان_رضوی","مشهد","شهر_مشهد",578,887,36,19,1416,2358,21,2379
"خراسان_رضوی","مشهد","شهر_مشهد",579,1302,45,20,848,2215,25,2240
"خراسان_رضوی","مشهد","شهر_مشهد",580,1081,57,25,1251,2414,27,2441
"خراسان_رضوی","مشهد","شهر_مشهد",581,1256,87,24,1068,2435,21,2456
"خراسان_رضوی","مشهد","شهر_مشهد",582,1010,51,24,996,2081,13,2094
"خراسان_رضوی","مشهد","شهر_مشهد",583,1295,43,27,1302,2667,23,2690
"خراسان_رضوی","مشهد","شهر_مشهد",584,739,55,16,568,1378,22,1400
"خراسان_رضوی","مشهد","شهر_مشهد",585,642,34,13,593,1282,17,1299
"خراسان_رضوی","مشهد","شهر_مشهد",586,1095,32,9,461,1597,10,1607
"خراسان_رضوی","مشهد","شهر_مشهد",587,851,23,9,612,1495,8,1503
"خراسان_رضوی","مشهد","شهر_مشهد",588,1054,62,19,1116,2251,28,2279
"خراسان_رضوی","مشهد","شهر_مشهد",589,1430,48,6,582,2066,28,2094
"خراسان_رضوی","مشهد","شهر_مشهد",590,1160,66,16,800,2042,26,2068
"خراسان_رضوی","مشهد","شهر_مشهد",591,1619,44,9,524,2196,20,2216
"خراسان_رضوی","مشهد","شهر_مشهد",592,1971,36,7,579,2593,19,2612
"خراسان_رضوی","مشهد","شهر_مشهد",593,1244,45,13,612,1914,22,1936
"خراسان_رضوی","مشهد","شهر_مشهد",594,990,43,14,1040,2087,18,2105
"خراسان_رضوی","مشهد","شهر_مشهد",595,1086,43,22,735,1886,24,1910
"خراسان_رضوی","مشهد","شهر_مشهد",596,1058,51,13,954,2076,18,2094
"خراسان_رضوی","مشهد","شهر_مشهد",597,1182,46,8,774,2010,22,2032
"خراسان_رضوی","مشهد","شهر_مشهد",598,1070,57,4,716,1847,19,1866
"خراسان_رضوی","مشهد","شهر_مشهد",599,1421,86,15,1266,2788,29,2817
"خراسان_رضوی","مشهد","شهر_مشهد",600,1415,66,14,716,2211,22,2233
"خراسان_رضوی","مشهد","شهر_مشهد",601,1290,47,8,588,1933,16,1949
"خراسان_رضوی","مشهد","شهر_مشهد",602,976,48,14,735,1773,13,1786
"خراسان_رضوی","مشهد","شهر_مشهد",603,1272,34,5,568,1879,16,1895
"خراسان_رضوی","مشهد","شهر_مشهد",604,1035,42,13,801,1891,10,1901
"خراسان_رضوی","مشهد","شهر_مشهد",605,1258,60,7,920,2245,12,2257
"خراسان_رضوی","مشهد","شهر_مشهد",606,969,49,22,1264,2304,18,2322
"خراسان_رضوی","مشهد","شهر_مشهد",607,1195,42,12,652,1901,8,1909
"خراسان_رضوی","مشهد","شهر_مشهد",608,1588,49,4,571,2212,19,2231
"خراسان_رضوی","مشهد","شهر_مشهد",609,1320,47,5,577,1949,12,1961
"خراسان_رضوی","مشهد","شهر_مشهد",610,1091,53,20,712,1876,17,1893
"خراسان_رضوی","مشهد","شهر_مشهد",611,1253,40,7,716,2016,25,2041
"خراسان_رضوی","مشهد","شهر_مشهد",612,1722,47,7,665,2441,22,2463
"خراسان_رضوی","مشهد","شهر_مشهد",613,1656,61,22,1107,2846,35,2881
"خراسان_رضوی","مشهد","شهر_مشهد",614,1204,60,19,1027,2310,27,2337
"خراسان_رضوی","مشهد","شهر_مشهد",615,1866,50,8,691,2615,30,2645
"خراسان_رضوی","مشهد","شهر_مشهد",616,1607,51,14,896,2568,27,2595
"خراسان_رضوی","مشهد","شهر_مشهد",617,1212,51,7,612,1882,16,1898
"خراسان_رضوی","مشهد","شهر_مشهد",618,1155,67,9,967,2198,25,2223
"خراسان_رضوی","مشهد","شهر_مشهد",619,997,44,8,611,1660,23,1683
"خراسان_رضوی","مشهد","شهر_مشهد",620,1116,40,7,743,1906,15,1921
"خراسان_رضوی","مشهد","شهر_مشهد",621,1392,55,6,586,2039,17,2056
"خراسان_رضوی","مشهد","شهر_مشهد",622,1277,56,10,727,2070,4,2074
"خراسان_رضوی","مشهد","شهر_مشهد",623,1461,40,22,762,2285,21,2306
"خراسان_رضوی","مشهد","شهر_مشهد",624,1120,43,15,698,1876,22,1898
"خراسان_رضوی","مشهد","شهر_مشهد",625,1761,63,10,1140,2974,22,2996
"خراسان_رضوی","مشهد","شهر_مشهد",626,994,51,19,949,2013,19,2032
"خراسان_رضوی","مشهد","شهر_مشهد",627,1354,52,8,948,2362,25,2387
"خراسان_رضوی","مشهد","شهر_مشهد",628,1325,49,10,990,2374,24,2398
"خراسان_رضوی","مشهد","شهر_مشهد",629,945,44,11,854,1854,25,1879
"خراسان_رضوی","مشهد","شهر_مشهد",630,1083,51,19,702,1855,17,1872
"خراسان_رضوی","مشهد","شهر_مشهد",631,906,40,11,621,1578,19,1597
"خراسان_رضوی","مشهد","شهر_مشهد",632,606,34,6,492,1138,11,1149
"خراسان_رضوی","مشهد","شهر_مشهد",633,751,22,3,442,1218,13,1231
"خراسان_رضوی","مشهد","شهر_مشهد",634,979,53,5,696,1733,21,1754
"خراسان_رضوی","مشهد","شهر_مشهد",635,948,28,9,628,1613,7,1620
"خراسان_رضوی","مشهد","شهر_مشهد",636,729,27,4,510,1270,11,1281
"خراسان_رضوی","مشهد","شهر_مشهد",637,1030,58,10,787,1885,25,1910
"خراسان_رضوی","مشهد","شهر_مشهد",638,625,69,21,1600,2315,25,2340
"خراسان_رضوی","مشهد","شهر_مشهد",639,994,72,11,875,1952,24,1976
"خراسان_رضوی","مشهد","شهر_مشهد",640,885,52,30,1062,2029,28,2057
"خراسان_رضوی","مشهد","شهر_مشهد",641,559,35,10,1293,1897,18,1915
"خراسان_رضوی","مشهد","شهر_مشهد",642,491,29,21,1425,1966,14,1980
"خراسان_رضوی","مشهد","شهر_مشهد",643,988,46,8,732,1774,20,1794
"خراسان_رضوی","مشهد","شهر_مشهد",644,787,38,21,901,1747,16,1763
"خراسان_رضوی","مشهد","شهر_مشهد",645,1155,55,11,827,2048,18,2066
"خراسان_رضوی","مشهد","شهر_مشهد",646,1100,52,10,837,1999,13,2012
"خراسان_رضوی","مشهد","شهر_مشهد",647,830,55,13,842,1740,20,1760
"خراسان_رضوی","مشهد","شهر_مشهد",648,898,48,17,1047,2010,21,2031
"خراسان_رضوی","مشهد","شهر_مشهد",649,1092,37,11,644,1784,33,1817
"خراسان_رضوی","مشهد","شهر_مشهد",650,1014,51,20,923,2008,28,2036
"خراسان_رضوی","مشهد","شهر_مشهد",651,1149,60,9,864,2082,19,2101
"خراسان_رضوی","مشهد","شهر_مشهد",652,1062,64,11,1098,2235,27,2262
"خراسان_رضوی","مشهد","شهر_مشهد",653,811,47,23,971,1852,17,1869
"خراسان_رضوی","مشهد","شهر_مشهد",654,1071,56,7,843,1977,11,1988
"خراسان_رضوی","مشهد","شهر_مشهد",655,1141,54,10,1092,2297,33,2330
"خراسان_رضوی","مشهد","شهر_مشهد",656,517,52,36,1378,1983,29,2012
"خراسان_رضوی","مشهد","شهر_مشهد",657,1086,87,42,1684,2899,41,2940
"خراسان_رضوی","مشهد","شهر_مشهد",658,683,69,44,1456,2252,15,2267
"خراسان_رضوی","مشهد","شهر_مشهد",659,582,52,17,1203,1854,27,1881
"خراسان_رضوی","مشهد","شهر_مشهد",660,492,51,26,1369,1938,20,1958
"خراسان_رضوی","مشهد","شهر_مشهد",661,1092,52,11,944,2099,26,2125
"خراسان_رضوی","مشهد","شهر_مشهد",662,807,51,25,1048,1931,23,1954
"خراسان_رضوی","مشهد","شهر_مشهد",663,1869,93,12,1089,3063,32,3095
"خراسان_رضوی","مشهد","شهر_مشهد",664,785,56,12,1389,2242,48,2290
"خراسان_رضوی","مشهد","شهر_مشهد",665,566,48,29,1257,1900,17,1917
"خراسان_رضوی","مشهد","شهر_مشهد",666,564,38,22,1242,1866,24,1890
"خراسان_رضوی","مشهد","شهر_مشهد",667,732,48,37,1634,2451,23,2474
"خراسان_رضوی","مشهد","شهر_مشهد",668,766,49,11,1062,1888,17,1905
"خراسان_رضوی","مشهد","شهر_مشهد",669,621,45,21,1219,1906,18,1924
"خراسان_رضوی","مشهد","شهر_مشهد",670,907,72,28,1427,2434,38,2472
"خراسان_رضوی","مشهد","شهر_مشهد",671,737,66,28,1315,2146,29,2175
"خراسان_رضوی","مشهد","شهر_مشهد",672,650,68,32,1532,2282,29,2311
"خراسان_رضوی","مشهد","شهر_مشهد",673,869,71,28,1356,2324,18,2342
"خراسان_رضوی","مشهد","شهر_مشهد",674,1111,70,24,1328,2533,28,2561
"خراسان_رضوی","مشهد","شهر_مشهد",675,1033,42,14,942,2031,30,2061
"خراسان_رضوی","مشهد","شهر_مشهد",676,1068,80,14,1368,2530,17,2547
"خراسان_رضوی","مشهد","شهر_مشهد",677,842,62,17,1057,1978,22,2000
"خراسان_رضوی","مشهد","شهر_مشهد",678,900,52,35,954,1941,17,1958
"خراسان_رضوی","مشهد","شهر_مشهد",679,979,56,18,1370,2423,28,2451
"خراسان_رضوی","مشهد","شهر_مشهد",680,921,73,22,1479,2495,19,2514
"خراسان_رضوی","مشهد","شهر_مشهد",681,392,23,12,807,1234,24,1258
"خراسان_رضوی","مشهد","شهر_مشهد",682,530,30,16,781,1357,18,1375
"خراسان_رضوی","مشهد","شهر_مشهد",683,449,45,11,705,1210,10,1220
"خراسان_رضوی","مشهد","شهر_مشهد",684,466,31,11,753,1261,24,1285
"خراسان_رضوی","مشهد","شهر_مشهد",685,859,17,5,394,1275,13,1288
"خراسان_رضوی","مشهد","شهر_مشهد",686,683,23,5,468,1179,8,1187
"خراسان_رضوی","مشهد","شهر_مشهد",687,1326,55,7,654,2042,17,2059
"خراسان_رضوی","مشهد","شهر_مشهد",688,932,42,3,520,1497,16,1513
"خراسان_رضوی","مشهد","شهر_مشهد",689,937,47,9,716,1709,19,1728
"خراسان_رضوی","مشهد","شهر_مشهد",690,1048,40,7,413,1508,17,1525
"خراسان_رضوی","مشهد","شهر_مشهد",691,818,26,3,578,1425,16,1441
"خراسان_رضوی","مشهد","شهر_مشهد",692,621,15,3,354,993,15,1008
"خراسان_رضوی","مشهد","شهر_مشهد",693,1279,47,8,516,1850,13,1863
"خراسان_رضوی","مشهد","شهر_مشهد",694,1016,61,18,708,1803,9,1812
"خراسان_رضوی","مشهد","شهر_مشهد",695,1706,9,4,260,1979,4,1983
"خراسان_رضوی","مشهد","شهر_مشهد",696,1767,14,6,258,2045,17,2062
"خراسان_رضوی","مشهد","شهر_مشهد",697,1973,12,4,290,2279,13,2292
"خراسان_رضوی","مشهد","شهر_مشهد",698,1597,20,1,250,1868,10,1878
"خراسان_رضوی","مشهد","شهر_مشهد",699,1630,14,4,326,1974,10,1984
"خراسان_رضوی","مشهد","شهر_مشهد",700,1199,12,1,206,1418,1,1419
"خراسان_رضوی","مشهد","شهر_مشهد",701,1775,17,5,283,2080,10,2090
"خراسان_رضوی","مشهد","شهر_مشهد",702,1667,15,1,273,1956,23,1979
"خراسان_رضوی","مشهد","شهر_مشهد",703,1730,24,9,331,2094,9,2103
"خراسان_رضوی","مشهد","شهر_مشهد",704,832,7,2,634,1475,11,1486
"خراسان_رضوی","مشهد","شهر_مشهد",705,1745,16,4,361,2126,16,2142
"خراسان_رضوی","مشهد","شهر_مشهد",706,2161,20,2,211,2394,14,2408
"خراسان_رضوی","مشهد","شهر_مشهد",707,2309,24,9,629,2971,16,2987
"خراسان_رضوی","مشهد","شهر_مشهد",708,1178,11,5,201,1395,4,1399
"خراسان_رضوی","مشهد","شهر_مشهد",709,2069,18,1,288,2376,18,2394
"خراسان_رضوی","مشهد","شهر_مشهد",710,1797,21,1,244,2063,4,2067
"خراسان_رضوی","مشهد","شهر_مشهد",711,1954,15,2,208,2179,15,2194
"خراسان_رضوی","مشهد","شهر_مشهد",712,1392,8,3,221,1624,9,1633
"خراسان_رضوی","مشهد","شهر_مشهد",713,1565,15,3,240,1823,13,1836
"خراسان_رضوی","مشهد","شهر_مشهد",714,1477,12,0,224,1713,5,1718
"خراسان_رضوی","مشهد","شهر_مشهد",715,1284,18,2,435,1739,12,1751
"خراسان_رضوی","مشهد","شهر_مشهد",716,1692,24,2,345,2063,8,2071
"خراسان_رضوی","مشهد","شهر_مشهد",717,1545,10,3,217,1775,4,1779
"خراسان_رضوی","مشهد","شهر_مشهد",718,2205,26,2,306,2539,11,2550
"خراسان_رضوی","مشهد","شهر_مشهد",719,1201,14,1,204,1420,79,1499
"خراسان_رضوی","مشهد","شهر_مشهد",720,1118,17,3,124,1262,12,1274
"خراسان_رضوی","مشهد","شهر_مشهد",721,2098,17,2,264,2381,43,2424
"خراسان_رضوی","مشهد","شهر_مشهد",722,1484,21,3,411,1919,6,1925
"خراسان_رضوی","مشهد","شهر_مشهد",723,1764,18,3,298,2083,14,2097
"خراسان_رضوی","مشهد","شهر_مشهد",724,2275,43,7,880,3205,33,3238
"خراسان_رضوی","مشهد","شهر_مشهد",725,1576,22,1,162,1761,6,1767
"خراسان_رضوی","مشهد","شهر_مشهد",726,1479,32,9,445,1965,10,1975
"خراسان_رضوی","مشهد","شهر_مشهد",727,1326,27,7,366,1726,9,1735
"خراسان_رضوی","مشهد","شهر_مشهد",728,1876,25,3,329,2233,14,2247
"خراسان_رضوی","مشهد","شهر_مشهد",729,1357,18,1,243,1619,2,1621
"خراسان_رضوی","مشهد","شهر_مشهد",730,1454,11,2,183,1650,7,1657
"خراسان_رضوی","مشهد","شهر_مشهد",731,591,32,4,369,996,4,1000
"خراسان_رضوی","مشهد","شهر_مشهد",732,952,35,8,785,1780,12,1792
"خراسان_رضوی","مشهد","شهر_مشهد",733,323,22,7,214,566,12,578
"خراسان_رضوی","مشهد","شهر_مشهد",734,972,20,6,353,1351,14,1365
"خراسان_رضوی","مشهد","شهر_مشهد",735,1051,9,2,117,1179,5,1184
"خراسان_رضوی","مشهد","شهر_مشهد",736,713,16,3,162,894,6,900
"خراسان_رضوی","مشهد","شهر_مشهد",737,883,28,5,467,1383,8,1391
"خراسان_رضوی","مشهد","شهر_مشهد",738,621,14,3,308,946,12,958
"خراسان_رضوی","مشهد","شهر_مشهد",739,898,11,2,109,1020,1,1021
"خراسان_رضوی","مشهد","شهر_مشهد",740,516,37,7,407,967,11,978
"خراسان_رضوی","مشهد","شهر_مشهد",741,397,9,2,170,578,5,583
"خراسان_رضوی","مشهد","شهر_مشهد",742,763,26,4,194,987,13,1000
"خراسان_رضوی","مشهد","شهر_مشهد",743,606,19,0,262,887,13,900
"خراسان_رضوی","مشهد","شهر_مشهد",744,230,10,0,73,313,10,323
"خراسان_رضوی","مشهد","شهر_مشهد",745,1218,11,4,205,1438,12,1450
"خراسان_رضوی","مشهد","شهر_مشهد",746,774,5,0,178,957,5,962
"خراسان_رضوی","مشهد","شهر_مشهد",747,363,25,6,430,824,13,837
"خراسان_رضوی","مشهد","شهر_مشهد",748,365,35,17,523,940,60,1000
"خراسان_رضوی","مشهد","شهر_مشهد",749,366,15,8,317,706,10,716
"خراسان_رضوی","مشهد","شهر_مشهد",750,431,19,3,287,740,6,746
"خراسان_رضوی","مشهد","شهر_مشهد",751,442,271,24,1,738,5,743
"خراسان_رضوی","مشهد","شهر_مشهد",752,684,8,7,337,1036,22,1058
"خراسان_رضوی","مشهد","شهر_مشهد",753,1175,4,2,151,1332,0,1332
"خراسان_رضوی","مشهد","شهر_مشهد",754,409,3,2,108,522,0,522
"خراسان_رضوی","مشهد","شهر_مشهد",755,1300,10,3,377,1690,10,1700
"خراسان_رضوی","مشهد","شهر_مشهد",756,1600,7,7,184,1798,0,1798
"خراسان_رضوی","مشهد","شهر_مشهد",757,1306,14,0,131,1451,10,1461
"خراسان_رضوی","مشهد","شهر_مشهد",758,1546,14,2,229,1791,8,1799
"خراسان_رضوی","مشهد","شهر_مشهد",759,943,10,0,174,1127,4,1131
"خراسان_رضوی","مشهد","شهر_مشهد",760,1262,5,0,154,1421,4,1425
"خراسان_رضوی","مشهد","شهر_مشهد",761,536,4,1,47,588,0,588
"خراسان_رضوی","مشهد","شهر_مشهد",762,1143,6,1,99,1249,4,1253
"خراسان_رضوی","مشهد","شهر_مشهد",763,1346,11,0,253,1610,9,1619
"خراسان_رضوی","مشهد","شهر_مشهد",764,1393,9,3,270,1675,20,1695
"خراسان_رضوی","مشهد","شهر_مشهد",765,1053,18,1,300,1372,8,1380
"خراسان_رضوی","مشهد","شهر_مشهد",766,867,16,3,352,1238,6,1244
"خراسان_رضوی","مشهد","شهر_مشهد",767,1361,21,9,416,1807,9,1816
"خراسان_رضوی","مشهد","شهر_مشهد",768,1166,29,3,254,1452,12,1464
"خراسان_رضوی","مشهد","شهر_مشهد",769,732,14,3,394,1143,6,1149
"خراسان_رضوی","مشهد","شهر_مشهد",770,1288,16,1,220,1525,8,1533
"خراسان_رضوی","مشهد","شهر_مشهد",771,1785,23,6,339,2153,4,2157
"خراسان_رضوی","مشهد","شهر_مشهد",772,813,6,4,139,962,8,970
"خراسان_رضوی","مشهد","شهر_مشهد",773,437,4,1,37,479,4,483
"خراسان_رضوی","مشهد","شهر_مشهد",774,808,7,3,119,937,2,939
"خراسان_رضوی","مشهد","شهر_مشهد",775,711,0,1,21,733,2,735
"خراسان_رضوی","مشهد","شهر_مشهد",776,474,1,0,37,512,1,513
"خراسان_رضوی","مشهد","شهر_مشهد",777,466,3,0,59,528,3,531
"خراسان_رضوی","مشهد","شهر_مشهد",778,801,9,0,102,912,1,913
"خراسان_رضوی","مشهد","شهر_مشهد",779,777,3,2,64,846,5,851
"خراسان_رضوی","مشهد","شهر_مشهد",780,748,10,0,88,846,4,850
"خراسان_رضوی","مشهد","شهر_مشهد",781,763,0,0,45,808,3,811
"خراسان_رضوی","مشهد","شهر_مشهد",782,761,9,3,169,942,4,946
"خراسان_رضوی","مشهد","شهر_مشهد",783,430,5,0,72,507,2,509
"خراسان_رضوی","مشهد","شهر_مشهد",784,275,0,4,74,353,0,353
"خراسان_رضوی","مشهد","شهر_مشهد",785,817,68,0,13,898,2,900
"خراسان_رضوی","مشهد","شهر_مشهد",786,940,8,8,71,1027,0,1027
"خراسان_رضوی","مشهد","شهر_مشهد",787,603,0,0,58,661,2,663
"خراسان_رضوی","مشهد","شهر_مشهد",788,435,9,2,104,550,2,552
"خراسان_رضوی","مشهد","شهر_مشهد",789,643,17,5,118,783,1,784
"خراسان_رضوی","مشهد","شهر_مشهد",790,903,20,4,542,1469,11,1480
"خراسان_رضوی","مشهد","شهر_مشهد",791,323,4,0,121,448,2,450
"خراسان_رضوی","مشهد","شهر_مشهد",792,632,6,0,59,697,2,699
"خراسان_رضوی","مشهد","شهر_مشهد",793,920,14,1,317,1252,9,1261
"خراسان_رضوی","مشهد","شهر_مشهد",794,1046,3,3,296,1348,9,1357
"خراسان_رضوی","مشهد","شهر_مشهد",795,520,7,0,140,667,0,667
"خراسان_رضوی","مشهد","شهر_مشهد",796,1067,23,2,167,1259,4,1263
"خراسان_رضوی","مشهد","شهر_مشهد",797,791,9,3,72,875,4,879
"خراسان_رضوی","مشهد","شهر_مشهد",798,874,20,5,367,1266,9,1275
"خراسان_رضوی","مشهد","شهر_مشهد",799,1103,7,9,215,1334,9,1343
"خراسان_رضوی","مشهد","شهر_مشهد",800,131,1,2,214,348,3,351
"خراسان_رضوی","مشهد","شهر_مشهد",801,386,7,0,84,477,6,483
"خراسان_رضوی","مشهد","شهر_مشهد",802,453,6,3,73,535,1,536
"خراسان_رضوی","مشهد","شهر_مشهد",803,898,16,3,165,1082,8,1090
"خراسان_رضوی","مشهد","شهر_مشهد",804,559,8,1,120,688,1,689
"خراسان_رضوی","مشهد","شهر_مشهد",805,1082,10,1,194,1287,3,1290
"خراسان_رضوی","مشهد","شهر_مشهد",806,1233,17,7,198,1455,7,1462
"خراسان_رضوی","مشهد","شهر_مشهد",807,912,6,0,134,1052,4,1056
"خراسان_رضوی","مشهد","شهر_مشهد",808,1676,22,0,208,1906,3,1909
"خراسان_رضوی","مشهد","شهر_مشهد",809,1037,8,1,181,1227,7,1234
"خراسان_رضوی","مشهد","شهر_مشهد",810,588,10,0,104,702,3,705
"خراسان_رضوی","مشهد","شهر_مشهد",811,288,0,0,14,302,0,302
"خراسان_رضوی","مشهد","شهر_مشهد",812,552,7,3,82,644,4,648
"خراسان_رضوی","مشهد","شهر_مشهد",813,713,2,3,34,752,8,760
"خراسان_رضوی","مشهد","شهر_مشهد",814,741,12,6,228,987,3,990
"خراسان_رضوی","مشهد","شهر_مشهد",815,432,4,0,66,502,1,503
"خراسان_رضوی","مشهد","شهر_مشهد",816,492,4,0,61,557,8,565
"خراسان_رضوی","مشهد","شهر_مشهد",817,1034,11,0,87,1132,5,1137
"خراسان_رضوی","مشهد","شهر_مشهد",818,1277,20,0,123,1420,6,1426
"خراسان_رضوی","مشهد","شهر_مشهد",819,944,7,4,131,1086,5,1091
"خراسان_رضوی","مشهد","شهر_مشهد",820,1078,15,4,166,1263,7,1270
"خراسان_رضوی","مشهد","شهر_مشهد",821,763,13,1,117,894,6,900
"خراسان_رضوی","مشهد","شهر_مشهد",822,709,1,2,52,764,0,764
"خراسان_رضوی","مشهد","شهر_مشهد",823,643,3,1,32,679,5,684
"خراسان_رضوی","مشهد","شهر_مشهد",824,1095,5,4,197,1301,2,1303
"خراسان_رضوی","مشهد","شهر_مشهد",825,1171,6,0,140,1317,9,1326
"خراسان_رضوی","مشهد","شهر_مشهد",826,1281,7,0,158,1446,7,1453
"خراسان_رضوی","مشهد","شهر_مشهد",827,1942,10,6,133,2091,15,2106
"خراسان_رضوی","مشهد","شهر_مشهد",828,1385,7,0,105,1497,3,1500
"خراسان_رضوی","مشهد","شهر_مشهد",829,1847,17,5,250,2119,14,2133
"خراسان_رضوی","مشهد","شهر_مشهد",830,928,7,4,158,1097,7,1104
"خراسان_رضوی","مشهد","شهر_مشهد",831,584,2,1,37,624,0,624
"خراسان_رضوی","مشهد","شهر_مشهد",832,1641,13,2,248,1904,7,1911
"خراسان_رضوی","مشهد","شهر_مشهد",833,1068,7,1,136,1212,5,1217
"خراسان_رضوی","مشهد","شهر_مشهد",834,754,0,2,26,782,4,786
"خراسان_رضوی","مشهد","شهر_مشهد",835,590,5,0,50,645,0,645
"خراسان_رضوی","مشهد","شهر_مشهد",836,238,0,1,26,265,1,266
"خراسان_رضوی","مشهد","شهر_مشهد",837,103,0,0,14,117,0,117
"خراسان_رضوی","مشهد","شهر_مشهد",838,582,1,0,56,639,1,640
"خراسان_رضوی","مشهد","شهر_مشهد",839,232,0,0,13,245,2,247
"خراسان_رضوی","مشهد","شهر_مشهد",840,637,5,2,78,722,3,725
"خراسان_رضوی","مشهد","شهر_مشهد",841,698,5,0,26,729,2,731
"خراسان_رضوی","مشهد","شهر_مشهد",842,1246,6,5,139,1396,6,1402
"خراسان_رضوی","مشهد","شهر_مشهد",843,1098,4,1,135,1238,9,1247
"خراسان_رضوی","مشهد","شهر_مشهد",844,283,1,2,22,308,2,310
"خراسان_رضوی","مشهد","شهر_مشهد",845,519,2,0,60,581,1,582
"خراسان_رضوی","مشهد","شهر_مشهد",846,1170,7,1,71,1249,6,1255
"خراسان_رضوی","مشهد","شهر_مشهد",847,692,0,1,59,752,2,754
"خراسان_رضوی","مشهد","شهر_مشهد",848,634,2,0,44,680,1,681
"خراسان_رضوی","مشهد","شهر_مشهد",849,139,3,3,439,584,3,587
"خراسان_رضوی","مشهد","شهر_مشهد",850,605,2,0,27,634,1,635
"خراسان_رضوی","مشهد","شهر_مشهد",851,659,2,0,69,730,6,736
"خراسان_رضوی","مشهد","شهر_مشهد",852,717,1,0,36,754,5,759
"خراسان_رضوی","مشهد","شهر_مشهد",853,497,2,0,92,591,1,592
"خراسان_رضوی","مشهد","شهر_مشهد",854,1559,5,4,140,1708,7,1715
"خراسان_رضوی","مشهد","شهر_مشهد",855,792,2,0,51,845,3,848
"خراسان_رضوی","مشهد","شهر_مشهد",856,870,0,1,48,919,0,919
"خراسان_رضوی","مشهد","شهر_مشهد",857,841,1,1,100,943,4,947
"خراسان_رضوی","مشهد","شهر_مشهد",858,403,14,1,197,615,5,620
"خراسان_رضوی","مشهد","شهر_مشهد",859,712,2,0,116,830,5,835
"خراسان_رضوی","مشهد","شهر_مشهد",860,1085,27,12,447,1571,3,1574
"خراسان_رضوی","مه_ولات","شادمهر",1,1107,9,2,136,1254,3,1257
"خراسان_رضوی","مه_ولات","شادمهر",2,796,2,0,80,878,5,883
"خراسان_رضوی","مه_ولات","شادمهر",3,775,2,3,252,1032,5,1037
"خراسان_رضوی","مه_ولات","شادمهر",4,679,4,2,165,850,2,852
"خراسان_رضوی","مه_ولات","شادمهر",5,833,2,2,83,920,2,922
"خراسان_رضوی","مه_ولات","شادمهر",6,348,3,0,69,420,2,422
"خراسان_رضوی","مه_ولات","شادمهر",7,100,0,0,20,120,0,120
"خراسان_رضوی","مه_ولات","شادمهر",8,628,2,1,50,681,0,681
"خراسان_رضوی","مه_ولات","شادمهر",9,368,0,0,41,409,2,411
"خراسان_رضوی","مه_ولات","شادمهر",10,480,4,2,87,573,1,574
"خراسان_رضوی","مه_ولات","شادمهر",11,314,1,1,46,362,0,362
"خراسان_رضوی","مه_ولات","شادمهر",12,584,0,1,27,612,1,613
"خراسان_رضوی","مه_ولات","شادمهر",13,361,7,1,62,431,6,437
"خراسان_رضوی","مه_ولات","شادمهر",14,145,0,0,10,155,0,155
"خراسان_رضوی","مه_ولات","شادمهر",15,268,0,0,11,279,7,286
"خراسان_رضوی","مه_ولات","شادمهر",16,261,0,0,21,282,1,283
"خراسان_رضوی","مه_ولات","شادمهر",17,169,0,0,5,174,0,174
"خراسان_رضوی","مه_ولات","شادمهر",18,712,1,1,75,789,4,793
"خراسان_رضوی","مه_ولات","شادمهر",19,101,2,0,17,120,1,121
"خراسان_رضوی","مه_ولات","شادمهر",20,91,0,0,9,100,1,101
"خراسان_رضوی","مه_ولات","شادمهر",21,207,2,0,19,228,2,230
"خراسان_رضوی","مه_ولات","شادمهر_سیار",22,87,1,0,10,98,0,98
"خراسان_رضوی","مه_ولات","مرکزی",1,920,7,1,316,1244,10,1254
"خراسان_رضوی","مه_ولات","مرکزی",2,326,4,0,161,491,7,498
"خراسان_رضوی","مه_ولات","مرکزی",3,1005,6,3,327,1341,4,1345
"خراسان_رضوی","مه_ولات","مرکزی",4,702,5,1,207,915,5,920
"خراسان_رضوی","مه_ولات","مرکزی",5,876,6,3,139,1024,5,1029
"خراسان_رضوی","مه_ولات","مرکزی",6,930,5,3,215,1153,2,1155
"خراسان_رضوی","مه_ولات","مرکزی",7,612,6,3,371,992,5,997
"خراسان_رضوی","مه_ولات","مرکزی",8,772,13,0,194,979,2,981
"خراسان_رضوی","مه_ولات","مرکزی",9,389,7,0,135,531,3,534
"خراسان_رضوی","مه_ولات","مرکزی",10,800,5,2,195,1002,11,1013
"خراسان_رضوی","مه_ولات","مرکزی",11,610,7,0,159,776,6,782
"خراسان_رضوی","مه_ولات","مرکزی",12,1343,10,1,143,1497,1,1498
"خراسان_رضوی","مه_ولات","مرکزی",13,754,5,2,83,844,2,846
"خراسان_رضوی","مه_ولات","مرکزی",14,865,16,1,116,998,2,1000
"خراسان_رضوی","مه_ولات","مرکزی",15,616,4,0,136,756,1,757
"خراسان_رضوی","مه_ولات","مرکزی",16,208,2,0,72,282,0,282
"خراسان_رضوی","مه_ولات","مرکزی",17,943,2,1,27,973,0,973
"خراسان_رضوی","مه_ولات","مرکزی",18,951,2,0,97,1050,1,1051
"خراسان_رضوی","مه_ولات","مرکزی",19,498,2,1,49,550,4,554
"خراسان_رضوی","مه_ولات","مرکزی",20,536,6,0,77,619,3,622
"خراسان_رضوی","مه_ولات","مرکزی",21,728,4,1,114,847,0,847
"خراسان_رضوی","مه_ولات","مرکزی",22,150,1,0,30,181,1,182
"خراسان_رضوی","نیشابور","مرکزی",1,1193,13,7,262,1475,8,1483
"خراسان_رضوی","نیشابور","مرکزی",2,760,12,7,203,982,3,985
"خراسان_رضوی","نیشابور","مرکزی",3,887,13,1,106,1007,5,1012
"خراسان_رضوی","نیشابور","مرکزی",4,1327,29,8,259,1623,10,1633
"خراسان_رضوی","نیشابور","مرکزی",5,628,6,6,207,847,9,856
"خراسان_رضوی","نیشابور","مرکزی",6,931,11,9,285,1236,7,1243
"خراسان_رضوی","نیشابور","مرکزی",7,562,23,6,306,897,7,904
"خراسان_رضوی","نیشابور","مرکزی",8,851,36,11,602,1500,18,1518
"خراسان_رضوی","نیشابور","مرکزی",9,1068,31,6,389,1494,15,1509
"خراسان_رضوی","نیشابور","مرکزی",10,1020,15,10,296,1341,9,1350
"خراسان_رضوی","نیشابور","مرکزی",11,639,37,9,501,1186,14,1200
"خراسان_رضوی","نیشابور","مرکزی",12,375,28,14,438,855,7,862
"خراسان_رضوی","نیشابور","مرکزی",13,1027,34,5,439,1505,17,1522
"خراسان_رضوی","نیشابور","مرکزی",14,1038,19,10,420,1487,13,1500
"خراسان_رضوی","نیشابور","مرکزی",15,838,14,4,237,1093,7,1100
"خراسان_رضوی","نیشابور","مرکزی",16,888,23,23,481,1415,9,1424
"خراسان_رضوی","نیشابور","مرکزی",17,805,17,10,185,1017,5,1022
"خراسان_رضوی","نیشابور","مرکزی",18,831,42,17,606,1496,22,1518
"خراسان_رضوی","نیشابور","مرکزی",19,260,30,8,327,625,4,629
"خراسان_رضوی","نیشابور","مرکزی",20,818,39,11,815,1683,16,1699
"خراسان_رضوی","نیشابور","مرکزی",21,575,13,4,303,895,1,896
"خراسان_رضوی","نیشابور","مرکزی",22,722,45,31,777,1575,15,1590
"خراسان_رضوی","نیشابور","مرکزی",23,499,10,1,279,789,10,799
"خراسان_رضوی","نیشابور","مرکزی",24,629,42,23,689,1383,15,1398
"خراسان_رضوی","نیشابور","مرکزی",25,624,42,5,913,1584,16,1600
"خراسان_رضوی","نیشابور","مرکزی",26,456,30,10,987,1483,17,1500
"خراسان_رضوی","نیشابور","مرکزی",27,493,36,10,567,1106,9,1115
"خراسان_رضوی","نیشابور","مرکزی",28,966,30,2,465,1463,16,1479
"خراسان_رضوی","نیشابور","مرکزی",29,497,20,5,355,877,16,893
"خراسان_رضوی","نیشابور","مرکزی",30,1208,27,13,363,1611,13,1624
"خراسان_رضوی","نیشابور","مرکزی",31,1028,23,10,325,1386,14,1400
"خراسان_رضوی","نیشابور","مرکزی",32,887,20,3,228,1138,10,1148
"خراسان_رضوی","نیشابور","مرکزی",33,379,20,4,214,617,9,626
"خراسان_رضوی","نیشابور","مرکزی",34,423,28,6,401,858,7,865
"خراسان_رضوی","نیشابور","مرکزی",35,661,28,9,743,1441,12,1453
"خراسان_رضوی","نیشابور","مرکزی",36,833,20,6,349,1208,6,1214
"خراسان_رضوی","نیشابور","مرکزی",37,399,11,4,204,618,4,622
"خراسان_رضوی","نیشابور","مرکزی",38,979,26,18,606,1629,15,1644
"خراسان_رضوی","نیشابور","مرکزی",39,746,36,9,560,1351,16,1367
"خراسان_رضوی","نیشابور","مرکزی",40,942,12,2,318,1274,11,1285
"خراسان_رضوی","نیشابور","مرکزی",41,861,42,16,527,1446,16,1462
"خراسان_رضوی","نیشابور","مرکزی",42,990,9,2,246,1247,5,1252
"خراسان_رضوی","نیشابور","مرکزی",43,270,9,4,152,435,2,437
"خراسان_رضوی","نیشابور","مرکزی",44,931,21,6,335,1293,22,1315
"خراسان_رضوی","نیشابور","مرکزی",45,890,25,2,367,1284,10,1294
"خراسان_رضوی","نیشابور","مرکزی",46,799,10,2,225,1036,10,1046
"خراسان_رضوی","نیشابور","مرکزی",47,515,13,5,239,772,3,775
"خراسان_رضوی","نیشابور","مرکزی",48,1168,17,1,398,1584,17,1601
"خراسان_رضوی","نیشابور","مرکزی",49,847,23,2,317,1189,11,1200
"خراسان_رضوی","نیشابور","مرکزی",50,916,14,8,294,1232,9,1241
"خراسان_رضوی","نیشابور","مرکزی",51,1038,15,11,363,1427,9,1436
"خراسان_رضوی","نیشابور","مرکزی",52,447,7,5,111,570,4,574
"خراسان_رضوی","نیشابور","مرکزی",53,1015,9,9,188,1221,7,1228
"خراسان_رضوی","نیشابور","مرکزی",54,689,6,5,173,873,1,874
"خراسان_رضوی","نیشابور","مرکزی",55,633,14,3,267,917,7,924
"خراسان_رضوی","نیشابور","مرکزی",56,926,11,9,246,1192,8,1200
"خراسان_رضوی","نیشابور","مرکزی",57,811,15,8,243,1077,6,1083
"خراسان_رضوی","نیشابور","مرکزی",58,655,13,2,187,857,5,862
"خراسان_رضوی","نیشابور","مرکزی",59,1356,8,10,291,1665,5,1670
"خراسان_رضوی","نیشابور","مرکزی",60,1079,49,7,637,1772,18,1790
"خراسان_رضوی","نیشابور","مرکزی",61,979,22,5,299,1305,14,1319
"خراسان_رضوی","نیشابور","مرکزی",62,466,19,4,460,949,14,963
"خراسان_رضوی","نیشابور","مرکزی",63,598,44,16,1234,1892,8,1900
"خراسان_رضوی","نیشابور","مرکزی",64,504,30,8,508,1050,7,1057
"خراسان_رضوی","نیشابور","مرکزی",65,711,38,4,522,1275,12,1287
"خراسان_رضوی","نیشابور","مرکزی",66,263,22,4,563,852,7,859
"خراسان_رضوی","نیشابور","مرکزی",67,802,32,6,708,1548,15,1563
"خراسان_رضوی","نیشابور","مرکزی",68,650,50,5,514,1219,18,1237
"خراسان_رضوی","نیشابور","مرکزی",69,657,39,20,968,1684,18,1702
"خراسان_رضوی","نیشابور","مرکزی",70,440,26,9,557,1032,15,1047
"خراسان_رضوی","نیشابور","مرکزی",71,613,38,13,712,1376,16,1392
"خراسان_رضوی","نیشابور","مرکزی",72,870,64,19,795,1748,15,1763
"خراسان_رضوی","نیشابور","مرکزی",73,686,38,13,640,1377,15,1392
"خراسان_رضوی","نیشابور","مرکزی",74,793,33,7,439,1272,10,1282
"خراسان_رضوی","نیشابور","مرکزی",75,909,41,4,704,1658,25,1683
"خراسان_رضوی","نیشابور","مرکزی",76,906,30,6,433,1375,23,1398
"خراسان_رضوی","نیشابور","مرکزی",77,1055,37,6,641,1739,13,1752
"خراسان_رضوی","نیشابور","مرکزی",78,703,31,6,369,1109,14,1123
"خراسان_رضوی","نیشابور","مرکزی",79,991,24,6,613,1634,23,1657
"خراسان_رضوی","نیشابور","مرکزی",80,874,30,7,538,1449,8,1457
"خراسان_رضوی","نیشابور","مرکزی",81,903,40,8,827,1778,21,1799
"خراسان_رضوی","نیشابور","مرکزی",82,876,9,9,211,1105,3,1108
"خراسان_رضوی","نیشابور","مرکزی",83,1412,21,7,263,1703,7,1710
"خراسان_رضوی","نیشابور","مرکزی",84,330,2,0,92,424,5,429
"خراسان_رضوی","نیشابور","مرکزی",85,922,22,6,337,1287,13,1300
"خراسان_رضوی","نیشابور","مرکزی",86,974,19,5,330,1328,8,1336
"خراسان_رضوی","نیشابور","مرکزی",87,1000,18,0,246,1264,5,1269
"خراسان_رضوی","نیشابور","مرکزی",88,750,15,5,277,1047,8,1055
"خراسان_رضوی","نیشابور","مرکزی",89,749,13,3,254,1019,3,1022
"خراسان_رضوی","نیشابور","مرکزی",90,946,14,5,248,1213,5,1218
"خراسان_رضوی","نیشابور","مرکزی",91,1123,9,7,149,1288,5,1293
"خراسان_رضوی","نیشابور","مرکزی",92,1252,8,4,136,1400,4,1404
"خراسان_رضوی","نیشابور","مرکزی",93,912,10,5,197,1124,17,1141
"خراسان_رضوی","نیشابور","مرکزی",94,1206,5,5,157,1373,4,1377
"خراسان_رضوی","نیشابور","مرکزی",95,1152,25,6,284,1467,11,1478
"خراسان_رضوی","نیشابور","مرکزی",96,747,9,2,261,1019,4,1023
"خراسان_رضوی","نیشابور","مرکزی",97,1046,7,2,172,1227,9,1236
"خراسان_رضوی","نیشابور","مرکزی",98,1384,14,4,225,1627,13,1640
"خراسان_رضوی","نیشابور","مرکزی",99,573,5,4,88,670,2,672
"خراسان_رضوی","نیشابور","مرکزی",100,778,6,1,142,927,2,929
"خراسان_رضوی","نیشابور","مرکزی",101,633,7,1,180,821,7,828
"خراسان_رضوی","نیشابور","مرکزی",102,476,9,0,103,588,4,592
"خراسان_رضوی","نیشابور","مرکزی",103,512,12,7,319,850,11,861
"خراسان_رضوی","نیشابور","مرکزی",104,704,8,2,76,790,2,792
"خراسان_رضوی","نیشابور","مرکزی",105,598,8,5,170,781,3,784
"خراسان_رضوی","نیشابور","مرکزی",106,395,34,12,441,882,22,904
"خراسان_رضوی","نیشابور","مرکزی",107,377,11,0,75,463,7,470
"خراسان_رضوی","نیشابور","مرکزی",108,356,18,8,241,623,17,640
"خراسان_رضوی","نیشابور","مرکزی",109,208,6,4,94,312,4,316
"خراسان_رضوی","نیشابور","مرکزی",110,380,1,1,100,482,1,483
"خراسان_رضوی","نیشابور","مرکزی",111,647,3,1,88,739,4,743
"خراسان_رضوی","نیشابور","مرکزی",112,451,3,0,50,504,0,504
"خراسان_رضوی","نیشابور","مرکزی",113,526,4,2,41,573,0,573
"خراسان_رضوی","نیشابور","مرکزی",114,627,3,1,59,690,0,690
"خراسان_رضوی","نیشابور","مرکزی",115,605,7,2,133,747,4,751
"خراسان_رضوی","نیشابور","مرکزی",116,902,5,7,47,961,3,964
"خراسان_رضوی","نیشابور","مرکزی",117,599,4,1,74,678,10,688
"خراسان_رضوی","نیشابور","مرکزی",118,570,4,2,103,679,3,682
"خراسان_رضوی","نیشابور","مرکزی",119,638,30,3,291,962,9,971
"خراسان_رضوی","نیشابور","مرکزی",120,391,2,3,125,521,5,526
"خراسان_رضوی","نیشابور","مرکزی",121,1074,10,5,169,1258,9,1267
"خراسان_رضوی","نیشابور","مرکزی",122,867,4,3,93,967,7,974
"خراسان_رضوی","نیشابور","مرکزی",123,600,2,4,54,660,4,664
"خراسان_رضوی","نیشابور","مرکزی",124,280,6,0,102,388,1,389
"خراسان_رضوی","نیشابور","مرکزی",125,343,3,0,55,401,1,402
"خراسان_رضوی","نیشابور","مرکزی",126,653,3,1,72,729,9,738
"خراسان_رضوی","نیشابور","مرکزی",127,365,1,3,50,419,0,419
"خراسان_رضوی","نیشابور","مرکزی",128,539,1,7,54,601,1,602
"خراسان_رضوی","نیشابور","مرکزی",129,515,2,4,124,645,8,653
"خراسان_رضوی","نیشابور","مرکزی",130,551,1,1,44,597,3,600
"خراسان_رضوی","نیشابور","مرکزی",131,515,5,0,104,624,4,628
"خراسان_رضوی","نیشابور","مرکزی",132,665,3,2,56,726,3,729
"خراسان_رضوی","نیشابور","مرکزی",133,721,6,0,118,845,4,849
"خراسان_رضوی","نیشابور","مرکزی",134,600,3,7,322,932,7,939
"خراسان_رضوی","نیشابور","مرکزی",135,890,4,1,138,1033,7,1040
"خراسان_رضوی","نیشابور","مرکزی",136,776,6,4,184,970,8,978
"خراسان_رضوی","نیشابور","مرکزی",137,970,19,0,207,1196,7,1203
"خراسان_رضوی","نیشابور","مرکزی",138,616,6,5,253,880,6,886
"خراسان_رضوی","نیشابور","مرکزی",139,570,7,2,144,723,10,733
"خراسان_رضوی","نیشابور","مرکزی",140,388,4,1,92,485,6,491
"خراسان_رضوی","نیشابور","مرکزی",141,895,7,10,102,1014,4,1018
"خراسان_رضوی","نیشابور","مرکزی",142,1029,4,5,144,1182,4,1186
"خراسان_رضوی","نیشابور","مرکزی",143,497,5,2,40,544,2,546
"خراسان_رضوی","نیشابور","مرکزی",144,533,4,0,80,617,0,617
"خراسان_رضوی","نیشابور","مرکزی",145,635,9,4,150,798,2,800
"خراسان_رضوی","نیشابور","مرکزی",146,959,13,3,189,1164,7,1171
"خراسان_رضوی","نیشابور","مرکزی",147,604,9,8,150,771,11,782
"خراسان_رضوی","نیشابور","مرکزی",148,1022,7,3,275,1307,6,1313
"خراسان_رضوی","نیشابور","مرکزی",149,638,3,1,114,756,4,760
"خراسان_رضوی","نیشابور","مرکزی",150,659,13,1,63,736,5,741
"خراسان_رضوی","نیشابور","مرکزی",151,1005,2,2,94,1103,1,1104
"خراسان_رضوی","نیشابور","مرکزی",152,1099,0,2,123,1224,9,1233
"خراسان_رضوی","نیشابور","مرکزی",153,906,10,4,130,1050,7,1057
"خراسان_رضوی","نیشابور","مرکزی",154,330,10,2,51,393,0,393
"خراسان_رضوی","نیشابور","مرکزی",155,460,1,5,145,611,1,612
"خراسان_رضوی","نیشابور","مرکزی",156,765,14,3,61,843,2,845
"خراسان_رضوی","نیشابور","مرکزی",157,614,5,0,71,690,2,692
"خراسان_رضوی","نیشابور","مرکزی",158,756,2,1,74,833,4,837
"خراسان_رضوی","نیشابور","مرکزی",159,566,4,1,121,692,3,695
"خراسان_رضوی","نیشابور","مرکزی",160,277,1,1,58,337,2,339
"خراسان_رضوی","نیشابور","مرکزی",161,447,14,2,114,577,2,579
"خراسان_رضوی","نیشابور","مرکزی",162,553,10,4,194,761,12,773
"خراسان_رضوی","نیشابور","مرکزی",163,644,8,1,111,764,8,772
"خراسان_رضوی","نیشابور","مرکزی",164,397,3,0,29,429,2,431
"خراسان_رضوی","نیشابور","مرکزی",165,600,2,1,80,683,2,685
"خراسان_رضوی","نیشابور","مرکزی",166,319,1,7,30,357,0,357
"خراسان_رضوی","نیشابور","مرکزی",167,413,0,3,17,433,0,433
"خراسان_رضوی","نیشابور","مرکزی",168,424,1,1,46,472,1,473
"خراسان_رضوی","نیشابور","مرکزی",169,285,0,1,27,313,0,313
"خراسان_رضوی","نیشابور","مرکزی",170,399,5,1,54,459,3,462
"خراسان_رضوی","نیشابور","مرکزی",171,190,2,2,11,205,1,206
"خراسان_رضوی","نیشابور","مرکزی",172,264,0,1,24,289,1,290
"خراسان_رضوی","نیشابور","مرکزی",173,353,6,3,29,391,2,393
"خراسان_رضوی","نیشابور","زبرخان",1,876,17,18,233,1144,4,1148
"خراسان_رضوی","نیشابور","زبرخان",2,856,2,0,80,938,6,944
"خراسان_رضوی","نیشابور","زبرخان",3,968,4,4,95,1071,5,1076
"خراسان_رضوی","نیشابور","زبرخان",4,696,10,0,115,821,3,824
"خراسان_رضوی","نیشابور","زبرخان",5,487,14,0,181,682,5,687
"خراسان_رضوی","نیشابور","زبرخان",6,834,2,1,108,945,3,948
"خراسان_رضوی","نیشابور","زبرخان",7,780,5,4,289,1078,7,1085
"خراسان_رضوی","نیشابور","زبرخان",8,1062,18,8,454,1542,18,1560
"خراسان_رضوی","نیشابور","زبرخان",9,671,10,2,173,856,7,863
"خراسان_رضوی","نیشابور","زبرخان",10,448,4,1,80,533,8,541
"خراسان_رضوی","نیشابور","زبرخان",11,554,5,0,75,634,2,636
"خراسان_رضوی","نیشابور","زبرخان",12,667,4,4,129,804,9,813
"خراسان_رضوی","نیشابور","زبرخان",13,357,5,4,76,442,8,450
"خراسان_رضوی","نیشابور","زبرخان",14,834,11,13,328,1186,8,1194
"خراسان_رضوی","نیشابور","زبرخان",15,451,2,3,101,557,6,563
"خراسان_رضوی","نیشابور","زبرخان",16,383,2,3,155,543,4,547
"خراسان_رضوی","نیشابور","زبرخان",17,623,4,8,46,681,1,682
"خراسان_رضوی","نیشابور","زبرخان",18,1070,12,2,262,1346,6,1352
"خراسان_رضوی","نیشابور","زبرخان",19,834,10,2,183,1029,1,1030
"خراسان_رضوی","نیشابور","زبرخان",20,484,6,1,100,591,1,592
"خراسان_رضوی","نیشابور","زبرخان",21,346,2,5,76,429,6,435
"خراسان_رضوی","نیشابور","زبرخان",22,694,6,1,118,819,2,821
"خراسان_رضوی","نیشابور","زبرخان",23,727,13,1,317,1058,8,1066
"خراسان_رضوی","نیشابور","زبرخان",24,703,8,2,435,1148,1,1149
"خراسان_رضوی","نیشابور","زبرخان",25,847,5,0,282,1134,16,1150
"خراسان_رضوی","نیشابور","زبرخان",26,823,8,2,290,1123,11,1134
"خراسان_رضوی","نیشابور","زبرخان",27,806,10,2,161,979,4,983
"خراسان_رضوی","نیشابور","زبرخان",28,916,1,0,62,979,1,980
"خراسان_رضوی","نیشابور","زبرخان",29,665,4,0,72,741,1,742
"خراسان_رضوی","نیشابور","زبرخان",30,744,12,5,179,940,7,947
"خراسان_رضوی","نیشابور","زبرخان",31,929,11,1,99,1040,8,1048
"خراسان_رضوی","نیشابور","زبرخان",32,725,5,1,29,760,5,765
"خراسان_رضوی","نیشابور","زبرخان",33,396,6,0,85,487,1,488
"خراسان_رضوی","نیشابور","زبرخان",34,893,4,16,73,986,4,990
"خراسان_رضوی","نیشابور","زبرخان",35,606,5,3,73,687,2,689
"خراسان_رضوی","نیشابور","زبرخان",36,389,2,0,78,469,0,469
"خراسان_رضوی","نیشابور","زبرخان",37,636,1,1,312,950,7,957
"خراسان_رضوی","نیشابور","زبرخان",38,651,4,0,36,691,3,694
"خراسان_رضوی","نیشابور","زبرخان",39,255,4,2,18,279,1,280
"خراسان_رضوی","نیشابور","زبرخان",40,687,1,0,84,772,4,776
"خراسان_رضوی","نیشابور","زبرخان",41,745,1,5,71,822,1,823
"خراسان_رضوی","نیشابور","زبرخان",42,669,9,6,75,759,5,764
"خراسان_رضوی","نیشابور","زبرخان",43,785,5,0,61,851,2,853
"خراسان_رضوی","نیشابور","زبرخان",44,796,5,1,44,846,4,850
"خراسان_رضوی","نیشابور","زبرخان",45,612,6,0,140,758,1,759
"خراسان_رضوی","نیشابور","سرولایت",1,414,9,1,172,596,1,597
"خراسان_رضوی","نیشابور","سرولایت",2,271,5,1,114,391,1,392
"خراسان_رضوی","نیشابور","سرولایت",3,584,7,0,33,624,0,624
"خراسان_رضوی","نیشابور","سرولایت",4,366,4,1,95,466,1,467
"خراسان_رضوی","نیشابور","سرولایت",5,351,0,0,31,382,0,382
"خراسان_رضوی","نیشابور","سرولایت",6,385,1,0,35,421,5,426
"خراسان_رضوی","نیشابور","سرولایت",7,598,3,0,80,681,0,681
"خراسان_رضوی","نیشابور","سرولایت",8,431,3,0,114,548,0,548
"خراسان_رضوی","نیشابور","سرولایت",9,278,1,0,59,338,0,338
"خراسان_رضوی","نیشابور","سرولایت",10,256,3,0,51,310,0,310
"خراسان_رضوی","نیشابور","سرولایت",11,402,2,0,58,462,0,462
"خراسان_رضوی","نیشابور","سرولایت",12,261,1,0,36,298,2,300
"خراسان_رضوی","نیشابور","سرولایت",13,275,4,0,49,328,6,334
"خراسان_رضوی","نیشابور","سرولایت",14,362,14,0,44,420,6,426
"خراسان_رضوی","نیشابور","سرولایت",15,250,1,0,37,288,5,293
"خراسان_رضوی","نیشابور","سرولایت",16,251,10,0,80,341,1,342
"خراسان_رضوی","نیشابور","سرولایت",17,391,1,0,64,456,2,458
"خراسان_رضوی","نیشابور","سرولایت",18,315,2,2,146,465,1,466
"خراسان_رضوی","نیشابور","سرولایت",19,243,3,1,21,268,1,269
"خراسان_رضوی","نیشابور","سرولایت",20,564,0,0,18,582,1,583
"خراسان_رضوی","نیشابور","سرولایت",21,398,5,0,18,421,0,421
"خراسان_رضوی","نیشابور","سرولایت",22,602,3,3,92,700,1,701
"خراسان_رضوی","نیشابور","سرولایت",23,547,1,0,39,587,2,589
"خراسان_رضوی","نیشابور","سرولایت",24,483,3,0,27,513,1,514
"خراسان_رضوی","نیشابور","سرولایت",25,248,0,0,18,266,2,268
"خراسان_رضوی","نیشابور","میان_جلگه",1,810,7,0,184,1001,9,1010
"خراسان_رضوی","نیشابور","میان_جلگه",2,368,2,0,17,387,0,387
"خراسان_رضوی","نیشابور","میان_جلگه",3,431,4,0,67,502,3,505
"خراسان_رضوی","نیشابور","میان_جلگه",4,674,4,0,43,721,3,724
"خراسان_رضوی","نیشابور","میان_جلگه",5,475,4,0,55,534,3,537
"خراسان_رضوی","نیشابور","میان_جلگه",6,764,2,3,54,823,6,829
"خراسان_رضوی","نیشابور","میان_جلگه",7,694,2,1,51,748,1,749
"خراسان_رضوی","نیشابور","میان_جلگه",8,827,14,0,59,900,0,900
"خراسان_رضوی","نیشابور","میان_جلگه",9,818,3,0,66,887,0,887
"خراسان_رضوی","نیشابور","میان_جلگه",10,916,0,0,16,932,0,932
"خراسان_رضوی","نیشابور","میان_جلگه",11,530,1,0,15,546,0,546
"خراسان_رضوی","نیشابور","میان_جلگه",12,524,0,0,12,536,0,536
"خراسان_رضوی","نیشابور","میان_جلگه",13,567,0,2,60,629,1,630
"خراسان_رضوی","نیشابور","میان_جلگه",14,384,2,1,7,394,0,394
"خراسان_رضوی","نیشابور","میان_جلگه",15,836,7,1,38,882,0,882
"خراسان_رضوی","نیشابور","میان_جلگه",16,867,5,0,25,897,2,899
"خراسان_رضوی","نیشابور","میان_جلگه",17,635,4,1,22,662,1,663
"خراسان_رضوی","نیشابور","میان_جلگه",18,956,2,0,35,993,4,997
"خراسان_رضوی","نیشابور","میان_جلگه",19,785,4,0,43,832,0,832
"خراسان_رضوی","نیشابور","میان_جلگه",20,728,1,2,18,749,0,749
"خراسان_رضوی","نیشابور","میان_جلگه",21,485,0,0,44,529,0,529
"خراسان_رضوی","نیشابور","میان_جلگه",22,461,1,0,12,474,2,476
"خراسان_رضوی","نیشابور","میان_جلگه",23,864,2,0,38,904,1,905
"خراسان_رضوی","نیشابور","میان_جلگه",24,1025,13,1,42,1081,1,1082
"خراسان_رضوی","نیشابور","میان_جلگه",25,1035,9,4,39,1087,0,1087
"خراسان_رضوی","نیشابور","میان_جلگه",26,630,4,0,17,651,3,654
"خراسان_رضوی","نیشابور","میان_جلگه",27,844,3,1,18,866,1,867
"خراسان_رضوی","نیشابور","میان_جلگه",28,469,0,0,13,482,4,486
"خراسان_رضوی","نیشابور","میان_جلگه",29,765,0,0,27,792,3,795
"خراسان_رضوی","نیشابور","میان_جلگه",30,707,1,0,17,725,1,726
"خراسان_رضوی","نیشابور","میان_جلگه",31,431,0,2,8,441,0,441
"خراسان_رضوی","نیشابور","میان_جلگه",32,212,3,0,22,237,2,239
"خراسان_شمالی","اسفراین","مرکزی",1,1103,24,26,555,1708,8,1716
"خراسان_شمالی","اسفراین","مرکزی",2,707,22,21,665,1415,15,1430
"خراسان_شمالی","اسفراین","مرکزی",3,589,15,19,407,1030,10,1040
"خراسان_شمالی","اسفراین","مرکزی",4,931,32,21,498,1482,18,1500
"خراسان_شمالی","اسفراین","مرکزی",5,416,14,13,204,647,8,655
"خراسان_شمالی","اسفراین","مرکزی",6,845,17,10,520,1392,9,1401
"خراسان_شمالی","اسفراین","مرکزی",7,423,9,6,148,586,6,592
"خراسان_شمالی","اسفراین","مرکزی",8,787,37,13,614,1451,13,1464
"خراسان_شمالی","اسفراین","مرکزی",9,840,14,8,343,1205,4,1209
"خراسان_شمالی","اسفراین","مرکزی",10,512,13,9,302,836,9,845
"خراسان_شمالی","اسفراین","مرکزی",11,1050,11,17,385,1463,16,1479
"خراسان_شمالی","اسفراین","مرکزی",12,681,6,14,211,912,9,921
"خراسان_شمالی","اسفراین","مرکزی",13,851,7,15,228,1101,5,1106
"خراسان_شمالی","اسفراین","مرکزی",14,1056,15,29,541,1641,13,1654
"خراسان_شمالی","اسفراین","مرکزی",15,869,11,11,309,1200,9,1209
"خراسان_شمالی","اسفراین","مرکزی",16,384,11,17,328,740,8,748
"خراسان_شمالی","اسفراین","مرکزی",17,914,29,25,568,1536,17,1553
"خراسان_شمالی","اسفراین","مرکزی",18,782,25,9,480,1296,13,1309
"خراسان_شمالی","اسفراین","مرکزی",19,685,34,62,693,1474,10,1484
"خراسان_شمالی","اسفراین","مرکزی",20,569,7,8,336,920,12,932
"خراسان_شمالی","اسفراین","مرکزی",21,593,6,21,384,1004,6,1010
"خراسان_شمالی","اسفراین","مرکزی",22,1121,15,14,503,1653,12,1665
"خراسان_شمالی","اسفراین","مرکزی",23,1079,14,12,269,1374,8,1382
"خراسان_شمالی","اسفراین","مرکزی",24,570,7,12,296,885,3,888
"خراسان_شمالی","اسفراین","مرکزی",25,317,6,4,146,473,2,475
"خراسان_شمالی","اسفراین","مرکزی",26,1021,18,19,290,1348,10,1358
"خراسان_شمالی","اسفراین","مرکزی",27,337,10,5,208,560,9,569
"خراسان_شمالی","اسفراین","مرکزی",28,660,8,19,128,815,5,820
"خراسان_شمالی","اسفراین","مرکزی",29,813,7,5,57,882,5,887
"خراسان_شمالی","اسفراین","مرکزی",30,849,8,13,96,966,4,970
"خراسان_شمالی","اسفراین","مرکزی",31,46,1,3,31,81,0,81
"خراسان_شمالی","اسفراین","مرکزی",32,501,7,13,135,656,1,657
"خراسان_شمالی","اسفراین","مرکزی",33,716,6,10,56,788,2,790
"خراسان_شمالی","اسفراین","مرکزی",34,818,8,7,81,914,5,919
"خراسان_شمالی","اسفراین","مرکزی",35,519,1,2,16,538,0,538
"خراسان_شمالی","اسفراین","مرکزی",36,419,6,1,50,476,2,478
"خراسان_شمالی","اسفراین","مرکزی",37,655,4,7,96,762,1,763
"خراسان_شمالی","اسفراین","مرکزی",38,514,2,7,40,563,8,571
"خراسان_شمالی","اسفراین","مرکزی",39,613,4,2,52,671,3,674
"خراسان_شمالی","اسفراین","مرکزی",40,393,3,1,30,427,1,428
"خراسان_شمالی","اسفراین","مرکزی",41,765,3,3,85,856,2,858
"خراسان_شمالی","اسفراین","مرکزی",42,267,0,1,106,374,0,374
"خراسان_شمالی","اسفراین","مرکزی",43,763,3,6,101,873,1,874
"خراسان_شمالی","اسفراین","مرکزی",44,551,0,3,76,630,4,634
"خراسان_شمالی","اسفراین","مرکزی",45,463,1,2,39,505,1,506
"خراسان_شمالی","اسفراین","مرکزی",46,207,1,3,40,251,2,253
"خراسان_شمالی","اسفراین","مرکزی",47,121,1,2,32,156,0,156
"خراسان_شمالی","اسفراین","مرکزی",48,233,1,3,29,266,0,266
"خراسان_شمالی","اسفراین","مرکزی",49,255,1,2,28,286,1,287
"خراسان_شمالی","اسفراین","مرکزی",50,358,1,5,68,432,0,432
"خراسان_شمالی","اسفراین","مرکزی",51,463,1,4,58,526,2,528
"خراسان_شمالی","اسفراین","مرکزی",52,746,1,39,122,908,6,914
"خراسان_شمالی","اسفراین","مرکزی",53,670,6,18,194,888,4,892
"خراسان_شمالی","اسفراین","مرکزی",54,564,6,4,87,661,4,665
"خراسان_شمالی","اسفراین","مرکزی",55,288,2,5,81,376,0,376
"خراسان_شمالی","اسفراین","مرکزی",56,410,0,5,43,458,2,460
"خراسان_شمالی","اسفراین","مرکزی",57,1049,6,4,96,1155,3,1158
"خراسان_شمالی","اسفراین","مرکزی",58,431,2,4,67,504,3,507
"خراسان_شمالی","اسفراین","مرکزی",59,600,1,4,85,690,3,693
"خراسان_شمالی","اسفراین","مرکزی",60,391,3,7,25,426,3,429
"خراسان_شمالی","اسفراین","مرکزی",61,332,1,1,59,393,1,394
"خراسان_شمالی","اسفراین","مرکزی",62,686,1,3,27,717,0,717
"خراسان_شمالی","اسفراین","مرکزی",63,307,1,1,29,338,1,339
"خراسان_شمالی","اسفراین","مرکزی",64,198,0,4,15,217,0,217
"خراسان_شمالی","اسفراین","مرکزی",65,541,4,12,127,684,2,686
"خراسان_شمالی","اسفراین","مرکزی",66,853,4,23,189,1069,9,1078
"خراسان_شمالی","اسفراین","مرکزی",67,301,1,1,51,354,0,354
"خراسان_شمالی","اسفراین","مرکزی",68,337,0,2,19,358,1,359
"خراسان_شمالی","اسفراین","مرکزی",69,509,5,4,77,595,0,595
"خراسان_شمالی","اسفراین","مرکزی",70,712,2,2,95,811,6,817
"خراسان_شمالی","اسفراین","مرکزی",71,340,2,2,18,362,0,362
"خراسان_شمالی","اسفراین","مرکزی",72,396,1,1,27,425,4,429
"خراسان_شمالی","اسفراین","مرکزی",73,844,3,10,67,924,2,926
"خراسان_شمالی","اسفراین","مرکزی",74,445,1,9,38,493,2,495
"خراسان_شمالی","اسفراین","بام_و_صفی_آباد",75,405,4,2,69,480,2,482
"خراسان_شمالی","اسفراین","بام_و_صفی_آباد",76,598,7,6,126,737,0,737
"خراسان_شمالی","اسفراین","بام_و_صفی_آباد",77,885,9,14,192,1100,3,1103
"خراسان_شمالی","اسفراین","بام_و_صفی_آباد",78,329,1,2,34,366,0,366
"خراسان_شمالی","اسفراین","بام_و_صفی_آباد",79,585,2,6,65,658,0,658
"خراسان_شمالی","اسفراین","بام_و_صفی_آباد",80,338,5,5,50,398,5,403
"خراسان_شمالی","اسفراین","بام_و_صفی_آباد",81,351,0,1,27,379,0,379
"خراسان_شمالی","اسفراین","بام_و_صفی_آباد",82,802,0,5,23,830,0,830
"خراسان_شمالی","اسفراین","بام_و_صفی_آباد",83,580,3,10,25,618,0,618
"خراسان_شمالی","اسفراین","بام_و_صفی_آباد",84,340,0,1,59,400,1,401
"خراسان_شمالی","اسفراین","بام_و_صفی_آباد",85,422,1,1,25,449,1,450
"خراسان_شمالی","اسفراین","بام_و_صفی_آباد",86,395,1,2,15,413,0,413
"خراسان_شمالی","اسفراین","بام_و_صفی_آباد",87,454,1,2,24,481,3,484
"خراسان_شمالی","اسفراین","بام_و_صفی_آباد",88,485,0,0,17,502,2,504
"خراسان_شمالی","اسفراین","بام_و_صفی_آباد",89,269,0,0,19,288,2,290
"خراسان_شمالی","اسفراین","بام_و_صفی_آباد",90,296,3,2,23,324,0,324
"خراسان_شمالی","اسفراین","بام_و_صفی_آباد",91,635,3,0,48,686,1,687
"خراسان_شمالی","اسفراین","بام_و_صفی_آباد",92,294,0,0,19,313,1,314
"خراسان_شمالی","اسفراین","بام_و_صفی_آباد",93,318,0,0,14,332,1,333
"خراسان_شمالی","اسفراین","بام_و_صفی_آباد",94,630,6,1,46,683,0,683
"خراسان_شمالی","اسفراین","بام_و_صفی_آباد",95,210,1,0,15,226,0,226
"خراسان_شمالی","اسفراین","بام_و_صفی_آباد",96,829,2,1,84,916,1,917
"خراسان_شمالی","اسفراین","بام_و_صفی_آباد",97,446,0,0,14,460,0,460
"خراسان_شمالی","اسفراین","بام_و_صفی_آباد",98,280,0,0,21,301,0,301
"خراسان_شمالی","اسفراین","بام_و_صفی_آباد",99,445,1,0,38,484,0,484
"خراسان_شمالی","اسفراین","بام_و_صفی_آباد",100,377,0,0,14,391,2,393
"خراسان_شمالی","بجنورد","مرکزی",1,1162,30,18,657,1867,11,1878
"خراسان_شمالی","بجنورد","مرکزی",2,355,15,6,390,766,3,769
"خراسان_شمالی","بجنورد","مرکزی",3,494,12,17,557,1080,12,1092
"خراسان_شمالی","بجنورد","مرکزی",4,288,13,9,496,806,8,814
"خراسان_شمالی","بجنورد","مرکزی",5,383,21,12,652,1068,10,1078
"خراسان_شمالی","بجنورد","مرکزی",6,214,9,2,122,347,0,347
"خراسان_شمالی","بجنورد","مرکزی",7,801,6,6,412,1225,14,1239
"خراسان_شمالی","بجنورد","مرکزی",8,787,11,5,238,1041,13,1054
"خراسان_شمالی","بجنورد","مرکزی",9,840,3,5,148,996,4,1000
"خراسان_شمالی","بجنورد","مرکزی",10,212,1,2,95,310,2,312
"خراسان_شمالی","بجنورد","مرکزی",11,827,3,1,126,957,3,960
"خراسان_شمالی","بجنورد","مرکزی",12,814,6,3,397,1220,2,1222
"خراسان_شمالی","بجنورد","مرکزی",13,682,11,8,610,1311,9,1320
"خراسان_شمالی","بجنورد","مرکزی",14,493,10,2,520,1025,4,1029
"خراسان_شمالی","بجنورد","مرکزی",15,480,24,12,659,1175,5,1180
"خراسان_شمالی","بجنورد","مرکزی",16,1074,14,0,368,1456,2,1458
"خراسان_شمالی","بجنورد","مرکزی",17,621,30,5,657,1313,15,1328
"خراسان_شمالی","بجنورد","مرکزی",18,248,7,0,98,353,4,357
"خراسان_شمالی","بجنورد","مرکزی",19,824,17,6,611,1458,8,1466
"خراسان_شمالی","بجنورد","مرکزی",20,237,17,14,866,1134,13,1147
"خراسان_شمالی","بجنورد","مرکزی",21,237,10,11,698,956,12,968
"خراسان_شمالی","بجنورد","مرکزی",22,281,13,7,509,810,9,819
"خراسان_شمالی","بجنورد","مرکزی",23,426,24,15,634,1099,12,1111
"خراسان_شمالی","بجنورد","مرکزی",24,181,9,5,412,607,16,623
"خراسان_شمالی","بجنورد","مرکزی",25,355,13,14,411,793,7,800
"خراسان_شمالی","بجنورد","مرکزی",26,738,22,15,551,1326,21,1347
"خراسان_شمالی","بجنورد","مرکزی",27,588,27,12,556,1183,17,1200
"خراسان_شمالی","بجنورد","مرکزی",28,719,21,7,565,1312,7,1319
"خراسان_شمالی","بجنورد","مرکزی",29,146,3,0,81,230,1,231
"خراسان_شمالی","بجنورد","مرکزی",30,544,10,5,274,833,4,837
"خراسان_شمالی","بجنورد","مرکزی",31,673,19,8,451,1151,7,1158
"خراسان_شمالی","بجنورد","مرکزی",32,502,11,9,330,852,6,858
"خراسان_شمالی","بجنورد","مرکزی",33,710,15,5,240,970,5,975
"خراسان_شمالی","بجنورد","مرکزی",34,726,12,5,599,1342,12,1354
"خراسان_شمالی","بجنورد","مرکزی",35,257,6,5,141,409,2,411
"خراسان_شمالی","بجنورد","مرکزی",36,735,11,4,255,1005,4,1009
"خراسان_شمالی","بجنورد","مرکزی",37,914,5,7,343,1269,8,1277
"خراسان_شمالی","بجنورد","مرکزی",38,1092,4,3,84,1183,0,1183
"خراسان_شمالی","بجنورد","مرکزی",39,1083,4,1,73,1161,1,1162
"خراسان_شمالی","بجنورد","مرکزی",40,974,13,4,515,1506,94,1600
"خراسان_شمالی","بجنورد","مرکزی",41,922,24,1,552,1499,7,1506
"خراسان_شمالی","بجنورد","مرکزی",42,1363,14,5,268,1650,4,1654
"خراسان_شمالی","بجنورد","مرکزی",43,783,10,1,186,980,4,984
"خراسان_شمالی","بجنورد","مرکزی",44,1224,22,7,379,1632,7,1639
"خراسان_شمالی","بجنورد","مرکزی",45,1015,10,5,92,1122,5,1127
"خراسان_شمالی","بجنورد","مرکزی",46,928,10,5,190,1133,5,1138
"خراسان_شمالی","بجنورد","مرکزی",47,854,0,3,136,993,8,1001
"خراسان_شمالی","بجنورد","مرکزی",48,698,6,0,74,778,1,779
"خراسان_شمالی","بجنورد","مرکزی",49,342,7,1,58,408,2,410
"خراسان_شمالی","بجنورد","مرکزی",50,663,5,0,119,787,4,791
"خراسان_شمالی","بجنورد","مرکزی",51,466,2,1,117,586,1,587
"خراسان_شمالی","بجنورد","مرکزی",52,739,23,22,604,1388,11,1399
"خراسان_شمالی","بجنورد","مرکزی",53,495,10,3,246,754,5,759
"خراسان_شمالی","بجنورد","مرکزی",54,1014,16,1,338,1369,13,1382
"خراسان_شمالی","بجنورد","مرکزی",55,484,18,8,336,846,10,856
"خراسان_شمالی","بجنورد","مرکزی",56,482,26,12,854,1374,19,1393
"خراسان_شمالی","بجنورد","مرکزی",57,512,32,19,865,1428,15,1443
"خراسان_شمالی","بجنورد","مرکزی",58,591,21,11,779,1402,19,1421
"خراسان_شمالی","بجنورد","مرکزی",59,646,45,27,1054,1772,16,1788
"خراسان_شمالی","بجنورد","مرکزی",60,905,31,6,740,1682,16,1698
"خراسان_شمالی","بجنورد","مرکزی",61,141,8,2,98,249,0,249
"خراسان_شمالی","بجنورد","مرکزی",62,179,5,14,426,624,1,625
"خراسان_شمالی","بجنورد","مرکزی",63,499,22,23,937,1481,9,1490
"خراسان_شمالی","بجنورد","مرکزی",64,283,10,3,427,723,4,727
"خراسان_شمالی","بجنورد","مرکزی",65,385,22,13,593,1013,15,1028
"خراسان_شمالی","بجنورد","مرکزی",66,414,13,17,636,1080,10,1090
"خراسان_شمالی","بجنورد","مرکزی",67,495,31,13,657,1196,9,1205
"خراسان_شمالی","بجنورد","مرکزی",68,552,18,4,289,863,7,870
"خراسان_شمالی","بجنورد","مرکزی",69,239,11,4,377,631,4,635
"خراسان_شمالی","بجنورد","مرکزی",70,387,12,9,549,957,8,965
"خراسان_شمالی","بجنورد","مرکزی",71,486,2,0,44,532,3,535
"خراسان_شمالی","بجنورد","مرکزی",72,329,10,3,339,681,10,691
"خراسان_شمالی","بجنورد","مرکزی",73,569,13,2,260,844,3,847
"خراسان_شمالی","بجنورد","مرکزی",74,486,8,4,132,630,4,634
"خراسان_شمالی","بجنورد","مرکزی",75,1133,12,5,285,1435,4,1439
"خراسان_شمالی","بجنورد","مرکزی",76,637,8,6,104,755,5,760
"خراسان_شمالی","بجنورد","مرکزی",77,118,3,6,196,323,4,327
"خراسان_شمالی","بجنورد","مرکزی",78,860,11,2,165,1038,7,1045
"خراسان_شمالی","بجنورد","مرکزی",79,752,25,7,604,1388,12,1400
"خراسان_شمالی","بجنورد","مرکزی",80,357,17,3,326,703,8,711
"خراسان_شمالی","بجنورد","مرکزی",81,641,15,3,290,949,13,962
"خراسان_شمالی","بجنورد","مرکزی",82,643,32,11,507,1193,5,1198
"خراسان_شمالی","بجنورد","مرکزی",83,434,13,11,376,834,4,838
"خراسان_شمالی","بجنورد","مرکزی",84,474,21,11,456,962,8,970
"خراسان_شمالی","بجنورد","مرکزی",85,502,13,4,533,1052,10,1062
"خراسان_شمالی","بجنورد","مرکزی",86,992,10,6,341,1349,8,1357
"خراسان_شمالی","بجنورد","مرکزی",87,547,9,0,131,687,3,690
"خراسان_شمالی","بجنورد","مرکزی",88,491,11,9,310,821,7,828
"خراسان_شمالی","بجنورد","مرکزی",89,1090,21,9,440,1560,15,1575
"خراسان_شمالی","بجنورد","مرکزی",90,684,7,2,94,787,3,790
"خراسان_شمالی","بجنورد","مرکزی",91,1056,15,2,282,1355,11,1366
"خراسان_شمالی","بجنورد","مرکزی",92,288,16,9,200,513,7,520
"خراسان_شمالی","بجنورد","مرکزی",93,452,34,17,859,1362,14,1376
"خراسان_شمالی","بجنورد","مرکزی",94,179,20,5,359,563,3,566
"خراسان_شمالی","بجنورد","مرکزی",95,667,31,29,850,1577,15,1592
"خراسان_شمالی","بجنورد","مرکزی",96,137,14,11,412,574,10,584
"خراسان_شمالی","بجنورد","مرکزی",97,486,27,21,898,1432,10,1442
"خراسان_شمالی","بجنورد","مرکزی",98,483,28,4,556,1071,7,1078
"خراسان_شمالی","بجنورد","مرکزی",99,936,28,15,655,1634,10,1644
"خراسان_شمالی","بجنورد","مرکزی",100,779,23,9,532,1343,12,1355
"خراسان_شمالی","بجنورد","مرکزی",101,345,17,0,166,528,4,532
"خراسان_شمالی","بجنورد","مرکزی",102,861,19,4,454,1338,13,1351
"خراسان_شمالی","بجنورد","مرکزی",103,430,9,2,152,593,5,598
"خراسان_شمالی","بجنورد","مرکزی",104,494,11,2,220,727,3,730
"خراسان_شمالی","بجنورد","مرکزی",105,639,16,6,231,892,2,894
"خراسان_شمالی","بجنورد","مرکزی",106,1048,26,5,347,1426,3,1429
"خراسان_شمالی","بجنورد","مرکزی",107,476,8,3,171,658,2,660
"خراسان_شمالی","بجنورد","مرکزی",108,601,13,2,196,812,3,815
"خراسان_شمالی","بجنورد","مرکزی",109,701,2,4,171,878,12,890
"خراسان_شمالی","بجنورد","مرکزی",110,685,19,1,237,942,4,946
"خراسان_شمالی","بجنورد","مرکزی",111,394,6,2,168,570,9,579
"خراسان_شمالی","بجنورد","مرکزی",112,395,9,4,183,591,10,601
"خراسان_شمالی","بجنورد","مرکزی",113,231,6,1,150,388,2,390
"خراسان_شمالی","بجنورد","مرکزی",114,452,13,0,153,618,7,625
"خراسان_شمالی","بجنورد","مرکزی",115,269,6,3,93,371,5,376
"خراسان_شمالی","بجنورد","مرکزی",116,766,2,1,173,942,1,943
"خراسان_شمالی","بجنورد","مرکزی",117,360,0,1,31,392,0,392
"خراسان_شمالی","بجنورد","مرکزی",118,652,1,1,66,720,0,720
"خراسان_شمالی","بجنورد","مرکزی",119,170,0,0,14,184,1,185
"خراسان_شمالی","بجنورد","مرکزی",120,787,2,1,36,826,3,829
"خراسان_شمالی","بجنورد","مرکزی",121,528,0,0,52,580,4,584
"خراسان_شمالی","بجنورد","مرکزی",122,716,3,0,51,770,1,771
"خراسان_شمالی","بجنورد","مرکزی",123,686,3,3,87,779,2,781
"خراسان_شمالی","بجنورد","مرکزی",124,330,7,2,86,425,1,426
"خراسان_شمالی","بجنورد","مرکزی",125,424,9,0,15,448,3,451
"خراسان_شمالی","بجنورد","مرکزی",126,798,6,2,184,990,4,994
"خراسان_شمالی","بجنورد","مرکزی",127,819,9,6,160,994,6,1000
"خراسان_شمالی","بجنورد","مرکزی",128,377,1,0,71,449,2,451
"خراسان_شمالی","بجنورد","مرکزی",129,1131,4,1,66,1202,4,1206
"خراسان_شمالی","بجنورد","مرکزی",130,454,2,0,30,486,1,487
"خراسان_شمالی","بجنورد","مرکزی",131,574,2,0,139,715,1,716
"خراسان_شمالی","بجنورد","مرکزی",132,427,0,0,21,448,3,451
"خراسان_شمالی","بجنورد","مرکزی",133,757,2,4,113,876,2,878
"خراسان_شمالی","بجنورد","مرکزی",134,659,0,1,31,691,4,695
"خراسان_شمالی","بجنورد","مرکزی",135,645,10,1,81,737,5,742
"خراسان_شمالی","بجنورد","مرکزی",136,608,7,0,85,700,3,703
"خراسان_شمالی","بجنورد","مرکزی",137,775,1,1,39,816,1,817
"خراسان_شمالی","بجنورد","مرکزی",138,565,0,0,37,602,4,606
"خراسان_شمالی","بجنورد","مرکزی",139,759,7,1,32,799,4,803
"خراسان_شمالی","بجنورد","مرکزی",140,567,6,0,90,663,3,666
"خراسان_شمالی","بجنورد","مرکزی",141,909,1,0,15,925,0,925
"خراسان_شمالی","بجنورد","مرکزی",142,475,1,0,39,515,0,515
"خراسان_شمالی","بجنورد","مرکزی",143,314,2,3,90,409,3,412
"خراسان_شمالی","بجنورد","مرکزی",144,394,7,0,191,592,2,594
"خراسان_شمالی","بجنورد","مرکزی",145,688,4,3,68,763,9,772
"خراسان_شمالی","بجنورد","مرکزی",146,697,4,1,92,794,4,798
"خراسان_شمالی","بجنورد","مرکزی",147,822,1,0,13,836,0,836
"خراسان_شمالی","بجنورد","مرکزی",148,571,4,5,54,634,6,640
"خراسان_شمالی","بجنورد","مرکزی",149,432,1,2,15,450,0,450
"خراسان_شمالی","بجنورد","مرکزی",150,360,3,2,60,425,0,425
"خراسان_شمالی","بجنورد","مرکزی",151,285,0,1,23,309,0,309
"خراسان_شمالی","بجنورد","مرکزی",152,424,4,3,122,553,3,556
"خراسان_شمالی","بجنورد","مرکزی",153,297,5,2,54,358,2,360
"خراسان_شمالی","بجنورد","مرکزی",154,558,7,0,58,623,4,627
"خراسان_شمالی","بجنورد","مرکزی",155,464,1,1,61,527,1,528
"خراسان_شمالی","بجنورد","مرکزی",156,139,2,1,88,230,1,231
"خراسان_شمالی","بجنورد","مرکزی",157,489,2,5,46,542,2,544
"خراسان_شمالی","بجنورد","مرکزی",158,586,2,2,14,604,4,608
"خراسان_شمالی","بجنورد","مرکزی",159,381,3,2,45,431,0,431
"خراسان_شمالی","بجنورد","مرکزی",160,304,2,2,30,338,2,340
"خراسان_شمالی","بجنورد","مرکزی",161,705,0,0,47,752,1,753
"خراسان_شمالی","بجنورد","مرکزی",162,498,1,0,70,569,4,573
"خراسان_شمالی","بجنورد","مرکزی",163,356,3,0,30,389,1,390
"خراسان_شمالی","بجنورد","مرکزی",164,662,7,3,50,722,4,726
"خراسان_شمالی","بجنورد","مرکزی",165,231,2,1,10,244,1,245
"خراسان_شمالی","بجنورد","مرکزی",166,371,1,1,10,383,1,384
"خراسان_شمالی","بجنورد","مرکزی",167,645,0,0,76,721,0,721
"خراسان_شمالی","بجنورد","مرکزی",168,340,1,1,20,362,2,364
"خراسان_شمالی","بجنورد","مرکزی",169,241,2,0,47,290,3,293
"خراسان_شمالی","بجنورد","مرکزی",170,370,4,0,14,388,0,388
"خراسان_شمالی","بجنورد","مرکزی",171,703,1,2,47,753,4,757
"خراسان_شمالی","بجنورد","مرکزی",172,498,1,1,26,526,0,526
"خراسان_شمالی","بجنورد","مرکزی",173,228,1,0,13,242,0,242
"خراسان_شمالی","بجنورد","رازوجرگلان",1,852,19,0,167,1038,5,1043
"خراسان_شمالی","بجنورد","رازوجرگلان",2,532,6,0,131,669,3,672
"خراسان_شمالی","بجنورد","رازوجرگلان",3,357,4,14,91,466,1,467
"خراسان_شمالی","بجنورد","رازوجرگلان",4,382,4,2,133,521,2,523
"خراسان_شمالی","بجنورد","رازوجرگلان",5,213,1,0,53,267,0,267
"خراسان_شمالی","بجنورد","رازوجرگلان",6,135,5,2,350,492,5,497
"خراسان_شمالی","بجنورد","رازوجرگلان",7,493,0,1,27,521,1,522
"خراسان_شمالی","بجنورد","رازوجرگلان",8,550,4,2,115,671,2,673
"خراسان_شمالی","بجنورد","رازوجرگلان",9,467,1,0,44,512,2,514
"خراسان_شمالی","بجنورد","رازوجرگلان",10,592,0,0,51,643,1,644
"خراسان_شمالی","بجنورد","رازوجرگلان",11,447,0,0,71,518,4,522
"خراسان_شمالی","بجنورد","رازوجرگلان",12,401,0,0,50,451,1,452
"خراسان_شمالی","بجنورد","رازوجرگلان",13,276,7,3,283,569,0,569
"خراسان_شمالی","بجنورد","رازوجرگلان",14,326,0,6,519,851,12,863
"خراسان_شمالی","بجنورد","رازوجرگلان",15,419,4,9,409,841,7,848
"خراسان_شمالی","بجنورد","رازوجرگلان",16,174,9,8,503,694,6,700
"خراسان_شمالی","بجنورد","رازوجرگلان",17,82,2,6,721,811,1,812
"خراسان_شمالی","بجنورد","رازوجرگلان",18,50,0,12,228,290,6,296
"خراسان_شمالی","بجنورد","رازوجرگلان",19,131,4,22,432,589,7,596
"خراسان_شمالی","بجنورد","رازوجرگلان",20,221,1,1,25,248,1,249
"خراسان_شمالی","بجنورد","رازوجرگلان",21,321,3,1,114,439,0,439
"خراسان_شمالی","بجنورد","رازوجرگلان",22,320,3,1,73,397,1,398
"خراسان_شمالی","بجنورد","رازوجرگلان",23,20,2,5,404,431,6,437
"خراسان_شمالی","بجنورد","رازوجرگلان",24,615,0,0,8,623,1,624
"خراسان_شمالی","بجنورد","رازوجرگلان",25,189,0,0,51,240,0,240
"خراسان_شمالی","بجنورد","رازوجرگلان",26,299,3,4,153,459,2,461
"خراسان_شمالی","بجنورد","رازوجرگلان",27,255,4,3,195,457,6,463
"خراسان_شمالی","بجنورد","رازوجرگلان",28,172,5,6,383,566,1,567
"خراسان_شمالی","بجنورد","رازوجرگلان",29,131,0,2,366,499,1,500
"خراسان_شمالی","بجنورد","رازوجرگلان",30,80,4,1,384,469,1,470
"خراسان_شمالی","بجنورد","رازوجرگلان",31,223,1,6,389,619,3,622
"خراسان_شمالی","بجنورد","رازوجرگلان",32,79,6,0,239,324,2,326
"خراسان_شمالی","بجنورد","رازوجرگلان",33,34,4,2,459,499,0,499
"خراسان_شمالی","بجنورد","رازوجرگلان",34,109,7,9,255,380,3,383
"خراسان_شمالی","بجنورد","رازوجرگلان",35,54,2,2,305,363,0,363
"خراسان_شمالی","بجنورد","رازوجرگلان",36,96,1,1,183,281,0,281
"خراسان_شمالی","بجنورد","رازوجرگلان",37,46,4,5,223,278,4,282
"خراسان_شمالی","بجنورد","رازوجرگلان",38,145,3,5,482,635,1,636
"خراسان_شمالی","بجنورد","رازوجرگلان",39,42,1,5,229,277,4,281
"خراسان_شمالی","بجنورد","رازوجرگلان",40,59,3,7,463,532,0,532
"خراسان_شمالی","بجنورد","رازوجرگلان",41,35,1,3,292,331,1,332
"خراسان_شمالی","بجنورد","رازوجرگلان",42,34,1,1,539,575,0,575
"خراسان_شمالی","بجنورد","رازوجرگلان",43,38,0,1,467,506,0,506
"خراسان_شمالی","بجنورد","رازوجرگلان",44,77,3,12,405,497,12,509
"خراسان_شمالی","بجنورد","رازوجرگلان",45,73,0,11,290,374,5,379
"خراسان_شمالی","بجنورد","گرمخان",1,639,6,0,163,808,1,809
"خراسان_شمالی","بجنورد","گرمخان",2,520,5,3,59,587,5,592
"خراسان_شمالی","بجنورد","گرمخان",3,618,5,1,44,668,7,675
"خراسان_شمالی","بجنورد","گرمخان",4,953,2,0,77,1032,2,1034
"خراسان_شمالی","بجنورد","گرمخان",5,544,3,2,18,567,1,568
"خراسان_شمالی","بجنورد","گرمخان",6,522,0,2,38,562,1,563
"خراسان_شمالی","بجنورد","گرمخان",7,701,6,1,57,765,4,769
"خراسان_شمالی","بجنورد","گرمخان",8,534,0,0,14,548,0,548
"خراسان_شمالی","بجنورد","گرمخان",9,572,3,1,64,640,2,642
"خراسان_شمالی","بجنورد","گرمخان",10,484,3,1,71,559,0,559
"خراسان_شمالی","بجنورد","گرمخان",11,610,2,0,58,670,1,671
"خراسان_شمالی","بجنورد","گرمخان",12,573,2,0,38,613,0,613
"خراسان_شمالی","بجنورد","گرمخان",13,520,10,0,11,541,0,541
"خراسان_شمالی","بجنورد","گرمخان",14,448,0,0,19,467,0,467
"خراسان_شمالی","بجنورد","گرمخان",15,746,0,1,20,767,5,772
"خراسان_شمالی","بجنورد","گرمخان",16,555,0,3,29,587,2,589
"خراسان_شمالی","بجنورد","گرمخان",17,584,1,1,26,612,1,613
"خراسان_شمالی","بجنورد","گرمخان",18,482,0,0,11,493,1,494
"خراسان_شمالی","بجنورد","گرمخان",19,392,2,0,45,439,3,442
"خراسان_شمالی","بجنورد","گرمخان",20,327,0,0,22,349,0,349
"خراسان_شمالی","بجنورد","گرمخان",21,464,0,0,20,484,2,486
"خراسان_شمالی","بجنورد","گرمخان",22,475,3,0,109,587,1,588
"خراسان_شمالی","بجنورد","گرمخان",23,394,2,0,11,407,0,407
"خراسان_شمالی","بجنورد","گرمخان",24,434,1,0,22,457,9,466
"خراسان_شمالی","بجنورد","گرمخان",25,436,1,1,5,443,0,443
"خراسان_شمالی","بجنورد","گرمخان",26,432,0,1,23,456,0,456
"خراسان_شمالی","بجنورد","گرمخان",27,130,3,2,36,171,0,171
"خراسان_شمالی","بجنورد","گرمخان",28,190,0,0,22,212,0,212
"خراسان_شمالی","جاجرم","مرکزی",1,776,7,9,289,1081,7,1088
"خراسان_شمالی","جاجرم","مرکزی",2,637,1,4,211,853,3,856
"خراسان_شمالی","جاجرم","مرکزی",3,531,8,2,379,920,3,923
"خراسان_شمالی","جاجرم","مرکزی",4,719,6,6,370,1101,2,1103
"خراسان_شمالی","جاجرم","مرکزی",5,236,3,4,141,384,2,386
"خراسان_شمالی","جاجرم","مرکزی",6,395,3,1,131,530,3,533
"خراسان_شمالی","جاجرم","مرکزی",7,659,5,5,203,872,1,873
"خراسان_شمالی","جاجرم","مرکزی",8,291,11,10,281,593,2,595
"خراسان_شمالی","جاجرم","مرکزی",9,513,2,9,227,751,0,751
"خراسان_شمالی","جاجرم","مرکزی",10,532,1,4,190,727,5,732
"خراسان_شمالی","جاجرم","مرکزی",11,483,8,3,221,715,4,719
"خراسان_شمالی","جاجرم","مرکزی",12,234,3,1,110,348,1,349
"خراسان_شمالی","جاجرم","مرکزی",13,295,2,0,134,431,2,433
"خراسان_شمالی","جاجرم","مرکزی",14,91,4,1,74,170,0,170
"خراسان_شمالی","جاجرم","مرکزی",15,194,2,0,114,310,0,310
"خراسان_شمالی","جاجرم","مرکزی",16,304,0,0,75,379,2,381
"خراسان_شمالی","جاجرم","مرکزی",17,344,1,0,59,404,0,404
"خراسان_شمالی","جاجرم","مرکزی",18,104,1,0,13,118,2,120
"خراسان_شمالی","جاجرم","سنخواست",1,370,4,5,245,624,3,627
"خراسان_شمالی","جاجرم","سنخواست",2,483,12,6,216,717,9,726
"خراسان_شمالی","جاجرم","سنخواست",3,370,1,3,50,424,2,426
"خراسان_شمالی","جاجرم","سنخواست",4,249,3,2,37,291,2,293
"خراسان_شمالی","جاجرم","سنخواست",5,333,3,2,39,377,2,379
"خراسان_شمالی","جاجرم","سنخواست",6,336,5,0,76,417,1,418
"خراسان_شمالی","جاجرم","سنخواست",7,449,4,2,40,495,2,497
"خراسان_شمالی","جاجرم","سنخواست",8,423,0,0,26,449,3,452
"خراسان_شمالی","جاجرم","سنخواست",9,127,2,1,8,138,1,139
"خراسان_شمالی","جاجرم","سنخواست",10,255,5,2,130,392,6,398
"خراسان_شمالی","جاجرم","سنخواست",11,280,1,1,49,331,2,333
"خراسان_شمالی","جاجرم","سنخواست",12,228,3,1,14,246,0,246
"خراسان_شمالی","جاجرم","شوقان",1,443,4,4,71,522,5,527
"خراسان_شمالی","جاجرم","شوقان",2,521,4,2,104,631,4,635
"خراسان_شمالی","جاجرم","شوقان",3,557,4,1,98,660,5,665
"خراسان_شمالی","جاجرم","شوقان",4,873,1,2,49,925,4,929
"خراسان_شمالی","جاجرم","شوقان",5,340,0,1,54,395,0,395
"خراسان_شمالی","جاجرم","شوقان",6,662,2,0,16,680,1,681
"خراسان_شمالی","جاجرم","شوقان",7,546,1,5,39,591,1,592
"خراسان_شمالی","جاجرم","شوقان",8,392,9,1,95,497,2,499
"خراسان_شمالی","جاجرم","شوقان",9,210,0,0,17,227,1,228
"خراسان_شمالی","جاجرم","شوقان",10,200,0,0,16,216,1,217
"خراسان_شمالی","جاجرم","شوقان",11,205,1,0,8,214,0,214
"خراسان_شمالی","جاجرم","شوقان",12,236,1,2,11,250,3,253
"خراسان_شمالی","جاجرم","شوقان",13,212,0,0,13,225,0,225
"خراسان_شمالی","شیروان","مرکزی",1,937,30,13,659,1639,19,1658
"خراسان_شمالی","شیروان","مرکزی",2,848,21,3,438,1310,12,1322
"خراسان_شمالی","شیروان","مرکزی",3,640,24,3,497,1164,11,1175
"خراسان_شمالی","شیروان","مرکزی",4,465,10,3,253,731,6,737
"خراسان_شمالی","شیروان","مرکزی",5,783,19,7,420,1229,11,1240
"خراسان_شمالی","شیروان","مرکزی",6,711,13,3,227,954,8,962
"خراسان_شمالی","شیروان","مرکزی",7,640,4,0,81,725,7,732
"خراسان_شمالی","شیروان","مرکزی",8,475,7,1,141,624,5,629
"خراسان_شمالی","شیروان","مرکزی",9,1044,8,3,380,1435,21,1456
"خراسان_شمالی","شیروان","مرکزی",10,813,24,3,480,1320,15,1335
"خراسان_شمالی","شیروان","مرکزی",11,959,12,3,260,1234,10,1244
"خراسان_شمالی","شیروان","مرکزی",12,956,13,3,336,1308,15,1323
"خراسان_شمالی","شیروان","مرکزی",13,1298,15,4,280,1597,6,1603
"خراسان_شمالی","شیروان","مرکزی",14,1296,19,6,280,1601,9,1610
"خراسان_شمالی","شیروان","مرکزی",15,783,13,5,225,1026,7,1033
"خراسان_شمالی","شیروان","مرکزی",16,1167,9,4,222,1402,13,1415
"خراسان_شمالی","شیروان","مرکزی",17,1077,18,6,411,1512,8,1520
"خراسان_شمالی","شیروان","مرکزی",18,1395,36,10,507,1948,19,1967
"خراسان_شمالی","شیروان","مرکزی",19,951,17,1,435,1404,7,1411
"خراسان_شمالی","شیروان","مرکزی",20,970,7,6,159,1142,7,1149
"خراسان_شمالی","شیروان","مرکزی",21,705,13,4,368,1090,8,1098
"خراسان_شمالی","شیروان","مرکزی",22,872,17,3,344,1236,3,1239
"خراسان_شمالی","شیروان","مرکزی",23,842,16,3,449,1310,15,1325
"خراسان_شمالی","شیروان","مرکزی",24,1101,17,1,311,1430,14,1444
"خراسان_شمالی","شیروان","مرکزی",25,961,14,8,319,1302,8,1310
"خراسان_شمالی","شیروان","مرکزی",26,600,20,4,553,1177,24,1201
"خراسان_شمالی","شیروان","مرکزی",27,1176,33,7,383,1599,8,1607
"خراسان_شمالی","شیروان","مرکزی",28,559,9,4,173,745,5,750
"خراسان_شمالی","شیروان","مرکزی",29,809,20,9,620,1458,26,1484
"خراسان_شمالی","شیروان","مرکزی",30,1163,12,8,188,1371,6,1377
"خراسان_شمالی","شیروان","مرکزی",31,703,21,2,439,1165,9,1174
"خراسان_شمالی","شیروان","مرکزی",32,829,16,7,357,1209,17,1226
"خراسان_شمالی","شیروان","مرکزی",33,1082,29,1,495,1607,20,1627
"خراسان_شمالی","شیروان","مرکزی",34,626,8,4,117,755,4,759
"خراسان_شمالی","شیروان","مرکزی",35,571,18,2,422,1013,11,1024
"خراسان_شمالی","شیروان","مرکزی",36,825,12,0,156,993,6,999
"خراسان_شمالی","شیروان","مرکزی",37,332,5,2,113,452,5,457
"خراسان_شمالی","شیروان","مرکزی",38,278,3,0,114,395,6,401
"خراسان_شمالی","شیروان","مرکزی",39,463,5,3,169,640,7,647
"خراسان_شمالی","شیروان","مرکزی",40,564,7,3,79,653,2,655
"خراسان_شمالی","شیروان","مرکزی",41,569,1,0,36,606,1,607
"خراسان_شمالی","شیروان","مرکزی",42,659,8,0,66,733,4,737
"خراسان_شمالی","شیروان","مرکزی",43,416,1,0,31,448,1,449
"خراسان_شمالی","شیروان","مرکزی",44,398,1,0,67,466,1,467
"خراسان_شمالی","شیروان","مرکزی",45,374,0,0,58,432,2,434
"خراسان_شمالی","شیروان","مرکزی",46,473,0,0,41,514,2,516
"خراسان_شمالی","شیروان","مرکزی",47,370,3,0,56,429,4,433
"خراسان_شمالی","شیروان","مرکزی",48,572,4,7,160,743,4,747
"خراسان_شمالی","شیروان","مرکزی",49,281,2,4,97,384,1,385
"خراسان_شمالی","شیروان","مرکزی",50,535,2,0,57,594,0,594
"خراسان_شمالی","شیروان","مرکزی",51,1245,6,1,122,1374,5,1379
"خراسان_شمالی","شیروان","مرکزی",52,393,1,0,37,431,2,433
"خراسان_شمالی","شیروان","مرکزی",53,422,5,0,46,473,1,474
"خراسان_شمالی","شیروان","مرکزی",54,522,2,1,25,550,0,550
"خراسان_شمالی","شیروان","مرکزی",55,495,2,0,42,539,1,540
"خراسان_شمالی","شیروان","مرکزی",56,346,4,7,127,484,4,488
"خراسان_شمالی","شیروان","مرکزی",57,549,1,2,59,611,3,614
"خراسان_شمالی","شیروان","مرکزی",58,501,3,0,94,598,8,606
"خراسان_شمالی","شیروان","مرکزی",59,1045,4,0,78,1127,3,1130
"خراسان_شمالی","شیروان","مرکزی",60,532,2,1,43,578,3,581
"خراسان_شمالی","شیروان","مرکزی",61,281,1,0,12,294,0,294
"خراسان_شمالی","شیروان","مرکزی",62,249,1,0,26,276,0,276
"خراسان_شمالی","شیروان","مرکزی",63,771,5,1,97,874,1,875
"خراسان_شمالی","شیروان","مرکزی",64,1012,5,1,87,1105,7,1112
"خراسان_شمالی","شیروان","مرکزی",65,346,4,1,49,400,4,404
"خراسان_شمالی","شیروان","مرکزی",66,770,2,0,34,806,1,807
"خراسان_شمالی","شیروان","مرکزی",67,1112,6,0,118,1236,3,1239
"خراسان_شمالی","شیروان","مرکزی",68,427,2,0,76,505,2,507
"خراسان_شمالی","شیروان","مرکزی",69,1027,2,4,144,1177,2,1179
"خراسان_شمالی","شیروان","مرکزی",70,1488,8,3,133,1632,0,1632
"خراسان_شمالی","شیروان","مرکزی",71,612,1,0,38,651,1,652
"خراسان_شمالی","شیروان","مرکزی",72,612,2,0,46,660,2,662
"خراسان_شمالی","شیروان","مرکزی",73,409,4,1,100,514,3,517
"خراسان_شمالی","شیروان","مرکزی",74,546,1,2,48,597,6,603
"خراسان_شمالی","شیروان","مرکزی",75,501,2,0,45,548,1,549
"خراسان_شمالی","شیروان","مرکزی",76,337,1,0,8,346,1,347
"خراسان_شمالی","شیروان","مرکزی",77,263,1,0,13,277,0,277
"خراسان_شمالی","شیروان","مرکزی",78,108,1,0,5,114,0,114
"خراسان_شمالی","شیروان","سرحد",1,549,2,1,77,629,4,633
"خراسان_شمالی","شیروان","سرحد",2,394,2,1,36,433,1,434
"خراسان_شمالی","شیروان","سرحد",3,485,1,0,20,506,1,507
"خراسان_شمالی","شیروان","سرحد",4,416,1,0,26,443,1,444
"خراسان_شمالی","شیروان","سرحد",5,453,1,0,79,533,2,535
"خراسان_شمالی","شیروان","سرحد",6,411,2,0,13,426,2,428
"خراسان_شمالی","شیروان","سرحد",7,249,1,0,18,268,0,268
"خراسان_شمالی","شیروان","سرحد",8,633,0,0,11,644,1,645
"خراسان_شمالی","شیروان","سرحد",9,680,0,0,55,735,0,735
"خراسان_شمالی","شیروان","سرحد",10,417,0,0,22,439,0,439
"خراسان_شمالی","شیروان","سرحد",11,303,1,1,57,362,3,365
"خراسان_شمالی","شیروان","سرحد",12,287,0,0,29,316,0,316
"خراسان_شمالی","شیروان","سرحد",13,478,0,2,24,504,2,506
"خراسان_شمالی","شیروان","سرحد",14,287,0,0,17,304,0,304
"خراسان_شمالی","شیروان","قوضخانه",1,404,3,1,53,461,0,461
"خراسان_شمالی","شیروان","قوضخانه",2,616,1,0,53,670,1,671
"خراسان_شمالی","شیروان","قوضخانه",3,566,1,1,45,613,4,617
"خراسان_شمالی","شیروان","قوضخانه",4,365,0,2,44,411,0,411
"خراسان_شمالی","شیروان","قوضخانه",5,402,1,0,36,439,1,440
"خراسان_شمالی","شیروان","قوضخانه",6,795,3,0,41,839,1,840
"خراسان_شمالی","شیروان","قوضخانه",7,523,0,0,7,530,2,532
"خراسان_شمالی","شیروان","قوضخانه",8,642,0,0,62,704,1,705
"خراسان_شمالی","شیروان","قوضخانه",9,571,2,0,53,626,2,628
"خراسان_شمالی","شیروان","قوضخانه",10,403,0,1,12,416,0,416
"خراسان_شمالی","شیروان","قوضخانه",11,557,1,7,35,600,4,604
"خراسان_شمالی","شیروان","قوضخانه",12,288,2,0,7,297,1,298
"خراسان_شمالی","فاروج","مرکزی",1,597,7,3,176,783,26,809
"خراسان_شمالی","فاروج","مرکزی",2,760,5,2,99,866,15,881
"خراسان_شمالی","فاروج","مرکزی",3,258,7,0,80,345,7,352
"خراسان_شمالی","فاروج","مرکزی",4,542,3,1,109,655,6,661
"خراسان_شمالی","فاروج","مرکزی",5,581,8,6,341,936,19,955
"خراسان_شمالی","فاروج","مرکزی",6,359,6,0,178,543,6,549
"خراسان_شمالی","فاروج","مرکزی",7,431,5,2,218,656,8,664
"خراسان_شمالی","فاروج","مرکزی",8,570,0,3,93,666,14,680
"خراسان_شمالی","فاروج","مرکزی",9,500,6,0,130,636,18,654
"خراسان_شمالی","فاروج","مرکزی",10,325,10,4,112,451,7,458
"خراسان_شمالی","فاروج","مرکزی",11,528,2,1,51,582,5,587
"خراسان_شمالی","فاروج","مرکزی",12,550,2,0,39,591,10,601
"خراسان_شمالی","فاروج","مرکزی",13,446,2,2,27,477,1,478
"خراسان_شمالی","فاروج","مرکزی",14,240,1,1,25,267,11,278
"خراسان_شمالی","فاروج","مرکزی",15,596,5,0,31,632,3,635
"خراسان_شمالی","فاروج","مرکزی",16,530,0,0,17,547,6,553
"خراسان_شمالی","فاروج","مرکزی",17,361,1,0,12,374,9,383
"خراسان_شمالی","فاروج","مرکزی",18,122,0,0,21,143,2,145
"خراسان_شمالی","فاروج","مرکزی",19,283,1,0,19,303,4,307
"خراسان_شمالی","فاروج","مرکزی",20,188,0,0,10,198,2,200
"خراسان_شمالی","فاروج","مرکزی",21,226,0,1,18,245,5,250
"خراسان_شمالی","فاروج","مرکزی",22,117,0,0,24,141,6,147
"خراسان_شمالی","فاروج","مرکزی",23,513,5,0,37,555,19,574
"خراسان_شمالی","فاروج","مرکزی",24,630,1,1,59,691,9,700
"خراسان_شمالی","فاروج","مرکزی",25,417,0,2,37,456,8,464
"خراسان_شمالی","فاروج","مرکزی",26,432,7,1,64,504,7,511
"خراسان_شمالی","فاروج","مرکزی",27,744,1,1,15,761,22,783
"خراسان_شمالی","فاروج","مرکزی",28,575,7,0,42,624,2,626
"خراسان_شمالی","فاروج","مرکزی",29,634,7,0,45,686,10,696
"خراسان_شمالی","فاروج","مرکزی",30,336,3,0,25,364,8,372
"خراسان_شمالی","فاروج","مرکزی",31,380,3,1,30,414,3,417
"خراسان_شمالی","فاروج","مرکزی",32,298,1,1,38,338,4,342
"خراسان_شمالی","فاروج","مرکزی",33,173,0,0,12,185,0,185
"خراسان_شمالی","فاروج","مرکزی",34,119,2,1,4,126,0,126
"خراسان_شمالی","فاروج","مرکزی",35,493,1,0,57,551,5,556
"خراسان_شمالی","فاروج","مرکزی",36,385,2,0,57,444,10,454
"خراسان_شمالی","فاروج","مرکزی",37,292,0,0,27,319,12,331
"خراسان_شمالی","فاروج","مرکزی",38,261,4,1,15,281,3,284
"خراسان_شمالی","فاروج","مرکزی",39,317,2,6,54,379,10,389
"خراسان_شمالی","فاروج","مرکزی",40,157,0,1,11,169,0,169
"خراسان_شمالی","فاروج","مرکزی",41,341,2,1,24,368,7,375
"خراسان_شمالی","فاروج","مرکزی",42,691,6,0,50,747,14,761
"خراسان_شمالی","فاروج","مرکزی",43,247,1,0,16,264,5,269
"خراسان_شمالی","فاروج","خبوشان",1,546,2,0,123,671,4,675
"خراسان_شمالی","فاروج","خبوشان",2,912,4,1,129,1046,31,1077
"خراسان_شمالی","فاروج","خبوشان",3,433,2,0,87,522,13,535
"خراسان_شمالی","فاروج","خبوشان",4,762,3,2,43,810,7,817
"خراسان_شمالی","فاروج","خبوشان",5,562,0,0,81,643,22,665
"خراسان_شمالی","فاروج","خبوشان",6,380,1,2,29,412,7,419
"خراسان_شمالی","فاروج","خبوشان",7,484,4,2,120,610,9,619
"خراسان_شمالی","فاروج","خبوشان",8,668,3,1,81,753,13,766
"خراسان_شمالی","فاروج","خبوشان",9,686,2,0,80,768,8,776
"خراسان_شمالی","فاروج","خبوشان",10,532,4,2,55,593,8,601
"خراسان_شمالی","فاروج","خبوشان",11,354,0,0,38,392,11,403
"خراسان_شمالی","فاروج","خبوشان",12,553,3,1,80,637,20,657
"خراسان_شمالی","فاروج","خبوشان",13,327,0,3,26,356,5,361
"خراسان_شمالی","فاروج","خبوشان",14,589,2,9,67,667,17,684
"خراسان_شمالی","گرمه","مرکزی",1,360,8,0,60,428,4,432
"خراسان_شمالی","گرمه","مرکزی",2,363,5,1,54,423,2,425
"خراسان_شمالی","گرمه","مرکزی",3,589,6,2,93,690,0,690
"خراسان_شمالی","گرمه","مرکزی",4,630,4,0,98,732,2,734
"خراسان_شمالی","گرمه","مرکزی",5,466,6,1,141,614,9,623
"خراسان_شمالی","گرمه","مرکزی",6,286,4,1,58,349,1,350
"خراسان_شمالی","گرمه","مرکزی",7,817,9,0,126,952,3,955
"خراسان_شمالی","گرمه","مرکزی",8,659,11,3,161,834,3,837
"خراسان_شمالی","گرمه","مرکزی",9,664,4,1,89,758,3,761
"خراسان_شمالی","گرمه","مرکزی",10,543,1,0,45,589,2,591
"خراسان_شمالی","گرمه","مرکزی",11,867,6,2,77,952,4,956
"خراسان_شمالی","گرمه","مرکزی",12,619,2,1,102,724,2,726
"خراسان_شمالی","گرمه","مرکزی",13,410,0,0,78,488,1,489
"خراسان_شمالی","گرمه","مرکزی",14,460,6,0,58,524,0,524
"خراسان_شمالی","گرمه","مرکزی",15,142,0,0,3,145,0,145
"خراسان_شمالی","گرمه","مرکزی",16,108,1,1,30,140,1,141
"خراسان_شمالی","گرمه","مرکزی",17,498,9,1,131,639,5,644
"خراسان_شمالی","گرمه","مرکزی",18,745,7,1,233,986,7,993
"خراسان_شمالی","گرمه","مرکزی",19,258,0,0,63,321,1,322
"خراسان_شمالی","گرمه","مرکزی",20,449,2,0,44,495,1,496
"خراسان_شمالی","گرمه","مرکزی",21,663,0,0,125,788,2,790
"خراسان_شمالی","گرمه","مرکزی",22,477,4,0,35,516,0,516
"خراسان_شمالی","گرمه","مرکزی",23,310,5,0,60,375,1,376
"خراسان_شمالی","گرمه","مرکزی",24,350,0,0,18,368,0,368
"خراسان_شمالی","گرمه","مرکزی",25,229,5,0,19,253,0,253
"خراسان_شمالی","گرمه","مرکزی",26,283,0,0,22,305,0,305
"خراسان_شمالی","مانه_و_سملقان","مرکزی",1,1026,12,11,319,1368,4,1372
"خراسان_شمالی","مانه_و_سملقان","مرکزی",2,706,1,3,119,829,8,837
"خراسان_شمالی","مانه_و_سملقان","مرکزی",3,378,8,5,166,557,3,560
"خراسان_شمالی","مانه_و_سملقان","مرکزی",4,564,5,2,179,750,2,752
"خراسان_شمالی","مانه_و_سملقان","مرکزی",5,257,4,4,66,331,0,331
"خراسان_شمالی","مانه_و_سملقان","مرکزی",6,985,10,6,259,1260,11,1271
"خراسان_شمالی","مانه_و_سملقان","مرکزی",7,596,5,3,143,747,4,751
"خراسان_شمالی","مانه_و_سملقان","مرکزی",8,739,11,1,169,920,6,926
"خراسان_شمالی","مانه_و_سملقان","مرکزی",9,1115,21,3,257,1396,4,1400
"خراسان_شمالی","مانه_و_سملقان","مرکزی",10,363,11,5,167,546,5,551
"خراسان_شمالی","مانه_و_سملقان","مرکزی",11,795,22,11,337,1165,7,1172
"خراسان_شمالی","مانه_و_سملقان","مرکزی",12,517,10,2,227,756,6,762
"خراسان_شمالی","مانه_و_سملقان","مرکزی",13,150,3,2,50,205,3,208
"خراسان_شمالی","مانه_و_سملقان","مرکزی",14,246,1,2,56,305,0,305
"خراسان_شمالی","مانه_و_سملقان","مرکزی",15,980,10,5,101,1096,4,1100
"خراسان_شمالی","مانه_و_سملقان","مرکزی",16,744,3,1,28,776,8,784
"خراسان_شمالی","مانه_و_سملقان","مرکزی",17,211,2,0,9,222,1,223
"خراسان_شمالی","مانه_و_سملقان","مرکزی",18,413,0,0,73,486,0,486
"خراسان_شمالی","مانه_و_سملقان","مرکزی",19,292,1,0,6,299,0,299
"خراسان_شمالی","مانه_و_سملقان","مرکزی",20,865,1,0,32,898,7,905
"خراسان_شمالی","مانه_و_سملقان","مرکزی",21,609,4,1,80,694,1,695
"خراسان_شمالی","مانه_و_سملقان","مرکزی",22,394,1,0,25,420,1,421
"خراسان_شمالی","مانه_و_سملقان","مرکزی",23,894,2,3,74,973,3,976
"خراسان_شمالی","مانه_و_سملقان","مرکزی",24,646,4,4,120,774,2,776
"خراسان_شمالی","مانه_و_سملقان","مرکزی",25,70,4,10,446,530,1,531
"خراسان_شمالی","مانه_و_سملقان","مرکزی",26,625,0,2,23,650,4,654
"خراسان_شمالی","مانه_و_سملقان","مرکزی",27,173,1,17,206,397,7,404
"خراسان_شمالی","مانه_و_سملقان","مرکزی",28,941,13,6,172,1132,5,1137
"خراسان_شمالی","مانه_و_سملقان","مرکزی",29,413,0,1,41,455,2,457
"خراسان_شمالی","مانه_و_سملقان","مرکزی",30,148,1,0,21,170,1,171
"خراسان_شمالی","مانه_و_سملقان","مرکزی",31,794,2,1,45,842,3,845
"خراسان_شمالی","مانه_و_سملقان","مرکزی",32,154,1,2,181,338,1,339
"خراسان_شمالی","مانه_و_سملقان","مرکزی",33,203,11,5,480,699,2,701
"خراسان_شمالی","مانه_و_سملقان","مرکزی",34,75,4,7,301,387,1,388
"خراسان_شمالی","مانه_و_سملقان","مرکزی",35,35,2,3,181,221,2,223
"خراسان_شمالی","مانه_و_سملقان","مرکزی",36,179,1,1,81,262,1,263
"خراسان_شمالی","مانه_و_سملقان","مرکزی",37,152,0,3,81,236,3,239
"خراسان_شمالی","مانه_و_سملقان","مرکزی",38,483,2,10,166,661,3,664
"خراسان_شمالی","مانه_و_سملقان","مرکزی",39,421,6,0,86,513,6,519
"خراسان_شمالی","مانه_و_سملقان","مرکزی",40,96,1,1,25,123,0,123
"خراسان_شمالی","مانه_و_سملقان","مرکزی",41,209,10,8,345,572,1,573
"خراسان_شمالی","مانه_و_سملقان","مرکزی",42,137,3,0,273,413,3,416
"خراسان_شمالی","مانه_و_سملقان","مرکزی",43,62,2,7,236,307,1,308
"خراسان_شمالی","مانه_و_سملقان","سملقان",1,692,5,3,166,866,3,869
"خراسان_شمالی","مانه_و_سملقان","سملقان",2,569,6,1,154,730,5,735
"خراسان_شمالی","مانه_و_سملقان","سملقان",3,1070,2,0,160,1232,3,1235
"خراسان_شمالی","مانه_و_سملقان","سملقان",4,552,1,0,19,572,0,572
"خراسان_شمالی","مانه_و_سملقان","سملقان",5,517,2,0,35,554,2,556
"خراسان_شمالی","مانه_و_سملقان","سملقان",6,644,12,0,57,713,2,715
"خراسان_شمالی","مانه_و_سملقان","سملقان",7,411,0,1,19,431,4,435
"خراسان_شمالی","مانه_و_سملقان","سملقان",8,862,5,0,47,914,1,915
"خراسان_شمالی","مانه_و_سملقان","سملقان",9,677,12,5,244,938,3,941
"خراسان_شمالی","مانه_و_سملقان","سملقان",10,562,6,0,63,631,1,632
"خراسان_شمالی","مانه_و_سملقان","سملقان",11,986,3,4,123,1116,5,1121
"خراسان_شمالی","مانه_و_سملقان","سملقان",12,501,5,0,55,561,3,564
"خراسان_شمالی","مانه_و_سملقان","سملقان",13,512,0,0,42,554,2,556
"خراسان_شمالی","مانه_و_سملقان","سملقان",14,538,5,1,135,679,2,681
"خراسان_شمالی","مانه_و_سملقان","سملقان",15,308,1,0,27,336,0,336
"خراسان_شمالی","مانه_و_سملقان","سملقان",16,510,0,3,28,541,0,541
"خراسان_شمالی","مانه_و_سملقان","سملقان",17,449,1,3,13,466,1,467
"خراسان_شمالی","مانه_و_سملقان","سملقان",18,774,1,2,36,813,1,814
"خراسان_شمالی","مانه_و_سملقان","مانه",1,535,7,4,113,659,4,663
"خراسان_شمالی","مانه_و_سملقان","مانه",2,366,2,3,174,545,5,550
"خراسان_شمالی","مانه_و_سملقان","مانه",3,433,0,3,130,566,0,566
"خراسان_شمالی","مانه_و_سملقان","مانه",4,504,4,4,61,573,2,575
"خراسان_شمالی","مانه_و_سملقان","مانه",5,719,5,2,80,806,7,813
"خراسان_شمالی","مانه_و_سملقان","مانه",6,469,3,3,119,594,0,594
"خراسان_شمالی","مانه_و_سملقان","مانه",7,227,1,0,33,261,0,261
"خراسان_شمالی","مانه_و_سملقان","مانه",8,441,1,3,63,508,3,511
"خراسان_شمالی","مانه_و_سملقان","مانه",9,641,6,1,107,755,2,757
"خراسان_شمالی","مانه_و_سملقان","مانه",10,484,2,1,46,533,4,537
"خراسان_شمالی","مانه_و_سملقان","مانه",11,261,0,2,36,299,1,300
"خراسان_شمالی","مانه_و_سملقان","مانه",12,303,0,1,42,346,0,346
"خراسان_شمالی","مانه_و_سملقان","مانه",13,256,0,2,30,288,1,289
"خراسان_شمالی","مانه_و_سملقان","مانه",14,434,4,0,61,499,1,500
"خراسان_شمالی","مانه_و_سملقان","مانه",15,144,1,0,16,161,1,162
"خراسان_شمالی","مانه_و_سملقان","مانه",16,288,1,2,8,299,0,299
"خراسان_شمالی","مانه_و_سملقان","مانه",17,314,1,0,30,345,0,345
"خراسان_شمالی","مانه_و_سملقان","مانه",18,671,4,0,45,720,3,723
"خراسان_شمالی","مانه_و_سملقان","مانه",19,24,1,4,298,327,5,332
"خراسان_شمالی","مانه_و_سملقان","مانه",20,360,4,0,38,402,3,405
"خراسان_شمالی","مانه_و_سملقان","مانه",21,328,0,0,14,342,0,342
"خراسان_شمالی","مانه_و_سملقان","مانه",22,311,3,3,258,575,0,575
"خراسان_شمالی","مانه_و_سملقان","مانه",23,56,3,1,407,467,2,469
"خراسان_شمالی","مانه_و_سملقان","مانه",24,213,3,2,97,315,0,315
"خراسان_شمالی","مانه_و_سملقان","مانه",25,37,1,5,171,214,0,214
"خراسان_شمالی","مانه_و_سملقان","مانه",26,107,2,4,448,561,4,565
"خراسان_شمالی","مانه_و_سملقان","مانه",27,23,1,0,248,272,0,272
"خراسان_شمالی","مانه_و_سملقان","مانه",28,136,7,6,264,413,0,413
"خراسان_شمالی","مانه_و_سملقان","مانه",29,39,1,2,315,357,0,357
"خوزستان","آبادان","مرکزی",1,497,29,9,506,1041,15,1056
"خوزستان","آبادان","مرکزی",2,645,47,21,497,1210,21,1231
"خوزستان","آبادان","مرکزی",3,260,24,1,312,597,9,606
"خوزستان","آبادان","مرکزی",4,404,14,7,375,800,11,811
"خوزستان","آبادان","مرکزی",5,438,50,48,560,1096,14,1110
"خوزستان","آبادان","مرکزی",6,255,15,9,393,672,16,688
"خوزستان","آبادان","مرکزی",7,305,19,11,299,634,12,646
"خوزستان","آبادان","مرکزی",8,356,20,6,384,766,14,780
"خوزستان","آبادان","مرکزی",9,424,43,11,299,777,17,794
"خوزستان","آبادان","مرکزی",10,508,7,0,65,580,2,582
"خوزستان","آبادان","مرکزی",11,489,3,0,52,544,6,550
"خوزستان","آبادان","مرکزی",12,1339,30,14,493,1876,30,1906
"خوزستان","آبادان","مرکزی",13,860,12,6,109,987,14,1001
"خوزستان","آبادان","مرکزی",14,982,10,14,274,1280,17,1297
"خوزستان","آبادان","مرکزی",15,1782,18,1,143,1944,8,1952
"خوزستان","آبادان","مرکزی",16,953,17,7,222,1199,12,1211
"خوزستان","آبادان","مرکزی",17,1187,14,3,85,1289,13,1302
"خوزستان","آبادان","مرکزی",18,1392,29,21,441,1883,17,1900
"خوزستان","آبادان","مرکزی",19,468,25,17,401,911,8,919
"خوزستان","آبادان","مرکزی",20,780,37,15,457,1289,11,1300
"خوزستان","آبادان","مرکزی",21,626,7,6,161,800,9,809
"خوزستان","آبادان","مرکزی",22,809,48,15,315,1187,24,1211
"خوزستان","آبادان","مرکزی",23,518,21,37,523,1099,26,1125
"خوزستان","آبادان","مرکزی",24,633,30,10,520,1193,13,1206
"خوزستان","آبادان","مرکزی",25,530,26,12,511,1079,19,1098
"خوزستان","آبادان","مرکزی",26,339,22,5,340,706,12,718
"خوزستان","آبادان","مرکزی",27,253,12,5,215,485,15,500
"خوزستان","آبادان","مرکزی",28,528,26,2,421,977,20,997
"خوزستان","آبادان","مرکزی",29,281,22,7,351,661,26,687
"خوزستان","آبادان","مرکزی",30,888,24,8,336,1256,26,1282
"خوزستان","آبادان","مرکزی",31,237,53,23,454,767,20,787
"خوزستان","آبادان","مرکزی",32,316,10,7,192,525,5,530
"خوزستان","آبادان","مرکزی",33,993,30,8,374,1405,18,1423
"خوزستان","آبادان","مرکزی",34,709,26,24,318,1077,11,1088
"خوزستان","آبادان","مرکزی",35,1163,10,5,291,1469,11,1480
"خوزستان","آبادان","مرکزی",36,565,22,11,389,987,14,1001
"خوزستان","آبادان","مرکزی",37,459,40,11,601,1111,15,1126
"خوزستان","آبادان","مرکزی",38,1163,22,10,189,1384,14,1398
"خوزستان","آبادان","مرکزی",39,941,19,8,158,1126,12,1138
"خوزستان","آبادان","مرکزی",40,785,11,3,175,974,10,984
"خوزستان","آبادان","مرکزی",41,841,20,9,152,1022,8,1030
"خوزستان","آبادان","مرکزی",42,293,24,8,374,699,11,710
"خوزستان","آبادان","مرکزی",43,243,30,16,360,649,16,665
"خوزستان","آبادان","مرکزی",44,857,24,17,277,1175,21,1196
"خوزستان","آبادان","مرکزی",45,323,14,3,112,452,8,460
"خوزستان","آبادان","مرکزی",46,710,23,9,170,912,19,931
"خوزستان","آبادان","مرکزی",47,605,14,8,230,857,15,872
"خوزستان","آبادان","مرکزی",48,507,20,8,202,737,12,749
"خوزستان","آبادان","مرکزی",49,626,21,11,173,831,6,837
"خوزستان","آبادان","مرکزی",50,1019,49,14,322,1404,12,1416
"خوزستان","آبادان","مرکزی",51,593,10,14,342,959,22,981
"خوزستان","آبادان","مرکزی",52,708,57,27,618,1410,26,1436
"خوزستان","آبادان","مرکزی",53,658,24,19,472,1173,26,1199
"خوزستان","آبادان","مرکزی",54,368,21,22,326,737,12,749
"خوزستان","آبادان","مرکزی",55,610,25,16,384,1035,20,1055
"خوزستان","آبادان","مرکزی",56,462,33,12,366,873,10,883
"خوزستان","آبادان","مرکزی",57,514,37,16,481,1048,19,1067
"خوزستان","آبادان","مرکزی",58,947,80,11,417,1455,22,1477
"خوزستان","آبادان","مرکزی",59,419,22,8,184,633,9,642
"خوزستان","آبادان","مرکزی",60,372,34,4,151,561,14,575
"خوزستان","آبادان","مرکزی",61,484,8,6,109,607,10,617
"خوزستان","آبادان","مرکزی",62,662,28,27,409,1126,21,1147
"خوزستان","آبادان","مرکزی",63,143,13,0,149,305,2,307
"خوزستان","آبادان","مرکزی",64,770,85,13,421,1289,30,1319
"خوزستان","آبادان","مرکزی",65,749,52,5,319,1125,18,1143
"خوزستان","آبادان","مرکزی",66,63,4,2,56,125,2,127
"خوزستان","آبادان","مرکزی",67,648,48,8,227,931,12,943
"خوزستان","آبادان","مرکزی",68,324,17,6,235,582,17,599
"خوزستان","آبادان","مرکزی",69,941,24,13,249,1227,19,1246
"خوزستان","آبادان","مرکزی",70,805,19,12,195,1031,12,1043
"خوزستان","آبادان","مرکزی",71,913,3,4,99,1019,14,1033
"خوزستان","آبادان","مرکزی",72,489,20,10,112,631,0,631
"خوزستان","آبادان","مرکزی",73,702,6,2,91,801,8,809
"خوزستان","آبادان","مرکزی",74,875,28,17,269,1189,13,1202
"خوزستان","آبادان","مرکزی",75,986,24,10,212,1232,24,1256
"خوزستان","آبادان","مرکزی",76,725,16,1,72,814,2,816
"خوزستان","آبادان","مرکزی",77,818,56,10,308,1192,35,1227
"خوزستان","آبادان","مرکزی",78,1562,108,24,517,2211,38,2249
"خوزستان","آبادان","مرکزی",79,961,39,15,361,1376,29,1405
"خوزستان","آبادان","مرکزی",80,1039,36,13,348,1436,19,1455
"خوزستان","آبادان","مرکزی",81,1091,26,2,216,1335,19,1354
"خوزستان","آبادان","مرکزی",82,601,23,9,216,849,15,864
"خوزستان","آبادان","مرکزی",83,703,7,3,113,826,14,840
"خوزستان","آبادان","مرکزی",84,420,12,12,137,581,19,600
"خوزستان","آبادان","مرکزی",85,567,7,7,106,687,6,693
"خوزستان","آبادان","مرکزی",86,498,12,3,177,690,16,706
"خوزستان","آبادان","مرکزی",87,344,12,5,75,436,7,443
"خوزستان","آبادان","مرکزی",88,210,9,0,93,312,21,333
"خوزستان","آبادان","مرکزی",89,382,12,0,115,509,14,523
"خوزستان","آبادان","مرکزی",90,273,31,24,629,957,17,974
"خوزستان","آبادان","مرکزی",91,371,57,27,741,1196,10,1206
"خوزستان","آبادان","مرکزی",92,561,22,7,194,784,13,797
"خوزستان","آبادان","مرکزی",93,556,40,18,661,1275,12,1287
"خوزستان","آبادان","مرکزی",94,382,1,1,40,424,5,429
"خوزستان","آبادان","مرکزی",95,441,6,2,31,480,4,484
"خوزستان","آبادان","مرکزی",96,394,6,1,31,432,3,435
"خوزستان","آبادان","مرکزی",97,835,1,1,41,878,6,884
"خوزستان","آبادان","مرکزی",98,210,0,0,6,216,1,217
"خوزستان","آبادان","مرکزی",99,243,2,0,13,258,2,260
"خوزستان","آبادان","مرکزی",100,729,1,0,17,747,4,751
"خوزستان","آبادان","مرکزی",101,682,4,0,33,719,2,721
"خوزستان","آبادان","مرکزی",102,788,3,1,35,827,7,834
"خوزستان","آبادان","مرکزی",103,726,2,5,9,742,3,745
"خوزستان","آبادان","مرکزی",104,380,2,1,45,428,22,450
"خوزستان","آبادان","مرکزی",105,522,10,2,103,637,7,644
"خوزستان","آبادان","مرکزی",106,342,4,0,11,357,1,358
"خوزستان","آبادان","مرکزی",107,521,1,0,22,544,4,548
"خوزستان","آبادان","مرکزی",108,442,2,1,40,485,3,488
"خوزستان","آبادان","مرکزی",109,283,0,0,7,290,0,290
"خوزستان","آبادان","مرکزی",110,389,4,1,26,420,7,427
"خوزستان","آبادان","مرکزی",111,421,3,3,62,489,7,496
"خوزستان","آبادان","مرکزی",112,525,8,7,68,608,10,618
"خوزستان","آبادان","مرکزی",113,403,4,0,27,434,7,441
"خوزستان","آبادان","مرکزی",114,634,9,0,24,667,9,676
"خوزستان","آبادان","مرکزی",115,287,3,0,14,304,0,304
"خوزستان","آبادان","مرکزی",116,222,1,0,11,234,0,234
"خوزستان","آبادان","مرکزی",117,406,1,0,15,422,1,423
"خوزستان","آبادان","مرکزی",118,266,3,1,14,284,1,285
"خوزستان","آبادان","مرکزی",119,682,6,0,44,732,8,740
"خوزستان","آبادان","مرکزی",120,379,5,0,17,401,5,406
"خوزستان","آبادان","مرکزی",121,522,2,0,7,531,3,534
"خوزستان","آبادان","مرکزی",122,73,9,0,22,104,1,105
"خوزستان","آبادان","مرکزی",123,128,12,2,56,198,4,202
"خوزستان","آبادان","مرکزی",124,341,0,2,10,353,5,358
"خوزستان","آبادان","مرکزی",125,383,0,1,12,396,1,397
"خوزستان","آبادان","اروندکنار",1,349,3,0,11,363,1,364
"خوزستان","آبادان","اروندکنار",2,620,0,1,26,647,4,651
"خوزستان","آبادان","اروندکنار",3,987,11,3,97,1098,7,1105
"خوزستان","آبادان","اروندکنار",4,401,6,0,21,428,3,431
"خوزستان","آبادان","اروندکنار",5,440,8,0,54,502,9,511
"خوزستان","آبادان","اروندکنار",6,559,2,1,50,612,14,626
"خوزستان","آبادان","اروندکنار",7,980,5,1,52,1038,9,1047
"خوزستان","آبادان","اروندکنار",8,601,4,0,10,615,3,618
"خوزستان","آبادان","اروندکنار",9,740,3,0,11,754,5,759
"خوزستان","آبادان","اروندکنار",10,322,5,5,17,349,2,351
"خوزستان","آبادان","اروندکنار",11,717,6,0,60,783,4,787
"خوزستان","آبادان","اروندکنار",12,567,2,0,24,593,3,596
"خوزستان","آبادان","اروندکنار",13,508,3,0,69,580,7,587
"خوزستان","آبادان","اروندکنار",14,530,6,2,53,591,6,597
"خوزستان","آبادان","اروندکنار",15,762,12,0,29,803,7,810
"خوزستان","آبادان","اروندکنار",16,362,6,0,9,377,3,380
"خوزستان","آبادان","اروندکنار",17,653,9,2,46,710,14,724
"خوزستان","امیدیه","مرکزی",1,1011,53,19,499,1582,26,1608
"خوزستان","امیدیه","مرکزی",2,216,19,5,181,421,11,432
"خوزستان","امیدیه","مرکزی",3,385,47,17,327,776,11,787
"خوزستان","امیدیه","مرکزی",4,373,26,13,349,761,20,781
"خوزستان","امیدیه","مرکزی",5,147,13,4,172,336,11,347
"خوزستان","امیدیه","مرکزی",6,287,10,6,191,494,5,499
"خوزستان","امیدیه","مرکزی",7,585,57,9,533,1184,23,1207
"خوزستان","امیدیه","مرکزی",8,316,31,8,552,907,17,924
"خوزستان","امیدیه","مرکزی",9,371,50,6,421,848,25,873
"خوزستان","امیدیه","مرکزی",10,116,18,4,128,266,2,268
"خوزستان","امیدیه","مرکزی",11,499,49,6,483,1037,21,1058
"خوزستان","امیدیه","مرکزی",12,618,37,9,477,1141,17,1158
"خوزستان","امیدیه","مرکزی",13,531,38,7,433,1009,19,1028
"خوزستان","امیدیه","مرکزی",14,542,43,7,460,1052,10,1062
"خوزستان","امیدیه","مرکزی",15,417,27,4,336,784,21,805
"خوزستان","امیدیه","مرکزی",16,849,43,13,414,1319,24,1343
"خوزستان","امیدیه","مرکزی",17,223,13,3,128,367,5,372
"خوزستان","امیدیه","مرکزی",18,571,15,3,226,815,8,823
"خوزستان","امیدیه","مرکزی",19,199,18,1,136,354,4,358
"خوزستان","امیدیه","مرکزی",20,721,22,9,209,961,19,980
"خوزستان","امیدیه","مرکزی",21,610,14,9,151,784,13,797
"خوزستان","امیدیه","مرکزی",22,826,10,4,204,1044,16,1060
"خوزستان","امیدیه","مرکزی",23,779,24,5,114,922,11,933
"خوزستان","امیدیه","مرکزی",24,509,24,6,184,723,14,737
"خوزستان","امیدیه","مرکزی",25,597,30,4,235,866,11,877
"خوزستان","امیدیه","مرکزی",26,1124,46,11,374,1555,25,1580
"خوزستان","امیدیه","مرکزی",27,362,13,9,216,600,12,612
"خوزستان","امیدیه","مرکزی",28,569,11,3,153,736,12,748
"خوزستان","امیدیه","مرکزی",29,1124,28,7,262,1421,17,1438
"خوزستان","امیدیه","مرکزی",30,232,12,2,100,346,3,349
"خوزستان","امیدیه","مرکزی",31,982,4,4,55,1045,6,1051
"خوزستان","امیدیه","مرکزی",32,360,18,3,109,490,3,493
"خوزستان","امیدیه","مرکزی",33,340,7,1,57,405,2,407
"خوزستان","امیدیه","مرکزی",34,455,39,8,295,797,7,804
"خوزستان","امیدیه","مرکزی",35,840,54,2,446,1342,20,1362
"خوزستان","امیدیه","مرکزی",36,343,27,0,186,556,12,568
"خوزستان","امیدیه","مرکزی",37,414,21,4,305,744,10,754
"خوزستان","امیدیه","مرکزی",38,174,43,9,314,540,13,553
"خوزستان","امیدیه","مرکزی",39,84,9,1,124,218,3,221
"خوزستان","امیدیه","مرکزی",40,407,2,2,48,459,6,465
"خوزستان","امیدیه","مرکزی",41,122,10,8,140,280,2,282
"خوزستان","امیدیه","مرکزی",42,135,7,5,90,237,4,241
"خوزستان","امیدیه","مرکزی",43,162,16,4,98,280,3,283
"خوزستان","امیدیه","مرکزی",44,557,4,2,45,608,5,613
"خوزستان","امیدیه","مرکزی",45,296,4,2,37,339,5,344
"خوزستان","امیدیه","مرکزی",46,112,5,5,42,164,3,167
"خوزستان","امیدیه","مرکزی",47,317,11,0,129,457,1,458
"خوزستان","امیدیه","مرکزی",48,356,8,0,83,447,4,451
"خوزستان","امیدیه","مرکزی",49,316,17,3,85,421,7,428
"خوزستان","امیدیه","مرکزی",50,316,4,0,43,363,3,366
"خوزستان","امیدیه","مرکزی",51,219,6,3,99,327,3,330
"خوزستان","امیدیه","مرکزی",52,803,7,3,115,928,9,937
"خوزستان","امیدیه","مرکزی",53,274,1,1,53,329,7,336
"خوزستان","امیدیه","مرکزی",54,129,5,2,25,161,2,163
"خوزستان","امیدیه","مرکزی",55,315,5,0,50,370,7,377
"خوزستان","امیدیه","مرکزی",56,329,6,1,39,375,2,377
"خوزستان","امیدیه","جایزان",1,408,30,22,200,660,9,669
"خوزستان","امیدیه","جایزان",2,530,13,4,127,674,16,690
"خوزستان","امیدیه","جایزان",3,422,12,16,207,657,6,663
"خوزستان","امیدیه","جایزان",4,262,11,20,140,433,2,435
"خوزستان","امیدیه","جایزان",5,567,20,5,103,695,5,700
"خوزستان","امیدیه","جایزان",6,547,16,4,113,680,11,691
"خوزستان","امیدیه","جایزان",7,812,4,6,158,980,9,989
"خوزستان","امیدیه","جایزان",8,489,21,5,265,780,11,791
"خوزستان","امیدیه","جایزان",9,640,8,1,50,699,15,714
"خوزستان","امیدیه","جایزان",10,629,14,2,103,748,1,749
"خوزستان","امیدیه","جایزان",11,378,2,2,182,564,7,571
"خوزستان","امیدیه","جایزان",12,488,11,4,85,588,7,595
"خوزستان","امیدیه","جایزان",13,190,4,2,76,272,2,274
"خوزستان","اندیکا","مرکزی",1,197,162,6,80,445,13,458
"خوزستان","اندیکا","مرکزی",2,183,119,7,10,319,7,326
"خوزستان","اندیکا","مرکزی",3,206,104,15,24,349,6,355
"خوزستان","اندیکا","مرکزی",4,118,46,3,11,178,0,178
"خوزستان","اندیکا","مرکزی",5,108,103,0,18,229,2,231
"خوزستان","اندیکا","مرکزی",6,218,49,1,21,289,1,290
"خوزستان","اندیکا","مرکزی",7,365,99,1,87,552,6,558
"خوزستان","اندیکا","مرکزی",8,505,47,1,31,584,2,586
"خوزستان","اندیکا","مرکزی",9,382,34,0,14,430,5,435
"خوزستان","اندیکا","مرکزی",10,438,43,0,9,490,1,491
"خوزستان","اندیکا","مرکزی",11,217,24,0,5,246,3,249
"خوزستان","اندیکا","مرکزی",12,75,78,0,3,156,2,158
"خوزستان","اندیکا","مرکزی",13,64,4,0,8,76,0,76
"خوزستان","اندیکا","مرکزی",14,68,24,0,2,94,1,95
"خوزستان","اندیکا","مرکزی",15,280,16,1,1,298,7,305
"خوزستان","اندیکا","مرکزی",16,91,29,0,4,124,4,128
"خوزستان","اندیکا","مرکزی",17,17,151,0,4,172,4,176
"خوزستان","اندیکا","مرکزی",18,132,19,0,4,155,0,155
"خوزستان","اندیکا","چلو",1,107,38,0,1,146,2,148
"خوزستان","اندیکا","چلو",2,324,39,0,14,377,5,382
"خوزستان","اندیکا","چلو",3,75,124,0,2,201,0,201
"خوزستان","اندیکا","چلو",4,202,33,0,9,244,5,249
"خوزستان","اندیکا","چلو",5,94,61,0,3,158,9,167
"خوزستان","اندیکا","چلو",6,34,6,0,4,44,1,45
"خوزستان","اندیکا","چلو",7,70,26,1,2,99,1,100
"خوزستان","اندیکا","چلو",8,100,11,1,8,120,0,120
"خوزستان","اندیکا","چلو",9,67,1,0,0,68,0,68
"خوزستان","اندیکا","چلو",10,11,92,1,0,104,0,104
"خوزستان","اندیکا","آبژدان",1,544,47,1,10,602,9,611
"خوزستان","اندیکا","آبژدان",2,236,86,0,36,358,2,360
"خوزستان","اندیکا","آبژدان",3,373,56,5,30,464,3,467
"خوزستان","اندیکا","آبژدان",4,612,98,1,41,752,16,768
"خوزستان","اندیکا","آبژدان",5,260,39,0,16,315,2,317
"خوزستان","اندیکا","آبژدان",6,462,189,3,132,786,7,793
"خوزستان","اندیکا","آبژدان",7,700,166,3,108,977,13,990
"خوزستان","اندیکا","آبژدان",8,70,19,0,34,123,0,123
"خوزستان","اندیکا","آبژدان",9,183,63,2,9,257,3,260
"خوزستان","اندیکا","آبژدان",10,662,214,4,21,901,10,911
"خوزستان","اندیکا","آبژدان",11,425,152,2,15,594,11,605
"خوزستان","اندیکا","آبژدان",12,364,228,5,64,661,6,667
"خوزستان","اندیکا","آبژدان",13,227,67,2,14,310,2,312
"خوزستان","اندیکا","آبژدان",14,251,120,1,42,414,1,415
"خوزستان","اندیکا","آبژدان",15,157,21,2,6,186,1,187
"خوزستان","اندیکا","آبژدان",16,341,113,2,21,477,6,483
"خوزستان","اندیکا","آبژدان",17,176,111,2,32,321,1,322
"خوزستان","اندیکا","آبژدان",18,422,259,0,15,696,6,702
"خوزستان","اندیمشک","مرکزی",1,609,80,19,461,1169,20,1189
"خوزستان","اندیمشک","مرکزی",2,738,95,59,934,1826,29,1855
"خوزستان","اندیمشک","مرکزی",3,251,25,7,219,502,6,508
"خوزستان","اندیمشک","مرکزی",4,368,76,20,405,869,5,874
"خوزستان","اندیمشک","مرکزی",5,188,47,29,339,603,8,611
"خوزستان","اندیمشک","مرکزی",6,425,50,17,491,983,15,998
"خوزستان","اندیمشک","مرکزی",7,366,33,14,381,794,15,809
"خوزستان","اندیمشک","مرکزی",8,346,25,14,257,642,12,654
"خوزستان","اندیمشک","مرکزی",9,384,39,20,314,757,18,775
"خوزستان","اندیمشک","مرکزی",10,231,29,9,271,540,4,544
"خوزستان","اندیمشک","مرکزی",11,524,73,23,650,1270,17,1287
"خوزستان","اندیمشک","مرکزی",12,320,33,12,316,681,18,699
"خوزستان","اندیمشک","مرکزی",13,339,31,11,362,743,15,758
"خوزستان","اندیمشک","مرکزی",14,442,52,42,411,947,15,962
"خوزستان","اندیمشک","مرکزی",15,923,389,13,87,1412,18,1430
"خوزستان","اندیمشک","مرکزی",16,690,228,9,149,1076,5,1081
"خوزستان","اندیمشک","مرکزی",17,742,93,8,355,1198,17,1215
"خوزستان","اندیمشک","مرکزی",18,376,36,26,391,829,20,849
"خوزستان","اندیمشک","مرکزی",19,634,53,26,398,1111,29,1140
"خوزستان","اندیمشک","مرکزی",20,449,42,26,440,957,17,974
"خوزستان","اندیمشک","مرکزی",21,470,42,29,490,1031,13,1044
"خوزستان","اندیمشک","مرکزی",22,462,50,10,492,1014,14,1028
"خوزستان","اندیمشک","مرکزی",23,449,57,15,348,869,20,889
"خوزستان","اندیمشک","مرکزی",24,410,41,13,458,922,21,943
"خوزستان","اندیمشک","مرکزی",25,476,59,24,468,1027,30,1057
"خوزستان","اندیمشک","مرکزی",26,247,43,21,301,612,18,630
"خوزستان","اندیمشک","مرکزی",27,391,42,16,415,864,27,891
"خوزستان","اندیمشک","مرکزی",28,339,26,7,264,636,8,644
"خوزستان","اندیمشک","مرکزی",29,688,72,21,849,1630,38,1668
"خوزستان","اندیمشک","مرکزی",30,309,21,12,363,705,10,715
"خوزستان","اندیمشک","مرکزی",31,573,47,28,431,1079,24,1103
"خوزستان","اندیمشک","مرکزی",32,676,65,25,363,1129,30,1159
"خوزستان","اندیمشک","مرکزی",33,804,91,27,339,1261,33,1294
"خوزستان","اندیمشک","مرکزی",34,839,98,15,238,1190,33,1223
"خوزستان","اندیمشک","مرکزی",35,865,142,24,238,1269,30,1299
"خوزستان","اندیمشک","مرکزی",36,733,122,38,79,972,11,983
"خوزستان","اندیمشک","مرکزی",37,583,75,22,415,1095,27,1122
"خوزستان","اندیمشک","مرکزی",38,853,94,35,427,1409,28,1437
"خوزستان","اندیمشک","مرکزی",39,425,35,14,207,681,16,697
"خوزستان","اندیمشک","مرکزی",40,315,14,8,146,483,15,498
"خوزستان","اندیمشک","مرکزی",41,818,16,9,156,999,8,1007
"خوزستان","اندیمشک","مرکزی",42,720,14,7,99,840,13,853
"خوزستان","اندیمشک","مرکزی",43,453,29,7,183,672,18,690
"خوزستان","اندیمشک","مرکزی",44,639,16,23,227,905,19,924
"خوزستان","اندیمشک","مرکزی",45,441,50,16,246,753,21,774
"خوزستان","اندیمشک","مرکزی",46,515,43,16,249,823,20,843
"خوزستان","اندیمشک","مرکزی",47,843,54,36,316,1249,26,1275
"خوزستان","اندیمشک","مرکزی",48,749,32,14,297,1092,15,1107
"خوزستان","اندیمشک","مرکزی",49,723,59,14,419,1215,26,1241
"خوزستان","اندیمشک","مرکزی",50,710,31,10,416,1167,19,1186
"خوزستان","اندیمشک","مرکزی",51,798,32,27,404,1261,26,1287
"خوزستان","اندیمشک","مرکزی",52,728,54,20,332,1134,48,1182
"خوزستان","اندیمشک","مرکزی",53,527,9,5,120,661,9,670
"خوزستان","اندیمشک","مرکزی",54,581,23,7,187,798,18,816
"خوزستان","اندیمشک","مرکزی",55,859,11,12,156,1038,28,1066
"خوزستان","اندیمشک","مرکزی",56,544,10,7,127,688,13,701
"خوزستان","اندیمشک","مرکزی",57,613,20,8,232,873,13,886
"خوزستان","اندیمشک","مرکزی",58,497,21,15,199,732,28,760
"خوزستان","اندیمشک","مرکزی",59,945,15,14,145,1119,25,1144
"خوزستان","اندیمشک","مرکزی",60,489,13,13,191,706,14,720
"خوزستان","اندیمشک","مرکزی",61,409,17,10,225,661,9,670
"خوزستان","اندیمشک","مرکزی",62,774,28,21,204,1027,19,1046
"خوزستان","اندیمشک","مرکزی",63,926,22,18,231,1197,21,1218
"خوزستان","اندیمشک","مرکزی",64,611,14,9,162,796,8,804
"خوزستان","اندیمشک","مرکزی",65,475,10,10,158,653,0,653
"خوزستان","اندیمشک","مرکزی",66,116,9,0,39,164,2,166
"خوزستان","اندیمشک","مرکزی",67,589,13,21,304,927,13,940
"خوزستان","اندیمشک","مرکزی",68,532,16,15,261,824,8,832
"خوزستان","اندیمشک","مرکزی",69,371,33,6,166,576,11,587
"خوزستان","اندیمشک","مرکزی",70,294,31,10,310,645,12,657
"خوزستان","اندیمشک","مرکزی",71,244,20,3,38,305,7,312
"خوزستان","اندیمشک","مرکزی",72,246,13,1,96,356,17,373
"خوزستان","اندیمشک","مرکزی",73,554,17,5,157,733,26,759
"خوزستان","اندیمشک","مرکزی",74,138,29,2,89,258,4,262
"خوزستان","اندیمشک","مرکزی",75,247,25,1,50,323,0,323
"خوزستان","اندیمشک","مرکزی",76,161,16,3,51,231,9,240
"خوزستان","اندیمشک","مرکزی",77,499,132,9,52,692,4,696
"خوزستان","اندیمشک","مرکزی",78,371,129,12,54,566,8,574
"خوزستان","اندیمشک","مرکزی",79,292,80,1,42,415,8,423
"خوزستان","اندیمشک","مرکزی",80,188,35,0,42,265,3,268
"خوزستان","اندیمشک","مرکزی",81,220,13,1,161,395,5,400
"خوزستان","اندیمشک","مرکزی",82,206,27,4,202,439,13,452
"خوزستان","اندیمشک","مرکزی",83,444,19,7,220,690,15,705
"خوزستان","اندیمشک","مرکزی",84,720,8,7,111,846,9,855
"خوزستان","اندیمشک","الوار",1,377,9,32,182,600,0,600
"خوزستان","اندیمشک","الوار",2,262,6,7,135,410,0,410
"خوزستان","اندیمشک","الوار",3,244,7,9,77,337,0,337
"خوزستان","اندیمشک","الوار",4,37,2,6,29,74,0,74
"خوزستان","اندیمشک","الوار",5,72,0,1,32,105,0,105
"خوزستان","اندیمشک","الوار",6,173,18,4,74,269,0,269
"خوزستان","اندیمشک","الوار",7,291,12,5,170,478,0,478
"خوزستان","اندیمشک","الوار",8,472,21,13,246,752,0,752
"خوزستان","اندیمشک","الوار",9,132,2,3,66,203,0,203
"خوزستان","اندیمشک","الوار",10,250,13,1,91,355,0,355
"خوزستان","اندیمشک","الوار",11,146,15,2,67,230,0,230
"خوزستان","اندیمشک","الوار",12,316,7,1,81,405,0,405
"خوزستان","اندیمشک","الوار",13,271,3,4,69,347,0,347
"خوزستان","اندیمشک","الوار",14,442,8,8,120,578,0,578
"خوزستان","اندیمشک","الوار",15,296,13,4,134,447,0,447
"خوزستان","اندیمشک","الوار",16,143,4,5,69,221,0,221
"خوزستان","اندیمشک","الوار",17,49,0,0,20,69,0,69
"خوزستان","اندیمشک","الوار",18,131,1,5,59,196,0,196
"خوزستان","اندیمشک","الوار",19,64,0,0,4,68,0,68
"خوزستان","اندیمشک","الوار",20,66,2,0,16,84,0,84
"خوزستان","اندیمشک","الوار",21,83,1,2,11,97,0,97
"خوزستان","اندیمشک","الوار",22,75,6,1,17,99,0,99
"خوزستان","اندیمشک","الوار",23,58,2,0,16,76,0,76
"خوزستان","اندیمشک","الوار",24,42,4,1,12,59,0,59
"خوزستان","اندیمشک","الوار",25,428,9,1,25,463,0,463
"خوزستان","اندیمشک","الوار",26,204,2,1,8,215,0,215
"خوزستان","اندیمشک","الوار",27,251,10,4,46,311,0,311
"خوزستان","اندیمشک","الوار",28,346,5,2,34,387,0,387
"خوزستان","اندیمشک","الوار",29,64,3,0,5,72,0,72
"خوزستان","اندیمشک","الوار",30,33,3,0,10,46,0,46
"خوزستان","اندیمشک","الوار",31,130,23,1,7,161,0,161
"خوزستان","اندیمشک","الوار",32,138,2,0,13,153,138,291
"خوزستان","اهواز","مرکزی",1,847,36,0,155,1038,11,1049
"خوزستان","اهواز","مرکزی",2,923,80,2,181,1186,12,1198
"خوزستان","اهواز","مرکزی",3,855,87,2,125,1069,15,1084
"خوزستان","اهواز","مرکزی",4,678,12,0,176,866,14,880
"خوزستان","اهواز","مرکزی",5,858,114,3,122,1097,17,1114
"خوزستان","اهواز","مرکزی",6,846,112,4,586,1548,23,1571
"خوزستان","اهواز","مرکزی",7,1095,257,12,636,2000,18,2018
"خوزستان","اهواز","مرکزی",8,849,23,3,135,1010,12,1022
"خوزستان","اهواز","مرکزی",9,1184,15,4,112,1315,17,1332
"خوزستان","اهواز","مرکزی",10,684,19,3,134,840,13,853
"خوزستان","اهواز","مرکزی",11,500,64,6,552,1122,8,1130
"خوزستان","اهواز","مرکزی",12,961,13,6,195,1175,22,1197
"خوزستان","اهواز","مرکزی",13,440,172,19,879,1510,11,1521
"خوزستان","اهواز","مرکزی",14,410,110,13,898,1431,9,1440
"خوزستان","اهواز","مرکزی",15,390,114,24,1176,1704,14,1718
"خوزستان","اهواز","مرکزی",16,594,120,7,649,1370,9,1379
"خوزستان","اهواز","مرکزی",17,587,167,14,862,1630,27,1657
"خوزستان","اهواز","مرکزی",18,351,120,15,924,1410,13,1423
"خوزستان","اهواز","مرکزی",19,1008,146,15,1172,2341,24,2365
"خوزستان","اهواز","مرکزی",20,999,205,23,1168,2395,29,2424
"خوزستان","اهواز","مرکزی",21,815,107,4,867,1793,10,1803
"خوزستان","اهواز","مرکزی",22,446,143,30,1344,1963,13,1976
"خوزستان","اهواز","مرکزی",23,410,101,15,944,1470,10,1480
"خوزستان","اهواز","مرکزی",24,972,134,10,1114,2230,20,2250
"خوزستان","اهواز","مرکزی",25,629,150,8,906,1693,26,1719
"خوزستان","اهواز","مرکزی",26,784,116,10,852,1762,32,1794
"خوزستان","اهواز","مرکزی",27,805,107,6,651,1569,16,1585
"خوزستان","اهواز","مرکزی",28,675,66,11,586,1338,19,1357
"خوزستان","اهواز","مرکزی",29,329,87,21,1009,1446,15,1461
"خوزستان","اهواز","مرکزی",30,297,45,15,774,1131,6,1137
"خوزستان","اهواز","مرکزی",31,323,121,36,1889,2369,13,2382
"خوزستان","اهواز","مرکزی",32,369,113,37,949,1468,10,1478
"خوزستان","اهواز","مرکزی",33,799,245,32,1314,2390,23,2413
"خوزستان","اهواز","مرکزی",34,461,203,33,949,1646,11,1657
"خوزستان","اهواز","مرکزی",35,697,211,14,632,1554,28,1582
"خوزستان","اهواز","مرکزی",36,859,139,5,571,1574,30,1604
"خوزستان","اهواز","مرکزی",37,505,152,25,986,1668,21,1689
"خوزستان","اهواز","مرکزی",38,695,215,14,825,1749,13,1762
"خوزستان","اهواز","مرکزی",39,380,178,15,519,1092,14,1106
"خوزستان","اهواز","مرکزی",40,555,131,9,517,1212,11,1223
"خوزستان","اهواز","مرکزی",41,391,102,10,865,1368,10,1378
"خوزستان","اهواز","مرکزی",42,540,149,12,998,1699,21,1720
"خوزستان","اهواز","مرکزی",43,210,79,11,588,888,4,892
"خوزستان","اهواز","مرکزی",44,881,159,12,953,2005,25,2030
"خوزستان","اهواز","مرکزی",45,413,157,21,1466,2057,25,2082
"خوزستان","اهواز","مرکزی",46,352,118,24,1311,1805,16,1821
"خوزستان","اهواز","مرکزی",47,281,103,7,915,1306,15,1321
"خوزستان","اهواز","مرکزی",48,570,139,32,1194,1935,20,1955
"خوزستان","اهواز","مرکزی",49,433,125,52,1531,2141,14,2155
"خوزستان","اهواز","مرکزی",50,311,85,22,989,1407,12,1419
"خوزستان","اهواز","مرکزی",51,769,165,18,1012,1964,20,1984
"خوزستان","اهواز","مرکزی",52,286,78,7,683,1054,8,1062
"خوزستان","اهواز","مرکزی",53,347,131,21,1309,1808,21,1829
"خوزستان","اهواز","مرکزی",54,882,167,16,952,2017,19,2036
"خوزستان","اهواز","مرکزی",55,757,44,6,329,1136,15,1151
"خوزستان","اهواز","مرکزی",56,834,149,13,910,1906,27,1933
"خوزستان","اهواز","مرکزی",57,685,111,6,720,1522,12,1534
"خوزستان","اهواز","مرکزی",58,372,53,10,356,791,9,800
"خوزستان","اهواز","مرکزی",59,1056,108,13,778,1955,23,1978
"خوزستان","اهواز","مرکزی",60,657,108,15,536,1316,20,1336
"خوزستان","اهواز","مرکزی",61,383,47,8,308,746,7,753
"خوزستان","اهواز","مرکزی",62,718,111,7,380,1216,13,1229
"خوزستان","اهواز","مرکزی",63,455,72,4,360,891,12,903
"خوزستان","اهواز","مرکزی",64,1180,122,6,277,1585,20,1605
"خوزستان","اهواز","مرکزی",65,865,174,9,742,1790,16,1806
"خوزستان","اهواز","مرکزی",66,1404,404,11,259,2078,17,2095
"خوزستان","اهواز","مرکزی",67,1140,33,2,82,1257,15,1272
"خوزستان","اهواز","مرکزی",68,1002,117,7,264,1390,24,1414
"خوزستان","اهواز","مرکزی",69,702,107,2,338,1149,12,1161
"خوزستان","اهواز","مرکزی",70,471,119,24,1386,2000,20,2020
"خوزستان","اهواز","مرکزی",71,942,47,9,512,1510,21,1531
"خوزستان","اهواز","مرکزی",72,547,18,1,405,971,6,977
"خوزستان","اهواز","مرکزی",73,447,7,1,263,718,6,724
"خوزستان","اهواز","مرکزی",74,561,25,5,353,944,10,954
"خوزستان","اهواز","مرکزی",75,495,15,4,206,720,11,731
"خوزستان","اهواز","مرکزی",76,610,42,5,235,892,5,897
"خوزستان","اهواز","مرکزی",77,349,28,4,175,556,3,559
"خوزستان","اهواز","مرکزی",78,1116,21,2,283,1422,12,1434
"خوزستان","اهواز","مرکزی",79,812,31,2,302,1147,12,1159
"خوزستان","اهواز","مرکزی",80,957,112,6,389,1464,22,1486
"خوزستان","اهواز","مرکزی",81,940,63,4,263,1270,7,1277
"خوزستان","اهواز","مرکزی",82,595,13,5,231,844,10,854
"خوزستان","اهواز","مرکزی",83,948,199,3,221,1371,12,1383
"خوزستان","اهواز","مرکزی",84,354,19,1,118,492,10,502
"خوزستان","اهواز","مرکزی",85,347,23,1,103,474,6,480
"خوزستان","اهواز","مرکزی",86,920,90,5,253,1268,20,1288
"خوزستان","اهواز","مرکزی",87,851,58,3,134,1046,8,1054
"خوزستان","اهواز","مرکزی",88,739,31,2,187,959,13,972
"خوزستان","اهواز","مرکزی",89,1064,44,9,299,1416,30,1446
"خوزستان","اهواز","مرکزی",90,623,82,5,305,1015,17,1032
"خوزستان","اهواز","مرکزی",91,662,28,5,245,940,9,949
"خوزستان","اهواز","مرکزی",92,705,20,3,130,858,0,858
"خوزستان","اهواز","مرکزی",93,420,23,16,161,620,8,628
"خوزستان","اهواز","مرکزی",94,361,38,7,133,539,7,546
"خوزستان","اهواز","مرکزی",95,712,127,5,362,1206,11,1217
"خوزستان","اهواز","مرکزی",96,848,264,7,272,1391,11,1402
"خوزستان","اهواز","مرکزی",97,601,262,10,215,1088,12,1100
"خوزستان","اهواز","مرکزی",98,725,346,7,289,1367,28,1395
"خوزستان","اهواز","مرکزی",99,908,178,2,219,1307,5,1312
"خوزستان","اهواز","مرکزی",100,1012,394,10,249,1665,8,1673
"خوزستان","اهواز","مرکزی",101,833,208,21,643,1705,21,1726
"خوزستان","اهواز","مرکزی",102,723,211,12,310,1256,13,1269
"خوزستان","اهواز","مرکزی",103,630,359,3,218,1210,9,1219
"خوزستان","اهواز","مرکزی",104,788,136,3,412,1339,20,1359
"خوزستان","اهواز","مرکزی",105,1448,449,15,555,2467,125,2592
"خوزستان","اهواز","مرکزی",106,568,69,2,225,864,4,868
"خوزستان","اهواز","مرکزی",107,702,142,13,512,1369,14,1383
"خوزستان","اهواز","مرکزی",108,539,82,7,496,1124,8,1132
"خوزستان","اهواز","مرکزی",109,680,165,5,619,1469,23,1492
"خوزستان","اهواز","مرکزی",110,621,143,13,776,1553,22,1575
"خوزستان","اهواز","مرکزی",111,755,100,6,451,1312,16,1328
"خوزستان","اهواز","مرکزی",112,691,148,10,617,1466,13,1479
"خوزستان","اهواز","مرکزی",113,376,64,4,226,670,15,685
"خوزستان","اهواز","مرکزی",114,539,14,1,133,687,32,719
"خوزستان","اهواز","مرکزی",115,681,89,7,589,1366,17,1383
"خوزستان","اهواز","مرکزی",116,283,47,6,427,763,4,767
"خوزستان","اهواز","مرکزی",117,224,44,14,519,801,9,810
"خوزستان","اهواز","مرکزی",118,868,133,16,757,1774,22,1796
"خوزستان","اهواز","مرکزی",119,820,120,17,948,1905,22,1927
"خوزستان","اهواز","مرکزی",120,423,63,2,318,806,16,822
"خوزستان","اهواز","مرکزی",121,1076,149,17,790,2032,37,2069
"خوزستان","اهواز","مرکزی",122,825,119,6,639,1589,20,1609
"خوزستان","اهواز","مرکزی",123,833,115,15,777,1740,22,1762
"خوزستان","اهواز","مرکزی",124,712,120,13,1075,1920,32,1952
"خوزستان","اهواز","مرکزی",125,611,80,12,768,1471,15,1486
"خوزستان","اهواز","مرکزی",126,710,95,9,521,1335,17,1352
"خوزستان","اهواز","مرکزی",127,488,97,11,677,1273,14,1287
"خوزستان","اهواز","مرکزی",128,700,66,7,500,1273,23,1296
"خوزستان","اهواز","مرکزی",129,695,130,7,709,1541,29,1570
"خوزستان","اهواز","مرکزی",130,652,74,6,414,1146,23,1169
"خوزستان","اهواز","مرکزی",131,541,91,5,513,1150,17,1167
"خوزستان","اهواز","مرکزی",132,906,139,13,931,1989,31,2020
"خوزستان","اهواز","مرکزی",133,500,72,9,344,925,10,935
"خوزستان","اهواز","مرکزی",134,857,64,11,693,1625,8,1633
"خوزستان","اهواز","مرکزی",135,368,46,26,693,1133,14,1147
"خوزستان","اهواز","مرکزی",136,250,43,19,410,722,12,734
"خوزستان","اهواز","مرکزی",137,456,55,13,513,1037,18,1055
"خوزستان","اهواز","مرکزی",138,453,91,24,812,1380,19,1399
"خوزستان","اهواز","مرکزی",139,337,37,3,419,796,12,808
"خوزستان","اهواز","مرکزی",140,403,79,12,634,1128,14,1142
"خوزستان","اهواز","مرکزی",141,732,62,10,652,1456,16,1472
"خوزستان","اهواز","مرکزی",142,797,95,34,772,1698,21,1719
"خوزستان","اهواز","مرکزی",143,395,30,2,379,806,8,814
"خوزستان","اهواز","مرکزی",144,482,34,19,380,915,12,927
"خوزستان","اهواز","مرکزی",145,400,38,10,285,733,11,744
"خوزستان","اهواز","مرکزی",146,465,55,6,423,949,18,967
"خوزستان","اهواز","مرکزی",147,292,22,1,285,600,4,604
"خوزستان","اهواز","مرکزی",148,229,22,5,421,677,10,687
"خوزستان","اهواز","مرکزی",149,763,49,12,570,1394,21,1415
"خوزستان","اهواز","مرکزی",150,600,49,10,587,1246,19,1265
"خوزستان","اهواز","مرکزی",151,981,39,0,380,1400,15,1415
"خوزستان","اهواز","مرکزی",152,477,33,6,300,816,14,830
"خوزستان","اهواز","مرکزی",153,662,52,2,372,1088,12,1100
"خوزستان","اهواز","مرکزی",154,735,31,13,523,1302,12,1314
"خوزستان","اهواز","مرکزی",155,559,48,19,423,1049,11,1060
"خوزستان","اهواز","مرکزی",156,572,75,16,408,1071,17,1088
"خوزستان","اهواز","مرکزی",157,459,41,5,303,808,22,830
"خوزستان","اهواز","مرکزی",158,590,26,10,460,1086,19,1105
"خوزستان","اهواز","مرکزی",159,291,27,9,440,767,9,776
"خوزستان","اهواز","مرکزی",160,546,29,7,283,865,10,875
"خوزستان","اهواز","مرکزی",161,334,34,7,428,803,10,813
"خوزستان","اهواز","مرکزی",162,834,46,7,416,1303,15,1318
"خوزستان","اهواز","مرکزی",163,332,34,4,345,715,13,728
"خوزستان","اهواز","مرکزی",164,943,70,10,681,1704,21,1725
"خوزستان","اهواز","مرکزی",165,892,37,2,397,1328,25,1353
"خوزستان","اهواز","مرکزی",166,1011,56,1,515,1583,30,1613
"خوزستان","اهواز","مرکزی",167,739,33,5,313,1090,15,1105
"خوزستان","اهواز","مرکزی",168,1099,14,4,308,1425,11,1436
"خوزستان","اهواز","مرکزی",169,1100,48,6,538,1692,16,1708
"خوزستان","اهواز","مرکزی",170,634,46,3,379,1062,13,1075
"خوزستان","اهواز","مرکزی",171,1077,43,5,486,1611,18,1629
"خوزستان","اهواز","مرکزی",172,982,48,8,629,1667,30,1697
"خوزستان","اهواز","مرکزی",173,872,36,4,374,1286,10,1296
"خوزستان","اهواز","مرکزی",174,722,28,5,319,1074,8,1082
"خوزستان","اهواز","مرکزی",175,807,17,1,242,1067,5,1072
"خوزستان","اهواز","مرکزی",176,1290,35,4,388,1717,22,1739
"خوزستان","اهواز","مرکزی",177,800,11,3,376,1190,12,1202
"خوزستان","اهواز","مرکزی",178,1388,18,4,272,1682,22,1704
"خوزستان","اهواز","مرکزی",179,580,14,6,173,773,23,796
"خوزستان","اهواز","مرکزی",180,530,34,5,310,879,12,891
"خوزستان","اهواز","مرکزی",181,369,24,5,384,782,12,794
"خوزستان","اهواز","مرکزی",182,282,32,3,299,616,8,624
"خوزستان","اهواز","مرکزی",183,812,55,11,409,1287,17,1304
"خوزستان","اهواز","مرکزی",184,633,43,10,635,1321,14,1335
"خوزستان","اهواز","مرکزی",185,782,27,8,215,1032,7,1039
"خوزستان","اهواز","مرکزی",186,700,35,4,305,1044,14,1058
"خوزستان","اهواز","مرکزی",187,401,44,7,438,890,15,905
"خوزستان","اهواز","مرکزی",188,670,31,20,488,1209,14,1223
"خوزستان","اهواز","مرکزی",189,897,59,11,601,1568,16,1584
"خوزستان","اهواز","مرکزی",190,817,82,11,737,1647,24,1671
"خوزستان","اهواز","مرکزی",191,718,53,19,988,1778,13,1791
"خوزستان","اهواز","مرکزی",192,871,71,21,632,1595,25,1620
"خوزستان","اهواز","مرکزی",193,599,55,7,704,1365,11,1376
"خوزستان","اهواز","مرکزی",194,1199,84,32,929,2244,15,2259
"خوزستان","اهواز","مرکزی",195,1077,50,11,607,1745,17,1762
"خوزستان","اهواز","مرکزی",196,394,26,9,559,988,7,995
"خوزستان","اهواز","مرکزی",197,449,54,9,855,1367,22,1389
"خوزستان","اهواز","مرکزی",198,619,51,11,1207,1888,30,1918
"خوزستان","اهواز","مرکزی",199,1182,77,10,704,1973,22,1995
"خوزستان","اهواز","مرکزی",200,1103,89,11,716,1919,21,1940
"خوزستان","اهواز","مرکزی",201,1057,57,8,615,1737,35,1772
"خوزستان","اهواز","مرکزی",202,1302,14,7,151,1474,22,1496
"خوزستان","اهواز","مرکزی",203,930,14,1,126,1071,25,1096
"خوزستان","اهواز","مرکزی",204,929,7,8,130,1074,12,1086
"خوزستان","اهواز","مرکزی",205,679,62,5,452,1198,25,1223
"خوزستان","اهواز","مرکزی",206,681,107,26,927,1741,18,1759
"خوزستان","اهواز","مرکزی",207,966,81,28,779,1854,21,1875
"خوزستان","اهواز","مرکزی",208,1101,102,10,905,2118,41,2159
"خوزستان","اهواز","مرکزی",209,844,64,7,514,1429,27,1456
"خوزستان","اهواز","مرکزی",210,868,54,5,409,1336,14,1350
"خوزستان","اهواز","مرکزی",211,673,71,14,642,1400,21,1421
"خوزستان","اهواز","مرکزی",212,594,102,4,642,1342,16,1358
"خوزستان","اهواز","مرکزی",213,711,76,4,521,1312,17,1329
"خوزستان","اهواز","مرکزی",214,928,116,10,712,1766,27,1793
"خوزستان","اهواز","مرکزی",215,610,52,4,428,1094,22,1116
"خوزستان","اهواز","مرکزی",216,507,45,8,335,895,12,907
"خوزستان","اهواز","مرکزی",217,755,8,8,198,969,8,977
"خوزستان","اهواز","مرکزی",218,747,16,0,136,899,20,919
"خوزستان","اهواز","مرکزی",219,1158,26,5,240,1429,23,1452
"خوزستان","اهواز","مرکزی",220,920,36,16,230,1202,20,1222
"خوزستان","اهواز","مرکزی",221,1130,12,0,167,1309,22,1331
"خوزستان","اهواز","مرکزی",222,743,9,0,165,917,23,940
"خوزستان","اهواز","مرکزی",223,750,4,3,81,838,7,845
"خوزستان","اهواز","مرکزی",224,1083,5,1,183,1272,14,1286
"خوزستان","اهواز","مرکزی",225,766,3,1,100,870,0,870
"خوزستان","اهواز","مرکزی",226,1822,26,6,304,2158,30,2188
"خوزستان","اهواز","مرکزی",227,554,25,2,159,740,9,749
"خوزستان","اهواز","مرکزی",228,1078,19,2,344,1443,13,1456
"خوزستان","اهواز","مرکزی",229,805,5,5,84,899,9,908
"خوزستان","اهواز","مرکزی",230,630,8,2,128,768,7,775
"خوزستان","اهواز","مرکزی",231,895,4,3,110,1012,14,1026
"خوزستان","اهواز","مرکزی",232,1410,10,17,145,1582,36,1618
"خوزستان","اهواز","مرکزی",233,1270,36,14,328,1648,24,1672
"خوزستان","اهواز","مرکزی",234,1271,4,5,189,1469,18,1487
"خوزستان","اهواز","مرکزی",235,728,8,4,145,885,6,891
"خوزستان","اهواز","مرکزی",236,1203,7,0,167,1377,17,1394
"خوزستان","اهواز","مرکزی",237,1000,3,3,103,1109,12,1121
"خوزستان","اهواز","مرکزی",238,1467,20,9,335,1831,37,1868
"خوزستان","اهواز","مرکزی",239,1284,9,6,209,1508,24,1532
"خوزستان","اهواز","مرکزی",240,870,7,7,116,1000,19,1019
"خوزستان","اهواز","مرکزی",241,964,22,6,291,1283,17,1300
"خوزستان","اهواز","مرکزی",242,1141,22,3,156,1322,13,1335
"خوزستان","اهواز","مرکزی",243,562,5,1,97,665,8,673
"خوزستان","اهواز","مرکزی",244,950,9,6,193,1158,11,1169
"خوزستان","اهواز","مرکزی",245,1137,15,2,151,1305,31,1336
"خوزستان","اهواز","مرکزی",246,1169,6,7,188,1370,21,1391
"خوزستان","اهواز","مرکزی",247,1449,10,3,94,1556,19,1575
"خوزستان","اهواز","مرکزی",248,1051,6,2,100,1159,18,1177
"خوزستان","اهواز","مرکزی",249,687,5,2,92,786,7,793
"خوزستان","اهواز","مرکزی",250,649,14,1,195,859,9,868
"خوزستان","اهواز","مرکزی",251,1087,21,2,287,1397,12,1409
"خوزستان","اهواز","مرکزی",252,460,30,3,181,674,9,683
"خوزستان","اهواز","مرکزی",253,396,34,4,240,674,19,693
"خوزستان","اهواز","مرکزی",254,310,35,5,133,483,5,488
"خوزستان","اهواز","مرکزی",255,754,57,3,146,960,6,966
"خوزستان","اهواز","مرکزی",256,848,57,9,453,1367,18,1385
"خوزستان","اهواز","مرکزی",257,539,65,20,894,1518,23,1541
"خوزستان","اهواز","مرکزی",258,823,87,17,619,1546,21,1567
"خوزستان","اهواز","مرکزی",259,926,58,13,524,1521,20,1541
"خوزستان","اهواز","مرکزی",260,542,94,37,1406,2079,18,2097
"خوزستان","اهواز","مرکزی",261,689,80,15,1211,1995,18,2013
"خوزستان","اهواز","مرکزی",262,904,120,14,1393,2431,18,2449
"خوزستان","اهواز","مرکزی",263,279,78,22,1170,1549,12,1561
"خوزستان","اهواز","مرکزی",264,877,111,32,1353,2373,20,2393
"خوزستان","اهواز","مرکزی",265,494,96,19,1294,1903,7,1910
"خوزستان","اهواز","مرکزی",266,374,83,27,1951,2435,14,2449
"خوزستان","اهواز","مرکزی",267,181,34,19,738,972,6,978
"خوزستان","اهواز","مرکزی",268,233,62,16,1035,1346,21,1367
"خوزستان","اهواز","مرکزی",269,237,48,21,864,1170,13,1183
"خوزستان","اهواز","مرکزی",270,442,94,22,1039,1597,0,1597
"خوزستان","اهواز","مرکزی",271,317,81,31,1444,1873,7,1880
"خوزستان","اهواز","مرکزی",272,536,93,28,1886,2543,23,2566
"خوزستان","اهواز","مرکزی",273,353,48,29,1565,1995,11,2006
"خوزستان","اهواز","مرکزی",274,847,102,39,963,1951,22,1973
"خوزستان","اهواز","مرکزی",275,218,60,18,1037,1333,11,1344
"خوزستان","اهواز","مرکزی",276,469,41,12,360,882,7,889
"خوزستان","اهواز","مرکزی",277,505,61,19,765,1350,11,1361
"خوزستان","اهواز","مرکزی",278,452,95,33,938,1518,6,1524
"خوزستان","اهواز","مرکزی",279,274,54,29,591,948,10,958
"خوزستان","اهواز","مرکزی",280,331,33,6,321,691,8,699
"خوزستان","اهواز","مرکزی",281,624,50,9,431,1114,16,1130
"خوزستان","اهواز","مرکزی",282,887,24,3,373,1287,17,1304
"خوزستان","اهواز","مرکزی",283,666,6,5,139,816,4,820
"خوزستان","اهواز","مرکزی",284,921,12,9,313,1255,27,1282
"خوزستان","اهواز","مرکزی",285,1120,9,10,180,1319,26,1345
"خوزستان","اهواز","مرکزی",286,845,7,11,212,1075,16,1091
"خوزستان","اهواز","مرکزی",287,971,13,7,394,1385,13,1398
"خوزستان","اهواز","مرکزی",288,296,15,6,184,501,18,519
"خوزستان","اهواز","مرکزی",289,653,6,9,150,818,12,830
"خوزستان","اهواز","مرکزی",290,756,65,9,518,1348,23,1371
"خوزستان","اهواز","مرکزی",291,413,30,7,301,751,11,762
"خوزستان","اهواز","مرکزی",292,840,36,9,608,1493,19,1512
"خوزستان","اهواز","مرکزی",293,466,46,23,695,1230,18,1248
"خوزستان","اهواز","مرکزی",294,735,40,7,205,987,13,1000
"خوزستان","اهواز","مرکزی",295,724,61,12,1047,1844,19,1863
"خوزستان","اهواز","مرکزی",296,603,57,30,890,1580,19,1599
"خوزستان","اهواز","مرکزی",297,652,47,3,460,1162,13,1175
"خوزستان","اهواز","مرکزی",298,469,30,28,602,1129,5,1134
"خوزستان","اهواز","مرکزی",299,670,38,18,519,1245,22,1267
"خوزستان","اهواز","مرکزی",300,1017,16,1,263,1297,25,1322
"خوزستان","اهواز","مرکزی",301,798,22,15,314,1149,14,1163
"خوزستان","اهواز","مرکزی",302,798,40,18,488,1344,18,1362
"خوزستان","اهواز","مرکزی",303,682,34,12,274,1002,5,1007
"خوزستان","اهواز","مرکزی",304,642,30,10,505,1187,12,1199
"خوزستان","اهواز","مرکزی",305,722,22,4,533,1281,25,1306
"خوزستان","اهواز","مرکزی",306,1509,68,14,637,2228,26,2254
"خوزستان","اهواز","مرکزی",307,238,6,14,288,546,11,557
"خوزستان","اهواز","مرکزی",308,713,39,19,460,1231,17,1248
"خوزستان","اهواز","مرکزی",309,946,44,13,534,1537,14,1551
"خوزستان","اهواز","مرکزی",310,1361,68,15,559,2003,27,2030
"خوزستان","اهواز","مرکزی",311,507,23,2,269,801,5,806
"خوزستان","اهواز","مرکزی",312,472,27,3,486,988,17,1005
"خوزستان","اهواز","مرکزی",313,871,30,5,257,1163,20,1183
"خوزستان","اهواز","مرکزی",314,1190,44,23,536,1793,18,1811
"خوزستان","اهواز","مرکزی",315,729,20,8,498,1255,22,1277
"خوزستان","اهواز","مرکزی",316,1051,46,11,600,1708,24,1732
"خوزستان","اهواز","مرکزی",317,1001,26,12,326,1365,18,1383
"خوزستان","اهواز","مرکزی",318,628,20,8,219,875,8,883
"خوزستان","اهواز","مرکزی",319,1261,20,7,416,1704,22,1726
"خوزستان","اهواز","مرکزی",320,796,32,7,466,1301,16,1317
"خوزستان","اهواز","مرکزی",321,883,34,11,445,1373,15,1388
"خوزستان","اهواز","مرکزی",322,924,11,1,211,1147,15,1162
"خوزستان","اهواز","مرکزی",323,664,11,2,220,897,8,905
"خوزستان","اهواز","مرکزی",324,1322,24,12,269,1627,15,1642
"خوزستان","اهواز","مرکزی",325,568,12,2,136,718,22,740
"خوزستان","اهواز","مرکزی",326,838,9,1,125,973,11,984
"خوزستان","اهواز","مرکزی",327,632,0,6,95,733,4,737
"خوزستان","اهواز","مرکزی",328,1146,15,1,191,1353,23,1376
"خوزستان","اهواز","مرکزی",329,1254,15,3,273,1545,25,1570
"خوزستان","اهواز","مرکزی",330,488,9,5,159,661,11,672
"خوزستان","اهواز","مرکزی",331,681,5,0,180,866,13,879
"خوزستان","اهواز","مرکزی",332,864,7,9,204,1084,16,1100
"خوزستان","اهواز","مرکزی",333,864,11,5,257,1137,16,1153
"خوزستان","اهواز","مرکزی",334,634,19,7,207,867,24,891
"خوزستان","اهواز","مرکزی",335,1222,32,5,246,1505,14,1519
"خوزستان","اهواز","مرکزی",336,532,13,1,121,667,8,675
"خوزستان","اهواز","مرکزی",337,927,25,8,286,1246,28,1274
"خوزستان","اهواز","مرکزی",338,998,21,4,363,1386,22,1408
"خوزستان","اهواز","مرکزی",339,860,21,1,183,1065,14,1079
"خوزستان","اهواز","مرکزی",340,753,6,3,212,974,25,999
"خوزستان","اهواز","مرکزی",341,1130,20,7,191,1348,19,1367
"خوزستان","اهواز","مرکزی",342,560,5,3,144,712,8,720
"خوزستان","اهواز","مرکزی",343,723,2,0,123,848,24,872
"خوزستان","اهواز","مرکزی",344,978,10,0,158,1146,25,1171
"خوزستان","اهواز","مرکزی",345,639,9,6,144,798,2,800
"خوزستان","اهواز","مرکزی",346,794,3,2,159,958,26,984
"خوزستان","اهواز","مرکزی",347,558,5,4,152,719,12,731
"خوزستان","اهواز","مرکزی",348,683,5,4,152,844,16,860
"خوزستان","اهواز","مرکزی",349,798,55,18,641,1512,74,1586
"خوزستان","اهواز","مرکزی",350,292,75,26,798,1191,17,1208
"خوزستان","اهواز","مرکزی",351,758,131,34,1374,2297,40,2337
"خوزستان","اهواز","مرکزی",352,899,116,17,1256,2288,28,2316
"خوزستان","اهواز","مرکزی",353,510,88,25,935,1558,3,1561
"خوزستان","اهواز","مرکزی",354,426,59,22,958,1465,21,1486
"خوزستان","اهواز","مرکزی",355,969,103,23,976,2071,34,2105
"خوزستان","اهواز","مرکزی",356,730,24,2,301,1057,5,1062
"خوزستان","اهواز","مرکزی",357,545,81,10,685,1321,24,1345
"خوزستان","اهواز","مرکزی",358,518,73,14,865,1470,19,1489
"خوزستان","اهواز","مرکزی",359,774,70,11,680,1535,20,1555
"خوزستان","اهواز","مرکزی",360,808,69,8,642,1527,22,1549
"خوزستان","اهواز","مرکزی",361,809,86,30,749,1674,27,1701
"خوزستان","اهواز","مرکزی",362,932,104,14,711,1761,35,1796
"خوزستان","اهواز","مرکزی",363,708,76,16,939,1739,15,1754
"خوزستان","اهواز","مرکزی",364,716,96,22,831,1665,19,1684
"خوزستان","اهواز","مرکزی",365,344,52,13,504,913,15,928
"خوزستان","اهواز","مرکزی",366,331,35,12,580,958,24,982
"خوزستان","اهواز","مرکزی",367,868,16,1,281,1166,25,1191
"خوزستان","اهواز","مرکزی",368,984,10,1,141,1136,13,1149
"خوزستان","اهواز","مرکزی",369,820,25,8,243,1096,31,1127
"خوزستان","اهواز","مرکزی",370,555,34,6,419,1014,20,1034
"خوزستان","اهواز","مرکزی",371,739,108,7,643,1497,22,1519
"خوزستان","اهواز","مرکزی",372,1082,129,20,895,2126,27,2153
"خوزستان","اهواز","مرکزی",373,838,78,26,791,1733,26,1759
"خوزستان","اهواز","مرکزی",374,1075,138,13,803,2029,24,2053
"خوزستان","اهواز","مرکزی",375,667,87,8,555,1317,22,1339
"خوزستان","اهواز","مرکزی",376,853,49,5,368,1275,25,1300
"خوزستان","اهواز","مرکزی",377,666,86,17,699,1468,12,1480
"خوزستان","اهواز","مرکزی",378,840,39,14,564,1457,12,1469
"خوزستان","اهواز","مرکزی",379,1010,120,22,639,1791,22,1813
"خوزستان","اهواز","مرکزی",380,706,33,4,451,1194,20,1214
"خوزستان","اهواز","مرکزی",381,370,1,1,88,460,5,465
"خوزستان","اهواز","مرکزی",382,864,69,14,678,1625,15,1640
"خوزستان","اهواز","مرکزی",383,721,101,19,777,1618,28,1646
"خوزستان","اهواز","مرکزی",384,760,64,13,742,1579,25,1604
"خوزستان","اهواز","مرکزی",385,881,49,5,495,1430,30,1460
"خوزستان","اهواز","مرکزی",386,493,66,26,638,1223,21,1244
"خوزستان","اهواز","مرکزی",387,673,54,18,648,1393,12,1405
"خوزستان","اهواز","مرکزی",388,659,106,24,1262,2051,21,2072
"خوزستان","اهواز","مرکزی",389,976,87,26,1010,2099,29,2128
"خوزستان","اهواز","مرکزی",390,598,71,13,731,1413,22,1435
"خوزستان","اهواز","مرکزی",391,348,59,4,395,806,20,826
"خوزستان","اهواز","مرکزی",392,1134,105,22,561,1822,20,1842
"خوزستان","اهواز","مرکزی",393,738,72,22,612,1444,8,1452
"خوزستان","اهواز","مرکزی",394,460,31,11,210,712,12,724
"خوزستان","اهواز","مرکزی",395,780,63,7,374,1224,15,1239
"خوزستان","اهواز","مرکزی",396,727,39,6,428,1200,20,1220
"خوزستان","اهواز","مرکزی",397,1045,67,25,641,1778,21,1799
"خوزستان","اهواز","مرکزی",398,503,63,15,367,948,6,954
"خوزستان","اهواز","مرکزی",399,741,9,3,126,879,7,886
"خوزستان","اهواز","مرکزی",400,701,7,7,158,873,10,883
"خوزستان","اهواز","مرکزی",401,741,6,4,253,1004,16,1020
"خوزستان","اهواز","مرکزی",402,845,6,2,74,927,11,938
"خوزستان","اهواز","مرکزی",403,975,11,5,274,1265,12,1277
"خوزستان","اهواز","مرکزی",404,916,5,3,227,1151,23,1174
"خوزستان","اهواز","مرکزی",405,1227,13,3,135,1378,23,1401
"خوزستان","اهواز","مرکزی",406,600,6,4,116,726,10,736
"خوزستان","اهواز","مرکزی",407,232,19,2,148,401,5,406
"خوزستان","اهواز","مرکزی",408,612,27,6,211,856,11,867
"خوزستان","اهواز","مرکزی",409,408,21,4,107,540,3,543
"خوزستان","اهواز","مرکزی",410,71,11,0,58,140,5,145
"خوزستان","اهواز","مرکزی",411,88,1,0,26,115,1,116
"خوزستان","اهواز","مرکزی",412,296,18,1,47,362,5,367
"خوزستان","اهواز","مرکزی",413,280,29,6,230,545,8,553
"خوزستان","اهواز","مرکزی",414,311,38,4,238,591,18,609
"خوزستان","اهواز","مرکزی",415,284,31,3,172,490,4,494
"خوزستان","اهواز","مرکزی",416,107,31,1,156,295,2,297
"خوزستان","اهواز","مرکزی",417,119,5,0,32,156,0,156
"خوزستان","اهواز","مرکزی",418,429,50,1,53,533,3,536
"خوزستان","اهواز","مرکزی",419,174,13,4,117,308,4,312
"خوزستان","اهواز","مرکزی",420,140,26,30,229,425,10,435
"خوزستان","اهواز","مرکزی",421,218,19,0,148,385,4,389
"خوزستان","اهواز","مرکزی",422,576,45,6,210,837,17,854
"خوزستان","اهواز","مرکزی",423,243,29,3,217,492,9,501
"خوزستان","اهواز","مرکزی",424,146,30,3,159,338,5,343
"خوزستان","اهواز","مرکزی",425,153,6,0,38,197,2,199
"خوزستان","اهواز","مرکزی",426,117,19,0,77,213,2,215
"خوزستان","اهواز","مرکزی",427,210,18,1,146,375,2,377
"خوزستان","اهواز","مرکزی",428,533,17,3,40,593,6,599
"خوزستان","اهواز","مرکزی",429,593,6,2,42,643,10,653
"خوزستان","اهواز","مرکزی",430,446,2,0,40,488,12,500
"خوزستان","اهواز","مرکزی",431,118,10,0,26,154,2,156
"خوزستان","اهواز","مرکزی",432,1045,3,2,94,1144,13,1157
"خوزستان","اهواز","مرکزی",433,412,3,0,26,441,6,447
"خوزستان","اهواز","مرکزی",434,345,1,0,62,408,2,410
"خوزستان","اهواز","مرکزی",435,276,0,0,9,285,0,285
"خوزستان","اهواز","مرکزی",436,76,,,15,91,0,91
"خوزستان","اهواز","مرکزی",437,235,,,6,241,5,246
"خوزستان","اهواز","مرکزی",438,128,1,1,17,147,0,147
"خوزستان","اهواز","مرکزی",439,589,2,0,66,657,7,664
"خوزستان","اهواز","مرکزی",440,252,25,6,196,479,23,502
"خوزستان","اهواز","مرکزی",441,660,6,1,127,794,13,807
"خوزستان","اهواز","مرکزی",442,368,0,0,29,397,2,399
"خوزستان","اهواز","مرکزی",443,318,6,1,56,381,7,388
"خوزستان","اهواز","مرکزی",444,209,2,0,5,216,4,220
"خوزستان","اهواز","مرکزی",445,221,0,0,26,247,0,247
"خوزستان","اهواز","مرکزی",446,130,1,0,6,137,1,138
"خوزستان","اهواز","مرکزی",447,920,22,0,180,1122,5,1127
"خوزستان","اهواز","مرکزی",448,771,0,0,114,885,15,900
"خوزستان","اهواز","مرکزی",449,1040,1,1,54,1096,2,1098
"خوزستان","اهواز","مرکزی",450,691,5,1,67,764,9,773
"خوزستان","اهواز","مرکزی",451,386,2,0,27,415,5,420
"خوزستان","اهواز","مرکزی",452,298,0,1,8,307,0,307
"خوزستان","اهواز","مرکزی",453,388,1,0,40,429,12,441
"خوزستان","اهواز","مرکزی",454,568,2,0,58,628,7,635
"خوزستان","اهواز","مرکزی",455,340,,,3,343,0,343
"خوزستان","اهواز","مرکزی",456,541,3,1,26,571,1,572
"خوزستان","اهواز","مرکزی",457,157,0,0,6,163,1,164
"خوزستان","اهواز","مرکزی",458,422,5,0,59,486,1,487
"خوزستان","اهواز","مرکزی",459,889,3,3,45,940,6,946
"خوزستان","اهواز","مرکزی",460,466,2,1,62,531,13,544
"خوزستان","اهواز","مرکزی",461,708,4,0,39,751,7,758
"خوزستان","اهواز","مرکزی",462,951,2,0,89,1042,13,1055
"خوزستان","اهواز","مرکزی",463,865,5,0,77,947,22,969
"خوزستان","اهواز","مرکزی",464,653,5,0,81,739,12,751
"خوزستان","اهواز","مرکزی",465,521,4,0,86,611,1,612
"خوزستان","اهواز","مرکزی",466,748,2,0,42,792,3,795
"خوزستان","اهواز","مرکزی",467,523,2,0,28,553,4,557
"خوزستان","اهواز","مرکزی",468,439,1,0,26,466,3,469
"خوزستان","اهواز","مرکزی",469,1478,17,2,119,1616,37,1653
"خوزستان","اهواز","مرکزی",470,670,1,4,52,727,16,743
"خوزستان","اهواز","مرکزی",471,1107,10,5,115,1237,15,1252
"خوزستان","اهواز","مرکزی",472,327,1,1,45,374,1,375
"خوزستان","اهواز","مرکزی",473,311,9,1,75,396,4,400
"خوزستان","اهواز","مرکزی",474,439,1,0,30,470,9,479
"خوزستان","اهواز","مرکزی",475,377,10,4,92,483,6,489
"خوزستان","اهواز","مرکزی",476,904,20,2,146,1072,22,1094
"خوزستان","اهواز","مرکزی",477,391,,6,38,435,2,437
"خوزستان","اهواز","مرکزی",478,327,1,1,105,434,5,439
"خوزستان","اهواز","مرکزی",479,348,4,0,30,382,4,386
"خوزستان","اهواز","مرکزی",480,88,3,2,33,126,2,128
"خوزستان","اهواز","مرکزی",481,209,1,1,40,251,3,254
"خوزستان","اهواز","مرکزی",482,498,1,1,150,650,7,657
"خوزستان","اهواز","مرکزی",483,527,2,0,63,592,5,597
"خوزستان","اهواز","مرکزی",484,928,5,3,37,973,3,976
"خوزستان","اهواز","مرکزی",485,791,2,0,69,862,5,867
"خوزستان","اهواز","مرکزی",486,1144,4,2,75,1225,33,1258
"خوزستان","اهواز","مرکزی",487,985,4,0,40,1029,10,1039
"خوزستان","اهواز","مرکزی",488,588,2,0,37,627,5,632
"خوزستان","اهواز","مرکزی",489,1075,3,0,50,1128,26,1154
"خوزستان","اهواز","مرکزی",490,425,5,0,48,478,5,483
"خوزستان","اهواز","مرکزی",491,397,3,1,22,423,5,428
"خوزستان","اهواز","مرکزی",492,601,0,0,31,632,6,638
"خوزستان","اهواز","مرکزی",493,607,4,1,83,695,13,708
"خوزستان","اهواز","مرکزی",494,936,5,4,74,1019,20,1039
"خوزستان","اهواز","مرکزی",495,484,1,1,11,497,3,500
"خوزستان","اهواز","مرکزی",496,235,0,1,16,252,0,252
"خوزستان","اهواز","مرکزی",497,260,2,4,15,281,3,284
"خوزستان","اهواز","مرکزی",498,470,0,0,6,476,0,476
"خوزستان","اهواز","مرکزی",499,287,1,4,39,331,4,335
"خوزستان","اهواز","مرکزی",500,302,7,4,26,339,9,348
"خوزستان","اهواز","مرکزی",501,776,8,0,59,843,0,843
"خوزستان","اهواز","مرکزی",502,235,1,0,11,247,1,248
"خوزستان","اهواز","مرکزی",503,179,0,1,20,200,0,200
"خوزستان","اهواز","مرکزی",504,326,0,3,32,361,4,365
"خوزستان","اهواز","مرکزی",505,154,0,4,27,185,2,187
"خوزستان","اهواز","مرکزی",506,213,11,0,47,271,5,276
"خوزستان","اهواز","مرکزی",507,370,1,0,50,421,4,425
"خوزستان","اهواز","مرکزی",508,46,2,0,9,57,1,58
"خوزستان","اهواز","مرکزی",509,836,5,0,68,909,11,920
"خوزستان","اهواز","مرکزی",510,779,5,1,138,923,11,934
"خوزستان","اهواز","مرکزی",511,457,8,1,53,519,3,522
"خوزستان","اهواز","مرکزی",512,428,0,0,18,446,6,452
"خوزستان","اهواز","مرکزی",513,1102,26,0,140,1268,5,1273
"خوزستان","اهواز","مرکزی",514,882,0,6,132,1020,6,1026
"خوزستان","اهواز","مرکزی",515,682,5,3,90,780,15,795
"خوزستان","اهواز","مرکزی",516,564,3,1,71,639,4,643
"خوزستان","اهواز","مرکزی",517,492,2,2,11,507,0,507
"خوزستان","اهواز","مرکزی",518,205,0,1,118,324,2,326
"خوزستان","اهواز","مرکزی",519,222,1,3,49,275,0,275
"خوزستان","اهواز","مرکزی",520,278,1,3,45,327,2,329
"خوزستان","اهواز","مرکزی",521,379,2,1,43,425,5,430
"خوزستان","اهواز","مرکزی",522,435,3,3,28,469,2,471
"خوزستان","اهواز","مرکزی",523,289,2,0,43,334,3,337
"خوزستان","اهواز","مرکزی",524,169,3,2,103,277,2,279
"خوزستان","اهواز","مرکزی",525,326,47,0,69,442,2,444
"خوزستان","اهواز","مرکزی",526,514,2,0,63,579,3,582
"خوزستان","اهواز","حمیدیه",1,1177,8,4,163,1352,15,1367
"خوزستان","اهواز","حمیدیه",2,562,5,6,127,700,23,723
"خوزستان","اهواز","حمیدیه",3,525,5,3,74,607,7,614
"خوزستان","اهواز","حمیدیه",4,938,14,3,129,1084,19,1103
"خوزستان","اهواز","حمیدیه",5,464,9,2,115,590,7,597
"خوزستان","اهواز","حمیدیه",6,599,2,3,106,710,10,720
"خوزستان","اهواز","حمیدیه",7,824,2,2,44,872,8,880
"خوزستان","اهواز","حمیدیه",8,518,2,1,55,576,10,586
"خوزستان","اهواز","حمیدیه",9,446,1,1,50,498,0,498
"خوزستان","اهواز","حمیدیه",10,182,1,1,20,204,2,206
"خوزستان","اهواز","حمیدیه",11,498,13,5,44,560,6,566
"خوزستان","اهواز","حمیدیه",12,310,3,6,15,334,3,337
"خوزستان","اهواز","حمیدیه",13,258,4,0,23,285,2,287
"خوزستان","اهواز","حمیدیه",14,450,8,4,98,560,7,567
"خوزستان","اهواز","حمیدیه",15,855,2,1,112,970,3,973
"خوزستان","اهواز","حمیدیه",16,990,2,0,53,1045,9,1054
"خوزستان","اهواز","حمیدیه",17,195,0,0,16,211,3,214
"خوزستان","اهواز","حمیدیه",18,627,1,1,16,645,3,648
"خوزستان","اهواز","حمیدیه",19,790,13,31,154,988,10,998
"خوزستان","اهواز","حمیدیه",20,738,0,0,11,749,3,752
"خوزستان","اهواز","حمیدیه",21,798,4,2,26,830,8,838
"خوزستان","اهواز","حمیدیه",22,319,4,0,17,340,1,341
"خوزستان","اهواز","حمیدیه",23,382,5,0,15,402,1,403
"خوزستان","اهواز","حمیدیه",24,370,3,3,14,390,2,392
"خوزستان","اهواز","حمیدیه",25,257,12,1,10,280,5,285
"خوزستان","اهواز","حمیدیه",26,540,0,0,77,617,6,623
"خوزستان","اهواز","حمیدیه",27,291,0,0,48,339,1,340
"خوزستان","اهواز","حمیدیه",28,229,0,3,49,281,0,281
"خوزستان","اهواز","حمیدیه",29,276,6,0,59,341,0,341
"خوزستان","اهواز","حمیدیه",30,256,0,0,14,270,2,272
"خوزستان","اهواز","حمیدیه",31,529,1,0,20,550,0,550
"خوزستان","اهواز","حمیدیه",32,379,2,0,8,389,0,389
"خوزستان","اهواز","حمیدیه",33,17,2,0,6,25,0,25
"خوزستان","اهواز","حمیدیه",34,180,0,0,50,230,4,234
"خوزستان","اهواز","حمیدیه",35,160,1,0,17,178,0,178
"خوزستان","اهواز","حمیدیه",36,190,5,1,16,212,5,217
"خوزستان","اهواز","حمیدیه",37,197,1,0,9,207,0,207
"خوزستان","اهواز","حمیدیه",38,264,0,0,34,298,5,303
"خوزستان","اهواز","حمیدیه",39,205,5,0,4,214,2,216
"خوزستان","اهواز","باوی",1,621,16,1,177,815,5,820
"خوزستان","اهواز","باوی",2,1349,21,4,137,1511,19,1530
"خوزستان","اهواز","باوی",3,1084,10,6,112,1212,17,1229
"خوزستان","اهواز","باوی",4,808,8,2,102,920,13,933
"خوزستان","اهواز","باوی",5,350,39,12,287,688,28,716
"خوزستان","اهواز","باوی",6,836,15,2,73,926,14,940
"خوزستان","اهواز","باوی",7,607,18,2,71,698,9,707
"خوزستان","اهواز","باوی",8,499,6,2,40,547,2,549
"خوزستان","اهواز","باوی",9,363,0,0,55,418,3,421
"خوزستان","اهواز","باوی",10,611,5,1,99,716,3,719
"خوزستان","اهواز","باوی",11,404,7,1,63,475,12,487
"خوزستان","اهواز","باوی",12,357,0,0,19,376,4,380
"خوزستان","اهواز","باوی",13,248,0,0,21,269,0,269
"خوزستان","اهواز","باوی",14,276,3,0,10,289,1,290
"خوزستان","اهواز","باوی",15,479,2,1,37,519,6,525
"خوزستان","اهواز","باوی",16,154,2,1,4,161,0,161
"خوزستان","اهواز","باوی",17,396,1,0,45,442,4,446
"خوزستان","اهواز","باوی",18,232,20,4,68,324,5,329
"خوزستان","اهواز","باوی",19,903,10,3,99,1015,21,1036
"خوزستان","اهواز","باوی",20,473,8,2,78,561,14,575
"خوزستان","اهواز","باوی",21,845,14,8,116,983,21,1004
"خوزستان","اهواز","باوی",22,478,4,2,137,621,16,637
"خوزستان","اهواز","باوی",23,639,10,1,45,695,3,698
"خوزستان","اهواز","باوی",24,176,1,0,19,196,3,199
"خوزستان","اهواز","باوی",25,535,14,2,50,601,6,607
"خوزستان","اهواز","باوی",26,923,14,6,57,1000,12,1012
"خوزستان","اهواز","باوی",27,495,3,3,106,607,14,621
"خوزستان","اهواز","باوی",28,730,9,2,61,802,13,815
"خوزستان","اهواز","باوی",29,204,5,0,1,210,2,212
"خوزستان","اهواز","باوی",30,140,3,0,5,148,0,148
"خوزستان","اهواز","باوی",31,276,4,0,4,284,0,284
"خوزستان","اهواز","باوی",32,237,13,2,133,385,6,391
"خوزستان","اهواز","باوی",33,533,3,0,24,560,2,562
"خوزستان","اهواز","باوی",34,317,9,0,26,352,2,354
"خوزستان","اهواز","باوی",35,196,3,1,84,284,1,285
"خوزستان","اهواز","باوی",36,262,1,0,22,285,3,288
"خوزستان","اهواز","باوی",37,338,2,0,51,391,3,394
"خوزستان","اهواز","باوی",38,181,2,2,23,208,2,210
"خوزستان","اهواز","باوی",39,320,3,0,72,395,5,400
"خوزستان","اهواز","باوی",40,133,0,1,11,145,1,146
"خوزستان","اهواز","باوی",41,1008,9,9,179,1205,14,1219
"خوزستان","اهواز","باوی",42,724,11,4,69,808,12,820
"خوزستان","اهواز","باوی",43,1333,21,6,215,1575,16,1591
"خوزستان","اهواز","باوی",44,921,15,5,186,1127,12,1139
"خوزستان","اهواز","باوی",45,740,7,0,54,801,15,816
"خوزستان","اهواز","باوی",46,800,24,4,126,954,19,973
"خوزستان","اهواز","باوی",47,903,23,2,143,1071,20,1091
"خوزستان","اهواز","باوی",48,724,7,4,156,891,11,902
"خوزستان","اهواز","باوی",49,423,2,1,92,518,9,527
"خوزستان","اهواز","باوی",50,782,9,0,120,911,9,920
"خوزستان","اهواز","باوی",51,1043,20,2,102,1167,12,1179
"خوزستان","اهواز","باوی",52,837,5,2,118,962,6,968
"خوزستان","اهواز","باوی",53,289,4,1,53,347,5,352
"خوزستان","اهواز","باوی",54,381,4,12,41,438,2,440
"خوزستان","اهواز","باوی",55,135,3,0,46,184,0,184
"خوزستان","ایذه","مرکزی",1,965,327,11,155,1458,13,1471
"خوزستان","ایذه","مرکزی",2,472,311,31,378,1192,14,1206
"خوزستان","ایذه","مرکزی",3,292,224,30,244,790,12,802
"خوزستان","ایذه","مرکزی",4,627,280,13,259,1179,16,1195
"خوزستان","ایذه","مرکزی",5,300,211,10,303,824,12,836
"خوزستان","ایذه","مرکزی",6,461,299,14,400,1174,27,1201
"خوزستان","ایذه","مرکزی",7,622,292,16,207,1137,15,1152
"خوزستان","ایذه","مرکزی",8,200,147,7,136,490,6,496
"خوزستان","ایذه","مرکزی",9,509,224,8,210,951,6,957
"خوزستان","ایذه","مرکزی",10,515,357,8,276,1156,24,1180
"خوزستان","ایذه","مرکزی",11,542,304,10,179,1035,19,1054
"خوزستان","ایذه","مرکزی",12,571,534,11,284,1400,6,1406
"خوزستان","ایذه","مرکزی",13,596,423,14,164,1197,2,1199
"خوزستان","ایذه","مرکزی",14,238,224,10,273,745,12,757
"خوزستان","ایذه","مرکزی",15,447,326,12,205,990,9,999
"خوزستان","ایذه","مرکزی",16,448,353,20,289,1110,9,1119
"خوزستان","ایذه","مرکزی",17,389,220,24,260,893,12,905
"خوزستان","ایذه","مرکزی",18,270,224,16,305,815,10,825
"خوزستان","ایذه","مرکزی",19,443,425,28,383,1279,18,1297
"خوزستان","ایذه","مرکزی",20,405,397,24,498,1324,13,1337
"خوزستان","ایذه","مرکزی",21,137,127,3,176,443,7,450
"خوزستان","ایذه","مرکزی",22,537,448,26,424,1435,7,1442
"خوزستان","ایذه","مرکزی",23,390,339,19,348,1096,18,1114
"خوزستان","ایذه","مرکزی",24,378,639,13,210,1240,7,1247
"خوزستان","ایذه","مرکزی",25,609,472,17,301,1399,22,1421
"خوزستان","ایذه","مرکزی",26,333,197,17,264,811,12,823
"خوزستان","ایذه","مرکزی",27,427,353,34,395,1209,18,1227
"خوزستان","ایذه","مرکزی",28,270,271,32,369,942,17,959
"خوزستان","ایذه","مرکزی",29,409,266,17,392,1084,12,1096
"خوزستان","ایذه","مرکزی",30,458,235,9,210,912,13,925
"خوزستان","ایذه","مرکزی",31,290,292,10,129,721,5,726
"خوزستان","ایذه","مرکزی",32,360,554,16,300,1230,16,1246
"خوزستان","ایذه","مرکزی",33,427,496,4,206,1133,8,1141
"خوزستان","ایذه","مرکزی",34,557,646,20,276,1499,1,1500
"خوزستان","ایذه","مرکزی",35,146,204,9,199,558,8,566
"خوزستان","ایذه","مرکزی",36,374,503,14,245,1136,6,1142
"خوزستان","ایذه","مرکزی",37,456,564,21,245,1286,10,1296
"خوزستان","ایذه","مرکزی",38,476,700,14,395,1585,14,1599
"خوزستان","ایذه","مرکزی",39,505,653,23,368,1549,24,1573
"خوزستان","ایذه","مرکزی",40,476,316,20,239,1051,5,1056
"خوزستان","ایذه","مرکزی",41,353,371,25,212,961,14,975
"خوزستان","ایذه","مرکزی",42,544,550,17,290,1401,6,1407
"خوزستان","ایذه","مرکزی",43,261,242,17,190,710,4,714
"خوزستان","ایذه","مرکزی",44,140,114,14,59,327,5,332
"خوزستان","ایذه","مرکزی",45,143,82,3,58,286,0,286
"خوزستان","ایذه","مرکزی",46,293,307,2,53,655,7,662
"خوزستان","ایذه","مرکزی",47,349,268,6,121,744,0,744
"خوزستان","ایذه","مرکزی",48,264,175,3,53,495,0,495
"خوزستان","ایذه","مرکزی",49,252,283,7,39,581,0,581
"خوزستان","ایذه","مرکزی",50,170,161,0,35,366,1,367
"خوزستان","ایذه","مرکزی",51,359,96,1,34,490,4,494
"خوزستان","ایذه","مرکزی",52,420,239,16,235,910,1,911
"خوزستان","ایذه","مرکزی",53,411,349,2,38,800,3,803
"خوزستان","ایذه","مرکزی",54,109,134,8,77,328,0,328
"خوزستان","ایذه","مرکزی",55,238,27,1,49,315,0,315
"خوزستان","ایذه","مرکزی",56,37,40,0,5,82,2,84
"خوزستان","ایذه","مرکزی",57,364,118,2,52,536,4,540
"خوزستان","ایذه","مرکزی",58,81,100,0,65,246,1,247
"خوزستان","ایذه","مرکزی",59,164,168,0,38,370,0,370
"خوزستان","ایذه","مرکزی",60,11,26,0,5,42,0,42
"خوزستان","ایذه","مرکزی",61,121,263,0,23,407,1,408
"خوزستان","ایذه","مرکزی",62,224,175,4,16,419,5,424
"خوزستان","ایذه","مرکزی",63,158,111,2,73,344,1,345
"خوزستان","ایذه","مرکزی",64,446,200,4,120,770,13,783
"خوزستان","ایذه","مرکزی",65,197,63,0,53,313,5,318
"خوزستان","ایذه","مرکزی",66,335,138,3,53,529,0,529
"خوزستان","ایذه","مرکزی",67,444,262,3,33,742,5,747
"خوزستان","ایذه","مرکزی",68,416,511,2,34,963,3,966
"خوزستان","ایذه","مرکزی",69,492,136,6,87,721,1,722
"خوزستان","ایذه","مرکزی",70,438,90,1,32,561,0,561
"خوزستان","ایذه","مرکزی",71,36,26,1,10,73,0,73
"خوزستان","ایذه","مرکزی",72,389,89,1,17,496,1,497
"خوزستان","ایذه","مرکزی",73,154,40,1,5,200,1,201
"خوزستان","ایذه","مرکزی",74,0,12,0,1,13,0,13
"خوزستان","ایذه","مرکزی",75,8,4,0,5,17,0,17
"خوزستان","ایذه","مرکزی",76,23,4,0,1,28,0,28
"خوزستان","ایذه","مرکزی",77,123,137,55,32,347,4,351
"خوزستان","ایذه","مرکزی",78,147,137,13,42,339,3,342
"خوزستان","ایذه","مرکزی",79,261,144,0,33,438,4,442
"خوزستان","ایذه","مرکزی",80,197,55,0,71,323,7,330
"خوزستان","ایذه","مرکزی",81,306,184,22,62,574,0,574
"خوزستان","ایذه","مرکزی",82,67,24,2,42,135,0,135
"خوزستان","ایذه","مرکزی",83,140,97,1,15,253,0,253
"خوزستان","ایذه","مرکزی",84,171,27,2,11,211,0,211
"خوزستان","ایذه","مرکزی",85,166,107,2,14,289,2,291
"خوزستان","ایذه","مرکزی",86,100,94,0,36,230,3,233
"خوزستان","ایذه","مرکزی",87,199,197,7,96,499,1,500
"خوزستان","ایذه","مرکزی",88,60,66,0,4,130,0,130
"خوزستان","ایذه","مرکزی",89,141,41,10,18,210,0,210
"خوزستان","ایذه","مرکزی",90,83,79,1,53,216,0,216
"خوزستان","ایذه","مرکزی",91,219,58,0,15,292,1,293
"خوزستان","ایذه","مرکزی",92,206,35,0,25,266,0,266
"خوزستان","ایذه","مرکزی",93,138,25,0,14,177,0,177
"خوزستان","ایذه","مرکزی",94,68,72,0,6,146,0,146
"خوزستان","ایذه","مرکزی",95,110,50,0,35,195,0,195
"خوزستان","ایذه","مرکزی",96,18,10,0,1,29,0,29
"خوزستان","ایذه","سوسن",1,3,2,0,0,5,0,5
"خوزستان","ایذه","سوسن",2,103,19,0,22,144,0,144
"خوزستان","ایذه","سوسن",3,223,122,3,57,405,1,406
"خوزستان","ایذه","سوسن",4,173,68,2,18,261,0,261
"خوزستان","ایذه","سوسن",5,92,157,4,19,272,6,278
"خوزستان","ایذه","سوسن",6,219,67,2,12,300,0,300
"خوزستان","ایذه","سوسن",7,460,271,1,20,752,15,767
"خوزستان","ایذه","سوسن",8,38,62,0,3,103,1,104
"خوزستان","ایذه","سوسن",9,75,74,0,2,151,0,151
"خوزستان","ایذه","سوسن",10,62,28,0,1,91,0,91
"خوزستان","ایذه","سوسن",11,39,4,0,6,49,0,49
"خوزستان","ایذه","سوسن",12,45,78,2,17,142,0,142
"خوزستان","ایذه","سوسن",13,128,46,0,1,175,0,175
"خوزستان","ایذه","سوسن",14,316,77,0,7,400,1,401
"خوزستان","ایذه","سوسن",15,141,35,0,5,181,0,181
"خوزستان","ایذه","سوسن",16,288,18,1,1,308,0,308
"خوزستان","ایذه","سوسن",17,870,319,0,0,1189,0,1189
"خوزستان","ایذه","سوسن",18,351,0,0,0,351,0,351
"خوزستان","ایذه","دهدز",1,236,108,5,90,439,1,440
"خوزستان","ایذه","دهدز",2,321,71,1,47,440,3,443
"خوزستان","ایذه","دهدز",3,422,200,1,141,764,0,764
"خوزستان","ایذه","دهدز",4,168,66,0,84,318,0,318
"خوزستان","ایذه","دهدز",5,435,203,0,53,691,0,691
"خوزستان","ایذه","دهدز",6,290,157,1,36,484,1,485
"خوزستان","ایذه","دهدز",7,45,119,0,36,200,0,200
"خوزستان","ایذه","دهدز",8,125,15,0,19,159,1,160
"خوزستان","ایذه","دهدز",9,86,23,0,7,116,0,116
"خوزستان","ایذه","دهدز",10,110,54,1,11,176,0,176
"خوزستان","ایذه","دهدز",11,297,37,3,13,350,1,351
"خوزستان","ایذه","دهدز",12,255,17,0,28,300,0,300
"خوزستان","ایذه","دهدز",13,49,6,1,18,74,0,74
"خوزستان","ایذه","دهدز",14,157,35,0,40,232,3,235
"خوزستان","ایذه","دهدز",15,61,13,2,29,105,1,106
"خوزستان","ایذه","دهدز",16,122,127,0,63,312,1,313
"خوزستان","ایذه","دهدز",17,39,33,1,19,92,0,92
"خوزستان","ایذه","دهدز",18,357,37,0,6,400,0,400
"خوزستان","ایذه","دهدز",19,85,20,1,50,156,0,156
"خوزستان","ایذه","دهدز",20,134,100,3,59,296,0,296
"خوزستان","ایذه","دهدز",21,293,4,0,53,350,0,350
"خوزستان","ایذه","دهدز",22,90,0,0,0,90,2,92
"خوزستان","ایذه","دهدز",23,64,2,3,4,73,0,73
"خوزستان","ایذه","دهدز",24,68,15,1,16,100,0,100
"خوزستان","ایذه","دهدز",25,174,32,8,12,226,0,226
"خوزستان","ایذه","دهدز",26,635,336,4,125,1100,0,1100
"خوزستان","ایذه","دهدز",27,363,135,25,15,538,8,546
"خوزستان","ایذه","دهدز",28,468,49,2,104,623,1,624
"خوزستان","ایذه","دهدز",29,484,8,1,12,505,0,505
"خوزستان","ایذه","دهدز",30,485,61,1,94,641,0,641
"خوزستان","ایذه","دهدز",31,445,44,10,54,553,0,553
"خوزستان","باغملک","مرکزی",58,415,8,0,30,453,0,453
"خوزستان","باغملک","مرکزی",57,605,32,2,53,692,0,692
"خوزستان","باغملک","مرکزی",56,303,29,0,29,361,6,367
"خوزستان","باغملک","مرکزی",55,527,11,0,38,576,1,577
"خوزستان","باغملک","مرکزی",54,677,46,1,46,770,2,772
"خوزستان","باغملک","مرکزی",53,442,39,6,48,535,2,537
"خوزستان","باغملک","مرکزی",52,560,28,3,87,678,1,679
"خوزستان","باغملک","مرکزی",51,524,22,0,76,622,0,622
"خوزستان","باغملک","مرکزی",50,527,41,3,154,725,5,730
"خوزستان","باغملک","مرکزی",49,717,33,1,60,811,5,816
"خوزستان","باغملک","مرکزی",48,544,18,0,40,602,1,603
"خوزستان","باغملک","مرکزی",47,697,33,1,42,773,2,775
"خوزستان","باغملک","مرکزی",46,886,58,3,69,1016,1,1017
"خوزستان","باغملک","مرکزی",45,302,8,0,22,332,0,332
"خوزستان","باغملک","مرکزی",44,685,50,5,75,815,0,815
"خوزستان","باغملک","مرکزی",43,560,17,1,138,716,4,720
"خوزستان","باغملک","مرکزی",42,391,26,0,79,496,4,500
"خوزستان","باغملک","مرکزی",41,678,9,0,54,741,0,741
"خوزستان","باغملک","مرکزی",40,640,92,0,32,764,6,770
"خوزستان","باغملک","مرکزی",39,328,21,0,55,404,1,405
"خوزستان","باغملک","مرکزی",38,141,6,1,130,278,1,279
"خوزستان","باغملک","مرکزی",37,278,13,1,41,333,2,335
"خوزستان","باغملک","مرکزی",36,425,24,7,134,590,7,597
"خوزستان","باغملک","مرکزی",35,245,42,2,123,412,1,413
"خوزستان","باغملک","مرکزی",34,480,18,0,75,573,3,576
"خوزستان","باغملک","مرکزی",33,62,2,0,5,69,0,69
"خوزستان","باغملک","مرکزی",32,203,100,4,56,363,4,367
"خوزستان","باغملک","مرکزی",31,171,29,3,126,329,1,330
"خوزستان","باغملک","مرکزی",30,440,112,1,204,757,6,763
"خوزستان","باغملک","مرکزی",29,325,40,2,52,419,3,422
"خوزستان","باغملک","مرکزی",28,166,26,1,108,301,1,302
"خوزستان","باغملک","مرکزی",27,528,74,4,182,788,4,792
"خوزستان","باغملک","مرکزی",26,223,33,8,143,407,3,410
"خوزستان","باغملک","مرکزی",25,561,52,12,270,895,10,905
"خوزستان","باغملک","مرکزی",24,483,73,4,286,846,14,860
"خوزستان","باغملک","مرکزی",23,351,65,0,215,631,7,638
"خوزستان","باغملک","مرکزی",22,477,60,1,165,703,4,707
"خوزستان","باغملک","مرکزی",21,300,39,2,71,412,4,416
"خوزستان","باغملک","مرکزی",20,301,16,0,116,433,3,436
"خوزستان","باغملک","مرکزی",19,668,78,3,141,890,4,894
"خوزستان","باغملک","مرکزی",18,584,62,4,271,921,3,924
"خوزستان","باغملک","مرکزی",17,497,54,1,65,617,3,620
"خوزستان","باغملک","مرکزی",16,457,51,1,187,696,11,707
"خوزستان","باغملک","مرکزی",15,365,78,6,317,766,0,766
"خوزستان","باغملک","مرکزی",14,532,37,0,48,617,0,617
"خوزستان","باغملک","مرکزی",13,224,28,1,98,351,4,355
"خوزستان","باغملک","مرکزی",12,477,125,2,324,928,6,934
"خوزستان","باغملک","مرکزی",11,145,33,1,104,283,4,287
"خوزستان","باغملک","مرکزی",10,350,93,5,213,661,5,666
"خوزستان","باغملک","مرکزی",9,521,135,0,399,1055,10,1065
"خوزستان","باغملک","مرکزی",8,170,38,0,104,312,0,312
"خوزستان","باغملک","مرکزی",7,320,69,5,204,598,0,598
"خوزستان","باغملک","مرکزی",6,325,36,0,90,451,6,457
"خوزستان","باغملک","مرکزی",5,283,27,1,78,389,4,393
"خوزستان","باغملک","مرکزی",4,259,16,0,58,333,1,334
"خوزستان","باغملک","مرکزی",3,110,12,0,93,215,1,216
"خوزستان","باغملک","مرکزی",2,280,22,0,24,326,2,328
"خوزستان","باغملک","مرکزی",1,448,33,2,228,711,5,716
"خوزستان","باغملک","میداوود",59,514,24,1,135,674,5,679
"خوزستان","باغملک","میداوود",60,505,17,1,52,575,2,577
"خوزستان","باغملک","میداوود",61,452,26,0,65,543,0,543
"خوزستان","باغملک","میداوود",62,549,28,0,71,648,5,653
"خوزستان","باغملک","میداوود",63,613,80,1,93,787,0,787
"خوزستان","باغملک","میداوود",64,326,48,0,113,487,2,489
"خوزستان","باغملک","میداوود",65,468,30,0,135,633,4,637
"خوزستان","باغملک","میداوود",66,548,8,1,55,612,0,612
"خوزستان","باغملک","میداوود",67,650,4,0,26,680,5,685
"خوزستان","باغملک","میداوود",68,841,13,0,40,894,1,895
"خوزستان","باغملک","میداوود",69,634,16,1,39,690,1,691
"خوزستان","باغملک","میداوود",70,637,7,0,75,719,3,722
"خوزستان","باغملک","میداوود",71,698,12,1,202,913,4,917
"خوزستان","باغملک","میداوود",72,376,4,0,9,389,0,389
"خوزستان","باغملک","میداوود",73,233,1,0,5,239,0,239
"خوزستان","باغملک","میداوود",74,460,0,1,5,466,0,466
"خوزستان","باغملک","میداوود",75,196,1,0,9,206,4,210
"خوزستان","باغملک","صیدون",76,705,30,0,53,788,1,789
"خوزستان","باغملک","صیدون",77,642,27,1,175,845,0,845
"خوزستان","باغملک","صیدون",78,993,56,2,47,1098,0,1098
"خوزستان","باغملک","صیدون",79,823,27,0,55,905,0,905
"خوزستان","باغملک","صیدون",80,324,11,0,152,487,5,492
"خوزستان","باغملک","صیدون",81,766,7,0,70,843,0,843
"خوزستان","باغملک","صیدون",82,920,15,2,29,966,0,966
"خوزستان","باغملک","صیدون",83,127,2,0,7,136,0,136
"خوزستان","باغملک","صیدون",84,424,19,0,65,508,2,510
"خوزستان","باغملک","صیدون",85,660,21,1,17,699,5,704
"خوزستان","باغملک","صیدون",86,575,25,0,33,633,0,633
"خوزستان","باغملک","صیدون",87,686,15,1,20,722,1,723
"خوزستان","باغملک","صیدون",88,594,13,0,37,644,0,644
"خوزستان","باغملک","صیدون",89,880,5,0,12,897,0,897
"خوزستان","باغملک","صیدون",90,349,0,2,21,372,2,374
"خوزستان","باغملک","صیدون",91,520,10,28,8,566,2,568
"خوزستان","باغملک","صیدون",92,190,1,0,1,192,0,192
"خوزستان","باغملک","صیدون",93,657,3,0,125,785,2,787
"خوزستان","باغملک","صیدون",94,577,21,2,8,608,0,608
"خوزستان","باغملک","صیدون",95,812,18,0,4,834,0,834
"خوزستان","باغملک","صیدون",96,805,22,0,73,900,0,900
"خوزستان","بندر_ماهشهر","مرکزی",1,592,25,13,348,978,11,989
"خوزستان","بندر_ماهشهر","مرکزی",2,1028,42,16,458,1544,18,1562
"خوزستان","بندر_ماهشهر","مرکزی",3,573,18,4,201,796,3,799
"خوزستان","بندر_ماهشهر","مرکزی",4,870,6,4,64,944,7,951
"خوزستان","بندر_ماهشهر","مرکزی",5,1099,21,16,160,1296,16,1312
"خوزستان","بندر_ماهشهر","مرکزی",6,352,35,5,322,714,8,722
"خوزستان","بندر_ماهشهر","مرکزی",7,809,19,3,298,1129,9,1138
"خوزستان","بندر_ماهشهر","مرکزی",8,722,8,5,190,925,19,944
"خوزستان","بندر_ماهشهر","مرکزی",9,375,16,2,160,553,6,559
"خوزستان","بندر_ماهشهر","مرکزی",10,330,20,5,260,615,13,628
"خوزستان","بندر_ماهشهر","مرکزی",11,558,14,6,247,825,12,837
"خوزستان","بندر_ماهشهر","مرکزی",12,710,25,6,313,1054,14,1068
"خوزستان","بندر_ماهشهر","مرکزی",13,370,26,13,473,882,17,899
"خوزستان","بندر_ماهشهر","مرکزی",14,616,55,12,347,1030,13,1043
"خوزستان","بندر_ماهشهر","مرکزی",15,422,14,3,157,596,9,605
"خوزستان","بندر_ماهشهر","مرکزی",16,869,63,10,453,1395,25,1420
"خوزستان","بندر_ماهشهر","مرکزی",17,668,19,6,210,903,11,914
"خوزستان","بندر_ماهشهر","مرکزی",18,811,25,2,206,1044,23,1067
"خوزستان","بندر_ماهشهر","مرکزی",19,939,25,6,178,1148,9,1157
"خوزستان","بندر_ماهشهر","مرکزی",20,962,14,1,162,1139,19,1158
"خوزستان","بندر_ماهشهر","مرکزی",21,464,28,9,440,941,20,961
"خوزستان","بندر_ماهشهر","مرکزی",22,778,20,4,181,983,18,1001
"خوزستان","بندر_ماهشهر","مرکزی",23,839,59,11,577,1486,14,1500
"خوزستان","بندر_ماهشهر","مرکزی",24,829,62,7,426,1324,13,1337
"خوزستان","بندر_ماهشهر","مرکزی",25,935,48,12,679,1674,27,1701
"خوزستان","بندر_ماهشهر","مرکزی",26,450,41,6,425,922,14,936
"خوزستان","بندر_ماهشهر","مرکزی",27,876,36,4,256,1172,14,1186
"خوزستان","بندر_ماهشهر","مرکزی",28,478,53,10,472,1013,17,1030
"خوزستان","بندر_ماهشهر","مرکزی",29,856,15,8,154,1033,15,1048
"خوزستان","بندر_ماهشهر","مرکزی",30,781,15,12,182,990,8,998
"خوزستان","بندر_ماهشهر","مرکزی",31,374,44,11,367,796,6,802
"خوزستان","بندر_ماهشهر","مرکزی",32,593,51,6,579,1229,20,1249
"خوزستان","بندر_ماهشهر","مرکزی",33,979,73,12,298,1362,13,1375
"خوزستان","بندر_ماهشهر","مرکزی",34,848,76,12,582,1518,19,1537
"خوزستان","بندر_ماهشهر","مرکزی",35,470,42,4,426,942,15,957
"خوزستان","بندر_ماهشهر","مرکزی",36,967,52,6,533,1558,20,1578
"خوزستان","بندر_ماهشهر","مرکزی",37,570,20,3,210,803,8,811
"خوزستان","بندر_ماهشهر","مرکزی",38,901,53,10,582,1546,15,1561
"خوزستان","بندر_ماهشهر","مرکزی",39,831,50,26,852,1759,31,1790
"خوزستان","بندر_ماهشهر","مرکزی",40,378,31,0,34,443,1,444
"خوزستان","بندر_ماهشهر","مرکزی",41,470,15,5,166,656,11,667
"خوزستان","بندر_ماهشهر","مرکزی",42,698,45,4,455,1202,12,1214
"خوزستان","بندر_ماهشهر","مرکزی",43,821,87,18,656,1582,19,1601
"خوزستان","بندر_ماهشهر","مرکزی",44,243,38,8,231,520,8,528
"خوزستان","بندر_ماهشهر","مرکزی",45,282,51,6,508,847,17,864
"خوزستان","بندر_ماهشهر","مرکزی",46,262,29,5,271,567,8,575
"خوزستان","بندر_ماهشهر","مرکزی",47,347,46,24,874,1291,20,1311
"خوزستان","بندر_ماهشهر","مرکزی",48,196,41,13,435,685,4,689
"خوزستان","بندر_ماهشهر","مرکزی",49,286,56,10,664,1016,11,1027
"خوزستان","بندر_ماهشهر","مرکزی",50,404,68,20,801,1293,22,1315
"خوزستان","بندر_ماهشهر","مرکزی",51,243,49,26,813,1131,16,1147
"خوزستان","بندر_ماهشهر","مرکزی",52,543,8,2,39,592,6,598
"خوزستان","بندر_ماهشهر","مرکزی",53,1147,8,6,120,1281,18,1299
"خوزستان","بندر_ماهشهر","مرکزی",54,846,10,3,81,940,9,949
"خوزستان","بندر_ماهشهر","مرکزی",55,1170,13,8,163,1354,16,1370
"خوزستان","بندر_ماهشهر","مرکزی",56,1038,3,2,126,1169,11,1180
"خوزستان","بندر_ماهشهر","مرکزی",57,788,12,3,119,922,8,930
"خوزستان","بندر_ماهشهر","مرکزی",58,764,8,3,80,855,13,868
"خوزستان","بندر_ماهشهر","مرکزی",59,748,3,1,42,794,8,802
"خوزستان","بندر_ماهشهر","مرکزی",60,995,12,2,122,1131,15,1146
"خوزستان","بندر_ماهشهر","مرکزی",61,769,12,7,117,905,10,915
"خوزستان","بندر_ماهشهر","مرکزی",62,1041,8,3,107,1159,25,1184
"خوزستان","بندر_ماهشهر","مرکزی",63,1160,4,6,99,1269,20,1289
"خوزستان","بندر_ماهشهر","مرکزی",64,867,8,1,43,919,6,925
"خوزستان","بندر_ماهشهر","مرکزی",65,581,7,2,53,643,12,655
"خوزستان","بندر_ماهشهر","مرکزی",66,878,4,5,73,960,13,973
"خوزستان","بندر_ماهشهر","مرکزی",67,715,65,6,390,1176,23,1199
"خوزستان","بندر_ماهشهر","مرکزی",68,675,37,2,241,955,8,963
"خوزستان","بندر_ماهشهر","مرکزی",69,1372,56,18,331,1777,21,1798
"خوزستان","بندر_ماهشهر","مرکزی",70,431,28,13,276,748,12,760
"خوزستان","بندر_ماهشهر","مرکزی",71,1104,67,9,228,1408,16,1424
"خوزستان","بندر_ماهشهر","مرکزی",72,692,16,1,121,830,15,845
"خوزستان","بندر_ماهشهر","مرکزی",73,327,29,4,150,510,12,522
"خوزستان","بندر_ماهشهر","مرکزی",74,537,109,17,916,1579,21,1600
"خوزستان","بندر_ماهشهر","مرکزی",75,332,93,36,1117,1578,21,1599
"خوزستان","بندر_ماهشهر","مرکزی",76,323,70,19,722,1134,10,1144
"خوزستان","بندر_ماهشهر","مرکزی",77,183,52,3,556,794,6,800
"خوزستان","بندر_ماهشهر","مرکزی",78,163,36,3,190,392,7,399
"خوزستان","بندر_ماهشهر","مرکزی",79,196,2,0,53,251,6,257
"خوزستان","بندر_ماهشهر","مرکزی",80,206,6,2,121,335,0,335
"خوزستان","بندر_ماهشهر","مرکزی",81,254,11,3,116,384,6,390
"خوزستان","بندر_ماهشهر","مرکزی",82,191,17,6,79,293,2,295
"خوزستان","بندر_ماهشهر","مرکزی",83,287,31,5,171,494,16,510
"خوزستان","بندر_ماهشهر","مرکزی",84,348,3,1,29,381,0,381
"خوزستان","بندر_ماهشهر","مرکزی",85,284,4,0,19,307,2,309
"خوزستان","بندر_ماهشهر","مرکزی",86,775,7,3,74,859,19,878
"خوزستان","بندر_ماهشهر","مرکزی",87,294,1,1,37,333,0,333
"خوزستان","بندر_ماهشهر","مرکزی",88,677,9,3,58,747,7,754
"خوزستان","بندر_ماهشهر","مرکزی",89,271,6,10,69,356,3,359
"خوزستان","بندر_ماهشهر","مرکزی",90,332,12,0,22,366,1,367
"خوزستان","بندر_ماهشهر","مرکزی",91,322,4,0,18,344,3,347
"خوزستان","بندر_ماهشهر","مرکزی",92,233,0,0,8,241,0,241
"خوزستان","بندر_ماهشهر","مرکزی",93,146,3,0,7,156,0,156
"خوزستان","بندر_ماهشهر","مرکزی",94,57,0,1,33,91,0,91
"خوزستان","بندر_ماهشهر","مرکزی",95,359,5,2,16,382,3,385
"خوزستان","بندر_ماهشهر","مرکزی",96,423,6,0,17,446,0,446
"خوزستان","بندر_ماهشهر","مرکزی",97,171,2,2,11,186,1,187
"خوزستان","بندر_ماهشهر","مرکزی",98,149,0,0,13,162,0,162
"خوزستان","بندر_ماهشهر","مرکزی",99,150,1,0,11,162,0,162
"خوزستان","بندر_ماهشهر","بندر_اما_خمینی",1,594,38,15,327,974,11,985
"خوزستان","بندر_ماهشهر","بندر_اما_خمینی",2,633,39,17,520,1209,23,1232
"خوزستان","بندر_ماهشهر","بندر_اما_خمینی",3,505,42,32,603,1182,15,1197
"خوزستان","بندر_ماهشهر","بندر_اما_خمینی",4,659,44,15,511,1229,31,1260
"خوزستان","بندر_ماهشهر","بندر_اما_خمینی",5,958,25,9,328,1320,29,1349
"خوزستان","بندر_ماهشهر","بندر_اما_خمینی",6,616,26,6,284,932,10,942
"خوزستان","بندر_ماهشهر","بندر_اما_خمینی",7,856,21,8,225,1110,18,1128
"خوزستان","بندر_ماهشهر","بندر_اما_خمینی",8,961,19,7,250,1237,23,1260
"خوزستان","بندر_ماهشهر","بندر_اما_خمینی",9,970,43,15,315,1343,17,1360
"خوزستان","بندر_ماهشهر","بندر_اما_خمینی",10,1204,45,15,429,1693,31,1724
"خوزستان","بندر_ماهشهر","بندر_اما_خمینی",11,751,27,8,302,1088,11,1099
"خوزستان","بندر_ماهشهر","بندر_اما_خمینی",12,925,25,5,339,1294,8,1302
"خوزستان","بندر_ماهشهر","بندر_اما_خمینی",13,1215,23,12,271,1521,25,1546
"خوزستان","بندر_ماهشهر","بندر_اما_خمینی",14,791,20,13,212,1036,12,1048
"خوزستان","بندر_ماهشهر","بندر_اما_خمینی",15,637,30,18,388,1073,17,1090
"خوزستان","بندر_ماهشهر","بندر_اما_خمینی",16,526,12,6,106,650,19,669
"خوزستان","بندر_ماهشهر","بندر_اما_خمینی",17,1101,8,10,155,1274,22,1296
"خوزستان","بندر_ماهشهر","بندر_اما_خمینی",18,854,31,34,792,1711,36,1747
"خوزستان","بندر_ماهشهر","بندر_اما_خمینی",19,819,33,50,727,1629,24,1653
"خوزستان","بندر_ماهشهر","بندر_اما_خمینی",20,804,38,16,673,1531,15,1546
"خوزستان","بندر_ماهشهر","بندر_اما_خمینی",21,917,40,16,559,1532,15,1547
"خوزستان","بندر_ماهشهر","بندر_اما_خمینی",22,422,48,21,649,1140,17,1157
"خوزستان","بندر_ماهشهر","بندر_اما_خمینی",23,330,6,4,58,398,8,406
"خوزستان","بندر_ماهشهر","بندر_اما_خمینی",24,295,48,4,327,674,11,685
"خوزستان","بندر_ماهشهر","بندر_اما_خمینی",25,629,20,12,229,890,9,899
"خوزستان","بهبهان","مرکزی",1,521,23,11,565,1120,10,1130
"خوزستان","بهبهان","مرکزی",2,407,19,24,539,989,11,1000
"خوزستان","بهبهان","مرکزی",3,372,22,17,988,1399,18,1417
"خوزستان","بهبهان","مرکزی",4,332,21,5,642,1000,23,1023
"خوزستان","بهبهان","مرکزی",5,293,16,8,780,1097,18,1115
"خوزستان","بهبهان","مرکزی",6,232,2,4,329,567,6,573
"خوزستان","بهبهان","مرکزی",7,493,9,18,861,1381,26,1407
"خوزستان","بهبهان","مرکزی",8,458,28,6,582,1074,25,1099
"خوزستان","بهبهان","مرکزی",9,399,18,8,558,983,12,995
"خوزستان","بهبهان","مرکزی",10,460,28,19,781,1288,30,1318
"خوزستان","بهبهان","مرکزی",11,480,25,29,679,1213,22,1235
"خوزستان","بهبهان","مرکزی",12,532,13,17,371,933,21,954
"خوزستان","بهبهان","مرکزی",13,499,14,19,358,890,18,908
"خوزستان","بهبهان","مرکزی",14,417,14,12,535,978,22,1000
"خوزستان","بهبهان","مرکزی",15,694,21,15,989,1719,25,1744
"خوزستان","بهبهان","مرکزی",16,337,22,14,779,1152,24,1176
"خوزستان","بهبهان","مرکزی",17,444,24,13,729,1210,27,1237
"خوزستان","بهبهان","مرکزی",18,650,18,10,417,1095,20,1115
"خوزستان","بهبهان","مرکزی",19,316,12,10,524,862,12,874
"خوزستان","بهبهان","مرکزی",20,511,16,5,537,1069,21,1090
"خوزستان","بهبهان","مرکزی",21,423,30,8,658,1119,21,1140
"خوزستان","بهبهان","مرکزی",22,382,22,8,605,1017,20,1037
"خوزستان","بهبهان","مرکزی",23,362,20,7,588,977,22,999
"خوزستان","بهبهان","مرکزی",24,392,17,4,806,1219,26,1245
"خوزستان","بهبهان","مرکزی",25,442,25,6,643,1116,25,1141
"خوزستان","بهبهان","مرکزی",26,282,6,5,455,748,5,753
"خوزستان","بهبهان","مرکزی",27,363,17,8,604,992,27,1019
"خوزستان","بهبهان","مرکزی",28,315,20,3,399,737,13,750
"خوزستان","بهبهان","مرکزی",29,238,0,2,263,503,9,512
"خوزستان","بهبهان","مرکزی",30,218,14,6,511,749,13,762
"خوزستان","بهبهان","مرکزی",31,245,7,6,396,654,14,668
"خوزستان","بهبهان","مرکزی",32,309,14,14,426,763,16,779
"خوزستان","بهبهان","مرکزی",33,200,18,6,376,600,14,614
"خوزستان","بهبهان","مرکزی",34,366,14,12,599,991,18,1009
"خوزستان","بهبهان","مرکزی",35,150,6,1,278,435,12,447
"خوزستان","بهبهان","مرکزی",36,384,11,9,612,1016,14,1030
"خوزستان","بهبهان","مرکزی",37,453,13,12,660,1138,27,1165
"خوزستان","بهبهان","مرکزی",38,190,16,10,792,1008,12,1020
"خوزستان","بهبهان","مرکزی",39,296,18,11,682,1007,19,1026
"خوزستان","بهبهان","مرکزی",40,470,29,10,741,1250,29,1279
"خوزستان","بهبهان","مرکزی",41,285,9,6,499,799,21,820
"خوزستان","بهبهان","مرکزی",42,235,18,7,630,890,19,909
"خوزستان","بهبهان","مرکزی",43,450,21,15,867,1353,23,1376
"خوزستان","بهبهان","مرکزی",44,518,21,10,692,1241,20,1261
"خوزستان","بهبهان","مرکزی",45,356,26,10,776,1168,12,1180
"خوزستان","بهبهان","مرکزی",46,251,16,6,719,992,19,1011
"خوزستان","بهبهان","مرکزی",47,231,24,18,502,775,16,791
"خوزستان","بهبهان","مرکزی",48,252,13,7,712,984,25,1009
"خوزستان","بهبهان","مرکزی",49,118,3,2,178,301,7,308
"خوزستان","بهبهان","مرکزی",50,306,10,6,504,826,14,840
"خوزستان","بهبهان","مرکزی",51,513,16,36,259,824,9,833
"خوزستان","بهبهان","مرکزی",52,299,22,23,1014,1358,18,1376
"خوزستان","بهبهان","مرکزی",53,225,24,9,752,1010,26,1036
"خوزستان","بهبهان","مرکزی",54,279,6,9,558,852,20,872
"خوزستان","بهبهان","مرکزی",55,361,19,8,891,1279,36,1315
"خوزستان","بهبهان","مرکزی",56,120,9,3,123,255,9,264
"خوزستان","بهبهان","مرکزی",57,122,12,7,114,255,17,272
"خوزستان","بهبهان","مرکزی",58,466,4,0,51,521,4,525
"خوزستان","بهبهان","مرکزی",59,224,4,2,65,295,4,299
"خوزستان","بهبهان","مرکزی",60,803,11,4,225,1043,5,1048
"خوزستان","بهبهان","مرکزی",61,442,2,1,114,559,7,566
"خوزستان","بهبهان","مرکزی",62,315,23,0,169,507,4,511
"خوزستان","بهبهان","مرکزی",63,302,8,0,107,417,7,424
"خوزستان","بهبهان","مرکزی",64,14,1,1,19,35,0,35
"خوزستان","بهبهان","مرکزی",65,64,2,3,76,145,2,147
"خوزستان","بهبهان","مرکزی",66,639,18,3,398,1058,26,1084
"خوزستان","بهبهان","مرکزی",67,511,11,1,293,816,16,832
"خوزستان","بهبهان","مرکزی",68,332,8,4,288,632,13,645
"خوزستان","بهبهان","مرکزی",69,414,7,0,205,626,12,638
"خوزستان","بهبهان","مرکزی",70,722,5,32,310,1069,13,1082
"خوزستان","بهبهان","مرکزی",71,491,13,5,187,696,13,709
"خوزستان","بهبهان","مرکزی",72,585,19,0,290,894,18,912
"خوزستان","بهبهان","مرکزی",73,591,15,4,222,832,15,847
"خوزستان","بهبهان","مرکزی",74,662,20,3,209,894,17,911
"خوزستان","بهبهان","مرکزی",75,569,24,1,143,737,15,752
"خوزستان","بهبهان","مرکزی",76,730,10,12,181,933,18,951
"خوزستان","بهبهان","مرکزی",77,695,10,2,129,836,7,843
"خوزستان","بهبهان","مرکزی",78,316,12,7,156,491,4,495
"خوزستان","بهبهان","مرکزی",79,171,4,2,91,268,1,269
"خوزستان","بهبهان","مرکزی",80,172,1,2,123,298,7,305
"خوزستان","بهبهان","تشان",1,635,10,2,257,904,7,911
"خوزستان","بهبهان","تشان",2,354,2,4,252,612,7,619
"خوزستان","بهبهان","تشان",3,163,9,3,323,498,7,505
"خوزستان","بهبهان","تشان",4,310,24,13,380,727,16,743
"خوزستان","بهبهان","تشان",5,504,4,3,148,659,11,670
"خوزستان","بهبهان","تشان",6,425,21,3,174,623,7,630
"خوزستان","بهبهان","تشان",7,484,13,8,310,815,14,829
"خوزستان","بهبهان","تشان",8,293,8,0,119,420,8,428
"خوزستان","بهبهان","تشان",9,148,9,0,70,227,2,229
"خوزستان","بهبهان","تشان",10,200,16,1,306,523,6,529
"خوزستان","بهبهان","تشان",11,365,3,1,90,459,8,467
"خوزستان","بهبهان","تشان",12,125,0,0,27,152,3,155
"خوزستان","بهبهان","تشان",13,227,0,1,141,369,5,374
"خوزستان","بهبهان","تشان",14,158,2,4,50,214,2,216
"خوزستان","بهبهان","تشان",15,343,16,0,158,517,6,523
"خوزستان","بهبهان","آغاجاری",1,792,17,12,157,978,22,1000
"خوزستان","بهبهان","آغاجاری",2,597,15,5,201,818,31,849
"خوزستان","بهبهان","آغاجاری",3,361,3,0,86,450,7,457
"خوزستان","بهبهان","آغاجاری",4,368,5,3,126,502,12,514
"خوزستان","بهبهان","آغاجاری",5,443,7,4,123,577,8,585
"خوزستان","بهبهان","آغاجاری",6,749,20,4,223,996,15,1011
"خوزستان","بهبهان","آغاجاری",7,417,2,1,61,481,7,488
"خوزستان","بهبهان","آغاجاری",8,542,6,4,122,674,10,684
"خوزستان","بهبهان","آغاجاری",9,389,5,4,217,615,5,620
"خوزستان","بهبهان","آغاجاری",10,401,12,4,128,545,24,569
"خوزستان","بهبهان","آغاجاری",11,379,0,1,48,428,10,438
"خوزستان","بهبهان","آغاجاری",12,214,1,1,69,285,3,288
"خوزستان","بهبهان","زیدون",1,602,6,2,343,953,13,966
"خوزستان","بهبهان","زیدون",2,524,19,6,292,841,9,850
"خوزستان","بهبهان","زیدون",3,517,9,4,304,834,13,847
"خوزستان","بهبهان","زیدون",4,221,7,3,215,446,7,453
"خوزستان","بهبهان","زیدون",5,295,4,3,196,498,3,501
"خوزستان","بهبهان","زیدون",6,364,16,3,309,692,5,697
"خوزستان","بهبهان","زیدون",7,358,14,1,143,516,4,520
"خوزستان","بهبهان","زیدون",8,224,9,0,110,343,7,350
"خوزستان","بهبهان","زیدون",9,235,2,3,108,348,5,353
"خوزستان","بهبهان","زیدون",10,392,3,2,192,589,2,591
"خوزستان","بهبهان","زیدون",11,249,8,5,149,411,6,417
"خوزستان","بهبهان","زیدون",12,231,16,2,102,351,5,356
"خوزستان","بهبهان","زیدون",13,356,12,3,158,529,6,535
"خوزستان","بهبهان","زیدون",14,627,3,2,86,718,6,724
"خوزستان","بهبهان","زیدون",15,526,11,3,153,693,7,700
"خوزستان","خرمشهر","مرکزی",1,579,8,2,87,676,14,690
"خوزستان","خرمشهر","مرکزی",2,487,15,0,88,590,10,600
"خوزستان","خرمشهر","مرکزی",3,1132,17,3,192,1344,19,1363
"خوزستان","خرمشهر","مرکزی",4,874,3,1,81,959,18,977
"خوزستان","خرمشهر","مرکزی",5,576,12,2,119,709,6,715
"خوزستان","خرمشهر","مرکزی",6,792,30,16,336,1174,24,1198
"خوزستان","خرمشهر","مرکزی",7,469,13,8,253,743,5,748
"خوزستان","خرمشهر","مرکزی",8,779,12,13,208,1012,17,1029
"خوزستان","خرمشهر","مرکزی",9,864,41,11,261,1177,18,1195
"خوزستان","خرمشهر","مرکزی",10,771,23,8,230,1032,10,1042
"خوزستان","خرمشهر","مرکزی",11,353,23,11,188,575,10,585
"خوزستان","خرمشهر","مرکزی",12,434,12,2,136,584,15,599
"خوزستان","خرمشهر","مرکزی",13,469,31,8,348,856,22,878
"خوزستان","خرمشهر","مرکزی",14,692,29,11,303,1035,14,1049
"خوزستان","خرمشهر","مرکزی",15,497,18,10,276,801,17,818
"خوزستان","خرمشهر","مرکزی",16,476,22,0,184,682,7,689
"خوزستان","خرمشهر","مرکزی",17,561,7,11,238,817,8,825
"خوزستان","خرمشهر","مرکزی",18,478,10,5,150,643,13,656
"خوزستان","خرمشهر","مرکزی",19,1002,21,13,239,1275,22,1297
"خوزستان","خرمشهر","مرکزی",20,270,24,1,170,465,11,476
"خوزستان","خرمشهر","مرکزی",21,530,27,11,240,808,21,829
"خوزستان","خرمشهر","مرکزی",22,325,13,3,176,517,13,530
"خوزستان","خرمشهر","مرکزی",23,406,10,1,148,565,10,575
"خوزستان","خرمشهر","مرکزی",24,550,5,0,119,674,12,686
"خوزستان","خرمشهر","مرکزی",25,835,7,8,113,963,10,973
"خوزستان","خرمشهر","مرکزی",26,251,11,3,132,397,8,405
"خوزستان","خرمشهر","مرکزی",27,542,19,3,206,770,10,780
"خوزستان","خرمشهر","مرکزی",28,480,27,10,317,834,23,857
"خوزستان","خرمشهر","مرکزی",29,612,28,15,327,982,17,999
"خوزستان","خرمشهر","مرکزی",30,225,8,3,103,339,7,346
"خوزستان","خرمشهر","مرکزی",31,930,20,13,239,1202,28,1230
"خوزستان","خرمشهر","مرکزی",32,682,18,12,247,959,20,979
"خوزستان","خرمشهر","مرکزی",33,872,9,7,201,1089,14,1103
"خوزستان","خرمشهر","مرکزی",34,929,42,18,280,1269,20,1289
"خوزستان","خرمشهر","مرکزی",35,889,19,18,245,1171,19,1190
"خوزستان","خرمشهر","مرکزی",36,833,16,13,261,1123,13,1136
"خوزستان","خرمشهر","مرکزی",37,580,10,10,185,785,13,798
"خوزستان","خرمشهر","مرکزی",38,904,37,15,293,1249,16,1265
"خوزستان","خرمشهر","مرکزی",39,797,21,3,221,1042,10,1052
"خوزستان","خرمشهر","مرکزی",40,516,12,6,182,716,12,728
"خوزستان","خرمشهر","مرکزی",41,1139,11,6,78,1234,35,1269
"خوزستان","خرمشهر","مرکزی",42,711,18,12,248,989,9,998
"خوزستان","خرمشهر","مرکزی",43,559,9,3,113,684,9,693
"خوزستان","خرمشهر","مرکزی",44,679,9,2,96,786,16,802
"خوزستان","خرمشهر","مرکزی",45,618,15,7,133,773,0,773
"خوزستان","خرمشهر","مرکزی",46,320,3,4,48,375,9,384
"خوزستان","خرمشهر","مرکزی",47,710,6,5,213,934,35,969
"خوزستان","خرمشهر","مرکزی",48,635,15,3,143,796,5,801
"خوزستان","خرمشهر","مرکزی",49,253,3,0,46,302,0,302
"خوزستان","خرمشهر","مرکزی",50,586,6,4,60,656,5,661
"خوزستان","خرمشهر","مرکزی",51,518,1,3,29,551,8,559
"خوزستان","خرمشهر","مرکزی",52,809,14,4,121,948,10,958
"خوزستان","خرمشهر","مرکزی",53,441,1,4,52,498,10,508
"خوزستان","خرمشهر","مرکزی",54,696,9,6,104,815,19,834
"خوزستان","خرمشهر","مرکزی",55,709,9,5,109,832,6,838
"خوزستان","خرمشهر","مرکزی",56,893,16,3,68,980,15,995
"خوزستان","خرمشهر","مرکزی",57,780,28,6,231,1045,18,1063
"خوزستان","خرمشهر","مرکزی",58,822,18,4,168,1012,0,1012
"خوزستان","خرمشهر","مرکزی",59,411,12,5,179,607,12,619
"خوزستان","خرمشهر","مرکزی",60,720,9,2,90,821,18,839
"خوزستان","خرمشهر","مرکزی",61,318,9,1,146,474,8,482
"خوزستان","خرمشهر","مرکزی",62,407,24,5,199,635,18,653
"خوزستان","خرمشهر","مرکزی",63,348,3,3,84,438,13,451
"خوزستان","خرمشهر","مرکزی",64,508,29,8,173,718,15,733
"خوزستان","خرمشهر","مرکزی",65,310,6,2,88,406,15,421
"خوزستان","خرمشهر","مرکزی",66,940,7,3,95,1045,12,1057
"خوزستان","خرمشهر","مرکزی",67,683,4,2,35,724,5,729
"خوزستان","خرمشهر","مرکزی",68,668,3,1,61,733,2,735
"خوزستان","خرمشهر","مرکزی",69,778,5,5,39,827,11,838
"خوزستان","خرمشهر","مرکزی",70,561,17,2,36,616,13,629
"خوزستان","خرمشهر","مرکزی",71,466,9,1,57,533,6,539
"خوزستان","خرمشهر","مرکزی",72,791,2,2,33,828,9,837
"خوزستان","خرمشهر","مرکزی",73,598,2,1,67,668,3,671
"خوزستان","خرمشهر","مرکزی",74,277,1,0,24,302,7,309
"خوزستان","خرمشهر","مرکزی",75,440,6,1,70,517,5,522
"خوزستان","خرمشهر","مرکزی",76,505,2,2,52,561,4,565
"خوزستان","خرمشهر","مرکزی",77,520,3,0,51,574,8,582
"خوزستان","خرمشهر","مرکزی",78,307,4,3,16,330,3,333
"خوزستان","خرمشهر","مرکزی",79,399,6,5,52,462,8,470
"خوزستان","خرمشهر","مرکزی",80,719,8,1,67,795,14,809
"خوزستان","خرمشهر","مرکزی",81,670,4,1,62,737,5,742
"خوزستان","خرمشهر","مرکزی",82,98,8,0,10,116,1,117
"خوزستان","خرمشهر","مرکزی",83,274,26,5,151,456,10,466
"خوزستان","خرمشهر","مینو",1,972,5,5,102,1084,7,1091
"خوزستان","خرمشهر","مینو",2,647,5,1,44,697,8,705
"خوزستان","خرمشهر","مینو",3,501,3,0,71,575,17,592
"خوزستان","خرمشهر","مینو",4,447,4,1,31,483,7,490
"خوزستان","خرمشهر","مینو",5,223,2,0,16,241,2,243
"خوزستان","خرمشهر","مینو",6,356,12,1,40,409,4,413
"خوزستان","خرمشهر","مینو",7,288,1,0,11,300,2,302
"خوزستان","خرمشهر","مینو",8,357,2,0,26,385,5,390
"خوزستان","دزفول","مرکزی",1,278,25,9,278,590,8,598
"خوزستان","دزفول","مرکزی",2,549,27,14,296,886,24,910
"خوزستان","دزفول","مرکزی",3,504,22,8,174,708,9,717
"خوزستان","دزفول","مرکزی",4,702,36,9,440,1187,19,1206
"خوزستان","دزفول","مرکزی",5,609,19,5,180,813,10,823
"خوزستان","دزفول","مرکزی",6,644,22,7,213,886,13,899
"خوزستان","دزفول","مرکزی",7,157,48,4,189,398,8,406
"خوزستان","دزفول","مرکزی",8,114,11,8,114,247,6,253
"خوزستان","دزفول","مرکزی",9,508,43,13,383,947,17,964
"خوزستان","دزفول","مرکزی",10,485,29,9,255,778,14,792
"خوزستان","دزفول","مرکزی",11,369,46,10,410,835,19,854
"خوزستان","دزفول","مرکزی",12,315,22,2,142,481,9,490
"خوزستان","دزفول","مرکزی",13,644,58,25,469,1196,24,1220
"خوزستان","دزفول","مرکزی",14,215,11,1,75,302,4,306
"خوزستان","دزفول","مرکزی",15,750,83,10,256,1099,16,1115
"خوزستان","دزفول","مرکزی",16,728,28,2,126,884,12,896
"خوزستان","دزفول","مرکزی",17,401,23,14,167,605,14,619
"خوزستان","دزفول","مرکزی",18,611,21,6,189,827,9,836
"خوزستان","دزفول","مرکزی",19,390,24,5,101,520,12,532
"خوزستان","دزفول","مرکزی",20,158,6,0,36,200,2,202
"خوزستان","دزفول","مرکزی",21,790,37,2,138,967,16,983
"خوزستان","دزفول","مرکزی",22,378,30,0,71,479,5,484
"خوزستان","دزفول","مرکزی",23,800,49,5,61,915,12,927
"خوزستان","دزفول","مرکزی",24,551,65,8,481,1105,22,1127
"خوزستان","دزفول","مرکزی",25,626,62,2,295,985,28,1013
"خوزستان","دزفول","مرکزی",26,626,35,5,226,892,17,909
"خوزستان","دزفول","مرکزی",27,345,22,3,147,517,13,530
"خوزستان","دزفول","مرکزی",28,211,24,1,113,349,9,358
"خوزستان","دزفول","مرکزی",29,814,64,5,356,1239,36,1275
"خوزستان","دزفول","مرکزی",30,274,39,1,226,540,11,551
"خوزستان","دزفول","مرکزی",31,1214,110,19,460,1803,47,1850
"خوزستان","دزفول","مرکزی",32,1089,210,3,268,1570,18,1588
"خوزستان","دزفول","مرکزی",33,385,37,9,442,873,26,899
"خوزستان","دزفول","مرکزی",34,400,17,8,258,683,8,691
"خوزستان","دزفول","مرکزی",35,402,23,6,290,721,18,739
"خوزستان","دزفول","مرکزی",36,413,39,7,430,889,29,918
"خوزستان","دزفول","مرکزی",37,1044,150,11,259,1464,15,1479
"خوزستان","دزفول","مرکزی",38,370,99,8,259,736,10,746
"خوزستان","دزفول","مرکزی",39,345,40,8,299,692,21,713
"خوزستان","دزفول","مرکزی",40,377,23,1,294,695,16,711
"خوزستان","دزفول","مرکزی",41,421,37,5,312,775,20,795
"خوزستان","دزفول","مرکزی",42,419,22,3,249,693,26,719
"خوزستان","دزفول","مرکزی",43,383,22,6,219,630,27,657
"خوزستان","دزفول","مرکزی",44,836,101,3,560,1500,23,1523
"خوزستان","دزفول","مرکزی",45,862,68,6,303,1239,31,1270
"خوزستان","دزفول","مرکزی",46,361,41,6,264,672,24,696
"خوزستان","دزفول","مرکزی",47,759,79,10,465,1313,29,1342
"خوزستان","دزفول","مرکزی",48,468,69,7,295,839,8,847
"خوزستان","دزفول","مرکزی",49,382,39,8,190,619,15,634
"خوزستان","دزفول","مرکزی",50,536,61,9,277,883,22,905
"خوزستان","دزفول","مرکزی",51,529,39,2,242,812,6,818
"خوزستان","دزفول","مرکزی",52,520,30,6,429,985,13,998
"خوزستان","دزفول","مرکزی",53,395,44,11,501,951,38,989
"خوزستان","دزفول","مرکزی",54,456,44,10,400,910,27,937
"خوزستان","دزفول","مرکزی",55,460,26,2,231,719,18,737
"خوزستان","دزفول","مرکزی",56,512,32,10,426,980,23,1003
"خوزستان","دزفول","مرکزی",57,444,29,6,336,815,23,838
"خوزستان","دزفول","مرکزی",58,171,18,2,217,408,17,425
"خوزستان","دزفول","مرکزی",59,303,27,5,349,684,16,700
"خوزستان","دزفول","مرکزی",60,332,16,3,282,633,18,651
"خوزستان","دزفول","مرکزی",61,240,20,4,399,663,19,682
"خوزستان","دزفول","مرکزی",62,115,12,0,196,323,10,333
"خوزستان","دزفول","مرکزی",63,525,52,15,337,929,31,960
"خوزستان","دزفول","مرکزی",64,605,24,4,272,905,15,920
"خوزستان","دزفول","مرکزی",65,268,9,2,293,572,13,585
"خوزستان","دزفول","مرکزی",66,207,14,4,237,462,11,473
"خوزستان","دزفول","مرکزی",67,492,24,3,215,734,9,743
"خوزستان","دزفول","مرکزی",68,780,38,8,204,1030,23,1053
"خوزستان","دزفول","مرکزی",69,151,9,2,86,248,5,253
"خوزستان","دزفول","مرکزی",70,422,65,9,356,852,22,874
"خوزستان","دزفول","مرکزی",71,456,24,6,236,722,10,732
"خوزستان","دزفول","مرکزی",72,300,30,1,216,547,18,565
"خوزستان","دزفول","مرکزی",73,514,32,2,285,833,17,850
"خوزستان","دزفول","مرکزی",74,664,41,8,291,1004,24,1028
"خوزستان","دزفول","مرکزی",75,503,20,3,152,678,6,684
"خوزستان","دزفول","مرکزی",76,465,43,6,488,1002,27,1029
"خوزستان","دزفول","مرکزی",77,303,27,2,294,626,13,639
"خوزستان","دزفول","مرکزی",78,627,42,5,280,954,26,980
"خوزستان","دزفول","مرکزی",79,206,112,2,39,359,4,363
"خوزستان","دزفول","مرکزی",80,265,35,2,33,335,4,339
"خوزستان","دزفول","مرکزی",81,713,116,3,38,870,6,876
"خوزستان","دزفول","مرکزی",82,838,584,24,85,1531,26,1557
"خوزستان","دزفول","مرکزی",83,353,112,3,45,513,3,516
"خوزستان","دزفول","مرکزی",84,506,249,10,95,860,11,871
"خوزستان","دزفول","مرکزی",85,354,62,1,27,444,2,446
"خوزستان","دزفول","مرکزی",86,671,138,3,44,856,6,862
"خوزستان","دزفول","مرکزی",87,910,152,8,24,1094,4,1098
"خوزستان","دزفول","مرکزی",88,540,122,2,16,680,4,684
"خوزستان","دزفول","مرکزی",89,764,173,4,24,965,14,979
"خوزستان","دزفول","مرکزی",90,595,150,6,22,773,9,782
"خوزستان","دزفول","مرکزی",91,406,72,6,28,512,6,518
"خوزستان","دزفول","مرکزی",92,539,354,15,39,947,10,957
"خوزستان","دزفول","مرکزی",93,693,379,19,67,1158,21,1179
"خوزستان","دزفول","مرکزی",94,385,244,3,35,667,3,670
"خوزستان","دزفول","مرکزی",95,375,237,11,33,656,11,667
"خوزستان","دزفول","مرکزی",96,143,30,2,169,344,7,351
"خوزستان","دزفول","مرکزی",97,641,76,5,359,1081,18,1099
"خوزستان","دزفول","مرکزی",98,693,42,3,261,999,19,1018
"خوزستان","دزفول","مرکزی",99,360,45,6,405,816,24,840
"خوزستان","دزفول","مرکزی",100,428,27,3,454,912,24,936
"خوزستان","دزفول","مرکزی",101,434,65,9,508,1016,22,1038
"خوزستان","دزفول","مرکزی",102,547,51,4,443,1045,22,1067
"خوزستان","دزفول","مرکزی",103,720,89,11,563,1383,31,1414
"خوزستان","دزفول","مرکزی",104,545,69,9,409,1032,14,1046
"خوزستان","دزفول","مرکزی",105,509,56,0,363,928,20,948
"خوزستان","دزفول","مرکزی",106,432,21,4,318,775,25,800
"خوزستان","دزفول","مرکزی",107,242,11,0,273,526,18,544
"خوزستان","دزفول","مرکزی",108,212,14,4,183,413,9,422
"خوزستان","دزفول","مرکزی",109,308,31,13,757,1109,1,1110
"خوزستان","دزفول","مرکزی",110,188,6,2,86,282,9,291
"خوزستان","دزفول","مرکزی",111,588,57,3,418,1066,29,1095
"خوزستان","دزفول","مرکزی",112,407,29,3,283,722,10,732
"خوزستان","دزفول","مرکزی",113,221,6,1,163,391,10,401
"خوزستان","دزفول","مرکزی",114,497,27,8,255,787,19,806
"خوزستان","دزفول","مرکزی",115,189,10,1,69,269,2,271
"خوزستان","دزفول","مرکزی",116,295,40,9,197,541,19,560
"خوزستان","دزفول","مرکزی",117,233,12,6,122,373,11,384
"خوزستان","دزفول","مرکزی",118,131,12,3,68,214,1,215
"خوزستان","دزفول","مرکزی",119,256,9,0,112,377,15,392
"خوزستان","دزفول","مرکزی",120,303,18,9,177,507,17,524
"خوزستان","دزفول","مرکزی",121,298,11,2,202,513,16,529
"خوزستان","دزفول","مرکزی",122,570,19,2,315,906,18,924
"خوزستان","دزفول","مرکزی",123,638,18,4,264,924,11,935
"خوزستان","دزفول","مرکزی",124,230,14,0,161,405,3,408
"خوزستان","دزفول","مرکزی",125,396,21,11,401,829,18,847
"خوزستان","دزفول","مرکزی",126,472,17,7,311,807,22,829
"خوزستان","دزفول","مرکزی",127,436,22,2,249,709,17,726
"خوزستان","دزفول","مرکزی",128,647,26,9,269,951,20,971
"خوزستان","دزفول","مرکزی",129,407,31,2,217,657,9,666
"خوزستان","دزفول","مرکزی",130,491,11,3,168,673,17,690
"خوزستان","دزفول","مرکزی",131,526,18,5,116,665,9,674
"خوزستان","دزفول","مرکزی",132,894,17,7,160,1078,14,1092
"خوزستان","دزفول","مرکزی",133,559,26,4,200,789,11,800
"خوزستان","دزفول","مرکزی",134,696,12,1,149,858,9,867
"خوزستان","دزفول","مرکزی",135,407,14,2,113,536,5,541
"خوزستان","دزفول","مرکزی",136,651,35,1,244,931,15,946
"خوزستان","دزفول","مرکزی",137,746,33,7,259,1045,26,1071
"خوزستان","دزفول","مرکزی",138,368,9,6,162,545,12,557
"خوزستان","دزفول","مرکزی",139,482,12,1,112,607,14,621
"خوزستان","دزفول","مرکزی",140,547,15,5,379,946,21,967
"خوزستان","دزفول","مرکزی",141,458,20,3,249,730,21,751
"خوزستان","دزفول","مرکزی",142,421,12,4,163,600,14,614
"خوزستان","دزفول","مرکزی",143,594,30,4,149,777,15,792
"خوزستان","دزفول","مرکزی",144,506,30,2,361,899,29,928
"خوزستان","دزفول","مرکزی",145,441,21,2,231,695,21,716
"خوزستان","دزفول","مرکزی",146,360,18,2,190,570,18,588
"خوزستان","دزفول","مرکزی",147,139,9,1,116,265,15,280
"خوزستان","دزفول","مرکزی",148,375,31,2,298,706,20,726
"خوزستان","دزفول","مرکزی",149,385,31,2,256,674,12,686
"خوزستان","دزفول","مرکزی",150,469,15,0,191,675,19,694
"خوزستان","دزفول","مرکزی",151,619,229,4,258,1110,21,1131
"خوزستان","دزفول","مرکزی",152,598,170,2,259,1029,16,1045
"خوزستان","دزفول","مرکزی",153,607,78,0,142,827,11,838
"خوزستان","دزفول","مرکزی",154,374,37,2,163,576,9,585
"خوزستان","دزفول","مرکزی",155,625,150,2,43,820,2,822
"خوزستان","دزفول","مرکزی",156,772,49,1,31,853,2,855
"خوزستان","دزفول","مرکزی",157,677,144,10,84,915,7,922
"خوزستان","دزفول","مرکزی",158,637,101,5,55,798,11,809
"خوزستان","دزفول","مرکزی",159,466,24,2,124,616,7,623
"خوزستان","دزفول","مرکزی",160,204,12,1,85,302,6,308
"خوزستان","دزفول","مرکزی",161,868,87,10,77,1042,6,1048
"خوزستان","دزفول","مرکزی",162,856,84,4,107,1051,20,1071
"خوزستان","دزفول","مرکزی",163,533,24,1,78,636,7,643
"خوزستان","دزفول","مرکزی",164,322,9,1,42,374,1,375
"خوزستان","دزفول","مرکزی",165,413,13,4,68,498,4,502
"خوزستان","دزفول","مرکزی",166,335,1,0,33,369,3,372
"خوزستان","دزفول","مرکزی",167,470,8,0,61,539,3,542
"خوزستان","دزفول","مرکزی",168,636,92,5,28,761,4,765
"خوزستان","دزفول","مرکزی",169,565,11,2,35,613,5,618
"خوزستان","دزفول","مرکزی",170,883,94,10,214,1201,14,1215
"خوزستان","دزفول","مرکزی",171,306,49,11,48,414,9,423
"خوزستان","دزفول","مرکزی",172,481,47,2,161,691,14,705
"خوزستان","دزفول","مرکزی",173,340,6,1,39,386,15,401
"خوزستان","دزفول","مرکزی",174,906,67,1,99,1073,13,1086
"خوزستان","دزفول","مرکزی",175,897,96,1,95,1089,11,1100
"خوزستان","دزفول","مرکزی",176,433,19,1,45,498,12,510
"خوزستان","دزفول","مرکزی",177,449,30,1,54,534,3,537
"خوزستان","دزفول","مرکزی",178,322,5,1,12,340,3,343
"خوزستان","دزفول","مرکزی",179,655,24,15,62,756,6,762
"خوزستان","دزفول","مرکزی",180,218,10,0,46,274,5,279
"خوزستان","دزفول","مرکزی",181,1093,42,12,65,1212,6,1218
"خوزستان","دزفول","مرکزی",182,807,8,10,50,875,5,880
"خوزستان","دزفول","مرکزی",183,949,22,2,120,1093,13,1106
"خوزستان","دزفول","مرکزی",184,378,13,1,70,462,1,463
"خوزستان","دزفول","مرکزی",185,887,122,1,15,1025,2,1027
"خوزستان","دزفول","مرکزی",186,1084,48,8,153,1293,21,1314
"خوزستان","دزفول","مرکزی",187,809,58,21,53,941,2,943
"خوزستان","دزفول","مرکزی",188,500,30,6,16,552,0,552
"خوزستان","دزفول","مرکزی",189,170,3,0,38,211,3,214
"خوزستان","دزفول","مرکزی",190,651,46,0,144,841,18,859
"خوزستان","دزفول","مرکزی",191,847,46,4,111,1008,12,1020
"خوزستان","دزفول","مرکزی",192,777,19,1,116,913,25,938
"خوزستان","دزفول","مرکزی",193,485,32,0,104,621,15,636
"خوزستان","دزفول","مرکزی",194,536,15,8,146,705,18,723
"خوزستان","دزفول","مرکزی",195,496,17,1,69,583,18,601
"خوزستان","دزفول","مرکزی",196,611,26,4,107,748,12,760
"خوزستان","دزفول","مرکزی",197,613,18,1,90,722,8,730
"خوزستان","دزفول","مرکزی",198,536,67,5,238,846,13,859
"خوزستان","دزفول","مرکزی",199,1075,87,8,167,1337,37,1374
"خوزستان","دزفول","مرکزی",200,351,11,2,51,415,4,419
"خوزستان","دزفول","مرکزی",201,442,30,1,121,594,8,602
"خوزستان","دزفول","مرکزی",202,560,38,2,111,711,21,732
"خوزستان","دزفول","مرکزی",203,599,24,1,187,811,12,823
"خوزستان","دزفول","مرکزی",204,380,21,1,132,534,18,552
"خوزستان","دزفول","مرکزی",205,885,40,4,242,1171,23,1194
"خوزستان","دزفول","مرکزی",206,713,28,3,167,911,27,938
"خوزستان","دزفول","مرکزی",207,486,11,1,110,608,9,617
"خوزستان","دزفول","مرکزی",208,641,15,4,101,761,12,773
"خوزستان","دزفول","مرکزی",209,1106,22,6,67,1201,15,1216
"خوزستان","دزفول","مرکزی",210,170,7,1,17,195,3,198
"خوزستان","دزفول","مرکزی",211,541,6,1,26,574,2,576
"خوزستان","دزفول","مرکزی",212,789,103,3,26,921,3,924
"خوزستان","دزفول","مرکزی",213,382,272,12,48,714,10,724
"خوزستان","دزفول","مرکزی",214,1052,95,7,89,1243,9,1252
"خوزستان","دزفول","مرکزی",215,585,204,1,48,838,9,847
"خوزستان","دزفول","مرکزی",216,638,36,2,39,715,8,723
"خوزستان","دزفول","مرکزی",217,752,51,5,173,981,15,996
"خوزستان","دزفول","مرکزی",218,492,20,1,31,544,3,547
"خوزستان","دزفول","چغامیش",1,435,90,0,34,559,4,563
"خوزستان","دزفول","چغامیش",2,699,68,8,63,838,9,847
"خوزستان","دزفول","چغامیش",3,824,83,5,50,962,7,969
"خوزستان","دزفول","چغامیش",4,627,64,10,94,795,14,809
"خوزستان","دزفول","چغامیش",5,405,159,29,125,718,9,727
"خوزستان","دزفول","چغامیش",6,178,96,12,57,343,11,354
"خوزستان","دزفول","چغامیش",7,852,7,1,51,911,10,921
"خوزستان","دزفول","چغامیش",8,387,3,2,6,398,6,404
"خوزستان","دزفول","چغامیش",9,554,14,3,46,617,5,622
"خوزستان","دزفول","چغامیش",10,793,58,5,149,1005,11,1016
"خوزستان","دزفول","چغامیش",11,435,8,3,124,570,6,576
"خوزستان","دزفول","چغامیش",12,1000,13,1,75,1089,15,1104
"خوزستان","دزفول","چغامیش",13,557,18,6,44,625,5,630
"خوزستان","دزفول","چغامیش",14,648,15,0,128,791,10,801
"خوزستان","دزفول","چغامیش",15,611,11,6,51,679,8,687
"خوزستان","دزفول","چغامیش",16,552,18,2,84,656,0,656
"خوزستان","دزفول","چغامیش",17,217,7,3,27,254,8,262
"خوزستان","دزفول","چغامیش",18,666,73,2,95,836,14,850
"خوزستان","دزفول","چغامیش",19,379,114,8,120,621,7,628
"خوزستان","دزفول","چغامیش",20,287,12,1,127,427,2,429
"خوزستان","دزفول","چغامیش",21,91,5,0,8,104,0,104
"خوزستان","دزفول","چغامیش",22,144,3,0,7,154,3,157
"خوزستان","دزفول","سردشت",1,525,347,6,131,1009,11,1020
"خوزستان","دزفول","سردشت",2,396,107,2,61,566,4,570
"خوزستان","دزفول","سردشت",3,109,63,0,9,181,3,184
"خوزستان","دزفول","سردشت",4,213,21,1,20,255,2,257
"خوزستان","دزفول","سردشت",5,297,79,4,10,390,2,392
"خوزستان","دزفول","سردشت",6,80,9,0,6,95,0,95
"خوزستان","دزفول","سردشت",7,30,5,0,35,70,0,70
"خوزستان","دزفول","سردشت",8,49,23,0,20,92,0,92
"خوزستان","دزفول","سردشت",9,303,52,1,15,371,5,376
"خوزستان","دزفول","سردشت",10,210,10,0,21,241,0,241
"خوزستان","دزفول","سردشت",11,34,13,0,19,66,1,67
"خوزستان","دزفول","سردشت",12,189,11,1,24,225,1,226
"خوزستان","دزفول","سردشت",13,114,9,0,6,129,0,129
"خوزستان","دزفول","سردشت",14,75,9,0,29,113,0,113
"خوزستان","دزفول","سردشت",15,26,28,0,8,62,1,63
"خوزستان","دزفول","سردشت",16,75,13,0,9,97,0,97
"خوزستان","دزفول","سردشت",17,118,71,0,11,200,0,200
"خوزستان","دزفول","سردشت",18,346,144,0,6,496,3,499
"خوزستان","دزفول","سردشت",19,154,71,1,95,321,0,321
"خوزستان","دزفول","سردشت",20,262,218,5,10,495,5,500
"خوزستان","دزفول","سردشت",21,121,122,2,33,278,1,279
"خوزستان","دزفول","سردشت",22,625,55,6,109,795,3,798
"خوزستان","دزفول","سردشت",23,676,30,6,27,739,7,746
"خوزستان","دزفول","سردشت",24,898,72,3,65,1038,9,1047
"خوزستان","دزفول","سردشت",25,815,119,1,21,956,9,965
"خوزستان","دزفول","سردشت",26,306,126,1,28,461,5,466
"خوزستان","دزفول","سردشت",27,52,8,1,9,70,0,70
"خوزستان","دزفول","سردشت",28,27,2,0,12,41,0,41
"خوزستان","دزفول","سردشت",29,72,11,0,5,88,0,88
"خوزستان","دزفول","سردشت",30,26,0,0,4,30,0,30
"خوزستان","دزفول","سردشت",31,37,17,0,15,69,0,69
"خوزستان","دزفول","سردشت",32,53,6,0,35,94,0,94
"خوزستان","دزفول","سردشت",33,17,0,0,10,27,0,27
"خوزستان","دزفول","سردشت",34,21,7,0,6,34,0,34
"خوزستان","دزفول","سردشت",35,10,2,0,0,12,0,12
"خوزستان","دزفول","سردشت",36,33,2,3,18,56,0,56
"خوزستان","دزفول","سردشت",37,17,6,0,0,23,0,23
"خوزستان","دزفول","سردشت",38,8,12,0,2,22,2,24
"خوزستان","دزفول","سردشت",39,10,1,0,0,11,0,11
"خوزستان","دزفول","سردشت",40,54,5,0,0,59,0,59
"خوزستان","دشت_مرکزی","مرکزی",1,476,15,6,135,632,16,648
"خوزستان","دشت_مرکزی","مرکزی",2,845,27,5,245,1122,29,1151
"خوزستان","دشت_مرکزی","مرکزی",3,197,11,1,56,265,8,273
"خوزستان","دشت_مرکزی","مرکزی",4,171,3,3,80,257,11,268
"خوزستان","دشت_مرکزی","مرکزی",5,244,2,2,67,315,12,327
"خوزستان","دشت_مرکزی","مرکزی",6,371,8,1,131,511,15,526
"خوزستان","دشت_مرکزی","مرکزی",7,450,18,2,200,670,18,688
"خوزستان","دشت_مرکزی","مرکزی",8,265,13,1,89,368,12,380
"خوزستان","دشت_مرکزی","مرکزی",9,174,6,2,50,232,9,241
"خوزستان","دشت_مرکزی","مرکزی",10,598,14,2,120,734,25,759
"خوزستان","دشت_مرکزی","مرکزی",11,270,6,3,85,364,4,368
"خوزستان","دشت_مرکزی","مرکزی",12,528,17,5,194,744,18,762
"خوزستان","دشت_مرکزی","مرکزی",13,69,8,0,32,109,3,112
"خوزستان","دشت_مرکزی","مرکزی",14,429,13,5,151,598,14,612
"خوزستان","دشت_مرکزی","مرکزی",15,611,9,2,217,839,13,852
"خوزستان","دشت_مرکزی","مرکزی",16,140,0,0,51,191,1,192
"خوزستان","دشت_مرکزی","مرکزی",17,573,19,4,106,702,18,720
"خوزستان","دشت_مرکزی","مرکزی",18,303,8,0,68,379,11,390
"خوزستان","دشت_مرکزی","مرکزی",19,430,3,1,70,504,7,511
"خوزستان","دشت_مرکزی","مرکزی",20,654,12,3,170,839,9,848
"خوزستان","دشت_مرکزی","مرکزی",21,476,7,3,71,557,8,565
"خوزستان","دشت_مرکزی","مرکزی",22,585,4,5,63,657,6,663
"خوزستان","دشت_مرکزی","مرکزی",23,987,9,0,171,1167,33,1200
"خوزستان","دشت_مرکزی","مرکزی",24,340,7,1,39,387,5,392
"خوزستان","دشت_مرکزی","مرکزی",25,549,0,2,27,578,15,593
"خوزستان","دشت_مرکزی","مرکزی",26,394,5,0,111,510,17,527
"خوزستان","دشت_مرکزی","مرکزی",27,208,0,0,23,231,2,233
"خوزستان","دشت_مرکزی","مرکزی",28,585,7,4,88,684,6,690
"خوزستان","دشت_مرکزی","مرکزی",29,376,12,1,55,444,5,449
"خوزستان","دشت_مرکزی","مرکزی",30,619,11,3,160,793,13,806
"خوزستان","دشت_مرکزی","مرکزی",31,331,2,0,108,441,12,453
"خوزستان","دشت_مرکزی","مرکزی",32,452,2,5,109,568,22,590
"خوزستان","دشت_مرکزی","مرکزی",33,355,8,2,79,444,8,452
"خوزستان","دشت_مرکزی","مرکزی",34,263,6,4,77,350,14,364
"خوزستان","دشت_مرکزی","مرکزی",35,133,5,2,68,208,5,213
"خوزستان","دشت_مرکزی","مرکزی",36,527,26,3,182,738,19,757
"خوزستان","دشت_مرکزی","مرکزی",37,370,21,1,177,569,18,587
"خوزستان","دشت_مرکزی","مرکزی",38,187,5,2,39,233,9,242
"خوزستان","دشت_مرکزی","مرکزی",39,151,6,0,60,217,7,224
"خوزستان","دشت_مرکزی","مرکزی",40,623,11,0,50,684,16,700
"خوزستان","دشت_مرکزی","مرکزی",41,526,0,1,7,534,0,534
"خوزستان","دشت_مرکزی","مرکزی",42,651,3,0,27,681,9,690
"خوزستان","دشت_مرکزی","مرکزی",43,305,4,1,17,327,3,330
"خوزستان","دشت_مرکزی","مرکزی",44,305,1,0,38,344,12,356
"خوزستان","دشت_مرکزی","مرکزی",45,565,2,0,27,594,11,605
"خوزستان","دشت_مرکزی","مرکزی",46,273,1,1,11,286,4,290
"خوزستان","دشت_مرکزی","مرکزی",47,492,10,0,20,522,3,525
"خوزستان","دشت_مرکزی","مرکزی",48,180,1,0,1,182,0,182
"خوزستان","دشت_مرکزی","مرکزی",49,691,3,10,88,792,13,805
"خوزستان","دشت_مرکزی","مرکزی",50,550,6,4,62,622,20,642
"خوزستان","دشت_مرکزی","مرکزی",51,602,3,3,69,677,23,700
"خوزستان","دشت_مرکزی","مرکزی",52,687,1,1,64,753,10,763
"خوزستان","دشت_مرکزی","مرکزی",53,796,6,1,72,875,15,890
"خوزستان","دشت_مرکزی","مرکزی",54,412,5,0,53,470,7,477
"خوزستان","دشت_مرکزی","مرکزی",55,347,3,0,58,408,8,416
"خوزستان","دشت_مرکزی","مرکزی",56,531,5,1,75,612,16,628
"خوزستان","دشت_مرکزی","مرکزی",57,482,2,0,24,508,0,508
"خوزستان","دشت_مرکزی","مرکزی",58,654,3,1,80,738,7,745
"خوزستان","دشت_مرکزی","مرکزی",59,295,1,0,22,318,1,319
"خوزستان","دشت_مرکزی","مرکزی",60,803,6,9,75,893,5,898
"خوزستان","دشت_مرکزی","مرکزی",61,322,0,1,29,352,0,352
"خوزستان","دشت_مرکزی","مرکزی",62,417,1,1,33,452,8,460
"خوزستان","دشت_مرکزی","مرکزی",63,766,1,0,44,811,0,811
"خوزستان","دشت_مرکزی","مرکزی",64,470,1,0,18,489,0,489
"خوزستان","دشت_مرکزی","مرکزی",65,133,2,0,4,139,1,140
"خوزستان","دشت_مرکزی","مرکزی",66,644,0,1,45,690,8,698
"خوزستان","دشت_مرکزی","مرکزی",67,609,4,1,19,633,4,637
"خوزستان","دشت_مرکزی","مرکزی",68,407,4,1,24,436,8,444
"خوزستان","دشت_مرکزی","بستان",1,870,5,1,96,972,28,1000
"خوزستان","دشت_مرکزی","بستان",2,410,1,1,32,444,12,456
"خوزستان","دشت_مرکزی","بستان",3,464,1,2,24,491,6,497
"خوزستان","دشت_مرکزی","بستان",4,357,1,0,35,393,8,401
"خوزستان","دشت_مرکزی","بستان",5,264,1,1,29,295,6,301
"خوزستان","دشت_مرکزی","بستان",6,262,4,3,34,303,3,306
"خوزستان","دشت_مرکزی","بستان",7,320,3,3,28,354,7,361
"خوزستان","دشت_مرکزی","بستان",8,311,4,1,47,363,1,364
"خوزستان","دشت_مرکزی","بستان",9,180,7,2,18,207,3,210
"خوزستان","دشت_مرکزی","بستان",10,233,2,0,20,255,2,257
"خوزستان","دشت_مرکزی","بستان",11,132,1,0,4,137,2,139
"خوزستان","دشت_مرکزی","بستان",12,28,6,0,25,59,3,62
"خوزستان","دشت_مرکزی","بستان",13,58,5,0,18,81,2,83
"خوزستان","دشت_مرکزی","بستان",14,27,2,2,10,41,0,41
"خوزستان","رامشیر","شهری",1,769,26,9,310,1114,0,1114
"خوزستان","رامشیر","شهری",2,1227,24,8,292,1551,21,1572
"خوزستان","رامشیر","شهری",3,406,9,5,224,644,9,653
"خوزستان","رامشیر","شهری",4,848,9,2,116,975,24,999
"خوزستان","رامشیر","شهری",5,804,14,7,211,1036,24,1060
"خوزستان","رامشیر","شهری",6,436,4,2,267,709,11,720
"خوزستان","رامشیر","شهری",7,845,22,5,269,1141,23,1164
"خوزستان","رامشیر","شهری",8,266,7,2,175,450,6,456
"خوزستان","رامشیر","شهری",9,806,12,4,88,910,8,918
"خوزستان","رامشیر","شهری",10,736,6,8,72,822,17,839
"خوزستان","رامشیر","شهری",11,482,8,4,134,628,14,642
"خوزستان","رامشیر","شهری",12,721,16,3,131,871,14,885
"خوزستان","رامشیر","شهری",13,156,8,1,94,259,6,265
"خوزستان","رامشیر","شهری",14,159,4,0,80,243,6,249
"خوزستان","رامشیر","شهری",15,583,32,4,178,797,6,803
"خوزستان","رامشیر","شهری",16,111,7,0,31,149,4,153
"خوزستان","رامشیر","شهری",17,194,5,4,53,256,7,263
"خوزستان","رامشیر","شهری",18,290,26,12,124,452,4,456
"خوزستان","رامشیر","مرکزی",19,453,7,2,64,526,3,529
"خوزستان","رامشیر","مرکزی",20,402,9,0,90,501,4,505
"خوزستان","رامشیر","مرکزی",21,220,7,4,58,289,5,294
"خوزستان","رامشیر","مرکزی",22,221,1,0,38,260,4,264
"خوزستان","رامشیر","مرکزی",23,385,3,3,68,459,6,465
"خوزستان","رامشیر","مرکزی",24,309,1,6,14,330,6,336
"خوزستان","رامشیر","مرکزی",25,253,1,0,44,298,2,300
"خوزستان","رامشیر","مرکزی",26,117,1,0,27,145,1,146
"خوزستان","رامشیر","مرکزی",27,581,10,1,82,674,6,680
"خوزستان","رامشیر","مرکزی",28,273,4,0,37,314,2,316
"خوزستان","رامشیر","مرکزی",29,168,1,0,27,196,1,197
"خوزستان","رامشیر","مرکزی",30,335,1,0,94,430,7,437
"خوزستان","رامشیر","مرکزی",31,312,0,1,74,387,3,390
"خوزستان","رامشیر","مرکزی",32,160,1,0,46,207,0,207
"خوزستان","رامشیر","مشراگه",33,625,3,5,120,753,4,757
"خوزستان","رامشیر","مشراگه",34,463,8,1,88,560,8,568
"خوزستان","رامشیر","مشراگه",35,222,6,1,23,252,2,254
"خوزستان","رامشیر","مشراگه",36,471,3,0,43,517,4,521
"خوزستان","رامشیر","مشراگه",37,268,3,0,71,342,1,343
"خوزستان","رامشیر","مشراگه",38,425,4,3,79,511,5,516
"خوزستان","رامشیر","مشراگه",39,414,1,1,24,440,0,440
"خوزستان","رامشیر","مشراگه",40,325,1,0,9,335,4,339
"خوزستان","رامشیر","مشراگه",41,413,11,4,67,495,2,497
"خوزستان","رامشیر","مشراگه",42,641,7,2,63,713,12,725
"خوزستان","رامشیر","مشراگه",43,250,1,1,45,297,2,299
"خوزستان","رامشیر","مشراگه",44,505,11,3,79,598,3,601
"خوزستان","رامهرمز","مرکزی",1,739,35,4,280,1058,13,1071
"خوزستان","رامهرمز","مرکزی",2,768,39,4,254,1065,15,1080
"خوزستان","رامهرمز","مرکزی",3,302,9,2,122,435,3,438
"خوزستان","رامهرمز","مرکزی",4,535,25,11,418,989,7,996
"خوزستان","رامهرمز","مرکزی",5,307,11,6,330,654,9,663
"خوزستان","رامهرمز","مرکزی",6,682,20,3,190,895,7,902
"خوزستان","رامهرمز","مرکزی",7,206,10,1,78,295,1,296
"خوزستان","رامهرمز","مرکزی",8,430,24,1,372,827,11,838
"خوزستان","رامهرمز","مرکزی",9,541,27,8,452,1028,10,1038
"خوزستان","رامهرمز","مرکزی",10,582,37,6,401,1026,10,1036
"خوزستان","رامهرمز","مرکزی",11,263,30,10,181,484,5,489
"خوزستان","رامهرمز","مرکزی",12,896,44,7,360,1307,16,1323
"خوزستان","رامهرمز","مرکزی",13,350,11,0,169,530,7,537
"خوزستان","رامهرمز","مرکزی",14,629,50,1,419,1099,19,1118
"خوزستان","رامهرمز","مرکزی",15,705,53,18,364,1140,11,1151
"خوزستان","رامهرمز","مرکزی",16,317,9,6,199,531,11,542
"خوزستان","رامهرمز","مرکزی",17,543,24,2,178,747,3,750
"خوزستان","رامهرمز","مرکزی",18,497,32,8,280,817,13,830
"خوزستان","رامهرمز","مرکزی",19,287,12,0,247,546,6,552
"خوزستان","رامهرمز","مرکزی",20,674,46,14,321,1055,9,1064
"خوزستان","رامهرمز","مرکزی",21,682,37,7,174,900,14,914
"خوزستان","رامهرمز","مرکزی",22,348,6,1,79,434,4,438
"خوزستان","رامهرمز","مرکزی",23,861,22,5,80,968,7,975
"خوزستان","رامهرمز","مرکزی",24,852,20,3,115,990,8,998
"خوزستان","رامهرمز","مرکزی",25,707,26,8,192,933,5,938
"خوزستان","رامهرمز","مرکزی",26,446,26,5,170,647,14,661
"خوزستان","رامهرمز","مرکزی",27,674,30,6,268,978,9,987
"خوزستان","رامهرمز","مرکزی",28,486,45,9,302,842,9,851
"خوزستان","رامهرمز","مرکزی",29,537,37,12,339,925,4,929
"خوزستان","رامهرمز","مرکزی",30,493,35,3,269,800,6,806
"خوزستان","رامهرمز","مرکزی",31,743,34,14,229,1020,17,1037
"خوزستان","رامهرمز","مرکزی",32,460,41,8,254,763,13,776
"خوزستان","رامهرمز","مرکزی",33,401,49,6,350,806,16,822
"خوزستان","رامهرمز","مرکزی",34,300,32,9,243,584,7,591
"خوزستان","رامهرمز","مرکزی",35,377,25,7,433,842,16,858
"خوزستان","رامهرمز","مرکزی",36,634,50,4,471,1159,13,1172
"خوزستان","رامهرمز","مرکزی",37,542,31,9,386,968,13,981
"خوزستان","رامهرمز","مرکزی",38,620,50,11,360,1041,26,1067
"خوزستان","رامهرمز","مرکزی",39,564,36,21,360,981,10,991
"خوزستان","رامهرمز","مرکزی",40,560,53,16,476,1105,15,1120
"خوزستان","رامهرمز","مرکزی",41,357,2,2,95,456,8,464
"خوزستان","رامهرمز","مرکزی",42,202,16,3,83,304,3,307
"خوزستان","رامهرمز","مرکزی",43,471,7,0,137,615,7,622
"خوزستان","رامهرمز","مرکزی",44,320,4,0,21,345,0,345
"خوزستان","رامهرمز","مرکزی",45,470,27,3,90,590,4,594
"خوزستان","رامهرمز","مرکزی",46,723,10,3,144,880,2,882
"خوزستان","رامهرمز","مرکزی",47,651,4,1,55,711,1,712
"خوزستان","رامهرمز","مرکزی",48,235,18,2,59,314,2,316
"خوزستان","رامهرمز","مرکزی",49,270,2,0,16,288,2,290
"خوزستان","رامهرمز","مرکزی",50,516,6,3,89,614,2,616
"خوزستان","رامهرمز","مرکزی",51,166,0,0,42,208,1,209
"خوزستان","رامهرمز","مرکزی",52,522,38,3,158,721,2,723
"خوزستان","رامهرمز","مرکزی",53,554,6,0,129,689,8,697
"خوزستان","رامهرمز","مرکزی",54,529,12,1,131,673,10,683
"خوزستان","رامهرمز","مرکزی",55,451,12,0,89,552,4,556
"خوزستان","رامهرمز","مرکزی",56,204,6,1,37,248,3,251
"خوزستان","رامهرمز","مرکزی",57,377,4,0,14,395,2,397
"خوزستان","رامهرمز","مرکزی",58,302,5,3,31,341,0,341
"خوزستان","رامهرمز","مرکزی",59,426,16,3,105,550,8,558
"خوزستان","رامهرمز","مرکزی",60,330,26,3,77,436,5,441
"خوزستان","رامهرمز","مرکزی",61,201,6,0,51,258,2,260
"خوزستان","رامهرمز","مرکزی",62,448,15,2,93,558,3,561
"خوزستان","رامهرمز","مرکزی",63,338,12,1,105,456,5,461
"خوزستان","رامهرمز","مرکزی",64,339,7,0,30,376,3,379
"خوزستان","رامهرمز","مرکزی",65,411,13,1,94,519,3,522
"خوزستان","رامهرمز","مرکزی",66,246,5,1,147,399,5,404
"خوزستان","رامهرمز","مرکزی",67,124,8,0,76,208,0,208
"خوزستان","رامهرمز","مرکزی",68,528,13,0,116,657,7,664
"خوزستان","رامهرمز","مرکزی",69,289,6,0,29,324,3,327
"خوزستان","رامهرمز","مرکزی",70,462,10,0,55,527,1,528
"خوزستان","رامهرمز","مرکزی",71,147,2,0,52,201,0,201
"خوزستان","رامهرمز","مرکزی",72,345,8,0,27,380,4,384
"خوزستان","رامهرمز","مرکزی",73,464,24,3,47,538,6,544
"خوزستان","رامهرمز","مرکزی",74,781,16,7,94,898,5,903
"خوزستان","رامهرمز","مرکزی",75,125,12,1,12,150,1,151
"خوزستان","رامهرمز","مرکزی",76,625,14,2,133,774,7,781
"خوزستان","رامهرمز","مرکزی",77,502,1,2,47,552,2,554
"خوزستان","رامهرمز","مرکزی",78,187,0,0,22,209,3,212
"خوزستان","رامهرمز","مرکزی",79,141,5,0,14,160,0,160
"خوزستان","رامهرمز","مرکزی",80,593,25,1,95,714,6,720
"خوزستان","رامهرمز","مرکزی",81,213,3,0,52,268,1,269
"خوزستان","رامهرمز","مرکزی",82,441,6,2,60,509,3,512
"خوزستان","رامهرمز","مرکزی",83,198,3,7,47,255,3,258
"خوزستان","رامهرمز","مرکزی",84,175,3,5,100,283,7,290
"خوزستان","رامهرمز","مرکزی",85,298,5,0,81,384,2,386
"خوزستان","رامهرمز","مرکزی",86,228,2,1,105,336,0,336
"خوزستان","شادگان","مرکزی",1,1136,21,10,207,1374,21,1395
"خوزستان","شادگان","مرکزی",2,234,6,5,85,330,14,344
"خوزستان","شادگان","مرکزی",3,343,8,11,125,487,13,500
"خوزستان","شادگان","مرکزی",4,400,26,2,168,596,16,612
"خوزستان","شادگان","مرکزی",5,601,27,10,172,810,28,838
"خوزستان","شادگان","مرکزی",6,614,13,6,127,760,18,778
"خوزستان","شادگان","مرکزی",7,521,3,3,61,588,20,608
"خوزستان","شادگان","مرکزی",8,787,6,5,134,932,17,949
"خوزستان","شادگان","مرکزی",9,403,4,0,100,507,19,526
"خوزستان","شادگان","مرکزی",10,428,7,0,89,524,6,530
"خوزستان","شادگان","مرکزی",11,822,4,7,103,936,29,965
"خوزستان","شادگان","مرکزی",12,257,12,5,43,317,10,327
"خوزستان","شادگان","مرکزی",13,368,8,3,146,525,14,539
"خوزستان","شادگان","مرکزی",14,569,13,7,131,720,18,738
"خوزستان","شادگان","مرکزی",15,956,20,2,66,1044,13,1057
"خوزستان","شادگان","مرکزی",16,683,9,1,112,805,29,834
"خوزستان","شادگان","مرکزی",17,741,8,1,102,852,12,864
"خوزستان","شادگان","مرکزی",18,597,5,4,67,673,15,688
"خوزستان","شادگان","مرکزی",19,895,8,3,157,1063,24,1087
"خوزستان","شادگان","مرکزی",20,663,5,7,80,755,19,774
"خوزستان","شادگان","مرکزی",21,617,8,3,96,724,14,738
"خوزستان","شادگان","مرکزی",22,777,16,6,72,871,13,884
"خوزستان","شادگان","مرکزی",23,592,7,5,59,663,7,670
"خوزستان","شادگان","مرکزی",24,607,4,4,68,683,12,695
"خوزستان","شادگان","مرکزی",25,814,5,4,61,884,9,893
"خوزستان","شادگان","مرکزی",26,360,4,1,34,399,9,408
"خوزستان","شادگان","مرکزی",27,828,11,4,132,975,21,996
"خوزستان","شادگان","مرکزی",28,394,13,6,113,526,20,546
"خوزستان","شادگان","مرکزی",29,433,8,3,84,528,10,538
"خوزستان","شادگان","مرکزی",30,187,4,1,65,257,4,261
"خوزستان","شادگان","مرکزی",31,230,3,1,26,260,5,265
"خوزستان","شادگان","مرکزی",32,576,1,0,15,592,10,602
"خوزستان","شادگان","مرکزی",33,154,2,0,8,164,3,167
"خوزستان","شادگان","مرکزی",34,314,6,1,19,340,4,344
"خوزستان","شادگان","مرکزی",35,491,10,1,44,546,9,555
"خوزستان","شادگان","مرکزی",36,290,20,2,55,367,29,396
"خوزستان","شادگان","مرکزی",37,294,10,2,12,318,4,322
"خوزستان","شادگان","مرکزی",38,178,1,0,10,189,3,192
"خوزستان","شادگان","مرکزی",39,270,2,0,23,295,8,303
"خوزستان","شادگان","مرکزی",40,313,0,1,31,345,5,350
"خوزستان","شادگان","مرکزی",41,455,7,2,16,480,2,482
"خوزستان","شادگان","مرکزی",42,198,0,0,3,201,2,203
"خوزستان","شادگان","مرکزی",43,439,19,2,19,479,3,482
"خوزستان","شادگان","مرکزی",44,203,5,7,20,235,8,243
"خوزستان","شادگان","مرکزی",45,599,4,5,28,636,8,644
"خوزستان","شادگان","مرکزی",46,441,1,0,40,482,6,488
"خوزستان","شادگان","مرکزی",47,154,1,2,14,171,5,176
"خوزستان","شادگان","مرکزی",48,327,2,0,18,347,5,352
"خوزستان","شادگان","مرکزی",49,156,1,0,2,159,5,164
"خوزستان","شادگان","مرکزی",50,217,0,0,13,230,2,232
"خوزستان","شادگان","مرکزی",51,176,2,0,5,183,2,185
"خوزستان","شادگان","مرکزی",52,192,10,0,3,205,2,207
"خوزستان","شادگان","مرکزی",53,170,4,0,12,186,3,189
"خوزستان","شادگان","مرکزی",54,155,4,0,31,190,0,190
"خوزستان","شادگان","مرکزی",55,142,3,0,9,154,6,160
"خوزستان","شادگان","مرکزی",56,427,3,0,23,453,7,460
"خوزستان","شادگان","مرکزی",57,724,7,1,10,742,6,748
"خوزستان","شادگان","مرکزی",58,287,4,0,6,297,0,297
"خوزستان","شادگان","مرکزی",59,657,2,0,39,698,5,703
"خوزستان","شادگان","مرکزی",60,414,3,5,34,456,5,461
"خوزستان","شادگان","مرکزی",61,166,1,1,8,176,2,178
"خوزستان","شادگان","مرکزی",62,213,2,1,8,224,1,225
"خوزستان","شادگان","مرکزی",63,391,3,2,26,422,9,431
"خوزستان","شادگان","مرکزی",64,424,6,0,22,452,8,460
"خوزستان","شادگان","مرکزی",65,560,3,0,10,573,3,576
"خوزستان","شادگان","مرکزی",66,541,1,3,41,586,10,596
"خوزستان","شادگان","مرکزی",67,321,4,0,28,353,1,354
"خوزستان","شادگان","مرکزی",68,251,1,0,10,262,2,264
"خوزستان","شادگان","مرکزی",69,174,4,0,10,188,0,188
"خوزستان","شادگان","مرکزی",70,224,2,0,2,228,3,231
"خوزستان","شادگان","مرکزی",71,739,6,2,61,808,6,814
"خوزستان","شادگان","مرکزی",72,443,1,2,24,470,9,479
"خوزستان","شادگان","مرکزی",73,133,6,1,8,148,1,149
"خوزستان","شادگان","مرکزی",74,429,0,4,30,463,6,469
"خوزستان","شادگان","مرکزی",75,169,1,0,32,202,2,204
"خوزستان","شادگان","مرکزی",76,289,2,3,55,349,4,353
"خوزستان","شادگان","مرکزی",77,150,0,0,2,152,0,152
"خوزستان","شادگان","مرکزی",78,171,2,0,3,176,0,176
"خوزستان","شادگان","مرکزی",79,335,1,0,9,345,2,347
"خوزستان","شادگان","مرکزی",80,215,0,0,11,226,1,227
"خوزستان","شادگان","مرکزی",81,198,1,0,33,232,1,233
"خوزستان","شادگان","مرکزی",82,539,1,0,4,544,2,546
"خوزستان","شادگان","مرکزی",83,514,4,1,21,540,6,546
"خوزستان","شادگان","مرکزی",84,371,11,1,11,394,0,394
"خوزستان","شادگان","مرکزی",85,600,5,0,61,666,15,681
"خوزستان","شادگان","مرکزی",86,284,2,0,6,292,0,292
"خوزستان","شادگان","مرکزی",87,409,2,0,23,434,8,442
"خوزستان","شادگان","مرکزی",88,552,4,1,11,568,13,581
"خوزستان","شادگان","مرکزی",89,895,2,2,13,912,14,926
"خوزستان","شادگان","مرکزی",90,881,2,1,44,928,23,951
"خوزستان","شادگان","مرکزی",91,507,1,1,6,515,5,520
"خوزستان","شادگان","مرکزی",92,754,1,2,21,778,7,785
"خوزستان","شادگان","مرکزی",93,850,7,2,41,900,19,919
"خوزستان","شادگان","مرکزی",94,351,0,2,5,358,4,362
"خوزستان","شادگان","مرکزی",95,458,0,0,33,491,4,495
"خوزستان","شادگان","مرکزی",96,387,0,0,4,391,2,393
"خوزستان","شادگان","مرکزی",97,398,0,0,3,401,10,411
"خوزستان","شادگان","مرکزی",98,552,1,0,11,564,18,582
"خوزستان","شادگان","مرکزی",99,460,6,5,53,524,7,531
"خوزستان","شادگان","مرکزی",100,485,1,1,42,529,19,548
"خوزستان","شادگان","مرکزی",101,1050,10,7,111,1178,28,1206
"خوزستان","شادگان","مرکزی",102,403,2,0,20,425,6,431
"خوزستان","شادگان","مرکزی",103,544,3,2,33,582,9,591
"خوزستان","شادگان","مرکزی",104,416,1,0,10,427,8,435
"خوزستان","شادگان","مرکزی",105,289,3,3,19,314,1,315
"خوزستان","شادگان","مرکزی",106,531,2,3,46,582,6,588
"خوزستان","شادگان","مرکزی",107,333,1,0,11,345,1,346
"خوزستان","شادگان","مرکزی",108,177,1,1,11,190,1,191
"خوزستان","شادگان","مرکزی",109,171,0,0,20,191,1,192
"خوزستان","شادگان","مرکزی",110,370,3,0,11,384,3,387
"خوزستان","شوش","مرکزی",1,659,21,14,372,1066,18,1084
"خوزستان","شوش","مرکزی",2,977,25,18,308,1328,25,1353
"خوزستان","شوش","مرکزی",3,773,10,4,174,961,7,968
"خوزستان","شوش","مرکزی",4,1077,44,11,223,1355,33,1388
"خوزستان","شوش","مرکزی",5,858,12,10,326,1206,20,1226
"خوزستان","شوش","مرکزی",6,504,13,8,203,728,14,742
"خوزستان","شوش","مرکزی",7,542,21,17,209,789,19,808
"خوزستان","شوش","مرکزی",8,486,32,6,279,803,15,818
"خوزستان","شوش","مرکزی",9,880,35,9,426,1350,29,1379
"خوزستان","شوش","مرکزی",10,370,20,7,327,724,18,742
"خوزستان","شوش","مرکزی",11,573,36,20,479,1108,28,1136
"خوزستان","شوش","مرکزی",12,385,21,32,321,759,20,779
"خوزستان","شوش","مرکزی",13,564,45,18,392,1019,25,1044
"خوزستان","شوش","مرکزی",14,335,29,14,412,790,25,815
"خوزستان","شوش","مرکزی",15,435,47,23,712,1217,26,1243
"خوزستان","شوش","مرکزی",16,475,54,22,497,1048,22,1070
"خوزستان","شوش","مرکزی",17,736,18,13,373,1140,26,1166
"خوزستان","شوش","مرکزی",18,548,18,6,192,764,20,784
"خوزستان","شوش","مرکزی",19,591,23,21,365,1000,23,1023
"خوزستان","شوش","مرکزی",20,617,57,33,732,1439,30,1469
"خوزستان","شوش","مرکزی",21,251,27,16,340,634,20,654
"خوزستان","شوش","مرکزی",22,205,30,20,337,592,9,601
"خوزستان","شوش","مرکزی",23,332,30,54,404,820,7,827
"خوزستان","شوش","مرکزی",24,359,32,33,301,725,13,738
"خوزستان","شوش","مرکزی",25,370,32,22,430,854,25,879
"خوزستان","شوش","مرکزی",26,582,42,25,397,1046,22,1068
"خوزستان","شوش","مرکزی",27,270,19,10,302,601,17,618
"خوزستان","شوش","مرکزی",28,379,42,32,585,1038,23,1061
"خوزستان","شوش","مرکزی",29,108,8,0,75,191,3,194
"خوزستان","شوش","مرکزی",30,712,153,21,492,1378,38,1416
"خوزستان","شوش","مرکزی",31,288,57,4,176,525,0,525
"خوزستان","شوش","مرکزی",32,462,50,18,315,845,19,864
"خوزستان","شوش","مرکزی",33,665,28,8,424,1125,14,1139
"خوزستان","شوش","مرکزی",34,712,30,13,456,1211,16,1227
"خوزستان","شوش","مرکزی",35,653,13,3,96,765,12,777
"خوزستان","شوش","مرکزی",36,677,12,1,111,801,22,823
"خوزستان","شوش","مرکزی",37,665,11,1,109,786,12,798
"خوزستان","شوش","مرکزی",38,658,14,4,66,742,14,756
"خوزستان","شوش","مرکزی",39,521,14,3,112,650,11,661
"خوزستان","شوش","مرکزی",40,668,23,3,121,815,27,842
"خوزستان","شوش","مرکزی",41,297,18,2,61,378,6,384
"خوزستان","شوش","مرکزی",42,467,26,0,34,527,4,531
"خوزستان","شوش","مرکزی",43,542,9,2,62,615,5,620
"خوزستان","شوش","مرکزی",44,366,36,23,260,685,13,698
"خوزستان","شوش","مرکزی",45,724,19,22,337,1102,6,1108
"خوزستان","شوش","مرکزی",46,426,17,12,223,678,18,696
"خوزستان","شوش","مرکزی",47,630,43,29,426,1128,21,1149
"خوزستان","شوش","مرکزی",48,138,50,23,28,239,1,240
"خوزستان","شوش","مرکزی",49,340,2,4,84,430,10,440
"خوزستان","شوش","مرکزی",50,186,6,10,42,244,3,247
"خوزستان","شوش","مرکزی",51,329,7,2,29,367,7,374
"خوزستان","شوش","مرکزی",52,570,5,3,52,630,7,637
"خوزستان","شوش","مرکزی",53,339,3,3,35,380,4,384
"خوزستان","شوش","مرکزی",54,812,0,0,29,841,12,853
"خوزستان","شوش","مرکزی",55,625,4,0,19,648,8,656
"خوزستان","شوش","مرکزی",56,802,0,0,28,830,0,830
"خوزستان","شوش","مرکزی",57,616,3,2,22,643,6,649
"خوزستان","شوش","مرکزی",58,678,25,10,357,1070,31,1101
"خوزستان","شوش","مرکزی",59,538,38,12,231,819,16,835
"خوزستان","شوش","مرکزی",60,822,19,19,259,1119,0,1119
"خوزستان","شوش","مرکزی",61,1061,47,8,317,1433,28,1461
"خوزستان","شوش","مرکزی",62,349,5,1,85,440,4,444
"خوزستان","شوش","مرکزی",63,260,1,0,44,305,1,306
"خوزستان","شوش","مرکزی",64,393,61,5,260,719,10,729
"خوزستان","شوش","مرکزی",65,23,5,4,54,86,0,86
"خوزستان","شوش","مرکزی",66,53,15,0,52,120,1,121
"خوزستان","شوش","مرکزی",67,127,31,7,186,351,7,358
"خوزستان","شوش","مرکزی",68,280,88,6,286,660,8,668
"خوزستان","شوش","مرکزی",69,182,14,10,132,338,7,345
"خوزستان","شوش","مرکزی",70,349,71,4,240,664,6,670
"خوزستان","شوش","مرکزی",71,523,14,2,106,645,2,647
"خوزستان","شوش","فتح_المبین",1,367,7,4,47,425,14,439
"خوزستان","شوش","فتح_المبین",2,859,6,1,77,943,8,951
"خوزستان","شوش","فتح_المبین",3,530,11,4,138,683,16,699
"خوزستان","شوش","فتح_المبین",4,524,3,2,56,585,7,592
"خوزستان","شوش","فتح_المبین",5,373,4,3,26,406,4,410
"خوزستان","شوش","فتح_المبین",6,217,17,2,20,256,2,258
"خوزستان","شوش","فتح_المبین",7,562,1,2,52,617,3,620
"خوزستان","شوش","فتح_المبین",8,544,5,2,48,599,6,605
"خوزستان","شوش","فتح_المبین",9,361,1,0,12,374,2,376
"خوزستان","شوش","فتح_المبین",10,244,1,0,23,268,1,269
"خوزستان","شوش","فتح_المبین",11,242,2,1,12,257,3,260
"خوزستان","شوش","فتح_المبین",12,379,12,5,35,431,5,436
"خوزستان","شوش","شاوور",1,492,3,1,155,651,9,660
"خوزستان","شوش","شاوور",2,645,4,2,208,859,20,879
"خوزستان","شوش","شاوور",3,726,4,1,158,889,11,900
"خوزستان","شوش","شاوور",4,344,3,0,133,480,8,488
"خوزستان","شوش","شاوور",5,395,3,2,53,453,7,460
"خوزستان","شوش","شاوور",6,687,17,1,80,785,6,791
"خوزستان","شوش","شاوور",7,537,2,3,60,602,5,607
"خوزستان","شوش","شاوور",8,401,4,1,50,456,5,461
"خوزستان","شوش","شاوور",9,448,0,3,54,505,1,506
"خوزستان","شوش","شاوور",10,613,6,1,47,667,6,673
"خوزستان","شوش","شاوور",11,362,6,0,43,411,3,414
"خوزستان","شوش","شاوور",12,411,5,2,36,454,6,460
"خوزستان","شوش","شاوور",13,327,5,2,84,418,1,419
"خوزستان","شوش","شاوور",14,525,1,2,42,570,9,579
"خوزستان","شوش","شاوور",15,468,6,1,25,500,0,500
"خوزستان","شوش","شاوور",16,394,2,4,8,408,3,411
"خوزستان","شوش","شاوور",17,569,7,3,17,596,4,600
"خوزستان","شوش","شاوور",18,600,4,2,18,624,1,625
"خوزستان","شوش","شاوور",19,341,2,1,54,398,3,401
"خوزستان","شوش","شاوور",20,271,3,1,14,289,3,292
"خوزستان","شوش","شاوور",21,267,0,0,8,275,0,275
"خوزستان","شوش","شاوور",22,265,0,0,33,298,0,298
"خوزستان","شوش","شاوور",23,78,3,0,13,94,0,94
"خوزستان","شوش","شاوور",24,573,4,3,109,689,4,693
"خوزستان","شوش","شاوور",25,280,1,0,14,295,1,296
"خوزستان","شوش","شاوور",26,745,8,3,148,904,6,910
"خوزستان","شوش","شاوور",27,634,6,9,93,742,7,749
"خوزستان","شوش","شاوور",28,349,3,3,33,388,3,391
"خوزستان","شوش","شاوور",29,571,5,2,142,720,12,732
"خوزستان","شوش","شاوور",30,759,1,1,85,846,0,846
"خوزستان","شوش","شاوور",31,824,4,2,35,865,12,877
"خوزستان","شوش","شاوور",32,370,2,1,31,404,0,404
"خوزستان","شوش","شاوور",33,541,7,1,45,594,5,599
"خوزستان","شوش","شاوور",34,1011,2,5,72,1090,8,1098
"خوزستان","شوش","شاوور",35,570,2,0,32,604,9,613
"خوزستان","شوش","شاوور",36,658,11,1,70,740,10,750
"خوزستان","شوش","شاوور",37,881,4,7,127,1019,13,1032
"خوزستان","شوش","شاوور",38,818,9,9,98,934,6,940
"خوزستان","شوش","شاوور",39,572,4,6,47,629,7,636
"خوزستان","شوش","شاوور",40,204,0,0,31,235,1,236
"خوزستان","شوش","شاوور",41,572,17,1,66,656,2,658
"خوزستان","شوش","شاوور",42,171,0,0,9,180,1,181
"خوزستان","شوش","شاوور",43,165,0,1,8,174,0,174
"خوزستان","شوش","شاوور",44,646,1,0,22,669,2,671
"خوزستان","شوش","شاوور",45,295,0,1,16,312,1,313
"خوزستان","شوش","شاوور",46,318,4,2,23,347,1,348
"خوزستان","شوشتر","شهر",1,465,33,4,315,817,29,846
"خوزستان","شوشتر","شهر",2,334,23,3,233,593,12,605
"خوزستان","شوشتر","شهر",3,234,9,4,195,442,14,456
"خوزستان","شوشتر","شهر",4,377,31,2,274,684,13,697
"خوزستان","شوشتر","شهر",5,276,35,5,262,578,18,596
"خوزستان","شوشتر","شهر",6,196,10,2,94,302,8,310
"خوزستان","شوشتر","شهر",7,529,86,7,459,1081,15,1096
"خوزستان","شوشتر","شهر",8,453,35,0,274,762,15,777
"خوزستان","شوشتر","شهر",9,332,11,2,163,508,0,508
"خوزستان","شوشتر","شهر",10,210,21,2,198,431,14,445
"خوزستان","شوشتر","شهر",11,183,10,1,101,295,5,300
"خوزستان","شوشتر","شهر",12,222,33,8,140,403,8,411
"خوزستان","شوشتر","شهر",13,377,30,2,225,634,17,651
"خوزستان","شوشتر","شهر",14,136,12,3,118,269,4,273
"خوزستان","شوشتر","شهر",15,179,28,6,209,422,15,437
"خوزستان","شوشتر","شهر",16,372,44,5,288,709,12,721
"خوزستان","شوشتر","شهر",17,383,44,8,217,652,20,672
"خوزستان","شوشتر","شهر",18,418,36,7,248,709,15,724
"خوزستان","شوشتر","شهر",19,278,13,0,146,437,19,456
"خوزستان","شوشتر","شهر",20,299,9,2,89,399,15,414
"خوزستان","شوشتر","شهر",21,321,15,0,215,551,9,560
"خوزستان","شوشتر","شهر",22,352,52,9,319,732,23,755
"خوزستان","شوشتر","شهر",23,387,38,8,263,696,16,712
"خوزستان","شوشتر","شهر",24,172,19,2,169,362,7,369
"خوزستان","شوشتر","شهر",25,46,9,0,81,136,6,142
"خوزستان","شوشتر","شهر",26,321,59,13,341,734,19,753
"خوزستان","شوشتر","شهر",27,209,29,5,153,396,9,405
"خوزستان","شوشتر","شهر",28,310,36,6,194,546,13,559
"خوزستان","شوشتر","شهر",29,119,8,2,177,306,5,311
"خوزستان","شوشتر","شهر",30,161,6,0,108,275,2,277
"خوزستان","شوشتر","شهر",31,415,81,19,423,938,21,959
"خوزستان","شوشتر","شهر",32,357,84,0,232,673,9,682
"خوزستان","شوشتر","شهر",33,406,99,20,358,883,14,897
"خوزستان","شوشتر","شهر",34,455,134,19,372,980,16,996
"خوزستان","شوشتر","شهر",35,261,72,3,173,509,10,519
"خوزستان","شوشتر","شهر",36,212,21,4,108,345,7,352
"خوزستان","شوشتر","شهر",37,315,93,5,252,665,22,687
"خوزستان","شوشتر","شهر",38,405,113,6,184,708,15,723
"خوزستان","شوشتر","شهر",39,346,76,13,139,574,4,578
"خوزستان","شوشتر","شهر",40,403,51,2,107,563,13,576
"خوزستان","شوشتر","شهر",41,147,40,3,108,298,2,300
"خوزستان","شوشتر","شهر",42,449,114,21,255,839,26,865
"خوزستان","شوشتر","شهر",43,320,117,7,181,625,6,631
"خوزستان","شوشتر","شهر",44,140,44,5,76,265,9,274
"خوزستان","شوشتر","شهر",45,266,71,2,120,459,16,475
"خوزستان","شوشتر","شهر",46,460,416,4,110,990,9,999
"خوزستان","شوشتر","شهر",47,339,226,6,142,713,9,722
"خوزستان","شوشتر","شهر",48,242,73,0,66,381,2,383
"خوزستان","شوشتر","شهر",49,165,58,5,36,264,9,273
"خوزستان","شوشتر","شهر",50,313,96,2,142,553,9,562
"خوزستان","شوشتر","شهر",51,402,53,1,78,534,6,540
"خوزستان","شوشتر","شهر",52,333,101,5,195,634,15,649
"خوزستان","شوشتر","شهر",53,334,136,4,132,606,6,612
"خوزستان","شوشتر","شهر",54,164,57,9,78,308,4,312
"خوزستان","شوشتر","شهر",55,309,262,0,168,739,11,750
"خوزستان","شوشتر","شهر",56,370,79,2,144,595,6,601
"خوزستان","شوشتر","شهر",57,549,208,6,176,939,13,952
"خوزستان","شوشتر","شهر",58,505,172,15,261,953,6,959
"خوزستان","شوشتر","شهر",59,260,60,5,180,505,5,510
"خوزستان","شوشتر","شهر",60,285,141,6,181,613,9,622
"خوزستان","شوشتر","شهر",61,93,26,0,96,215,7,222
"خوزستان","شوشتر","شهر",62,254,40,2,124,420,6,426
"خوزستان","شوشتر","شهر",63,293,61,14,430,798,12,810
"خوزستان","شوشتر","شهر",64,519,153,21,519,1212,18,1230
"خوزستان","شوشتر","شهر",65,316,53,5,214,588,19,607
"خوزستان","شوشتر","شهر",66,276,82,8,242,608,10,618
"خوزستان","شوشتر","شهر",67,410,94,12,269,785,16,801
"خوزستان","شوشتر","شهر",68,419,115,10,302,846,12,858
"خوزستان","شوشتر","شهر",69,373,160,8,416,957,17,974
"خوزستان","شوشتر","شهر",70,180,88,10,213,491,10,501
"خوزستان","شوشتر","شهر",71,131,85,1,49,266,7,273
"خوزستان","شوشتر","شهر",72,336,183,18,287,824,11,835
"خوزستان","شوشتر","شهر",73,364,82,11,229,686,14,700
"خوزستان","شوشتر","شهر",74,484,174,15,338,1011,13,1024
"خوزستان","شوشتر","شهر",75,395,143,16,262,816,9,825
"خوزستان","شوشتر","شهر",76,268,92,6,246,612,6,618
"خوزستان","شوشتر","شهر",77,140,23,1,64,228,5,233
"خوزستان","شوشتر","شهر",78,183,31,5,137,356,7,363
"خوزستان","شوشتر","شهر",79,112,102,1,40,255,2,257
"خوزستان","شوشتر","شهر",80,171,46,8,115,340,5,345
"خوزستان","شوشتر","شهر",81,66,8,0,33,107,3,110
"خوزستان","شوشتر","شهر",82,125,59,2,71,257,4,261
"خوزستان","شوشتر","شهر",83,134,14,1,42,191,9,200
"خوزستان","شوشتر","مرکزی",84,86,38,15,149,288,2,290
"خوزستان","شوشتر","مرکزی",85,175,49,1,196,421,2,423
"خوزستان","شوشتر","مرکزی",86,362,12,5,43,422,2,424
"خوزستان","شوشتر","مرکزی",87,29,30,1,33,93,0,93
"خوزستان","شوشتر","مرکزی",88,114,52,0,68,234,2,236
"خوزستان","شوشتر","مرکزی",89,237,161,1,7,406,1,407
"خوزستان","شوشتر","مرکزی",90,76,278,0,14,368,1,369
"خوزستان","شوشتر","مرکزی",91,341,188,2,153,684,11,695
"خوزستان","شوشتر","مرکزی",92,180,221,0,49,450,9,459
"خوزستان","شوشتر","مرکزی",93,433,190,4,146,773,17,790
"خوزستان","شوشتر","مرکزی",94,60,29,1,29,119,3,122
"خوزستان","شوشتر","مرکزی",95,60,61,0,35,156,2,158
"خوزستان","شوشتر","مرکزی",96,436,65,0,93,594,5,599
"خوزستان","شوشتر","مرکزی",97,243,141,1,61,446,3,449
"خوزستان","شوشتر","مرکزی",98,531,521,5,63,1120,0,1120
"خوزستان","شوشتر","مرکزی",99,325,339,7,53,724,10,734
"خوزستان","شوشتر","مرکزی",100,361,459,10,21,851,3,854
"خوزستان","شوشتر","مرکزی",101,414,395,5,42,856,5,861
"خوزستان","شوشتر","مرکزی",102,309,293,3,51,656,8,664
"خوزستان","شوشتر","مرکزی",103,224,214,1,24,463,2,465
"خوزستان","شوشتر","مرکزی",104,179,177,2,36,394,2,396
"خوزستان","شوشتر","مرکزی",105,114,74,6,199,393,7,400
"خوزستان","شوشتر","مرکزی",106,347,45,2,13,407,0,407
"خوزستان","شوشتر","مرکزی",107,281,84,3,11,379,2,381
"خوزستان","شوشتر","مرکزی",108,338,87,5,44,474,4,478
"خوزستان","شوشتر","مرکزی",109,312,111,0,17,440,3,443
"خوزستان","شوشتر","مرکزی",110,142,56,0,33,231,4,235
"خوزستان","شوشتر","مرکزی",111,222,54,0,13,289,4,293
"خوزستان","شوشتر","مرکزی",112,39,14,0,1,54,1,55
"خوزستان","شوشتر","مرکزی",113,146,67,8,28,249,2,251
"خوزستان","شوشتر","مرکزی",114,41,1,0,10,52,0,52
"خوزستان","شوشتر","مرکزی",115,34,13,1,14,62,0,62
"خوزستان","شوشتر","مرکزی",116,229,55,0,20,304,0,304
"خوزستان","شوشتر","مرکزی",117,203,6,1,45,255,3,258
"خوزستان","شوشتر","مرکزی",118,226,9,1,67,303,15,318
"خوزستان","شوشتر","مرکزی",119,156,7,2,9,174,1,175
"خوزستان","شوشتر","مرکزی",120,309,23,1,40,373,1,374
"خوزستان","شوشتر","مرکزی",121,250,18,0,19,287,3,290
"خوزستان","شوشتر","مرکزی",122,269,42,0,18,329,6,335
"خوزستان","شوشتر","مرکزی",123,532,55,11,103,701,9,710
"خوزستان","شوشتر","مرکزی",124,917,33,14,125,1089,15,1104
"خوزستان","شوشتر","مرکزی",125,589,13,0,67,669,5,674
"خوزستان","شوشتر","مرکزی",126,707,21,1,85,814,14,828
"خوزستان","شوشتر","مرکزی",127,368,10,1,74,453,7,460
"خوزستان","شوشتر","مرکزی",128,575,12,7,97,691,15,706
"خوزستان","شوشتر","مرکزی",129,433,77,1,77,588,9,597
"خوزستان","شوشتر","مرکزی",130,279,44,2,55,380,6,386
"خوزستان","شوشتر","مرکزی",131,482,115,1,69,667,7,674
"خوزستان","شوشتر","مرکزی",132,365,105,1,45,516,3,519
"خوزستان","شوشتر","مرکزی",133,533,24,1,83,641,5,646
"خوزستان","شوشتر","مرکزی",134,330,18,2,124,474,2,476
"خوزستان","شوشتر","مرکزی",135,318,33,2,24,377,4,381
"خوزستان","شوشتر","مرکزی",136,354,35,2,37,428,0,428
"خوزستان","شوشتر","مرکزی",137,222,47,1,84,354,2,356
"خوزستان","شوشتر","مرکزی",138,316,18,0,66,400,2,402
"خوزستان","شوشتر","مرکزی",139,299,5,2,27,333,6,339
"خوزستان","شوشتر","مرکزی",140,311,8,4,23,346,4,350
"خوزستان","شوشتر","مرکزی",141,261,4,0,22,287,3,290
"خوزستان","شوشتر","مرکزی",142,232,2,1,27,262,1,263
"خوزستان","شوشتر","مرکزی",143,357,4,0,41,402,3,405
"خوزستان","شوشتر","مرکزی",144,359,6,3,43,411,1,412
"خوزستان","شوشتر","مرکزی",145,234,0,2,19,255,3,258
"خوزستان","شوشتر","مرکزی",146,424,14,3,42,483,4,487
"خوزستان","شوشتر","مرکزی",147,294,4,2,42,342,3,345
"خوزستان","شوشتر","مرکزی",148,274,3,5,23,305,7,312
"خوزستان","شوشتر","مرکزی",149,602,15,1,69,687,12,699
"خوزستان","شوشتر","مرکزی",150,254,12,0,31,297,6,303
"خوزستان","شوشتر","مرکزی",151,371,8,2,36,417,2,419
"خوزستان","شوشتر","مرکزی",152,218,6,6,42,272,9,281
"خوزستان","شوشتر","شعیبیه",153,225,26,1,81,333,1,334
"خوزستان","شوشتر","شعیبیه",1,397,41,3,148,589,7,596
"خوزستان","شوشتر","شعیبیه",2,199,20,2,65,286,7,293
"خوزستان","شوشتر","شعیبیه",3,186,9,0,39,234,0,234
"خوزستان","شوشتر","شعیبیه",4,467,45,2,75,589,3,592
"خوزستان","شوشتر","شعیبیه",5,161,4,9,51,225,4,229
"خوزستان","شوشتر","شعیبیه",6,256,8,0,73,337,4,341
"خوزستان","شوشتر","شعیبیه",7,285,12,1,86,384,3,387
"خوزستان","شوشتر","شعیبیه",8,202,4,1,13,220,2,222
"خوزستان","شوشتر","شعیبیه",9,474,14,0,31,519,0,519
"خوزستان","شوشتر","شعیبیه",10,297,14,2,82,395,1,396
"خوزستان","شوشتر","شعیبیه",11,391,6,1,26,424,0,424
"خوزستان","شوشتر","شعیبیه",12,291,8,1,25,325,1,326
"خوزستان","شوشتر","شعیبیه",13,233,4,2,23,262,8,270
"خوزستان","شوشتر","شعیبیه",14,253,3,0,98,354,2,356
"خوزستان","شوشتر","شعیبیه",15,166,1,5,50,222,3,225
"خوزستان","شوشتر","شعیبیه",16,179,23,4,73,279,3,282
"خوزستان","شوشتر","شعیبیه",17,143,9,0,86,238,3,241
"خوزستان","شوشتر","شعیبیه",18,278,6,4,62,350,4,354
"خوزستان","شوشتر","شعیبیه",19,283,8,0,28,319,2,321
"خوزستان","شوشتر","شعیبیه",20,326,15,0,40,381,2,383
"خوزستان","شوشتر","شعیبیه",21,140,68,9,219,436,8,444
"خوزستان","شوشتر","شعیبیه",22,32,33,1,28,94,2,96
"خوزستان","گتوند","شهر_گتوند",1,120,56,4,215,395,2,397
"خوزستان","گتوند","شهر_گتوند",2,85,17,0,77,179,3,182
"خوزستان","گتوند","شهر_گتوند",3,151,93,7,196,447,8,455
"خوزستان","گتوند","شهر_گتوند",4,204,66,7,263,540,13,553
"خوزستان","گتوند","شهر_گتوند",5,359,49,10,241,659,13,672
"خوزستان","گتوند","شهر_گتوند",6,217,124,14,475,830,11,841
"خوزستان","گتوند","شهر_گتوند",7,90,33,7,146,276,2,278
"خوزستان","گتوند","شهر_گتوند",8,265,45,3,250,563,6,569
"خوزستان","گتوند","شهر_گتوند",9,636,94,7,227,964,17,981
"خوزستان","گتوند","شهر_گتوند",10,248,124,3,178,553,12,565
"خوزستان","گتوند","شهر_گتوند",11,301,133,1,106,541,18,559
"خوزستان","گتوند","شهر_گتوند",12,304,79,2,205,590,10,600
"خوزستان","گتوند","شهر_گتوند",13,265,78,3,177,523,9,532
"خوزستان","گتوند","شهر_گتوند",14,301,50,1,273,625,12,637
"خوزستان","گتوند","شهر_گتوند",15,133,9,1,102,245,3,248
"خوزستان","گتوند","شهر_گتوند",16,244,44,5,135,428,5,433
"خوزستان","گتوند","شهر_گتوند",17,319,140,13,345,817,15,832
"خوزستان","گتوند","شهر_گتوند",18,442,74,6,234,756,11,767
"خوزستان","گتوند","شهر_گتوند",19,193,61,10,258,522,10,532
"خوزستان","گتوند","شهر_گتوند",20,73,19,3,121,216,3,219
"خوزستان","گتوند","شهر_گتوند",21,114,21,1,85,221,5,226
"خوزستان","گتوند","شهر_گتوند",22,378,3,1,23,405,1,406
"خوزستان","گتوند","شهر_گتوند",23,300,3,7,72,382,9,391
"خوزستان","گتوند","شهر_گتوند",24,46,12,0,58,116,1,117
"خوزستان","گتوند","مرکزی",25,213,234,4,131,582,16,598
"خوزستان","گتوند","مرکزی",26,200,151,2,49,402,1,403
"خوزستان","گتوند","مرکزی",27,77,82,1,46,206,3,209
"خوزستان","گتوند","مرکزی",28,310,82,1,57,450,8,458
"خوزستان","گتوند","مرکزی",29,520,151,2,96,769,6,775
"خوزستان","گتوند","مرکزی",30,99,30,0,27,156,1,157
"خوزستان","گتوند","مرکزی",31,83,54,0,53,190,5,195
"خوزستان","گتوند","مرکزی",32,186,31,1,37,255,2,257
"خوزستان","گتوند","مرکزی",33,228,188,2,80,498,4,502
"خوزستان","گتوند","مرکزی",34,269,246,4,61,580,2,582
"خوزستان","گتوند","مرکزی",35,121,41,0,134,296,3,299
"خوزستان","گتوند","مرکزی",36,384,49,1,118,552,6,558
"خوزستان","گتوند","مرکزی",37,539,96,7,185,827,13,840
"خوزستان","گتوند","مرکزی",38,242,117,3,177,539,10,549
"خوزستان","گتوند","مرکزی",39,263,20,0,148,431,0,431
"خوزستان","گتوند","مرکزی",40,179,91,1,119,390,7,397
"خوزستان","گتوند","مرکزی",41,203,83,2,136,424,18,442
"خوزستان","گتوند","مرکزی",42,108,107,1,1,217,3,220
"خوزستان","گتوند","مرکزی",43,59,139,0,4,202,2,204
"خوزستان","گتوند","مرکزی",44,21,22,3,8,54,3,57
"خوزستان","گتوند","مرکزی",45,104,344,1,10,459,8,467
"خوزستان","گتوند","عقیلی",46,210,85,1,166,462,5,467
"خوزستان","گتوند","عقیلی",47,138,25,3,95,261,4,265
"خوزستان","گتوند","عقیلی",48,227,111,18,119,475,6,481
"خوزستان","گتوند","عقیلی",49,240,72,6,97,415,3,418
"خوزستان","گتوند","عقیلی",50,139,44,2,103,288,5,293
"خوزستان","گتوند","عقیلی",51,153,33,2,30,218,0,218
"خوزستان","گتوند","عقیلی",52,202,49,4,11,266,2,268
"خوزستان","گتوند","عقیلی",53,377,40,0,33,450,4,454
"خوزستان","گتوند","عقیلی",54,277,115,3,47,442,4,446
"خوزستان","گتوند","عقیلی",55,296,25,3,116,440,4,444
"خوزستان","گتوند","عقیلی",56,352,63,0,75,490,6,496
"خوزستان","گتوند","عقیلی",57,439,60,2,24,525,6,531
"خوزستان","گتوند","عقیلی",58,130,26,1,47,204,9,213
"خوزستان","گتوند","عقیلی",59,132,30,0,103,265,4,269
"خوزستان","گتوند","عقیلی",60,238,39,1,91,369,11,380
"خوزستان","گتوند","عقیلی",61,282,34,5,94,415,9,424
"خوزستان","گتوند","عقیلی",62,314,26,1,146,487,7,494
"خوزستان","گتوند","عقیلی",63,511,47,1,184,743,6,749
"خوزستان","گتوند","عقیلی",64,181,15,1,66,263,3,266
"خوزستان","گتوند","عقیلی",65,206,29,2,171,408,9,417
"خوزستان","گتوند","عقیلی",66,247,76,4,132,459,7,466
"خوزستان","گتوند","عقیلی",67,355,77,1,166,599,8,607
"خوزستان","گتوند","عقیلی",68,134,106,5,26,271,3,274
"خوزستان","گتوند","عقیلی",69,142,100,17,55,314,2,316
"خوزستان","لالی","حتی",1,22,185,0,5,212,2,214
"خوزستان","لالی","حتی",2,27,132,0,3,162,4,166
"خوزستان","لالی","حتی",3,24,123,0,2,149,1,150
"خوزستان","لالی","حتی",4,16,199,0,4,219,3,222
"خوزستان","لالی","حتی",5,9,233,0,4,246,0,246
"خوزستان","لالی","حتی",6,13,168,0,2,183,0,183
"خوزستان","لالی","حتی",7,7,52,0,4,63,0,63
"خوزستان","لالی","حتی",8,0,17,0,0,17,0,17
"خوزستان","لالی","حتی",9,1,76,0,7,84,0,84
"خوزستان","لالی","حتی",10,4,7,0,2,13,0,13
"خوزستان","لالی","حتی",11,5,16,0,6,27,1,28
"خوزستان","لالی","حتی",12,2,9,0,4,15,0,15
"خوزستان","لالی","مرکزی",1,238,634,8,178,1058,12,1070
"خوزستان","لالی","مرکزی",2,61,163,4,129,357,5,362
"خوزستان","لالی","مرکزی",3,111,453,3,66,633,3,636
"خوزستان","لالی","مرکزی",4,112,141,7,93,353,0,353
"خوزستان","لالی","مرکزی",5,225,250,8,154,637,5,642
"خوزستان","لالی","مرکزی",6,187,358,4,64,613,7,620
"خوزستان","لالی","مرکزی",7,88,727,3,22,840,2,842
"خوزستان","لالی","مرکزی",8,158,498,5,82,743,7,750
"خوزستان","لالی","مرکزی",9,388,610,7,102,1107,10,1117
"خوزستان","لالی","مرکزی",10,265,450,2,56,773,7,780
"خوزستان","لالی","مرکزی",11,148,177,1,20,346,3,349
"خوزستان","لالی","مرکزی",12,134,468,4,56,662,11,673
"خوزستان","لالی","مرکزی",13,79,305,3,40,427,5,432
"خوزستان","لالی","مرکزی",14,66,140,16,23,245,2,247
"خوزستان","لالی","مرکزی",15,174,170,5,34,383,12,395
"خوزستان","لالی","مرکزی",16,36,36,0,3,75,0,75
"خوزستان","لالی","مرکزی",17,264,278,7,62,611,4,615
"خوزستان","لالی","مرکزی",18,386,70,9,11,476,3,479
"خوزستان","لالی","مرکزی",19,55,48,0,5,108,1,109
"خوزستان","لالی","مرکزی",20,23,53,0,3,79,1,80
"خوزستان","لالی","مرکزی",21,36,310,0,8,354,2,356
"خوزستان","لالی","مرکزی",22,61,492,3,23,579,2,581
"خوزستان","لالی","مرکزی",23,37,70,0,1,108,2,110
"خوزستان","مسجد_سیمان","مرکزی",1,243,282,5,87,617,4,621
"خوزستان","مسجد_سیمان","مرکزی",2,613,410,13,210,1246,18,1264
"خوزستان","مسجد_سیمان","مرکزی",3,224,231,1,139,595,15,610
"خوزستان","مسجد_سیمان","مرکزی",4,607,187,12,143,949,12,961
"خوزستان","مسجد_سیمان","مرکزی",5,536,243,14,178,971,12,983
"خوزستان","مسجد_سیمان","مرکزی",6,323,169,11,76,579,22,601
"خوزستان","مسجد_سیمان","مرکزی",7,476,287,7,121,891,18,909
"خوزستان","مسجد_سیمان","مرکزی",8,553,393,19,218,1183,14,1197
"خوزستان","مسجد_سیمان","مرکزی",9,825,339,0,117,1281,22,1303
"خوزستان","مسجد_سیمان","مرکزی",10,201,237,5,136,579,20,599
"خوزستان","مسجد_سیمان","مرکزی",11,412,363,3,128,906,10,916
"خوزستان","مسجد_سیمان","مرکزی",12,564,532,26,329,1451,19,1470
"خوزستان","مسجد_سیمان","مرکزی",13,246,266,4,95,611,10,621
"خوزستان","مسجد_سیمان","مرکزی",14,385,309,8,189,891,9,900
"خوزستان","مسجد_سیمان","مرکزی",15,872,347,11,237,1467,21,1488
"خوزستان","مسجد_سیمان","مرکزی",16,325,307,20,180,832,9,841
"خوزستان","مسجد_سیمان","مرکزی",17,560,365,9,197,1131,21,1152
"خوزستان","مسجد_سیمان","مرکزی",18,432,372,17,207,1028,28,1056
"خوزستان","مسجد_سیمان","مرکزی",19,391,258,5,137,791,8,799
"خوزستان","مسجد_سیمان","مرکزی",20,346,271,14,199,830,10,840
"خوزستان","مسجد_سیمان","مرکزی",21,227,121,11,66,425,8,433
"خوزستان","مسجد_سیمان","مرکزی",22,354,255,2,130,741,18,759
"خوزستان","مسجد_سیمان","مرکزی",23,534,183,10,116,843,24,867
"خوزستان","مسجد_سیمان","مرکزی",24,803,384,19,144,1350,18,1368
"خوزستان","مسجد_سیمان","مرکزی",25,303,259,5,242,809,12,821
"خوزستان","مسجد_سیمان","مرکزی",26,618,401,4,259,1282,17,1299
"خوزستان","مسجد_سیمان","مرکزی",27,530,388,10,249,1177,22,1199
"خوزستان","مسجد_سیمان","مرکزی",28,602,404,8,290,1304,12,1316
"خوزستان","مسجد_سیمان","مرکزی",29,540,380,8,215,1143,14,1157
"خوزستان","مسجد_سیمان","مرکزی",30,246,236,13,141,636,11,647
"خوزستان","مسجد_سیمان","مرکزی",31,569,314,15,179,1077,16,1093
"خوزستان","مسجد_سیمان","مرکزی",32,210,198,9,79,496,12,508
"خوزستان","مسجد_سیمان","مرکزی",33,453,303,5,124,885,15,900
"خوزستان","مسجد_سیمان","مرکزی",34,336,247,9,97,689,16,705
"خوزستان","مسجد_سیمان","مرکزی",35,343,193,3,40,579,0,579
"خوزستان","مسجد_سیمان","مرکزی",36,668,368,17,169,1222,4,1226
"خوزستان","مسجد_سیمان","مرکزی",37,338,206,7,100,651,8,659
"خوزستان","مسجد_سیمان","مرکزی",38,266,177,0,73,516,3,519
"خوزستان","مسجد_سیمان","مرکزی",39,366,370,8,102,846,6,852
"خوزستان","مسجد_سیمان","مرکزی",40,328,277,11,43,659,11,670
"خوزستان","مسجد_سیمان","مرکزی",41,509,551,15,180,1255,17,1272
"خوزستان","مسجد_سیمان","مرکزی",42,641,496,4,164,1305,20,1325
"خوزستان","مسجد_سیمان","مرکزی",43,212,235,0,53,500,4,504
"خوزستان","مسجد_سیمان","مرکزی",44,305,317,11,157,790,12,802
"خوزستان","مسجد_سیمان","مرکزی",45,698,662,31,229,1620,28,1648
"خوزستان","مسجد_سیمان","مرکزی",46,303,90,4,143,540,8,548
"خوزستان","مسجد_سیمان","مرکزی",47,126,92,4,38,260,4,264
"خوزستان","مسجد_سیمان","مرکزی",48,405,495,14,178,1092,20,1112
"خوزستان","مسجد_سیمان","مرکزی",49,843,221,6,206,1276,24,1300
"خوزستان","مسجد_سیمان","مرکزی",50,580,532,10,168,1290,8,1298
"خوزستان","مسجد_سیمان","مرکزی",51,500,368,8,313,1189,16,1205
"خوزستان","مسجد_سیمان","مرکزی",52,554,418,12,280,1264,22,1286
"خوزستان","مسجد_سیمان","مرکزی",53,222,116,7,32,377,3,380
"خوزستان","مسجد_سیمان","مرکزی",54,169,98,5,68,340,4,344
"خوزستان","مسجد_سیمان","مرکزی",55,110,115,1,30,256,0,256
"خوزستان","مسجد_سیمان","مرکزی",56,103,31,1,12,147,0,147
"خوزستان","مسجد_سیمان","مرکزی",57,189,147,1,69,406,6,412
"خوزستان","مسجد_سیمان","مرکزی",58,48,29,1,2,80,1,81
"خوزستان","مسجد_سیمان","مرکزی",59,47,89,0,10,146,2,148
"خوزستان","مسجد_سیمان","مرکزی",60,146,84,6,104,340,6,346
"خوزستان","مسجد_سیمان","مرکزی",61,64,35,7,29,135,2,137
"خوزستان","مسجد_سیمان","مرکزی",62,47,37,1,8,93,3,96
"خوزستان","مسجد_سیمان","مرکزی",63,85,51,1,12,149,1,150
"خوزستان","مسجد_سیمان","مرکزی",64,125,106,7,43,281,0,281
"خوزستان","مسجد_سیمان","مرکزی",65,67,77,3,16,163,1,164
"خوزستان","مسجد_سیمان","گلگیر",1,290,199,3,35,527,3,530
"خوزستان","مسجد_سیمان","گلگیر",2,34,52,0,14,100,0,100
"خوزستان","مسجد_سیمان","گلگیر",3,124,105,4,26,259,2,261
"خوزستان","مسجد_سیمان","گلگیر",4,15,39,0,9,63,0,63
"خوزستان","مسجد_سیمان","گلگیر",5,40,87,0,6,133,0,133
"خوزستان","مسجد_سیمان","گلگیر",6,87,11,1,4,103,0,103
"خوزستان","مسجد_سیمان","گلگیر",7,60,31,7,2,100,0,100
"خوزستان","مسجد_سیمان","گلگیر",8,125,22,1,4,152,0,152
"خوزستان","مسجد_سیمان","گلگیر",9,161,62,0,4,227,2,229
"خوزستان","مسجد_سیمان","گلگیر",10,125,12,0,3,140,0,140
"خوزستان","مسجد_سیمان","گلگیر",11,119,41,3,15,178,1,179
"خوزستان","مسجد_سیمان","گلگیر",12,245,156,6,51,458,8,466
"خوزستان","هفتکل","مرکزی",1,774,68,10,262,1114,14,1128
"خوزستان","هفتکل","مرکزی",2,389,41,7,204,641,9,650
"خوزستان","هفتکل","مرکزی",3,555,62,17,261,895,16,911
"خوزستان","هفتکل","مرکزی",4,480,31,19,128,658,7,665
"خوزستان","هفتکل","مرکزی",5,124,16,4,98,242,1,243
"خوزستان","هفتکل","مرکزی",6,577,53,13,201,844,15,859
"خوزستان","هفتکل","مرکزی",7,573,46,18,285,922,13,935
"خوزستان","هفتکل","مرکزی",8,332,31,1,150,514,9,523
"خوزستان","هفتکل","مرکزی",9,513,33,4,123,673,13,686
"خوزستان","هفتکل","مرکزی",10,617,95,18,144,874,5,879
"خوزستان","هفتکل","مرکزی",11,99,3,1,34,137,0,137
"خوزستان","هفتکل","مرکزی",12,507,7,0,100,614,11,625
"خوزستان","هفتکل","مرکزی",13,157,2,6,56,221,2,223
"خوزستان","هفتکل","مرکزی",14,265,29,5,158,457,12,469
"خوزستان","هفتکل","مرکزی",15,133,9,0,34,176,1,177
"خوزستان","هفتکل","مرکزی",16,214,7,1,62,284,1,285
"خوزستان","هفتکل","مرکزی",17,179,16,2,51,248,0,248
"خوزستان","هفتکل","مرکزی",18,76,10,10,41,137,0,137
"خوزستان","هفتکل","رغیوه",1,224,3,1,14,242,4,246
"خوزستان","هفتکل","رغیوه",2,275,1,0,9,285,0,285
"خوزستان","هفتکل","رغیوه",3,191,29,7,47,274,5,279
"خوزستان","هفتکل","رغیوه",4,124,2,1,37,164,0,164
"خوزستان","هفتکل","رغیوه",5,349,9,1,39,398,1,399
"خوزستان","هفتکل","رغیوه",6,186,0,6,9,201,0,201
"خوزستان","هفتکل","رغیوه",7,143,1,0,4,148,0,148
"خوزستان","هفتکل","رغیوه",8,200,32,0,10,242,2,244
"خوزستان","هفتکل","رغیوه",9,63,17,0,18,98,1,99
"خوزستان","هندیجان","مرکزی",1,588,18,14,249,869,13,882
"خوزستان","هندیجان","مرکزی",2,267,7,1,174,449,11,460
"خوزستان","هندیجان","مرکزی",3,313,6,3,173,495,4,499
"خوزستان","هندیجان","مرکزی",4,788,10,3,129,930,14,944
"خوزستان","هندیجان","مرکزی",5,352,11,3,211,577,18,595
"خوزستان","هندیجان","مرکزی",6,544,21,9,241,815,15,830
"خوزستان","هندیجان","مرکزی",7,427,27,3,252,709,14,723
"خوزستان","هندیجان","مرکزی",8,481,6,5,71,563,6,569
"خوزستان","هندیجان","مرکزی",9,445,9,23,257,734,8,742
"خوزستان","هندیجان","مرکزی",10,465,7,2,179,653,15,668
"خوزستان","هندیجان","مرکزی",11,424,3,6,98,531,5,536
"خوزستان","هندیجان","مرکزی",12,807,8,4,170,989,11,1000
"خوزستان","هندیجان","مرکزی",13,548,10,9,173,740,18,758
"خوزستان","هندیجان","مرکزی",14,381,12,8,118,519,5,524
"خوزستان","هندیجان","مرکزی",15,472,4,2,125,603,4,607
"خوزستان","هندیجان","مرکزی",16,865,6,3,60,934,7,941
"خوزستان","هندیجان","مرکزی",17,459,7,7,55,528,7,535
"خوزستان","هندیجان","مرکزی",18,280,4,0,32,316,2,318
"خوزستان","هندیجان","مرکزی",19,166,0,2,43,211,1,212
"خوزستان","هندیجان","مرکزی",20,275,3,2,72,352,3,355
"خوزستان","هندیجان","مرکزی",21,559,8,3,98,668,0,668
"خوزستان","هندیجان","مرکزی",22,35,2,0,25,62,0,62
"خوزستان","هندیجان","مرکزی",23,463,4,3,79,549,8,557
"خوزستان","هندیجان","چم_خلف_عیسی",1,377,20,11,194,602,11,613
"خوزستان","هندیجان","چم_خلف_عیسی",2,484,13,2,140,639,8,647
"خوزستان","هندیجان","چم_خلف_عیسی",3,387,2,0,43,432,4,436
"خوزستان","هندیجان","چم_خلف_عیسی",4,437,4,1,57,499,1,500
"خوزستان","هندیجان","چم_خلف_عیسی",5,475,3,3,26,507,5,512
"خوزستان","هندیجان","چم_خلف_عیسی",6,344,2,4,80,430,5,435
"خوزستان","هندیجان","چم_خلف_عیسی",7,121,4,0,34,159,3,162
"خوزستان","هندیجان","چم_خلف_عیسی",8,342,1,3,35,381,1,382
"خوزستان","هندیجان","چم_خلف_عیسی",9,191,1,1,14,207,1,208
"خوزستان","هندیجان","چم_خلف_عیسی",10,148,6,1,35,190,5,195
"خوزستان","هویزه","مرکزی",1,456,8,5,117,586,10,596
"خوزستان","هویزه","مرکزی",2,453,18,7,179,657,28,685
"خوزستان","هویزه","مرکزی",3,482,2,1,88,573,11,584
"خوزستان","هویزه","مرکزی",4,218,7,8,96,329,15,344
"خوزستان","هویزه","مرکزی",5,407,3,1,105,516,6,522
"خوزستان","هویزه","مرکزی",6,450,13,4,220,687,37,724
"خوزستان","هویزه","مرکزی",7,194,3,1,75,273,7,280
"خوزستان","هویزه","مرکزی",8,728,9,9,172,918,41,959
"خوزستان","هویزه","مرکزی",9,945,7,5,72,1029,11,1040
"خوزستان","هویزه","مرکزی",10,303,7,1,21,332,4,336
"خوزستان","هویزه","مرکزی",11,184,1,2,23,210,5,215
"خوزستان","هویزه","مرکزی",12,129,1,0,23,153,1,154
"خوزستان","هویزه","مرکزی",13,301,0,0,12,313,0,313
"خوزستان","هویزه","مرکزی",14,328,2,2,14,346,3,349
"خوزستان","هویزه","مرکزی",15,102,1,0,16,119,0,119
"خوزستان","هویزه","مرکزی",16,240,2,3,44,289,2,291
"خوزستان","هویزه","مرکزی",17,232,5,0,23,260,2,262
"خوزستان","هویزه","مرکزی",18,320,5,5,45,375,2,377
"خوزستان","هویزه","مرکزی",19,362,0,1,5,368,0,368
"خوزستان","هویزه","مرکزی",20,397,1,2,50,450,0,450
"خوزستان","هویزه","نیسان",1,365,0,0,7,372,4,376
"خوزستان","هویزه","نیسان",2,157,0,0,8,165,6,171
"خوزستان","هویزه","نیسان",3,400,1,1,27,429,10,439
"خوزستان","هویزه","نیسان",4,270,5,0,23,298,4,302
"خوزستان","هویزه","نیسان",5,178,0,0,7,185,0,185
"خوزستان","هویزه","نیسان",6,172,2,0,8,182,1,183
"خوزستان","هویزه","نیسان",7,251,1,0,15,267,2,269
"خوزستان","هویزه","نیسان",8,311,1,0,28,340,1,341
"خوزستان","هویزه","نیسان",9,278,0,0,22,300,0,300
"خوزستان","هویزه","نیسان",10,612,2,0,24,638,3,641
"خوزستان","هویزه","نیسان",11,479,3,0,13,495,22,517
"خوزستان","هویزه","نیسان",12,88,0,1,24,113,1,114
"خوزستان","هویزه","نیسان",13,189,6,0,36,231,4,235
"زنجان","ابهر","مرکزی",1,1191,26,18,538,1773,19,1792
"زنجان","ابهر","مرکزی",2,760,27,3,372,1162,14,1176
"زنجان","ابهر","مرکزی",3,949,21,8,272,1250,13,1263
"زنجان","ابهر","مرکزی",4,1336,14,7,371,1728,16,1744
"زنجان","ابهر","مرکزی",5,1429,12,3,233,1677,20,1697
"زنجان","ابهر","مرکزی",6,1061,36,9,438,1544,13,1557
"زنجان","ابهر","مرکزی",7,1203,22,7,765,1997,16,2013
"زنجان","ابهر","مرکزی",8,583,9,6,292,890,20,910
"زنجان","ابهر","مرکزی",9,849,19,4,374,1246,14,1260
"زنجان","ابهر","مرکزی",10,1033,12,7,437,1489,19,1508
"زنجان","ابهر","مرکزی",11,335,3,0,41,379,1,380
"زنجان","ابهر","مرکزی",12,1520,17,1,182,1720,8,1728
"زنجان","ابهر","مرکزی",13,922,6,0,63,991,8,999
"زنجان","ابهر","مرکزی",14,1362,9,3,130,1504,32,1536
"زنجان","ابهر","مرکزی",15,825,6,3,166,1000,7,1007
"زنجان","ابهر","مرکزی",16,954,11,2,277,1244,28,1272
"زنجان","ابهر","مرکزی",17,649,2,1,133,785,5,790
"زنجان","ابهر","مرکزی",18,1039,13,12,672,1736,29,1765
"زنجان","ابهر","مرکزی",19,570,18,4,393,985,20,1005
"زنجان","ابهر","مرکزی",20,477,12,1,362,852,7,859
"زنجان","ابهر","مرکزی",21,619,9,9,379,1016,14,1030
"زنجان","ابهر","مرکزی",22,547,21,5,515,1088,16,1104
"زنجان","ابهر","مرکزی",23,657,33,19,1129,1838,31,1869
"زنجان","ابهر","مرکزی",24,477,23,9,702,1211,17,1228
"زنجان","ابهر","مرکزی",25,318,18,12,361,709,7,716
"زنجان","ابهر","مرکزی",26,855,51,20,948,1874,24,1898
"زنجان","ابهر","مرکزی",27,303,5,2,266,576,7,583
"زنجان","ابهر","مرکزی",28,441,19,2,254,716,10,726
"زنجان","ابهر","مرکزی",29,792,21,17,473,1303,19,1322
"زنجان","ابهر","مرکزی",30,427,16,10,195,648,14,662
"زنجان","ابهر","مرکزی",31,535,9,6,231,781,12,793
"زنجان","ابهر","مرکزی",32,412,13,3,248,676,7,683
"زنجان","ابهر","مرکزی",33,1258,21,9,410,1698,24,1722
"زنجان","ابهر","مرکزی",34,847,6,2,199,1054,8,1062
"زنجان","ابهر","مرکزی",35,903,13,8,242,1166,9,1175
"زنجان","ابهر","مرکزی",36,814,9,13,154,990,10,1000
"زنجان","ابهر","مرکزی",37,195,4,0,88,287,10,297
"زنجان","ابهر","مرکزی",38,74,2,0,55,131,0,131
"زنجان","ابهر","مرکزی",39,255,2,0,188,445,4,449
"زنجان","ابهر","مرکزی",40,1323,10,4,209,1546,19,1565
"زنجان","ابهر","مرکزی",41,791,6,4,115,916,15,931
"زنجان","ابهر","مرکزی",42,1089,8,3,131,1231,3,1234
"زنجان","ابهر","مرکزی",43,793,16,5,686,1500,26,1526
"زنجان","ابهر","مرکزی",44,526,11,6,303,846,9,855
"زنجان","ابهر","مرکزی",45,568,3,1,281,853,9,862
"زنجان","ابهر","مرکزی",46,619,13,5,639,1276,20,1296
"زنجان","ابهر","مرکزی",47,592,11,1,358,962,6,968
"زنجان","ابهر","مرکزی",48,634,6,1,404,1045,11,1056
"زنجان","ابهر","مرکزی",49,320,7,1,325,653,5,658
"زنجان","ابهر","مرکزی",50,1006,20,16,296,1338,26,1364
"زنجان","ابهر","مرکزی",51,996,10,5,213,1224,13,1237
"زنجان","ابهر","مرکزی",52,1103,15,4,398,1520,23,1543
"زنجان","ابهر","مرکزی",53,836,4,3,175,1018,12,1030
"زنجان","ابهر","مرکزی",54,788,9,8,174,979,7,986
"زنجان","ابهر","مرکزی",55,614,6,6,147,773,1,774
"زنجان","ابهر","مرکزی",56,319,10,3,54,386,6,392
"زنجان","ابهر","مرکزی",57,1090,7,2,236,1335,10,1345
"زنجان","ابهر","مرکزی",58,695,1,1,92,789,6,795
"زنجان","ابهر","مرکزی",59,812,4,2,189,1007,8,1015
"زنجان","ابهر","مرکزی",60,723,3,0,99,825,6,831
"زنجان","ابهر","مرکزی",61,202,0,1,83,286,4,290
"زنجان","ابهر","مرکزی",62,271,0,0,86,357,5,362
"زنجان","ابهر","مرکزی",63,116,1,0,24,141,1,142
"زنجان","ابهر","مرکزی",64,422,10,4,44,480,9,489
"زنجان","ابهر","مرکزی",65,300,1,0,33,334,0,334
"زنجان","ابهر","مرکزی",66,277,1,0,38,316,1,317
"زنجان","ابهر","مرکزی",67,402,1,0,25,428,3,431
"زنجان","ابهر","مرکزی",68,544,0,2,55,601,0,601
"زنجان","ابهر","مرکزی",69,291,0,0,28,319,0,319
"زنجان","ابهر","مرکزی",70,245,4,0,25,274,3,277
"زنجان","ابهر","مرکزی",71,666,2,3,43,714,3,717
"زنجان","ابهر","مرکزی",72,729,3,1,50,783,6,789
"زنجان","ابهر","مرکزی",73,809,8,2,139,958,20,978
"زنجان","ابهر","مرکزی",74,549,1,0,22,572,1,573
"زنجان","ابهر","مرکزی",75,476,0,0,24,500,0,500
"زنجان","ابهر","مرکزی",76,477,1,0,15,493,2,495
"زنجان","ابهر","مرکزی",77,627,3,3,48,681,2,683
"زنجان","ابهر","مرکزی",78,900,7,0,39,946,7,953
"زنجان","ابهر","مرکزی",79,549,3,0,65,617,7,624
"زنجان","ابهر","مرکزی",80,511,4,0,47,562,4,566
"زنجان","ابهر","مرکزی",81,631,2,1,134,768,15,783
"زنجان","ابهر","مرکزی",82,739,5,0,127,871,15,886
"زنجان","ابهر","مرکزی",83,685,2,0,84,771,3,774
"زنجان","ابهر","مرکزی",84,1120,6,2,60,1188,2,1190
"زنجان","ابهر","مرکزی",85,630,5,2,35,672,1,673
"زنجان","ابهر","مرکزی",86,214,2,0,19,235,5,240
"زنجان","ابهر","سلطانیه",1,1205,23,4,351,1583,21,1604
"زنجان","ابهر","سلطانیه",2,699,22,2,215,938,5,943
"زنجان","ابهر","سلطانیه",3,1066,37,2,411,1516,19,1535
"زنجان","ابهر","سلطانیه",4,1091,7,0,65,1163,4,1167
"زنجان","ابهر","سلطانیه",5,663,2,0,21,686,4,690
"زنجان","ابهر","سلطانیه",6,788,7,1,67,863,6,869
"زنجان","ابهر","سلطانیه",7,735,3,0,30,768,5,773
"زنجان","ابهر","سلطانیه",8,961,8,2,63,1034,11,1045
"زنجان","ابهر","سلطانیه",9,435,0,0,6,441,2,443
"زنجان","ابهر","سلطانیه",10,853,4,0,195,1052,10,1062
"زنجان","ابهر","سلطانیه",11,809,5,0,46,860,3,863
"زنجان","ابهر","سلطانیه",12,490,4,1,74,569,6,575
"زنجان","ابهر","سلطانیه",13,627,0,1,17,645,3,648
"زنجان","ابهر","سلطانیه",14,696,10,0,130,836,5,841
"زنجان","ابهر","سلطانیه",15,749,0,0,35,784,2,786
"زنجان","ابهر","سلطانیه",16,434,0,1,29,464,0,464
"زنجان","ابهر","سلطانیه",17,837,7,1,172,1017,3,1020
"زنجان","ابهر","سلطانیه",18,510,0,2,25,537,7,544
"زنجان","ابهر","سلطانیه",19,432,4,0,38,474,1,475
"زنجان","ابهر","سلطانیه",20,410,2,1,32,445,1,446
"زنجان","ابهر","سلطانیه",21,490,0,1,28,519,0,519
"زنجان","ابهر","سلطانیه",22,214,2,1,23,240,4,244
"زنجان","ابهر","سلطانیه",23,146,0,0,24,170,0,170
"زنجان","ابهر","سلطانیه",24,303,0,0,21,324,0,324
"زنجان","ابهر","سلطانیه",25,406,1,0,24,431,2,433
"زنجان","ابهر","سلطانیه",26,551,0,0,40,591,0,591
"زنجان","ابجرود","مرکزی",1,591,14,2,214,821,4,825
"زنجان","ابجرود","مرکزی",2,546,6,0,73,625,6,631
"زنجان","ابجرود","مرکزی",3,615,6,0,214,835,4,839
"زنجان","ابجرود","مرکزی",4,485,1,0,81,567,1,568
"زنجان","ابجرود","مرکزی",5,803,1,0,90,894,5,899
"زنجان","ابجرود","مرکزی",6,643,1,0,24,668,4,672
"زنجان","ابجرود","مرکزی",7,410,5,0,28,443,7,450
"زنجان","ابجرود","مرکزی",8,268,3,2,51,324,2,326
"زنجان","ابجرود","مرکزی",9,685,5,0,36,726,4,730
"زنجان","ابجرود","مرکزی",10,824,5,0,6,835,0,835
"زنجان","ابجرود","مرکزی",11,942,11,0,49,1002,1,1003
"زنجان","ابجرود","مرکزی",12,917,11,5,63,996,5,1001
"زنجان","ابجرود","مرکزی",13,311,1,0,10,322,3,325
"زنجان","ابجرود","مرکزی",14,392,4,1,18,415,5,420
"زنجان","ابجرود","مرکزی",15,924,2,0,60,986,4,990
"زنجان","ابجرود","مرکزی",16,1028,0,0,25,1053,2,1055
"زنجان","ابجرود","مرکزی",17,1012,0,0,20,1032,2,1034
"زنجان","ابجرود","مرکزی",18,845,3,4,8,860,2,862
"زنجان","ابجرود","مرکزی",19,648,1,0,67,716,1,717
"زنجان","ابجرود","مرکزی",20,845,0,0,37,882,5,887
"زنجان","ابجرود","مرکزی",21,357,1,0,25,383,3,386
"زنجان","ابجرود","مرکزی",22,770,4,0,154,928,9,937
"زنجان","ابجرود","مرکزی",23,594,1,1,73,669,0,669
"زنجان","ابجرود","مرکزی",24,226,0,0,27,253,1,254
"زنجان","ابجرود","مرکزی",25,587,1,0,31,619,1,620
"زنجان","ابجرود","حلب",1,224,7,1,121,353,4,357
"زنجان","ابجرود","حلب",2,259,2,0,72,333,0,333
"زنجان","ابجرود","حلب",3,419,2,0,44,465,0,465
"زنجان","ابجرود","حلب",4,241,0,0,8,249,1,250
"زنجان","ابجرود","حلب",5,204,2,0,11,217,1,218
"زنجان","ابجرود","حلب",6,229,2,0,28,259,0,259
"زنجان","ابجرود","حلب",7,267,0,0,14,281,7,288
"زنجان","ابجرود","حلب",8,275,1,1,12,289,3,292
"زنجان","ابجرود","حلب",9,405,0,0,45,450,2,452
"زنجان","ابجرود","حلب",10,468,0,0,9,477,3,480
"زنجان","ابجرود","حلب",11,596,0,1,32,629,0,629
"زنجان","ابجرود","حلب",12,162,2,1,3,168,0,168
"زنجان","خدابنده","مرکزی",1,710,15,6,246,977,5,982
"زنجان","خدابنده","مرکزی",2,506,12,2,271,791,9,800
"زنجان","خدابنده","مرکزی",3,646,25,10,482,1163,7,1170
"زنجان","خدابنده","مرکزی",4,791,28,13,355,1187,12,1199
"زنجان","خدابنده","مرکزی",5,701,11,3,229,944,14,958
"زنجان","خدابنده","مرکزی",6,658,20,9,344,1031,15,1046
"زنجان","خدابنده","مرکزی",7,465,12,2,148,627,5,632
"زنجان","خدابنده","مرکزی",8,548,14,4,295,861,4,865
"زنجان","خدابنده","مرکزی",9,428,12,9,301,750,13,763
"زنجان","خدابنده","مرکزی",10,795,15,2,302,1114,5,1119
"زنجان","خدابنده","مرکزی",11,762,25,22,499,1308,14,1322
"زنجان","خدابنده","مرکزی",12,667,13,2,248,930,5,935
"زنجان","خدابنده","مرکزی",13,594,19,12,354,979,16,995
"زنجان","خدابنده","مرکزی",14,531,13,7,268,819,8,827
"زنجان","خدابنده","مرکزی",15,504,17,5,367,893,7,900
"زنجان","خدابنده","مرکزی",16,650,12,4,362,1028,8,1036
"زنجان","خدابنده","مرکزی",17,406,9,3,219,637,3,640
"زنجان","خدابنده","مرکزی",18,299,12,1,103,415,6,421
"زنجان","خدابنده","مرکزی",19,686,5,1,182,874,6,880
"زنجان","خدابنده","مرکزی",20,862,10,0,145,1017,3,1020
"زنجان","خدابنده","مرکزی",21,665,1,2,57,725,1,726
"زنجان","خدابنده","مرکزی",22,1055,3,0,93,1151,4,1155
"زنجان","خدابنده","مرکزی",23,562,1,1,86,650,0,650
"زنجان","خدابنده","مرکزی",24,545,6,4,71,626,2,628
"زنجان","خدابنده","مرکزی",25,1022,7,0,90,1119,0,1119
"زنجان","خدابنده","مرکزی",26,790,5,6,144,945,6,951
"زنجان","خدابنده","مرکزی",27,387,0,1,38,426,1,427
"زنجان","خدابنده","مرکزی",28,959,4,0,43,1006,3,1009
"زنجان","خدابنده","مرکزی",29,877,0,3,45,925,6,931
"زنجان","خدابنده","مرکزی",30,766,5,0,46,817,0,817
"زنجان","خدابنده","مرکزی",31,623,4,0,48,675,1,676
"زنجان","خدابنده","مرکزی",32,665,1,0,52,718,2,720
"زنجان","خدابنده","مرکزی",33,946,6,2,117,1071,6,1077
"زنجان","خدابنده","مرکزی",34,756,7,0,129,892,5,897
"زنجان","خدابنده","مرکزی",35,357,4,2,31,394,0,394
"زنجان","خدابنده","مرکزی",36,840,3,4,136,983,5,988
"زنجان","خدابنده","مرکزی",37,922,3,0,80,1005,8,1013
"زنجان","خدابنده","مرکزی",38,426,6,0,73,505,2,507
"زنجان","خدابنده","مرکزی",39,603,2,1,49,655,5,660
"زنجان","خدابنده","مرکزی",40,818,2,0,74,894,1,895
"زنجان","خدابنده","مرکزی",41,1012,11,0,120,1143,6,1149
"زنجان","خدابنده","مرکزی",42,852,4,1,23,880,0,880
"زنجان","خدابنده","مرکزی",43,790,2,0,24,816,1,817
"زنجان","خدابنده","مرکزی",44,822,7,4,92,925,0,925
"زنجان","خدابنده","مرکزی",45,527,0,3,44,574,0,574
"زنجان","خدابنده","مرکزی",46,722,4,1,48,775,1,776
"زنجان","خدابنده","مرکزی",47,695,4,1,55,755,6,761
"زنجان","خدابنده","مرکزی",48,1113,2,1,135,1251,5,1256
"زنجان","خدابنده","مرکزی",49,780,13,2,82,877,6,883
"زنجان","خدابنده","مرکزی",50,1239,12,3,119,1373,5,1378
"زنجان","خدابنده","مرکزی",51,445,2,3,153,603,1,604
"زنجان","خدابنده","مرکزی",52,676,2,0,190,868,0,868
"زنجان","خدابنده","مرکزی",53,891,4,1,136,1032,1,1033
"زنجان","خدابنده","مرکزی",54,582,2,0,72,656,2,658
"زنجان","خدابنده","مرکزی",55,563,6,0,43,612,0,612
"زنجان","خدابنده","مرکزی",56,784,1,1,74,860,6,866
"زنجان","خدابنده","مرکزی",57,633,7,1,100,741,3,744
"زنجان","خدابنده","مرکزی",58,431,4,2,37,474,0,474
"زنجان","خدابنده","مرکزی",59,752,4,0,121,877,6,883
"زنجان","خدابنده","افشار",1,425,12,4,120,561,8,569
"زنجان","خدابنده","افشار",2,283,3,0,63,349,2,351
"زنجان","خدابنده","افشار",3,269,4,4,46,323,11,334
"زنجان","خدابنده","افشار",4,532,4,6,98,640,0,640
"زنجان","خدابنده","افشار",5,548,6,0,31,585,1,586
"زنجان","خدابنده","افشار",6,414,3,1,127,545,1,546
"زنجان","خدابنده","افشار",7,628,13,1,55,697,3,700
"زنجان","خدابنده","افشار",8,309,0,0,33,342,1,343
"زنجان","خدابنده","افشار",9,680,4,0,80,764,5,769
"زنجان","خدابنده","افشار",10,173,1,0,17,191,2,193
"زنجان","خدابنده","افشار",11,576,1,1,80,658,3,661
"زنجان","خدابنده","افشار",12,365,1,0,24,390,1,391
"زنجان","خدابنده","افشار",13,308,1,2,21,332,2,334
"زنجان","خدابنده","افشار",14,293,0,0,20,313,0,313
"زنجان","خدابنده","افشار",15,179,0,0,19,198,2,200
"زنجان","خدابنده","افشار",16,286,1,0,12,299,0,299
"زنجان","خدابنده","افشار",17,181,0,0,4,185,1,186
"زنجان","خدابنده","افشار",18,336,0,0,21,357,1,358
"زنجان","خدابنده","افشار",19,531,3,1,59,594,1,595
"زنجان","خدابنده","افشار",20,510,0,0,46,556,5,561
"زنجان","خدابنده","بزینه_رود",1,316,5,9,129,459,7,466
"زنجان","خدابنده","بزینه_رود",2,718,5,4,199,926,4,930
"زنجان","خدابنده","بزینه_رود",3,421,0,11,89,521,3,524
"زنجان","خدابنده","بزینه_رود",4,670,3,5,124,802,0,802
"زنجان","خدابنده","بزینه_رود",5,290,3,0,43,336,1,337
"زنجان","خدابنده","بزینه_رود",6,417,2,1,56,476,4,480
"زنجان","خدابنده","بزینه_رود",7,500,2,1,46,549,1,550
"زنجان","خدابنده","بزینه_رود",8,454,2,0,57,513,5,518
"زنجان","خدابنده","بزینه_رود",9,638,1,0,40,679,3,682
"زنجان","خدابنده","بزینه_رود",10,456,4,0,19,479,2,481
"زنجان","خدابنده","بزینه_رود",11,575,0,0,11,586,3,589
"زنجان","خدابنده","بزینه_رود",12,403,1,0,44,448,0,448
"زنجان","خدابنده","بزینه_رود",13,507,0,0,35,542,0,542
"زنجان","خدابنده","بزینه_رود",14,800,1,1,42,844,4,848
"زنجان","خدابنده","بزینه_رود",15,630,21,0,69,720,1,721
"زنجان","خدابنده","بزینه_رود",16,1034,0,0,26,1060,1,1061
"زنجان","خدابنده","بزینه_رود",17,535,4,0,44,583,0,583
"زنجان","خدابنده","بزینه_رود",18,573,1,0,47,621,1,622
"زنجان","خدابنده","بزینه_رود",19,609,4,3,151,767,6,773
"زنجان","خدابنده","بزینه_رود",20,463,2,1,73,539,2,541
"زنجان","خدابنده","بزینه_رود",21,676,8,11,68,763,6,769
"زنجان","خدابنده","بزینه_رود",22,691,5,0,35,731,1,732
"زنجان","خدابنده","بزینه_رود",23,358,0,0,24,382,4,386
"زنجان","خدابنده","بزینه_رود",24,471,7,1,21,500,3,503
"زنجان","خدابنده","بزینه_رود",25,386,5,1,37,429,1,430
"زنجان","خدابنده","بزینه_رود",26,595,7,3,49,654,4,658
"زنجان","خدابنده","بزینه_رود",27,887,3,0,101,991,1,992
"زنجان","خدابنده","بزینه_رود",28,597,2,0,27,626,0,626
"زنجان","خدابنده","بزینه_رود",29,766,0,0,38,804,0,804
"زنجان","خدابنده","بزینه_رود",30,369,2,0,33,404,2,406
"زنجان","خدابنده","بزینه_رود",31,473,2,0,10,485,1,486
"زنجان","خدابنده","سجاسرود",1,467,4,6,87,564,5,569
"زنجان","خدابنده","سجاسرود",2,569,11,3,100,683,8,691
"زنجان","خدابنده","سجاسرود",3,343,1,0,44,388,2,390
"زنجان","خدابنده","سجاسرود",4,298,3,0,37,338,0,338
"زنجان","خدابنده","سجاسرود",5,282,3,0,36,321,5,326
"زنجان","خدابنده","سجاسرود",6,318,1,3,29,351,2,353
"زنجان","خدابنده","سجاسرود",7,414,0,3,38,455,1,456
"زنجان","خدابنده","سجاسرود",8,383,5,1,91,480,2,482
"زنجان","خدابنده","سجاسرود",9,464,1,2,16,483,0,483
"زنجان","خدابنده","سجاسرود",10,402,1,2,23,428,2,430
"زنجان","خدابنده","سجاسرود",11,702,3,0,54,759,3,762
"زنجان","خدابنده","سجاسرود",12,660,11,1,26,698,0,698
"زنجان","خدابنده","سجاسرود",13,512,6,0,99,617,4,621
"زنجان","خدابنده","سجاسرود",14,357,0,0,57,414,0,414
"زنجان","خدابنده","سجاسرود",15,327,1,0,20,348,0,348
"زنجان","خدابنده","سجاسرود",16,317,0,0,11,328,0,328
"زنجان","خدابنده","سجاسرود",17,411,0,0,28,439,0,439
"زنجان","خدابنده","سجاسرود",18,453,2,0,20,475,5,480
"زنجان","خدابنده","سجاسرود",19,381,3,0,18,402,3,405
"زنجان","خدابنده","سجاسرود",20,631,4,0,51,686,2,688
"زنجان","خدابنده","سجاسرود",21,756,2,1,59,818,1,819
"زنجان","خدابنده","سجاسرود",22,579,1,2,17,599,1,600
"زنجان","خدابنده","سجاسرود",23,698,0,0,41,739,0,739
"زنجان","خدابنده","سجاسرود",24,606,2,3,77,688,2,690
"زنجان","خدابنده","سجاسرود",25,509,2,2,59,572,4,576
"زنجان","خدابنده","سجاسرود",26,575,1,0,21,597,1,598
"زنجان","خدابنده","سجاسرود",27,771,3,1,47,822,3,825
"زنجان","خدابنده","سجاسرود",28,999,1,0,13,1013,0,1013
"زنجان","خدابنده","سجاسرود",29,524,5,0,80,609,1,610
"زنجان","خرمدره","مرکزی",1,651,17,18,478,1164,12,1176
"زنجان","خرمدره","مرکزی",2,515,1,4,283,813,13,826
"زنجان","خرمدره","مرکزی",3,270,0,1,141,412,2,414
"زنجان","خرمدره","مرکزی",4,626,3,3,264,896,9,905
"زنجان","خرمدره","مرکزی",5,449,7,4,424,884,16,900
"زنجان","خرمدره","مرکزی",6,271,4,1,195,471,3,474
"زنجان","خرمدره","مرکزی",7,586,9,1,569,1165,18,1183
"زنجان","خرمدره","مرکزی",8,388,8,1,199,596,7,603
"زنجان","خرمدره","مرکزی",9,325,10,2,181,518,5,523
"زنجان","خرمدره","مرکزی",10,343,12,5,423,783,18,801
"زنجان","خرمدره","مرکزی",11,636,15,14,578,1243,15,1258
"زنجان","خرمدره","مرکزی",12,343,9,3,453,808,14,822
"زنجان","خرمدره","مرکزی",13,263,11,1,188,463,4,467
"زنجان","خرمدره","مرکزی",14,515,25,7,557,1104,8,1112
"زنجان","خرمدره","مرکزی",15,576,6,4,534,1120,22,1142
"زنجان","خرمدره","مرکزی",16,397,10,1,216,624,8,632
"زنجان","خرمدره","مرکزی",17,948,11,6,500,1465,6,1471
"زنجان","خرمدره","مرکزی",18,713,14,1,236,964,12,976
"زنجان","خرمدره","مرکزی",19,1010,14,0,329,1353,8,1361
"زنجان","خرمدره","مرکزی",20,536,8,0,286,830,5,835
"زنجان","خرمدره","مرکزی",21,1188,28,2,438,1656,23,1679
"زنجان","خرمدره","مرکزی",22,948,24,5,600,1577,21,1598
"زنجان","خرمدره","مرکزی",23,885,16,0,181,1082,20,1102
"زنجان","خرمدره","مرکزی",24,642,3,2,232,879,6,885
"زنجان","خرمدره","مرکزی",25,843,3,7,181,1034,16,1050
"زنجان","خرمدره","مرکزی",26,1128,10,1,249,1388,11,1399
"زنجان","خرمدره","مرکزی",27,1039,5,2,262,1308,14,1322
"زنجان","خرمدره","مرکزی",28,1138,4,3,272,1417,12,1429
"زنجان","خرمدره","مرکزی",29,581,7,3,360,951,6,957
"زنجان","خرمدره","مرکزی",30,395,4,1,111,511,1,512
"زنجان","خرمدره","مرکزی",31,409,2,0,16,427,2,429
"زنجان","خرمدره","مرکزی",32,79,0,4,18,101,1,102
"زنجان","خرمدره","مرکزی",33,502,2,1,73,578,5,583
"زنجان","خرمدره","مرکزی",34,427,5,1,81,514,3,517
"زنجان","خرمدره","مرکزی",35,696,8,0,157,861,10,871
"زنجان","خرمدره","مرکزی",36,409,1,3,59,472,3,475
"زنجان","خرمدره","مرکزی",37,463,0,0,50,513,1,514
"زنجان","خرمدره","مرکزی",38,433,0,1,26,460,5,465
"زنجان","خرمدره","مرکزی",39,724,7,0,43,774,5,779
"زنجان","خرمدره","مرکزی",40,226,1,1,6,234,0,234
"زنجان","خرمدره","مرکزی",41,535,9,3,145,692,9,701
"زنجان","خرمدره","مرکزی",42,549,3,0,104,656,1,657
"زنجان","خرمدره","مرکزی",43,675,1,14,40,730,3,733
"زنجان","خرمدره","مرکزی",44,628,4,12,85,729,5,734
"زنجان","خرمدره","مرکزی",45,125,0,1,28,154,1,155
"زنجان","زنجان","مرکزی",1,487,37,24,1423,1971,18,1989
"زنجان","زنجان","مرکزی",2,422,31,18,999,1470,16,1486
"زنجان","زنجان","مرکزی",3,763,67,27,1636,2493,23,2516
"زنجان","زنجان","مرکزی",4,643,48,30,1350,2071,15,2086
"زنجان","زنجان","مرکزی",5,1279,49,19,808,2155,23,2178
"زنجان","زنجان","مرکزی",6,905,52,11,561,1529,24,1553
"زنجان","زنجان","مرکزی",7,524,65,19,1038,1646,23,1669
"زنجان","زنجان","مرکزی",8,1068,70,8,734,1880,21,1901
"زنجان","زنجان","مرکزی",9,977,46,20,1187,2230,35,2265
"زنجان","زنجان","مرکزی",10,1004,46,8,414,1472,19,1491
"زنجان","زنجان","مرکزی",11,1109,35,5,311,1460,17,1477
"زنجان","زنجان","مرکزی",12,1127,62,5,541,1735,28,1763
"زنجان","زنجان","مرکزی",13,663,23,9,400,1095,15,1110
"زنجان","زنجان","مرکزی",14,1393,50,6,535,1984,16,2000
"زنجان","زنجان","مرکزی",15,1088,12,3,147,1250,12,1262
"زنجان","زنجان","مرکزی",16,1202,11,2,77,1292,8,1300
"زنجان","زنجان","مرکزی",17,664,50,9,812,1535,17,1552
"زنجان","زنجان","مرکزی",18,762,55,4,763,1584,16,1600
"زنجان","زنجان","مرکزی",19,786,68,17,1042,1913,27,1940
"زنجان","زنجان","مرکزی",20,583,40,30,1244,1897,20,1917
"زنجان","زنجان","مرکزی",21,466,28,3,567,1064,19,1083
"زنجان","زنجان","مرکزی",22,1003,60,10,597,1670,22,1692
"زنجان","زنجان","مرکزی",23,570,48,21,721,1360,35,1395
"زنجان","زنجان","مرکزی",24,525,19,1,205,750,13,763
"زنجان","زنجان","مرکزی",25,393,20,5,200,618,7,625
"زنجان","زنجان","مرکزی",26,1212,11,2,170,1395,5,1400
"زنجان","زنجان","مرکزی",27,1366,34,4,339,1743,21,1764
"زنجان","زنجان","مرکزی",28,640,24,6,312,982,5,987
"زنجان","زنجان","مرکزی",29,1386,19,3,128,1536,15,1551
"زنجان","زنجان","مرکزی",30,1922,9,0,147,2078,18,2096
"زنجان","زنجان","مرکزی",31,1558,16,4,179,1757,15,1772
"زنجان","زنجان","مرکزی",32,766,5,0,121,892,8,900
"زنجان","زنجان","مرکزی",33,717,9,0,73,799,7,806
"زنجان","زنجان","مرکزی",34,1474,25,6,281,1786,13,1799
"زنجان","زنجان","مرکزی",35,712,23,8,200,943,17,960
"زنجان","زنجان","مرکزی",36,835,18,3,196,1052,10,1062
"زنجان","زنجان","مرکزی",37,836,21,12,292,1161,13,1174
"زنجان","زنجان","مرکزی",38,1086,24,2,265,1377,22,1399
"زنجان","زنجان","مرکزی",39,1473,28,4,319,1824,20,1844
"زنجان","زنجان","مرکزی",40,1725,15,4,235,1979,21,2000
"زنجان","زنجان","مرکزی",41,594,36,8,593,1231,11,1242
"زنجان","زنجان","مرکزی",42,837,39,6,526,1408,20,1428
"زنجان","زنجان","مرکزی",43,862,47,17,617,1543,29,1572
"زنجان","زنجان","مرکزی",44,710,27,4,394,1135,16,1151
"زنجان","زنجان","مرکزی",45,795,37,19,679,1530,18,1548
"زنجان","زنجان","مرکزی",46,1382,38,11,713,2144,15,2159
"زنجان","زنجان","مرکزی",47,645,64,9,1167,1885,21,1906
"زنجان","زنجان","مرکزی",48,332,44,13,936,1325,9,1334
"زنجان","زنجان","مرکزی",49,884,67,25,1204,2180,33,2213
"زنجان","زنجان","مرکزی",50,1107,64,10,1101,2282,22,2304
"زنجان","زنجان","مرکزی",51,672,47,15,822,1556,15,1571
"زنجان","زنجان","مرکزی",52,1592,29,15,651,2287,22,2309
"زنجان","زنجان","مرکزی",53,1002,61,12,857,1932,29,1961
"زنجان","زنجان","مرکزی",54,894,58,13,929,1894,19,1913
"زنجان","زنجان","مرکزی",55,308,43,13,610,974,11,985
"زنجان","زنجان","مرکزی",56,797,50,23,1109,1979,21,2000
"زنجان","زنجان","مرکزی",57,506,52,6,850,1414,17,1431
"زنجان","زنجان","مرکزی",58,703,57,10,951,1721,26,1747
"زنجان","زنجان","مرکزی",59,700,5,0,64,769,7,776
"زنجان","زنجان","مرکزی",60,942,21,5,411,1379,21,1400
"زنجان","زنجان","مرکزی",61,758,37,13,567,1375,25,1400
"زنجان","زنجان","مرکزی",62,885,25,3,245,1158,27,1185
"زنجان","زنجان","مرکزی",63,1208,23,4,356,1591,25,1616
"زنجان","زنجان","مرکزی",64,1447,37,9,512,2005,34,2039
"زنجان","زنجان","مرکزی",65,455,14,2,325,796,9,805
"زنجان","زنجان","مرکزی",66,888,49,11,600,1548,15,1563
"زنجان","زنجان","مرکزی",67,741,28,22,691,1482,33,1515
"زنجان","زنجان","مرکزی",68,484,40,15,589,1128,27,1155
"زنجان","زنجان","مرکزی",69,813,26,7,339,1185,10,1195
"زنجان","زنجان","مرکزی",70,484,30,3,310,827,11,838
"زنجان","زنجان","مرکزی",71,615,31,1,374,1021,23,1044
"زنجان","زنجان","مرکزی",72,1008,28,8,289,1333,8,1341
"زنجان","زنجان","مرکزی",73,1064,27,8,198,1297,10,1307
"زنجان","زنجان","مرکزی",74,785,18,5,188,996,13,1009
"زنجان","زنجان","مرکزی",75,731,20,6,280,1037,11,1048
"زنجان","زنجان","مرکزی",76,657,38,4,375,1074,17,1091
"زنجان","زنجان","مرکزی",77,481,25,2,249,757,13,770
"زنجان","زنجان","مرکزی",78,931,13,5,294,1243,9,1252
"زنجان","زنجان","مرکزی",79,954,21,5,222,1202,11,1213
"زنجان","زنجان","مرکزی",80,1091,8,2,180,1281,14,1295
"زنجان","زنجان","مرکزی",81,939,20,7,245,1211,21,1232
"زنجان","زنجان","مرکزی",82,1086,41,5,410,1542,27,1569
"زنجان","زنجان","مرکزی",83,960,32,7,257,1256,20,1276
"زنجان","زنجان","مرکزی",84,762,17,1,208,988,12,1000
"زنجان","زنجان","مرکزی",85,1263,29,2,211,1505,23,1528
"زنجان","زنجان","مرکزی",86,709,16,5,158,888,16,904
"زنجان","زنجان","مرکزی",87,986,12,3,175,1176,9,1185
"زنجان","زنجان","مرکزی",88,1270,23,4,206,1503,19,1522
"زنجان","زنجان","مرکزی",89,1508,25,3,301,1837,20,1857
"زنجان","زنجان","مرکزی",90,1312,40,13,605,1970,43,2013
"زنجان","زنجان","مرکزی",91,950,41,4,368,1363,18,1381
"زنجان","زنجان","مرکزی",92,883,39,11,647,1580,20,1600
"زنجان","زنجان","مرکزی",93,837,50,26,571,1484,16,1500
"زنجان","زنجان","مرکزی",94,527,23,8,364,922,16,938
"زنجان","زنجان","مرکزی",95,973,57,14,773,1817,28,1845
"زنجان","زنجان","مرکزی",96,607,34,17,667,1325,19,1344
"زنجان","زنجان","مرکزی",97,493,22,5,262,782,21,803
"زنجان","زنجان","مرکزی",98,669,18,2,182,871,6,877
"زنجان","زنجان","مرکزی",99,1077,27,23,351,1478,20,1498
"زنجان","زنجان","مرکزی",100,1188,22,6,348,1564,24,1588
"زنجان","زنجان","مرکزی",101,1623,23,2,290,1938,23,1961
"زنجان","زنجان","مرکزی",102,1150,43,3,378,1574,22,1596
"زنجان","زنجان","مرکزی",103,1274,24,3,254,1555,13,1568
"زنجان","زنجان","مرکزی",104,1254,42,4,368,1668,21,1689
"زنجان","زنجان","مرکزی",105,903,26,13,461,1403,30,1433
"زنجان","زنجان","مرکزی",106,878,23,2,344,1247,9,1256
"زنجان","زنجان","مرکزی",107,1134,30,1,272,1437,19,1456
"زنجان","زنجان","مرکزی",108,1053,33,4,540,1630,22,1652
"زنجان","زنجان","مرکزی",109,737,33,11,470,1251,11,1262
"زنجان","زنجان","مرکزی",110,834,29,4,442,1309,15,1324
"زنجان","زنجان","مرکزی",111,1546,67,14,547,2174,21,2195
"زنجان","زنجان","مرکزی",112,1023,14,4,193,1234,7,1241
"زنجان","زنجان","مرکزی",113,1225,25,3,337,1590,8,1598
"زنجان","زنجان","مرکزی",114,742,19,6,224,991,8,999
"زنجان","زنجان","مرکزی",115,1199,15,6,262,1482,17,1499
"زنجان","زنجان","مرکزی",116,920,17,1,182,1120,9,1129
"زنجان","زنجان","مرکزی",117,1231,10,2,283,1526,23,1549
"زنجان","زنجان","مرکزی",118,1466,12,6,199,1683,17,1700
"زنجان","زنجان","مرکزی",119,1497,12,12,166,1687,15,1702
"زنجان","زنجان","مرکزی",120,1220,15,8,220,1463,22,1485
"زنجان","زنجان","مرکزی",121,1236,7,2,117,1362,12,1374
"زنجان","زنجان","مرکزی",122,1237,19,2,209,1467,13,1480
"زنجان","زنجان","مرکزی",123,1314,19,4,198,1535,25,1560
"زنجان","زنجان","مرکزی",124,1373,10,2,103,1488,12,1500
"زنجان","زنجان","مرکزی",125,1222,21,6,153,1402,10,1412
"زنجان","زنجان","مرکزی",126,1198,24,10,129,1361,16,1377
"زنجان","زنجان","مرکزی",127,1617,24,1,220,1862,15,1877
"زنجان","زنجان","مرکزی",128,1471,17,0,215,1703,16,1719
"زنجان","زنجان","مرکزی",129,1629,9,11,165,1814,12,1826
"زنجان","زنجان","مرکزی",130,1416,31,6,318,1771,28,1799
"زنجان","زنجان","مرکزی",131,1195,43,6,438,1682,5,1687
"زنجان","زنجان","مرکزی",132,1214,19,5,284,1522,43,1565
"زنجان","زنجان","مرکزی",133,1241,27,0,295,1563,13,1576
"زنجان","زنجان","مرکزی",134,1323,42,6,352,1723,32,1755
"زنجان","زنجان","مرکزی",135,1217,28,3,226,1474,10,1484
"زنجان","زنجان","مرکزی",136,381,3,0,145,529,15,544
"زنجان","زنجان","مرکزی",137,1600,24,6,329,1959,21,1980
"زنجان","زنجان","مرکزی",138,728,33,5,607,1373,17,1390
"زنجان","زنجان","مرکزی",139,812,34,6,462,1314,20,1334
"زنجان","زنجان","مرکزی",140,1438,35,7,539,2019,21,2040
"زنجان","زنجان","مرکزی",141,857,39,11,492,1399,10,1409
"زنجان","زنجان","مرکزی",142,754,37,12,575,1378,19,1397
"زنجان","زنجان","مرکزی",143,922,34,6,575,1537,19,1556
"زنجان","زنجان","مرکزی",144,1711,30,1,398,2140,0,2140
"زنجان","زنجان","مرکزی",145,648,25,3,251,927,19,946
"زنجان","زنجان","مرکزی",146,415,20,0,139,574,6,580
"زنجان","زنجان","مرکزی",147,549,16,2,218,785,7,792
"زنجان","زنجان","مرکزی",148,1447,9,0,105,1561,12,1573
"زنجان","زنجان","مرکزی",149,150,5,1,140,296,2,298
"زنجان","زنجان","مرکزی",150,220,7,0,105,332,6,338
"زنجان","زنجان","مرکزی",151,497,20,15,244,776,22,798
"زنجان","زنجان","مرکزی",152,449,5,0,52,506,1,507
"زنجان","زنجان","مرکزی",153,416,17,3,169,605,10,615
"زنجان","زنجان","مرکزی",154,675,17,2,172,866,10,876
"زنجان","زنجان","مرکزی",155,1786,8,1,92,1887,20,1907
"زنجان","زنجان","مرکزی",156,430,4,1,15,450,3,453
"زنجان","زنجان","مرکزی",157,833,3,0,61,897,3,900
"زنجان","زنجان","مرکزی",158,494,5,0,58,557,4,561
"زنجان","زنجان","مرکزی",159,442,0,0,40,482,1,483
"زنجان","زنجان","مرکزی",160,481,0,0,9,490,2,492
"زنجان","زنجان","مرکزی",161,424,2,0,8,434,1,435
"زنجان","زنجان","مرکزی",162,281,0,0,16,297,2,299
"زنجان","زنجان","مرکزی",163,275,1,0,2,278,0,278
"زنجان","زنجان","مرکزی",164,576,10,0,39,625,6,631
"زنجان","زنجان","مرکزی",165,1217,1,1,18,1237,4,1241
"زنجان","زنجان","مرکزی",166,951,1,0,17,969,2,971
"زنجان","زنجان","مرکزی",167,1192,3,1,38,1234,8,1242
"زنجان","زنجان","مرکزی",168,945,3,1,46,995,5,1000
"زنجان","زنجان","مرکزی",169,660,6,0,32,698,4,702
"زنجان","زنجان","مرکزی",170,1236,4,0,58,1298,9,1307
"زنجان","زنجان","مرکزی",171,414,2,0,34,450,1,451
"زنجان","زنجان","مرکزی",172,691,2,0,51,744,4,748
"زنجان","زنجان","مرکزی",173,1026,4,2,83,1115,12,1127
"زنجان","زنجان","مرکزی",174,1140,3,0,38,1181,6,1187
"زنجان","زنجان","مرکزی",175,782,3,0,46,831,3,834
"زنجان","زنجان","مرکزی",176,1070,6,2,108,1186,11,1197
"زنجان","زنجان","مرکزی",177,1058,4,1,92,1155,2,1157
"زنجان","زنجان","مرکزی",178,594,4,0,24,622,0,622
"زنجان","زنجان","مرکزی",179,804,3,1,49,857,1,858
"زنجان","زنجان","مرکزی",180,100,1,0,8,109,3,112
"زنجان","زنجان","مرکزی",181,335,6,0,9,350,1,351
"زنجان","زنجان","مرکزی",182,1023,3,0,26,1052,8,1060
"زنجان","زنجان","مرکزی",183,1093,1,1,32,1127,5,1132
"زنجان","زنجان","مرکزی",184,910,2,2,26,940,27,967
"زنجان","زنجان","مرکزی",185,779,1,0,10,790,2,792
"زنجان","زنجان","مرکزی",186,956,4,3,28,991,14,1005
"زنجان","زنجان","مرکزی",187,935,3,2,46,986,2,988
"زنجان","زنجان","مرکزی",188,891,7,0,110,1008,10,1018
"زنجان","زنجان","مرکزی",189,830,0,0,22,852,3,855
"زنجان","زنجان","زنجانرود",1,360,9,5,103,477,4,481
"زنجان","زنجان","زنجانرود",2,371,0,0,42,413,5,418
"زنجان","زنجان","زنجانرود",3,607,2,1,71,681,2,683
"زنجان","زنجان","زنجانرود",4,852,5,1,66,924,14,938
"زنجان","زنجان","زنجانرود",5,496,0,0,14,510,1,511
"زنجان","زنجان","زنجانرود",6,841,3,0,38,882,1,883
"زنجان","زنجان","زنجانرود",7,242,0,2,19,263,10,273
"زنجان","زنجان","زنجانرود",8,370,10,0,33,413,0,413
"زنجان","زنجان","زنجانرود",9,280,2,0,24,306,4,310
"زنجان","زنجان","زنجانرود",10,483,3,0,42,528,2,530
"زنجان","زنجان","زنجانرود",11,232,0,0,8,240,0,240
"زنجان","زنجان","زنجانرود",12,410,3,0,33,446,3,449
"زنجان","زنجان","زنجانرود",13,528,4,2,41,575,0,575
"زنجان","زنجان","زنجانرود",14,495,2,0,17,514,3,517
"زنجان","زنجان","زنجانرود",15,751,1,2,134,888,5,893
"زنجان","زنجان","زنجانرود",16,806,0,1,62,869,3,872
"زنجان","زنجان","زنجانرود",17,164,0,0,9,173,0,173
"زنجان","زنجان","زنجانرود",18,507,3,2,76,588,4,592
"زنجان","زنجان","زنجانرود",19,475,1,0,7,483,0,483
"زنجان","زنجان","زنجانرود",20,609,1,0,74,684,1,685
"زنجان","زنجان","زنجانرود",21,423,5,1,37,466,2,468
"زنجان","زنجان","زنجانرود",22,262,0,0,8,270,3,273
"زنجان","زنجان","زنجانرود",23,510,3,0,9,522,1,523
"زنجان","زنجان","زنجانرود",24,420,1,0,17,438,3,441
"زنجان","زنجان","زنجانرود",25,566,8,1,33,608,0,608
"زنجان","زنجان","زنجانرود",26,320,0,4,41,365,2,367
"زنجان","زنجان","زنجانرود",27,289,0,3,61,353,3,356
"زنجان","زنجان","زنجانرود",28,423,0,0,61,484,0,484
"زنجان","زنجان","زنجانرود",29,224,0,0,9,233,0,233
"زنجان","زنجان","زنجانرود",30,700,1,0,24,725,0,725
"زنجان","زنجان","زنجانرود",31,452,1,1,26,480,3,483
"زنجان","زنجان","زنجانرود",32,717,6,0,46,769,1,770
"زنجان","زنجان","زنجانرود",33,706,1,0,23,730,4,734
"زنجان","زنجان","قره_پشتلو",1,1055,1,0,69,1125,5,1130
"زنجان","زنجان","قره_پشتلو",2,1285,6,0,102,1393,7,1400
"زنجان","زنجان","قره_پشتلو",3,748,3,0,24,775,4,779
"زنجان","زنجان","قره_پشتلو",4,600,3,2,13,618,0,618
"زنجان","زنجان","قره_پشتلو",5,875,1,1,21,898,0,898
"زنجان","زنجان","قره_پشتلو",6,630,0,5,41,676,6,682
"زنجان","زنجان","قره_پشتلو",7,363,1,0,7,371,6,377
"زنجان","زنجان","قره_پشتلو",8,729,0,0,5,734,6,740
"زنجان","زنجان","قره_پشتلو",9,379,1,1,24,405,1,406
"زنجان","زنجان","قره_پشتلو",10,451,0,3,15,469,6,475
"زنجان","زنجان","قره_پشتلو",11,254,1,0,16,271,0,271
"زنجان","زنجان","قره_پشتلو",12,538,0,0,15,553,2,555
"زنجان","زنجان","قره_پشتلو",13,447,4,0,19,470,5,475
"زنجان","زنجان","قره_پشتلو",14,271,2,0,26,299,0,299
"زنجان","زنجان","قره_پشتلو",15,189,1,1,15,206,0,206
"زنجان","زنجان","قره_پشتلو",16,336,0,0,8,344,0,344
"زنجان","زنجان","قره_پشتلو",17,274,0,0,9,283,0,283
"زنجان","طارم","مرکزی",1,563,12,25,526,1126,16,1142
"زنجان","طارم","مرکزی",2,401,6,10,143,560,3,563
"زنجان","طارم","مرکزی",3,802,13,14,355,1184,4,1188
"زنجان","طارم","مرکزی",4,162,4,8,146,320,4,324
"زنجان","طارم","مرکزی",5,162,1,2,100,265,3,268
"زنجان","طارم","مرکزی",6,422,3,4,97,526,12,538
"زنجان","طارم","مرکزی",7,665,2,4,153,824,3,827
"زنجان","طارم","مرکزی",8,444,1,1,113,559,2,561
"زنجان","طارم","مرکزی",9,267,1,2,105,375,4,379
"زنجان","طارم","مرکزی",10,146,0,1,99,246,0,246
"زنجان","طارم","مرکزی",11,521,5,2,218,746,2,748
"زنجان","طارم","مرکزی",12,405,6,0,123,534,1,535
"زنجان","طارم","مرکزی",13,178,1,0,85,264,3,267
"زنجان","طارم","مرکزی",14,717,3,11,111,842,3,845
"زنجان","طارم","مرکزی",15,1020,2,4,46,1072,0,1072
"زنجان","طارم","مرکزی",16,629,9,0,117,755,3,758
"زنجان","طارم","مرکزی",17,133,0,0,12,145,1,146
"زنجان","طارم","مرکزی",18,563,0,6,63,632,1,633
"زنجان","طارم","مرکزی",19,478,1,0,109,588,2,590
"زنجان","طارم","مرکزی",20,159,0,2,15,176,0,176
"زنجان","طارم","مرکزی",21,385,4,4,103,496,3,499
"زنجان","طارم","مرکزی",22,346,2,6,138,492,2,494
"زنجان","طارم","مرکزی",23,226,2,0,52,280,2,282
"زنجان","طارم","مرکزی",24,255,1,0,111,367,2,369
"زنجان","طارم","مرکزی",25,150,2,0,23,175,2,177
"زنجان","طارم","مرکزی",26,59,1,0,21,81,0,81
"زنجان","طارم","مرکزی",27,174,0,1,24,199,0,199
"زنجان","طارم","مرکزی",28,372,3,16,233,624,5,629
"زنجان","طارم","مرکزی",29,505,3,9,227,744,10,754
"زنجان","طارم","مرکزی",30,634,6,20,283,943,1,944
"زنجان","طارم","چورزق",1,311,3,2,130,446,2,448
"زنجان","طارم","چورزق",2,341,1,3,84,429,3,432
"زنجان","طارم","چورزق",3,446,1,1,77,525,1,526
"زنجان","طارم","چورزق",4,548,4,3,104,659,1,660
"زنجان","طارم","چورزق",5,552,1,4,89,646,2,648
"زنجان","طارم","چورزق",6,895,3,0,88,986,5,991
"زنجان","طارم","چورزق",7,633,3,0,78,714,4,718
"زنجان","طارم","چورزق",8,299,0,0,20,319,1,320
"زنجان","طارم","چورزق",9,648,7,0,75,730,2,732
"زنجان","طارم","چورزق",10,786,1,1,132,920,0,920
"زنجان","طارم","چورزق",11,456,1,0,47,504,0,504
"زنجان","طارم","چورزق",12,186,3,0,28,217,0,217
"زنجان","طارم","چورزق",13,522,1,0,26,549,1,550
"زنجان","طارم","چورزق",14,654,0,0,53,707,1,708
"زنجان","طارم","چورزق",15,517,0,0,60,577,8,585
"زنجان","طارم","چورزق",16,380,1,0,15,396,0,396
"زنجان","طارم","چورزق",17,338,1,0,57,396,1,397
"زنجان","طارم","چورزق",18,492,3,2,64,561,0,561
"زنجان","طارم","چورزق",19,364,2,0,10,376,3,379
"زنجان","ماهنشان","مرکزی",1,462,7,3,91,563,1,564
"زنجان","ماهنشان","مرکزی",2,514,15,2,357,888,13,901
"زنجان","ماهنشان","مرکزی",3,413,6,1,185,605,2,607
"زنجان","ماهنشان","مرکزی",4,570,16,2,209,797,1,798
"زنجان","ماهنشان","مرکزی",5,590,0,1,69,660,1,661
"زنجان","ماهنشان","مرکزی",6,405,3,0,35,443,1,444
"زنجان","ماهنشان","مرکزی",7,584,1,1,63,649,0,649
"زنجان","ماهنشان","مرکزی",8,543,1,0,25,569,1,570
"زنجان","ماهنشان","مرکزی",9,346,0,0,78,424,2,426
"زنجان","ماهنشان","مرکزی",10,652,1,1,20,674,3,677
"زنجان","ماهنشان","مرکزی",11,514,1,0,48,563,5,568
"زنجان","ماهنشان","مرکزی",12,417,1,1,18,437,2,439
"زنجان","ماهنشان","مرکزی",13,648,2,0,32,682,4,686
"زنجان","ماهنشان","مرکزی",14,499,0,2,32,533,1,534
"زنجان","ماهنشان","مرکزی",15,431,6,0,85,522,1,523
"زنجان","ماهنشان","مرکزی",16,338,2,2,89,431,1,432
"زنجان","ماهنشان","مرکزی",17,335,7,1,21,364,0,364
"زنجان","ماهنشان","مرکزی",18,209,0,0,16,225,0,225
"زنجان","ماهنشان","مرکزی",19,301,3,1,121,426,5,431
"زنجان","ماهنشان","مرکزی",20,305,2,0,40,347,0,347
"زنجان","ماهنشان","مرکزی",21,229,1,0,15,245,2,247
"زنجان","ماهنشان","مرکزی",22,316,2,2,52,372,4,376
"زنجان","ماهنشان","مرکزی",23,191,0,2,19,212,1,213
"زنجان","ماهنشان","مرکزی",24,160,0,0,18,178,0,178
"زنجان","ماهنشان","مرکزی",25,322,1,3,45,371,0,371
"زنجان","ماهنشان","مرکزی",26,226,0,0,19,245,0,245
"زنجان","ماهنشان","انگوران",1,728,5,0,279,1012,2,1014
"زنجان","ماهنشان","انگوران",2,447,2,0,123,572,3,575
"زنجان","ماهنشان","انگوران",3,274,9,0,101,384,3,387
"زنجان","ماهنشان","انگوران",4,252,3,0,23,278,0,278
"زنجان","ماهنشان","انگوران",5,423,6,0,58,487,2,489
"زنجان","ماهنشان","انگوران",6,227,3,0,66,296,1,297
"زنجان","ماهنشان","انگوران",7,294,4,1,67,366,0,366
"زنجان","ماهنشان","انگوران",8,172,0,0,7,179,0,179
"زنجان","ماهنشان","انگوران",9,189,1,0,13,203,2,205
"زنجان","ماهنشان","انگوران",10,396,3,0,24,423,1,424
"زنجان","ماهنشان","انگوران",11,303,0,0,23,326,2,328
"زنجان","ماهنشان","انگوران",12,249,0,0,58,307,1,308
"زنجان","ماهنشان","انگوران",13,244,1,1,35,281,1,282
"زنجان","ماهنشان","انگوران",14,533,0,0,17,550,0,550
"زنجان","ماهنشان","انگوران",15,530,0,0,41,571,5,576
"زنجان","ماهنشان","انگوران",16,170,2,0,30,202,3,205
"زنجان","ماهنشان","انگوران",17,491,2,1,31,525,3,528
"زنجان","ماهنشان","انگوران",18,162,0,0,15,177,0,177
"زنجان","ماهنشان","انگوران",19,336,8,5,34,383,3,386
"زنجان","ماهنشان","انگوران",20,359,2,0,51,412,4,416
"زنجان","ماهنشان","انگوران",21,454,0,1,30,485,0,485
"زنجان","ماهنشان","انگوران",22,213,1,0,8,222,0,222
"زنجان","ماهنشان","انگوران",23,465,1,0,14,480,0,480
"زنجان","ماهنشان","انگوران",24,372,2,0,35,409,9,418
"زنجان","ماهنشان","انگوران",25,188,0,0,18,206,1,207
"زنجان","ماهنشان","انگوران",26,390,5,2,63,460,1,461
"زنجان","ماهنشان","انگوران",27,527,10,2,31,570,1,571
"سمنان","دامغان","مرکزی",1,806,7,0,237,1050,8,1058
"سمنان","دامغان","مرکزی",2,239,2,2,68,311,5,316
"سمنان","دامغان","مرکزی",3,955,26,11,334,1326,21,1347
"سمنان","دامغان","مرکزی",4,950,12,4,209,1175,12,1187
"سمنان","دامغان","مرکزی",5,246,7,1,77,331,5,336
"سمنان","دامغان","مرکزی",6,601,4,3,108,716,5,721
"سمنان","دامغان","مرکزی",7,598,19,2,223,842,8,850
"سمنان","دامغان","مرکزی",8,213,7,0,32,252,4,256
"سمنان","دامغان","مرکزی",9,677,6,1,159,843,12,855
"سمنان","دامغان","مرکزی",10,379,4,0,73,456,3,459
"سمنان","دامغان","مرکزی",11,818,16,4,253,1091,7,1098
"سمنان","دامغان","مرکزی",12,565,7,3,39,614,3,617
"سمنان","دامغان","مرکزی",13,682,15,6,153,856,5,861
"سمنان","دامغان","مرکزی",14,193,6,1,120,320,5,325
"سمنان","دامغان","مرکزی",15,324,6,1,118,449,8,457
"سمنان","دامغان","مرکزی",16,444,10,7,75,536,7,543
"سمنان","دامغان","مرکزی",17,466,9,1,53,529,6,535
"سمنان","دامغان","مرکزی",18,728,7,1,180,916,7,923
"سمنان","دامغان","مرکزی",19,300,8,1,177,486,8,494
"سمنان","دامغان","مرکزی",20,302,5,0,57,364,5,369
"سمنان","دامغان","مرکزی",21,1138,31,4,175,1348,13,1361
"سمنان","دامغان","مرکزی",22,622,21,0,118,761,9,770
"سمنان","دامغان","مرکزی",23,468,13,5,255,741,10,751
"سمنان","دامغان","مرکزی",24,379,12,5,164,560,5,565
"سمنان","دامغان","مرکزی",25,748,30,3,318,1099,8,1107
"سمنان","دامغان","مرکزی",26,400,8,0,120,528,5,533
"سمنان","دامغان","مرکزی",27,624,10,0,96,730,5,735
"سمنان","دامغان","مرکزی",28,612,5,2,117,736,11,747
"سمنان","دامغان","مرکزی",29,670,7,0,95,772,10,782
"سمنان","دامغان","مرکزی",30,576,15,3,158,752,4,756
"سمنان","دامغان","مرکزی",31,412,3,0,113,528,5,533
"سمنان","دامغان","مرکزی",32,1208,20,1,257,1486,14,1500
"سمنان","دامغان","مرکزی",33,373,5,0,128,506,4,510
"سمنان","دامغان","مرکزی",34,719,10,1,110,840,7,847
"سمنان","دامغان","مرکزی",35,1172,19,3,204,1398,12,1410
"سمنان","دامغان","مرکزی",36,1102,15,1,226,1344,15,1359
"سمنان","دامغان","مرکزی",37,883,22,3,293,1201,11,1212
"سمنان","دامغان","مرکزی",38,667,12,4,239,922,19,941
"سمنان","دامغان","مرکزی",39,422,1,0,118,541,9,550
"سمنان","دامغان","مرکزی",40,792,14,3,386,1195,18,1213
"سمنان","دامغان","مرکزی",41,459,18,3,204,684,9,693
"سمنان","دامغان","مرکزی",42,676,15,2,200,893,14,907
"سمنان","دامغان","مرکزی",43,595,14,0,376,985,15,1000
"سمنان","دامغان","مرکزی",44,435,20,2,352,809,7,816
"سمنان","دامغان","مرکزی",45,308,7,0,212,527,9,536
"سمنان","دامغان","مرکزی",46,248,8,0,82,338,7,345
"سمنان","دامغان","مرکزی",47,807,9,4,191,1011,5,1016
"سمنان","دامغان","مرکزی",48,195,5,1,50,251,3,254
"سمنان","دامغان","مرکزی",49,90,2,1,26,119,5,124
"سمنان","دامغان","مرکزی",50,291,15,3,170,479,13,492
"سمنان","دامغان","مرکزی",51,239,3,1,43,286,2,288
"سمنان","دامغان","مرکزی",52,208,2,0,19,229,3,232
"سمنان","دامغان","مرکزی",53,322,1,2,24,349,1,350
"سمنان","دامغان","مرکزی",54,333,10,2,54,399,3,402
"سمنان","دامغان","مرکزی",55,409,2,2,24,437,1,438
"سمنان","دامغان","مرکزی",56,891,3,0,33,927,4,931
"سمنان","دامغان","مرکزی",57,175,0,0,26,201,1,202
"سمنان","دامغان","مرکزی",58,550,3,1,41,595,2,597
"سمنان","دامغان","مرکزی",59,1019,4,3,105,1131,3,1134
"سمنان","دامغان","مرکزی",60,171,1,1,9,182,0,182
"سمنان","دامغان","مرکزی",61,329,2,2,27,360,1,361
"سمنان","دامغان","مرکزی",62,756,4,0,97,857,2,859
"سمنان","دامغان","مرکزی",63,666,7,1,137,811,10,821
"سمنان","دامغان","مرکزی",64,449,1,2,95,547,5,552
"سمنان","دامغان","مرکزی",65,525,4,0,71,600,4,604
"سمنان","دامغان","مرکزی",66,306,4,0,25,335,1,336
"سمنان","دامغان","مرکزی",67,1523,6,1,108,1638,6,1644
"سمنان","دامغان","مرکزی",68,114,0,0,5,119,0,119
"سمنان","دامغان","مرکزی",69,787,4,1,45,837,1,838
"سمنان","دامغان","مرکزی",70,649,6,0,47,702,4,706
"سمنان","دامغان","مرکزی",71,342,2,0,21,365,3,368
"سمنان","دامغان","مرکزی",72,267,0,0,13,280,0,280
"سمنان","دامغان","امیرآباد",1,511,1,0,66,578,2,580
"سمنان","دامغان","امیرآباد",2,561,6,1,114,682,7,689
"سمنان","دامغان","امیرآباد",3,614,3,0,51,668,6,674
"سمنان","دامغان","امیرآباد",4,258,3,1,44,306,1,307
"سمنان","دامغان","امیرآباد",5,753,6,1,84,844,5,849
"سمنان","دامغان","امیرآباد",6,459,3,0,98,560,3,563
"سمنان","دامغان","امیرآباد",7,360,0,0,40,400,0,400
"سمنان","دامغان","امیرآباد",8,183,2,0,14,199,0,199
"سمنان","دامغان","امیرآباد",9,170,0,0,26,196,5,201
"سمنان","دامغان","امیرآباد",10,343,6,0,61,410,3,413
"سمنان","دامغان","امیرآباد",11,560,5,0,167,732,4,736
"سمنان","دامغان","امیرآباد",12,346,2,0,17,365,0,365
"سمنان","دامغان","امیرآباد",13,225,1,1,57,284,2,286
"سمنان","دامغان","امیرآباد",14,576,1,0,33,610,2,612
"سمنان","دامغان","امیرآباد",15,506,2,1,80,589,1,590
"سمنان","سمنان","مرکزی",1,620,18,9,367,1014,22,1036
"سمنان","سمنان","مرکزی",2,391,23,10,522,946,11,957
"سمنان","سمنان","مرکزی",3,559,18,18,576,1171,16,1187
"سمنان","سمنان","مرکزی",4,788,13,2,288,1091,13,1104
"سمنان","سمنان","مرکزی",5,461,12,9,269,751,13,764
"سمنان","سمنان","مرکزی",6,615,19,17,348,999,2,1001
"سمنان","سمنان","مرکزی",7,672,13,7,192,884,8,892
"سمنان","سمنان","مرکزی",8,708,7,7,269,991,9,1000
"سمنان","سمنان","مرکزی",9,582,6,4,109,701,12,713
"سمنان","سمنان","مرکزی",10,353,5,2,177,537,13,550
"سمنان","سمنان","مرکزی",11,790,2,8,140,940,13,953
"سمنان","سمنان","مرکزی",12,574,12,4,184,774,15,789
"سمنان","سمنان","مرکزی",13,328,6,3,113,450,8,458
"سمنان","سمنان","مرکزی",14,217,9,0,82,308,6,314
"سمنان","سمنان","مرکزی",15,1013,14,6,139,1172,8,1180
"سمنان","سمنان","مرکزی",16,466,7,1,60,534,8,542
"سمنان","سمنان","مرکزی",17,785,9,10,140,944,11,955
"سمنان","سمنان","مرکزی",18,528,6,5,170,709,16,725
"سمنان","سمنان","مرکزی",19,388,7,1,99,495,6,501
"سمنان","سمنان","مرکزی",20,503,8,4,166,681,8,689
"سمنان","سمنان","مرکزی",21,996,10,7,119,1132,2,1134
"سمنان","سمنان","مرکزی",22,465,2,0,65,532,4,536
"سمنان","سمنان","مرکزی",23,413,3,3,113,532,6,538
"سمنان","سمنان","مرکزی",24,755,5,3,116,879,8,887
"سمنان","سمنان","مرکزی",25,924,9,3,74,1010,7,1017
"سمنان","سمنان","مرکزی",26,342,2,0,29,373,4,377
"سمنان","سمنان","مرکزی",27,663,4,7,126,800,7,807
"سمنان","سمنان","مرکزی",28,767,11,11,203,992,10,1002
"سمنان","سمنان","مرکزی",29,540,6,6,120,672,10,682
"سمنان","سمنان","مرکزی",30,622,10,15,194,841,8,849
"سمنان","سمنان","مرکزی",31,842,18,7,207,1074,13,1087
"سمنان","سمنان","مرکزی",32,849,31,8,253,1141,15,1156
"سمنان","سمنان","مرکزی",33,404,9,2,155,570,12,582
"سمنان","سمنان","مرکزی",34,561,7,4,218,790,15,805
"سمنان","سمنان","مرکزی",35,771,27,28,663,1489,21,1510
"سمنان","سمنان","مرکزی",36,581,16,11,445,1053,15,1068
"سمنان","سمنان","مرکزی",37,405,22,19,361,807,16,823
"سمنان","سمنان","مرکزی",38,807,38,17,474,1336,13,1349
"سمنان","سمنان","مرکزی",39,775,15,14,381,1185,17,1202
"سمنان","سمنان","مرکزی",40,769,20,20,374,1183,17,1200
"سمنان","سمنان","مرکزی",41,543,14,7,287,851,5,856
"سمنان","سمنان","مرکزی",42,830,10,4,278,1122,11,1133
"سمنان","سمنان","مرکزی",43,604,14,2,227,847,6,853
"سمنان","سمنان","مرکزی",44,726,13,0,212,951,14,965
"سمنان","سمنان","مرکزی",45,513,22,12,298,845,8,853
"سمنان","سمنان","مرکزی",46,814,29,12,280,1135,18,1153
"سمنان","سمنان","مرکزی",47,903,25,13,298,1239,19,1258
"سمنان","سمنان","مرکزی",48,533,6,9,187,735,7,742
"سمنان","سمنان","مرکزی",49,686,30,8,405,1129,20,1149
"سمنان","سمنان","مرکزی",50,491,13,12,258,774,10,784
"سمنان","سمنان","مرکزی",51,536,11,6,208,761,15,776
"سمنان","سمنان","مرکزی",52,537,19,11,238,805,9,814
"سمنان","سمنان","مرکزی",53,410,13,6,267,696,7,703
"سمنان","سمنان","مرکزی",54,445,15,10,322,792,12,804
"سمنان","سمنان","مرکزی",55,349,17,9,318,693,8,701
"سمنان","سمنان","مرکزی",56,456,19,5,287,767,10,777
"سمنان","سمنان","مرکزی",57,417,8,1,286,712,5,717
"سمنان","سمنان","مرکزی",58,301,10,1,205,517,5,522
"سمنان","سمنان","مرکزی",59,666,28,4,283,981,17,998
"سمنان","سمنان","مرکزی",60,578,18,9,321,926,12,938
"سمنان","سمنان","مرکزی",61,666,36,12,237,951,6,957
"سمنان","سمنان","مرکزی",62,545,13,4,101,663,7,670
"سمنان","سمنان","مرکزی",63,628,25,25,670,1348,14,1362
"سمنان","سمنان","مرکزی",64,667,13,15,552,1247,13,1260
"سمنان","سمنان","مرکزی",65,364,29,20,563,976,20,996
"سمنان","سمنان","مرکزی",66,412,16,13,322,763,7,770
"سمنان","سمنان","مرکزی",67,999,27,13,244,1283,16,1299
"سمنان","سمنان","مرکزی",68,760,28,15,318,1121,16,1137
"سمنان","سمنان","مرکزی",69,401,9,7,213,630,5,635
"سمنان","سمنان","مرکزی",70,1173,14,6,322,1515,10,1525
"سمنان","سمنان","مرکزی",71,1039,27,15,416,1497,33,1530
"سمنان","سمنان","مرکزی",72,611,13,2,183,809,14,823
"سمنان","سمنان","مرکزی",73,346,10,8,135,499,2,501
"سمنان","سمنان","مرکزی",74,808,16,14,477,1315,21,1336
"سمنان","سمنان","مرکزی",75,341,11,7,170,529,6,535
"سمنان","سمنان","مرکزی",76,691,17,4,147,859,13,872
"سمنان","سمنان","مرکزی",77,836,44,4,106,990,8,998
"سمنان","سمنان","مرکزی",78,770,20,3,202,995,11,1006
"سمنان","سمنان","مرکزی",79,910,12,3,182,1107,16,1123
"سمنان","سمنان","مرکزی",80,586,12,13,209,820,9,829
"سمنان","سمنان","مرکزی",81,146,12,1,110,269,5,274
"سمنان","سمنان","مرکزی",82,546,6,3,120,675,8,683
"سمنان","سمنان","مرکزی",83,450,5,1,81,537,8,545
"سمنان","سمنان","مرکزی",84,633,6,4,110,753,7,760
"سمنان","سمنان","مرکزی",85,778,1,0,84,863,4,867
"سمنان","سمنان","مرکزی",86,713,4,1,102,820,8,828
"سمنان","سمنان","مرکزی",87,762,5,0,58,825,9,834
"سمنان","سمنان","مرکزی",88,341,12,0,85,438,14,452
"سمنان","سمنان","مرکزی",89,429,9,1,112,551,6,557
"سمنان","سمنان","مرکزی",90,199,6,1,30,236,2,238
"سمنان","سمنان","مرکزی",91,158,4,2,26,190,3,193
"سمنان","سمنان","مرکزی",92,82,4,1,54,141,4,145
"سمنان","سمنان","مرکزی",93,357,15,3,165,540,21,561
"سمنان","سمنان","مرکزی",94,255,61,30,318,664,20,684
"سمنان","سمنان","مرکزی",95,101,4,3,81,189,19,208
"سمنان","سمنان","مرکزی",96,349,2,1,92,444,1,445
"سمنان","سمنان","مرکزی",97,951,6,0,79,1036,10,1046
"سمنان","سمنان","مرکزی",98,711,6,1,45,763,4,767
"سمنان","سمنان","مرکزی",99,567,3,0,51,621,5,626
"سمنان","سمنان","مرکزی",100,707,0,1,84,792,4,796
"سمنان","سمنان","مرکزی",101,219,0,1,26,246,3,249
"سمنان","سمنان","مرکزی",102,190,3,1,49,243,5,248
"سمنان","سمنان","مرکزی",103,628,11,17,432,1088,17,1105
"سمنان","سمنان","مرکزی",104,363,3,0,59,425,4,429
"سمنان","سمنان","سرخه",1,745,14,2,131,892,11,903
"سمنان","سمنان","سرخه",2,817,12,2,93,924,6,930
"سمنان","سمنان","سرخه",3,738,13,1,117,869,16,885
"سمنان","سمنان","سرخه",4,379,18,0,82,479,3,482
"سمنان","سمنان","سرخه",5,386,5,0,71,462,6,468
"سمنان","سمنان","سرخه",6,250,5,1,85,341,4,345
"سمنان","سمنان","سرخه",7,385,6,1,69,461,2,463
"سمنان","سمنان","سرخه",8,896,16,1,188,1101,10,1111
"سمنان","سمنان","سرخه",9,741,27,5,255,1028,17,1045
"سمنان","سمنان","سرخه",10,91,0,0,31,122,0,122
"سمنان","سمنان","سرخه",11,376,5,0,56,437,0,437
"سمنان","سمنان","سرخه",12,347,0,0,23,370,1,371
"سمنان","سمنان","سرخه",13,362,0,1,14,377,1,378
"سمنان","سمنان","سرخه",14,308,0,0,15,323,0,323
"سمنان","سمنان","سرخه",15,640,4,0,48,692,0,692
"سمنان","سمنان","سرخه",16,660,2,0,149,811,8,819
"سمنان","سمنان","سرخه",17,134,2,0,15,151,1,152
"سمنان","سمنان","سرخه",18,476,1,1,33,511,6,517
"سمنان","سمنان","سرخه",19,561,3,0,100,664,3,667
"سمنان","سمنان","سرخه",20,496,1,0,34,531,1,532
"سمنان","سمنان","سرخه",21,211,1,2,36,250,2,252
"سمنان","شاهرود","مرکزی",1,689,7,1,193,890,6,896
"سمنان","شاهرود","مرکزی",2,426,11,6,198,641,6,647
"سمنان","شاهرود","مرکزی",3,197,8,5,209,419,4,423
"سمنان","شاهرود","مرکزی",4,149,3,1,170,323,1,324
"سمنان","شاهرود","مرکزی",5,368,17,6,423,814,14,828
"سمنان","شاهرود","مرکزی",6,159,7,4,241,411,3,414
"سمنان","شاهرود","مرکزی",7,307,8,8,322,645,7,652
"سمنان","شاهرود","مرکزی",8,234,3,6,183,426,7,433
"سمنان","شاهرود","مرکزی",9,468,20,9,368,865,15,880
"سمنان","شاهرود","مرکزی",10,257,15,10,294,576,13,589
"سمنان","شاهرود","مرکزی",11,203,8,8,220,439,8,447
"سمنان","شاهرود","مرکزی",12,494,28,14,687,1223,13,1236
"سمنان","شاهرود","مرکزی",13,99,6,6,312,423,6,429
"سمنان","شاهرود","مرکزی",14,598,18,22,800,1438,14,1452
"سمنان","شاهرود","مرکزی",15,158,5,5,171,339,8,347
"سمنان","شاهرود","مرکزی",16,199,10,6,229,444,10,454
"سمنان","شاهرود","مرکزی",17,165,7,14,409,595,10,605
"سمنان","شاهرود","مرکزی",18,670,22,8,276,976,19,995
"سمنان","شاهرود","مرکزی",19,203,9,8,202,422,10,432
"سمنان","شاهرود","مرکزی",20,716,32,9,503,1260,9,1269
"سمنان","شاهرود","مرکزی",21,146,12,2,175,335,3,338
"سمنان","شاهرود","مرکزی",22,119,6,1,158,284,0,284
"سمنان","شاهرود","مرکزی",23,98,10,4,120,232,5,237
"سمنان","شاهرود","مرکزی",24,97,0,1,61,159,2,161
"سمنان","شاهرود","مرکزی",25,209,12,3,152,376,2,378
"سمنان","شاهرود","مرکزی",26,494,12,9,161,676,9,685
"سمنان","شاهرود","مرکزی",27,563,5,3,92,663,6,669
"سمنان","شاهرود","مرکزی",28,260,4,0,62,326,5,331
"سمنان","شاهرود","مرکزی",29,251,2,1,107,361,6,367
"سمنان","شاهرود","مرکزی",30,447,5,0,80,532,6,538
"سمنان","شاهرود","مرکزی",31,326,7,2,100,435,3,438
"سمنان","شاهرود","مرکزی",32,546,6,2,112,666,7,673
"سمنان","شاهرود","مرکزی",33,273,12,4,159,448,5,453
"سمنان","شاهرود","مرکزی",34,428,2,5,89,524,6,530
"سمنان","شاهرود","مرکزی",35,608,13,12,204,837,15,852
"سمنان","شاهرود","مرکزی",36,288,9,4,103,404,2,406
"سمنان","شاهرود","مرکزی",37,268,16,2,182,468,6,474
"سمنان","شاهرود","مرکزی",38,411,10,2,171,594,10,604
"سمنان","شاهرود","مرکزی",39,202,6,2,98,308,7,315
"سمنان","شاهرود","مرکزی",40,438,15,7,283,743,15,758
"سمنان","شاهرود","مرکزی",41,192,13,2,226,433,10,443
"سمنان","شاهرود","مرکزی",42,605,16,9,333,963,13,976
"سمنان","شاهرود","مرکزی",43,406,14,7,253,680,11,691
"سمنان","شاهرود","مرکزی",44,643,21,10,442,1116,17,1133
"سمنان","شاهرود","مرکزی",45,487,19,8,202,716,8,724
"سمنان","شاهرود","مرکزی",46,680,22,6,263,971,17,988
"سمنان","شاهرود","مرکزی",47,338,7,4,92,441,6,447
"سمنان","شاهرود","مرکزی",48,368,9,1,204,582,8,590
"سمنان","شاهرود","مرکزی",49,209,5,2,88,304,9,313
"سمنان","شاهرود","مرکزی",50,605,9,3,147,764,4,768
"سمنان","شاهرود","مرکزی",51,229,8,4,85,326,5,331
"سمنان","شاهرود","مرکزی",52,295,8,1,160,464,6,470
"سمنان","شاهرود","مرکزی",53,119,8,0,84,211,6,217
"سمنان","شاهرود","مرکزی",54,611,12,4,140,767,13,780
"سمنان","شاهرود","مرکزی",55,264,13,3,87,367,11,378
"سمنان","شاهرود","مرکزی",56,528,3,3,125,659,5,664
"سمنان","شاهرود","مرکزی",57,815,13,5,152,985,4,989
"سمنان","شاهرود","مرکزی",58,391,5,1,83,480,5,485
"سمنان","شاهرود","مرکزی",59,813,12,5,113,943,13,956
"سمنان","شاهرود","مرکزی",60,469,9,2,116,596,9,605
"سمنان","شاهرود","مرکزی",61,559,19,6,233,817,8,825
"سمنان","شاهرود","مرکزی",62,642,9,6,168,825,6,831
"سمنان","شاهرود","مرکزی",63,898,23,14,202,1137,10,1147
"سمنان","شاهرود","مرکزی",64,497,13,7,197,714,8,722
"سمنان","شاهرود","مرکزی",65,450,13,8,291,762,54,816
"سمنان","شاهرود","مرکزی",66,330,61,67,485,943,25,968
"سمنان","شاهرود","مرکزی",67,690,11,3,169,873,10,883
"سمنان","شاهرود","مرکزی",68,191,2,0,23,216,1,217
"سمنان","شاهرود","مرکزی",69,770,12,5,121,908,6,914
"سمنان","شاهرود","مرکزی",70,423,14,1,159,597,6,603
"سمنان","شاهرود","مرکزی",71,546,14,4,205,769,8,777
"سمنان","شاهرود","مرکزی",72,768,14,5,195,982,18,1000
"سمنان","شاهرود","مرکزی",73,490,3,1,63,557,3,560
"سمنان","شاهرود","مرکزی",74,658,8,0,68,734,3,737
"سمنان","شاهرود","مرکزی",75,330,1,1,28,360,1,361
"سمنان","شاهرود","مرکزی",76,256,5,0,92,353,5,358
"سمنان","شاهرود","مرکزی",77,258,5,9,49,321,6,327
"سمنان","شاهرود","مرکزی",78,135,6,2,49,192,1,193
"سمنان","شاهرود","مرکزی",79,739,12,7,234,992,13,1005
"سمنان","شاهرود","مرکزی",80,364,2,1,92,459,5,464
"سمنان","شاهرود","مرکزی",81,890,16,14,277,1197,10,1207
"سمنان","شاهرود","مرکزی",82,478,10,7,238,733,7,740
"سمنان","شاهرود","مرکزی",83,230,2,4,80,316,4,320
"سمنان","شاهرود","مرکزی",84,1337,14,4,183,1538,8,1546
"سمنان","شاهرود","مرکزی",85,815,5,2,169,991,4,995
"سمنان","شاهرود","مرکزی",86,307,10,0,80,397,4,401
"سمنان","شاهرود","مرکزی",87,182,9,5,88,284,3,287
"سمنان","شاهرود","مرکزی",88,719,11,3,195,928,12,940
"سمنان","شاهرود","مرکزی",89,121,2,8,86,217,3,220
"سمنان","شاهرود","مرکزی",90,811,19,9,249,1088,12,1100
"سمنان","شاهرود","مرکزی",91,624,6,4,247,881,20,901
"سمنان","شاهرود","مرکزی",92,466,21,3,176,666,8,674
"سمنان","شاهرود","مرکزی",93,333,2,4,87,426,7,433
"سمنان","شاهرود","مرکزی",94,458,3,2,128,591,7,598
"سمنان","شاهرود","مرکزی",95,462,9,5,166,642,6,648
"سمنان","شاهرود","مرکزی",96,358,7,6,115,486,7,493
"سمنان","شاهرود","مرکزی",97,419,2,5,222,648,9,657
"سمنان","شاهرود","مرکزی",98,382,2,6,184,574,5,579
"سمنان","شاهرود","مرکزی",99,283,5,2,99,389,11,400
"سمنان","شاهرود","مرکزی",100,946,22,1,217,1186,17,1203
"سمنان","شاهرود","مرکزی",101,373,2,1,111,487,6,493
"سمنان","شاهرود","مرکزی",102,446,16,4,172,638,9,647
"سمنان","شاهرود","مرکزی",103,308,3,3,78,392,3,395
"سمنان","شاهرود","مرکزی",104,968,12,4,198,1182,15,1197
"سمنان","شاهرود","مرکزی",105,277,7,0,120,404,4,408
"سمنان","شاهرود","مرکزی",106,219,5,0,83,307,7,314
"سمنان","شاهرود","مرکزی",107,476,8,2,139,625,8,633
"سمنان","شاهرود","مرکزی",108,159,2,0,31,192,4,196
"سمنان","شاهرود","مرکزی",109,521,2,4,98,625,6,631
"سمنان","شاهرود","مرکزی",110,122,2,0,31,155,1,156
"سمنان","شاهرود","مرکزی",111,811,9,7,154,981,11,992
"سمنان","شاهرود","مرکزی",112,875,5,0,90,970,6,976
"سمنان","شاهرود","مرکزی",113,556,3,0,106,665,6,671
"سمنان","شاهرود","مرکزی",114,466,0,3,46,515,2,517
"سمنان","شاهرود","مرکزی",115,829,3,0,98,930,7,937
"سمنان","شاهرود","مرکزی",116,1365,11,2,212,1590,6,1596
"سمنان","شاهرود","مرکزی",117,460,2,2,83,547,3,550
"سمنان","شاهرود","مرکزی",118,599,17,1,105,722,3,725
"سمنان","شاهرود","مرکزی",119,939,13,1,116,1069,9,1078
"سمنان","شاهرود","مرکزی",120,966,18,6,198,1188,18,1206
"سمنان","شاهرود","مرکزی",121,105,2,0,32,139,1,140
"سمنان","شاهرود","مرکزی",122,679,6,2,71,758,5,763
"سمنان","شاهرود","مرکزی",123,257,10,2,59,328,2,330
"سمنان","شاهرود","مرکزی",124,298,2,0,29,329,4,333
"سمنان","شاهرود","مرکزی",125,492,9,3,97,601,10,611
"سمنان","شاهرود","مرکزی",126,664,7,5,105,781,8,789
"سمنان","شاهرود","مرکزی",127,850,9,2,92,953,6,959
"سمنان","شاهرود","مرکزی",128,971,5,3,139,1118,6,1124
"سمنان","شاهرود","مرکزی",129,963,10,9,247,1229,18,1247
"سمنان","شاهرود","مرکزی",130,502,5,2,111,620,5,625
"سمنان","شاهرود","مرکزی",131,506,5,3,93,607,3,610
"سمنان","شاهرود","مرکزی",132,323,0,1,86,410,2,412
"سمنان","شاهرود","مرکزی",133,199,5,7,110,321,12,333
"سمنان","شاهرود","مرکزی",134,141,5,0,41,187,0,187
"سمنان","شاهرود","مرکزی",135,232,1,1,50,284,3,287
"سمنان","شاهرود","مرکزی",136,636,1,1,49,687,2,689
"سمنان","شاهرود","مرکزی",137,669,1,1,37,708,4,712
"سمنان","شاهرود","مرکزی",138,412,2,0,32,446,2,448
"سمنان","شاهرود","مرکزی",139,756,5,0,43,804,8,812
"سمنان","شاهرود","مرکزی",140,909,3,3,35,950,4,954
"سمنان","شاهرود","مرکزی",141,494,4,2,68,568,1,569
"سمنان","شاهرود","مرکزی",142,413,9,0,36,458,0,458
"سمنان","شاهرود","مرکزی",143,492,2,0,35,529,1,530
"سمنان","شاهرود","مرکزی",144,313,3,0,43,359,8,367
"سمنان","شاهرود","مرکزی",145,316,1,2,60,379,1,380
"سمنان","شاهرود","مرکزی",146,475,0,0,24,499,1,500
"سمنان","شاهرود","مرکزی",147,419,1,0,56,476,1,477
"سمنان","شاهرود","مرکزی",148,424,1,0,22,447,1,448
"سمنان","شاهرود","مرکزی",149,519,3,1,75,598,4,602
"سمنان","شاهرود","مرکزی",150,368,1,2,35,406,4,410
"سمنان","شاهرود","مرکزی",151,298,2,1,23,324,2,326
"سمنان","شاهرود","مرکزی",152,585,1,0,62,648,5,653
"سمنان","شاهرود","مرکزی",153,69,0,0,5,74,0,74
"سمنان","شاهرود","مرکزی",154,328,2,0,191,521,0,521
"سمنان","شاهرود","مرکزی",155,157,0,1,50,208,0,208
"سمنان","شاهرود","بیارجمند",1,361,0,0,91,452,7,459
"سمنان","شاهرود","بیارجمند",2,721,4,0,107,832,5,837
"سمنان","شاهرود","بیارجمند",3,253,2,2,17,274,1,275
"سمنان","شاهرود","بیارجمند",4,238,1,0,31,270,2,272
"سمنان","شاهرود","بیارجمند",5,223,1,1,53,278,0,278
"سمنان","شاهرود","بیارجمند",6,324,0,0,38,362,4,366
"سمنان","شاهرود","بیارجمند",7,225,0,0,7,232,1,233
"سمنان","شاهرود","بیارجمند",8,196,1,0,44,241,2,243
"سمنان","شاهرود","بیارجمند",9,181,0,0,12,193,0,193
"سمنان","شاهرود","بیارجمند",10,561,0,0,16,577,0,577
"سمنان","شاهرود","بیارجمند",11,419,0,0,12,431,1,432
"سمنان","شاهرود","بیارجمند",12,311,3,0,17,331,1,332
"سمنان","شاهرود","بیارجمند",13,303,4,1,17,325,0,325
"سمنان","شاهرود","بیارجمند",14,163,0,0,7,170,0,170
"سمنان","شاهرود","بیارجمند",15,256,0,0,12,268,0,268
"سمنان","شاهرود","میامی",1,1098,9,1,218,1326,17,1343
"سمنان","شاهرود","میامی",2,637,9,2,76,724,9,733
"سمنان","شاهرود","میامی",3,419,6,1,66,492,8,500
"سمنان","شاهرود","میامی",4,162,2,1,70,235,1,236
"سمنان","شاهرود","میامی",5,729,5,1,61,796,4,800
"سمنان","شاهرود","میامی",6,342,0,0,21,363,0,363
"سمنان","شاهرود","میامی",7,573,0,0,49,622,4,626
"سمنان","شاهرود","میامی",8,405,3,3,240,651,13,664
"سمنان","شاهرود","میامی",9,515,1,0,18,534,3,537
"سمنان","شاهرود","میامی",10,264,0,0,15,279,3,282
"سمنان","شاهرود","میامی",11,190,0,1,24,215,1,216
"سمنان","شاهرود","میامی",12,388,0,0,13,401,1,402
"سمنان","شاهرود","میامی",13,672,2,0,11,685,3,688
"سمنان","شاهرود","میامی",14,790,3,1,17,811,0,811
"سمنان","شاهرود","میامی",15,104,0,0,11,115,0,115
"سمنان","شاهرود","میامی",16,677,3,0,71,751,4,755
"سمنان","شاهرود","میامی",17,285,1,0,23,309,1,310
"سمنان","شاهرود","میامی",18,381,0,0,25,406,5,411
"سمنان","شاهرود","میامی",19,346,0,0,20,366,0,366
"سمنان","شاهرود","میامی",20,472,1,0,12,485,0,485
"سمنان","شاهرود","میامی",21,301,4,0,34,339,7,346
"سمنان","شاهرود","میامی",22,95,4,0,16,115,0,115
"سمنان","شاهرود","میامی",23,390,0,1,35,426,1,427
"سمنان","شاهرود","میامی",24,143,1,1,29,174,0,174
"سمنان","شاهرود","میامی",25,115,0,0,2,117,1,118
"سمنان","شاهرود","میامی",26,213,1,1,12,227,1,228
"سمنان","شاهرود","میامی",27,590,4,1,82,677,4,681
"سمنان","شاهرود","میامی",28,619,0,0,54,673,5,678
"سمنان","شاهرود","میامی",29,1312,7,0,73,1392,4,1396
"سمنان","شاهرود","میامی",30,252,3,0,15,270,0,270
"سمنان","شاهرود","میامی",31,351,0,0,4,355,0,355
"سمنان","شاهرود","میامی",32,749,5,0,68,822,5,827
"سمنان","شاهرود","میامی",33,446,3,0,43,492,0,492
"سمنان","شاهرود","میامی",34,391,1,1,32,425,7,432
"سمنان","شاهرود","میامی",35,800,0,2,32,834,1,835
"سمنان","شاهرود","میامی",36,929,5,0,26,960,0,960
"سمنان","شاهرود","میامی",37,479,1,2,10,492,0,492
"سمنان","شاهرود","میامی",38,786,2,0,9,797,0,797
"سمنان","شاهرود","میامی",39,698,2,0,52,752,1,753
"سمنان","شاهرود","میامی",40,685,1,0,73,759,3,762
"سمنان","شاهرود","میامی",41,634,4,1,76,715,0,715
"سمنان","شاهرود","میامی",42,658,1,0,5,664,0,664
"سمنان","شاهرود","بسطام",1,1481,25,9,435,1950,22,1972
"سمنان","شاهرود","بسطام",2,564,5,1,86,656,2,658
"سمنان","شاهرود","بسطام",3,824,4,1,141,970,12,982
"سمنان","شاهرود","بسطام",4,510,2,1,107,620,6,626
"سمنان","شاهرود","بسطام",5,425,4,0,122,551,7,558
"سمنان","شاهرود","بسطام",6,380,1,3,82,466,8,474
"سمنان","شاهرود","بسطام",7,432,4,3,49,488,1,489
"سمنان","شاهرود","بسطام",8,955,3,2,53,1013,4,1017
"سمنان","شاهرود","بسطام",9,636,6,1,78,721,5,726
"سمنان","شاهرود","بسطام",10,333,2,2,27,364,3,367
"سمنان","شاهرود","بسطام",11,1333,7,2,131,1473,7,1480
"سمنان","شاهرود","بسطام",12,675,1,0,52,728,3,731
"سمنان","شاهرود","بسطام",13,1037,10,1,157,1205,6,1211
"سمنان","شاهرود","بسطام",14,892,3,0,93,988,4,992
"سمنان","شاهرود","بسطام",15,358,0,1,21,380,1,381
"سمنان","شاهرود","بسطام",16,221,3,1,25,250,5,255
"سمنان","شاهرود","بسطام",17,929,19,15,643,1606,28,1634
"سمنان","شاهرود","بسطام",18,620,10,0,62,692,1,693
"سمنان","شاهرود","بسطام",19,414,6,0,30,450,1,451
"سمنان","شاهرود","بسطام",20,441,0,0,14,455,1,456
"سمنان","شاهرود","بسطام",21,536,0,0,15,551,0,551
"سمنان","شاهرود","بسطام",22,99,6,1,16,122,3,125
"سمنان","شاهرود","بسطام",23,451,7,2,60,520,3,523
"سمنان","شاهرود","بسطام",24,519,4,1,17,541,2,543
"سمنان","شاهرود","بسطام",25,302,1,0,24,327,2,329
"سمنان","شاهرود","بسطام",26,507,1,0,19,527,4,531
"سمنان","شاهرود","بسطام",27,257,3,1,38,299,4,303
"سمنان","شاهرود","بسطام",28,328,1,0,42,371,0,371
"سمنان","شاهرود","بسطام",29,395,1,2,9,407,5,412
"سمنان","شاهرود","بسطام",30,459,0,0,20,479,0,479
"سمنان","شاهرود","بسطام",31,360,1,1,18,380,1,381
"سمنان","شاهرود","بسطام",32,353,1,0,33,387,2,389
"سمنان","شاهرود","بسطام",33,952,0,1,31,984,3,987
"سمنان","شاهرود","بسطام",34,680,1,0,41,722,3,725
"سمنان","شاهرود","بسطام",35,902,1,3,68,974,12,986
"سمنان","شاهرود","بسطام",36,560,8,4,134,706,4,710
"سمنان","شاهرود","بسطام",37,835,6,2,126,969,12,981
"سمنان","شاهرود","بسطام",38,502,0,0,38,540,4,544
"سمنان","شاهرود","بسطام",39,702,5,3,70,780,14,794
"سمنان","شاهرود","بسطام",40,744,5,0,48,797,4,801
"سمنان","شاهرود","بسطام",41,441,2,0,20,463,5,468
"سمنان","شاهرود","بسطام",42,477,1,1,30,509,4,513
"سمنان","شاهرود","بسطام",43,562,0,2,19,583,2,585
"سمنان","گرمسار","مرکزی",1,1004,12,13,295,1324,10,1334
"سمنان","گرمسار","مرکزی",2,854,8,3,171,1036,9,1045
"سمنان","گرمسار","مرکزی",3,497,6,2,158,663,8,671
"سمنان","گرمسار","مرکزی",4,806,8,6,194,1014,8,1022
"سمنان","گرمسار","مرکزی",5,851,9,3,244,1107,14,1121
"سمنان","گرمسار","مرکزی",6,885,5,3,102,995,5,1000
"سمنان","گرمسار","مرکزی",7,771,13,5,122,911,12,923
"سمنان","گرمسار","مرکزی",8,813,8,12,287,1120,16,1136
"سمنان","گرمسار","مرکزی",9,814,7,3,155,979,8,987
"سمنان","گرمسار","مرکزی",10,606,7,8,228,849,12,861
"سمنان","گرمسار","مرکزی",11,175,2,4,61,242,3,245
"سمنان","گرمسار","مرکزی",12,672,12,4,420,1108,17,1125
"سمنان","گرمسار","مرکزی",13,1113,14,9,351,1487,16,1503
"سمنان","گرمسار","مرکزی",14,251,1,3,109,364,5,369
"سمنان","گرمسار","مرکزی",15,515,12,10,300,837,8,845
"سمنان","گرمسار","مرکزی",16,411,10,8,256,685,15,700
"سمنان","گرمسار","مرکزی",17,321,4,7,150,482,7,489
"سمنان","گرمسار","مرکزی",18,564,9,5,207,785,4,789
"سمنان","گرمسار","مرکزی",19,381,16,8,338,743,8,751
"سمنان","گرمسار","مرکزی",20,593,5,4,334,936,3,939
"سمنان","گرمسار","مرکزی",21,995,8,3,207,1213,7,1220
"سمنان","گرمسار","مرکزی",22,662,9,7,156,834,3,837
"سمنان","گرمسار","مرکزی",23,594,8,13,198,813,11,824
"سمنان","گرمسار","مرکزی",24,889,4,1,100,994,6,1000
"سمنان","گرمسار","مرکزی",25,498,9,15,198,720,10,730
"سمنان","گرمسار","مرکزی",26,255,1,0,71,327,3,330
"سمنان","گرمسار","مرکزی",27,337,7,7,44,395,0,395
"سمنان","گرمسار","مرکزی",28,259,6,1,47,313,3,316
"سمنان","گرمسار","مرکزی",29,484,5,1,84,574,1,575
"سمنان","گرمسار","مرکزی",30,324,5,2,144,475,3,478
"سمنان","گرمسار","مرکزی",31,722,0,2,26,750,2,752
"سمنان","گرمسار","مرکزی",32,364,1,2,42,409,1,410
"سمنان","گرمسار","مرکزی",33,270,2,2,44,318,2,320
"سمنان","گرمسار","مرکزی",34,857,2,2,114,975,3,978
"سمنان","گرمسار","مرکزی",35,52,1,1,8,62,0,62
"سمنان","گرمسار","مرکزی",36,783,2,2,106,893,8,901
"سمنان","گرمسار","مرکزی",37,467,2,3,32,504,0,504
"سمنان","گرمسار","مرکزی",38,434,2,1,48,485,3,488
"سمنان","گرمسار","مرکزی",39,479,2,2,58,541,2,543
"سمنان","گرمسار","مرکزی",40,223,2,10,91,326,2,328
"سمنان","گرمسار","مرکزی",41,354,5,0,36,395,4,399
"سمنان","گرمسار","مرکزی",42,392,1,0,41,434,0,434
"سمنان","گرمسار","آرادان",1,886,5,23,76,990,7,997
"سمنان","گرمسار","آرادان",2,475,2,48,108,633,8,641
"سمنان","گرمسار","آرادان",3,519,3,94,82,698,5,703
"سمنان","گرمسار","آرادان",4,324,2,6,42,374,2,376
"سمنان","گرمسار","آرادان",5,532,1,5,63,601,3,604
"سمنان","گرمسار","آرادان",6,83,0,1,10,94,0,94
"سمنان","گرمسار","آرادان",7,455,3,6,56,520,1,521
"سمنان","گرمسار","آرادان",8,478,0,0,71,549,0,549
"سمنان","گرمسار","آرادان",9,425,1,3,57,486,3,489
"سمنان","گرمسار","آرادان",10,659,1,9,50,719,6,725
"سمنان","گرمسار","آرادان",11,179,1,5,22,207,1,208
"سمنان","گرمسار","آرادان",12,502,3,5,59,569,9,578
"سمنان","گرمسار","آرادان",13,440,0,2,55,497,7,504
"سمنان","گرمسار","آرادان",14,484,5,8,32,529,0,529
"سمنان","گرمسار","آرادان",15,540,3,0,43,586,5,591
"سمنان","گرمسار","آرادان",16,735,3,10,43,791,3,794
"سمنان","گرمسار","آرادان",17,205,0,2,14,221,3,224
"سمنان","گرمسار","آرادان",18,243,0,1,30,274,3,277
"سمنان","گرمسار","آرادان",19,83,1,1,15,100,1,101
"سمنان","گرمسار","آرادان",20,310,0,0,25,335,2,337
"سمنان","گرمسار","آرادان",21,219,0,1,8,228,0,228
"سمنان","گرمسار","آرادان",22,124,0,0,11,135,0,135
"سمنان","گرمسار","آرادان",23,188,0,0,3,191,0,191
"سمنان","گرمسار","آرادان",24,141,6,0,28,175,2,177
"سمنان","گرمسار","آرادان",25,155,0,0,9,164,0,164
"سمنان","گرمسار","ایوانکی",1,564,2,4,216,786,7,793
"سمنان","گرمسار","ایوانکی",2,282,2,2,136,422,1,423
"سمنان","گرمسار","ایوانکی",3,444,4,4,204,656,8,664
"سمنان","گرمسار","ایوانکی",4,637,4,4,109,754,5,759
"سمنان","گرمسار","ایوانکی",5,188,2,0,101,291,6,297
"سمنان","گرمسار","ایوانکی",6,570,7,3,270,850,5,855
"سمنان","گرمسار","ایوانکی",7,483,8,1,127,619,3,622
"سمنان","گرمسار","ایوانکی",8,655,5,0,131,791,4,795
"سمنان","گرمسار","ایوانکی",9,271,1,1,100,373,3,376
"سمنان","گرمسار","ایوانکی",10,263,1,1,140,405,3,408
"سمنان","گرمسار","ایوانکی",11,162,1,0,21,184,1,185
"سمنان","گرمسار","ایوانکی",12,334,2,1,22,359,0,359
"سمنان","گرمسار","ایوانکی",13,377,0,0,50,427,2,429
"سمنان","گرمسار","ایوانکی",14,283,2,3,110,398,2,400
"سمنان","مهدیشهر","مرکزی",1,795,10,2,130,937,9,946
"سمنان","مهدیشهر","مرکزی",2,948,14,1,137,1100,10,1110
"سمنان","مهدیشهر","مرکزی",3,500,11,0,108,619,5,624
"سمنان","مهدیشهر","مرکزی",4,845,19,2,162,1028,11,1039
"سمنان","مهدیشهر","مرکزی",5,779,16,4,171,970,10,980
"سمنان","مهدیشهر","مرکزی",6,924,21,2,204,1151,6,1157
"سمنان","مهدیشهر","مرکزی",7,746,8,5,115,874,9,883
"سمنان","مهدیشهر","مرکزی",8,518,7,0,73,598,3,601
"سمنان","مهدیشهر","مرکزی",9,498,6,3,88,595,5,600
"سمنان","مهدیشهر","مرکزی",10,937,19,6,151,1113,13,1126
"سمنان","مهدیشهر","مرکزی",11,391,4,0,50,445,5,450
"سمنان","مهدیشهر","مرکزی",12,840,25,2,307,1174,14,1188
"سمنان","مهدیشهر","مرکزی",13,795,18,5,288,1106,13,1119
"سمنان","مهدیشهر","مرکزی",14,185,1,0,35,221,2,223
"سمنان","مهدیشهر","مرکزی",15,369,5,0,91,465,4,469
"سمنان","مهدیشهر","مرکزی",16,565,4,5,99,673,7,680
"سمنان","مهدیشهر","مرکزی",17,718,4,2,76,800,3,803
"سمنان","مهدیشهر","مرکزی",18,741,3,1,49,794,1,795
"سمنان","مهدیشهر","مرکزی",19,488,7,3,70,568,6,574
"سمنان","مهدیشهر","شهمیرزاد",1,432,12,6,371,821,15,836
"سمنان","مهدیشهر","شهمیرزاد",2,410,12,6,326,754,8,762
"سمنان","مهدیشهر","شهمیرزاد",3,326,10,6,227,569,5,574
"سمنان","مهدیشهر","شهمیرزاد",4,625,8,5,216,854,6,860
"سمنان","مهدیشهر","شهمیرزاد",5,435,8,2,163,608,9,617
"سمنان","مهدیشهر","شهمیرزاد",6,363,18,6,381,768,8,776
"سمنان","مهدیشهر","شهمیرزاد",7,196,3,6,117,322,3,325
"سمنان","مهدیشهر","شهمیرزاد",8,252,8,5,111,376,4,380
"سمنان","مهدیشهر","شهمیرزاد",9,207,1,0,60,268,0,268
"سمنان","مهدیشهر","شهمیرزاد",10,350,0,0,23,373,0,373
"سمنان","مهدیشهر","شهمیرزاد",11,971,5,5,109,1090,10,1100
"سمنان","مهدیشهر","شهمیرزاد",12,438,4,1,81,524,7,531
"سمنان","مهدیشهر","شهمیرزاد",13,100,1,0,10,111,1,112
"سمنان","مهدیشهر","شهمیرزاد",14,371,4,3,52,430,4,434
"سمنان","مهدیشهر","شهمیرزاد",15,397,2,1,63,463,3,466
"سیستان_و_بلوچستان","ایرانشهر","مرکزی",1,146,6,10,421,583,7,590
"سیستان_و_بلوچستان","ایرانشهر","مرکزی",2,275,7,19,770,1071,7,1078
"سیستان_و_بلوچستان","ایرانشهر","مرکزی",3,116,2,3,328,449,6,455
"سیستان_و_بلوچستان","ایرانشهر","مرکزی",4,208,3,9,676,896,18,914
"سیستان_و_بلوچستان","ایرانشهر","مرکزی",5,181,5,38,502,726,6,732
"سیستان_و_بلوچستان","ایرانشهر","مرکزی",6,161,23,18,742,944,5,949
"سیستان_و_بلوچستان","ایرانشهر","مرکزی",7,71,8,10,462,551,2,553
"سیستان_و_بلوچستان","ایرانشهر","مرکزی",8,117,8,21,832,978,12,990
"سیستان_و_بلوچستان","ایرانشهر","مرکزی",9,40,2,9,363,414,3,417
"سیستان_و_بلوچستان","ایرانشهر","مرکزی",10,32,0,2,74,108,1,109
"سیستان_و_بلوچستان","ایرانشهر","مرکزی",11,170,5,19,763,957,9,966
"سیستان_و_بلوچستان","ایرانشهر","مرکزی",12,79,0,7,190,276,0,276
"سیستان_و_بلوچستان","ایرانشهر","مرکزی",13,237,7,12,509,765,11,776
"سیستان_و_بلوچستان","ایرانشهر","مرکزی",14,182,8,23,815,1028,13,1041
"سیستان_و_بلوچستان","ایرانشهر","مرکزی",15,221,5,15,825,1066,9,1075
"سیستان_و_بلوچستان","ایرانشهر","مرکزی",16,408,6,26,899,1339,5,1344
"سیستان_و_بلوچستان","ایرانشهر","مرکزی",17,56,1,4,111,172,5,177
"سیستان_و_بلوچستان","ایرانشهر","مرکزی",18,196,15,14,614,839,8,847
"سیستان_و_بلوچستان","ایرانشهر","مرکزی",19,255,7,25,542,829,9,838
"سیستان_و_بلوچستان","ایرانشهر","مرکزی",20,23,2,3,187,215,2,217
"سیستان_و_بلوچستان","ایرانشهر","مرکزی",21,173,3,8,428,612,9,621
"سیستان_و_بلوچستان","ایرانشهر","مرکزی",22,343,10,3,140,496,6,502
"سیستان_و_بلوچستان","ایرانشهر","مرکزی",23,90,2,4,229,325,7,332
"سیستان_و_بلوچستان","ایرانشهر","مرکزی",24,310,6,9,469,794,6,800
"سیستان_و_بلوچستان","ایرانشهر","مرکزی",25,177,6,11,485,679,11,690
"سیستان_و_بلوچستان","ایرانشهر","مرکزی",26,74,2,7,276,359,4,363
"سیستان_و_بلوچستان","ایرانشهر","مرکزی",27,461,9,22,694,1186,10,1196
"سیستان_و_بلوچستان","ایرانشهر","مرکزی",28,174,11,33,626,844,6,850
"سیستان_و_بلوچستان","ایرانشهر","مرکزی",29,133,0,9,303,445,2,447
"سیستان_و_بلوچستان","ایرانشهر","مرکزی",30,432,16,29,610,1087,12,1099
"سیستان_و_بلوچستان","ایرانشهر","مرکزی",31,240,7,23,332,602,2,604
"سیستان_و_بلوچستان","ایرانشهر","مرکزی",32,421,1,32,524,978,14,992
"سیستان_و_بلوچستان","ایرانشهر","مرکزی",33,479,7,20,593,1099,12,1111
"سیستان_و_بلوچستان","ایرانشهر","مرکزی",34,208,10,17,232,467,3,470
"سیستان_و_بلوچستان","ایرانشهر","مرکزی",35,241,13,34,642,930,15,945
"سیستان_و_بلوچستان","ایرانشهر","مرکزی",36,350,7,26,555,938,9,947
"سیستان_و_بلوچستان","ایرانشهر","مرکزی",37,609,10,28,621,1268,9,1277
"سیستان_و_بلوچستان","ایرانشهر","مرکزی",38,127,10,8,311,456,8,464
"سیستان_و_بلوچستان","ایرانشهر","مرکزی",39,192,4,15,486,697,5,702
"سیستان_و_بلوچستان","ایرانشهر","مرکزی",40,363,1,17,404,785,10,795
"سیستان_و_بلوچستان","ایرانشهر","مرکزی",41,309,2,8,517,836,3,839
"سیستان_و_بلوچستان","ایرانشهر","مرکزی",42,400,12,14,660,1086,6,1092
"سیستان_و_بلوچستان","ایرانشهر","مرکزی",43,171,1,7,290,469,4,473
"سیستان_و_بلوچستان","ایرانشهر","مرکزی",44,321,4,6,352,683,3,686
"سیستان_و_بلوچستان","ایرانشهر","مرکزی",45,164,1,2,213,380,2,382
"سیستان_و_بلوچستان","ایرانشهر","مرکزی",46,463,16,30,589,1098,13,1111
"سیستان_و_بلوچستان","ایرانشهر","مرکزی",47,677,15,24,478,1194,6,1200
"سیستان_و_بلوچستان","ایرانشهر","مرکزی",48,320,14,25,625,984,10,994
"سیستان_و_بلوچستان","ایرانشهر","مرکزی",49,129,8,8,351,496,4,500
"سیستان_و_بلوچستان","ایرانشهر","مرکزی",50,389,7,12,582,990,5,995
"سیستان_و_بلوچستان","ایرانشهر","مرکزی",51,236,4,14,273,527,5,532
"سیستان_و_بلوچستان","ایرانشهر","مرکزی",52,119,5,13,765,902,9,911
"سیستان_و_بلوچستان","ایرانشهر","مرکزی",53,36,0,2,296,334,0,334
"سیستان_و_بلوچستان","ایرانشهر","مرکزی",54,305,6,25,392,728,0,728
"سیستان_و_بلوچستان","ایرانشهر","مرکزی",55,127,8,7,426,568,14,582
"سیستان_و_بلوچستان","ایرانشهر","مرکزی",56,190,0,9,545,744,0,744
"سیستان_و_بلوچستان","ایرانشهر","مرکزی",57,443,3,16,628,1090,8,1098
"سیستان_و_بلوچستان","ایرانشهر","مرکزی",58,109,2,40,242,393,0,393
"سیستان_و_بلوچستان","ایرانشهر","مرکزی",59,504,0,3,98,605,2,607
"سیستان_و_بلوچستان","ایرانشهر","مرکزی",60,596,2,13,156,767,9,776
"سیستان_و_بلوچستان","ایرانشهر","مرکزی",61,194,5,9,327,535,8,543
"سیستان_و_بلوچستان","ایرانشهر","مرکزی",62,126,2,10,450,588,2,590
"سیستان_و_بلوچستان","ایرانشهر","مرکزی",63,523,2,8,432,965,0,965
"سیستان_و_بلوچستان","ایرانشهر","مرکزی",64,193,1,6,222,422,4,426
"سیستان_و_بلوچستان","ایرانشهر","مرکزی",65,144,1,4,323,472,1,473
"سیستان_و_بلوچستان","ایرانشهر","مرکزی",66,8,0,0,43,51,0,51
"سیستان_و_بلوچستان","ایرانشهر","مرکزی",67,91,3,39,293,426,0,426
"سیستان_و_بلوچستان","ایرانشهر","مرکزی",68,17,0,3,183,203,0,203
"سیستان_و_بلوچستان","ایرانشهر","مرکزی",69,14,2,1,173,190,0,190
"سیستان_و_بلوچستان","ایرانشهر","مرکزی",70,183,2,6,419,610,1,611
"سیستان_و_بلوچستان","ایرانشهر","مرکزی",71,131,1,6,337,475,4,479
"سیستان_و_بلوچستان","ایرانشهر","مرکزی",72,48,0,4,124,176,2,178
"سیستان_و_بلوچستان","ایرانشهر","مرکزی",73,87,7,12,376,482,6,488
"سیستان_و_بلوچستان","ایرانشهر","مرکزی",74,149,1,23,442,615,6,621
"سیستان_و_بلوچستان","ایرانشهر","مرکزی",75,124,2,13,347,486,4,490
"سیستان_و_بلوچستان","ایرانشهر","مرکزی",76,45,0,12,398,455,2,457
"سیستان_و_بلوچستان","ایرانشهر","مرکزی",77,154,2,33,481,670,2,672
"سیستان_و_بلوچستان","ایرانشهر","مرکزی",78,29,1,14,269,313,3,316
"سیستان_و_بلوچستان","ایرانشهر","مرکزی",79,65,5,3,504,577,0,577
"سیستان_و_بلوچستان","ایرانشهر","مرکزی",80,18,1,0,207,226,0,226
"سیستان_و_بلوچستان","ایرانشهر","مرکزی",81,283,3,3,322,611,0,611
"سیستان_و_بلوچستان","ایرانشهر","مرکزی",82,92,0,1,201,294,0,294
"سیستان_و_بلوچستان","ایرانشهر","مرکزی",83,138,2,6,177,323,3,326
"سیستان_و_بلوچستان","ایرانشهر","مرکزی",84,106,0,3,276,385,2,387
"سیستان_و_بلوچستان","ایرانشهر","مرکزی",85,217,2,1,88,308,0,308
"سیستان_و_بلوچستان","ایرانشهر","مرکزی",86,180,1,9,392,582,0,582
"سیستان_و_بلوچستان","ایرانشهر","مرکزی",87,364,4,1,206,575,1,576
"سیستان_و_بلوچستان","ایرانشهر","مرکزی",88,236,1,7,265,509,4,513
"سیستان_و_بلوچستان","ایرانشهر","بزمان",1,277,3,12,269,561,0,561
"سیستان_و_بلوچستان","ایرانشهر","بزمان",2,354,2,46,31,433,3,436
"سیستان_و_بلوچستان","ایرانشهر","بزمان",3,430,0,32,64,526,0,526
"سیستان_و_بلوچستان","ایرانشهر","بزمان",4,330,1,2,99,432,2,434
"سیستان_و_بلوچستان","ایرانشهر","بزمان",5,474,1,2,87,564,0,564
"سیستان_و_بلوچستان","ایرانشهر","بزمان",6,387,0,17,54,458,0,458
"سیستان_و_بلوچستان","ایرانشهر","بزمان",7,398,0,0,2,400,0,400
"سیستان_و_بلوچستان","ایرانشهر","بزمان",8,195,0,4,201,400,0,400
"سیستان_و_بلوچستان","ایرانشهر","بزمان",9,539,0,0,11,550,0,550
"سیستان_و_بلوچستان","ایرانشهر","بزمان",10,92,1,0,22,115,0,115
"سیستان_و_بلوچستان","ایرانشهر","بزمان",11,34,0,5,103,142,0,142
"سیستان_و_بلوچستان","ایرانشهر","بزمان",12,118,2,0,6,126,0,126
"سیستان_و_بلوچستان","ایرانشهر","بزمان",13,134,2,33,91,260,0,260
"سیستان_و_بلوچستان","ایرانشهر","بزمان",14,200,0,0,0,200,0,200
"سیستان_و_بلوچستان","ایرانشهر","بزمان",15,198,0,1,1,200,0,200
"سیستان_و_بلوچستان","ایرانشهر","بزمان",16,106,0,1,47,154,0,154
"سیستان_و_بلوچستان","ایرانشهر","بزمان",17,96,1,8,198,303,0,303
"سیستان_و_بلوچستان","ایرانشهر","بزمان",18,9,0,0,84,93,0,93
"سیستان_و_بلوچستان","ایرانشهر","بزمان",19,195,0,0,5,200,0,200
"سیستان_و_بلوچستان","ایرانشهر","بزمان",20,100,0,0,100,200,0,200
"سیستان_و_بلوچستان","ایرانشهر","بزمان",21,11,0,0,166,177,0,177
"سیستان_و_بلوچستان","ایرانشهر","بمپور",1,411,2,9,451,873,6,879
"سیستان_و_بلوچستان","ایرانشهر","بمپور",2,286,1,2,240,529,1,530
"سیستان_و_بلوچستان","ایرانشهر","بمپور",3,571,3,15,316,905,4,909
"سیستان_و_بلوچستان","ایرانشهر","بمپور",4,561,1,7,431,1000,0,1000
"سیستان_و_بلوچستان","ایرانشهر","بمپور",5,112,6,6,495,619,6,625
"سیستان_و_بلوچستان","ایرانشهر","بمپور",6,419,0,1,70,490,0,490
"سیستان_و_بلوچستان","ایرانشهر","بمپور",7,26,1,1,411,439,0,439
"سیستان_و_بلوچستان","ایرانشهر","بمپور",8,34,0,2,348,384,0,384
"سیستان_و_بلوچستان","ایرانشهر","بمپور",9,313,45,11,702,1071,3,1074
"سیستان_و_بلوچستان","ایرانشهر","بمپور",10,99,1,7,223,330,2,332
"سیستان_و_بلوچستان","ایرانشهر","بمپور",11,391,9,5,532,937,2,939
"سیستان_و_بلوچستان","ایرانشهر","بمپور",12,232,5,6,352,595,6,601
"سیستان_و_بلوچستان","ایرانشهر","بمپور",13,400,3,1,507,911,0,911
"سیستان_و_بلوچستان","ایرانشهر","بمپور",14,506,7,9,379,901,1,902
"سیستان_و_بلوچستان","ایرانشهر","بمپور",15,234,15,5,340,594,0,594
"سیستان_و_بلوچستان","ایرانشهر","بمپور",16,402,1,9,444,856,5,861
"سیستان_و_بلوچستان","ایرانشهر","بمپور",17,166,3,3,382,554,3,557
"سیستان_و_بلوچستان","ایرانشهر","بمپور",18,568,3,19,674,1264,5,1269
"سیستان_و_بلوچستان","ایرانشهر","بمپور",19,581,1,17,366,965,12,977
"سیستان_و_بلوچستان","ایرانشهر","بمپور",20,293,5,1,500,799,1,800
"سیستان_و_بلوچستان","ایرانشهر","بمپور",21,180,6,19,838,1043,0,1043
"سیستان_و_بلوچستان","ایرانشهر","بمپور",22,312,6,13,339,670,2,672
"سیستان_و_بلوچستان","ایرانشهر","بمپور",23,552,5,4,254,815,1,816
"سیستان_و_بلوچستان","ایرانشهر","بمپور",24,881,7,3,252,1143,10,1153
"سیستان_و_بلوچستان","ایرانشهر","بمپور",25,90,1,0,68,159,0,159
"سیستان_و_بلوچستان","ایرانشهر","بمپور",26,209,2,2,304,517,3,520
"سیستان_و_بلوچستان","ایرانشهر","بمپور",27,35,1,2,214,252,0,252
"سیستان_و_بلوچستان","ایرانشهر","بمپور",28,300,11,6,614,931,6,937
"سیستان_و_بلوچستان","ایرانشهر","بمپور",29,192,1,3,394,590,7,597
"سیستان_و_بلوچستان","ایرانشهر","بمپور",30,278,6,9,405,698,2,700
"سیستان_و_بلوچستان","ایرانشهر","بمپور",31,190,22,2,307,521,5,526
"سیستان_و_بلوچستان","ایرانشهر","بمپور",32,108,2,1,193,304,0,304
"سیستان_و_بلوچستان","ایرانشهر","بمپور",33,345,8,11,428,792,2,794
"سیستان_و_بلوچستان","ایرانشهر","بمپور",34,110,3,1,217,331,8,339
"سیستان_و_بلوچستان","چابهار","مرکزی",1,272,8,15,669,964,2,966
"سیستان_و_بلوچستان","چابهار","مرکزی",2,239,7,22,425,693,8,701
"سیستان_و_بلوچستان","چابهار","مرکزی",3,415,8,13,523,959,41,1000
"سیستان_و_بلوچستان","چابهار","مرکزی",4,297,11,18,1059,1385,15,1400
"سیستان_و_بلوچستان","چابهار","مرکزی",5,416,19,34,944,1413,17,1430
"سیستان_و_بلوچستان","چابهار","مرکزی",6,176,11,6,863,1056,9,1065
"سیستان_و_بلوچستان","چابهار","مرکزی",7,141,15,3,271,430,2,432
"سیستان_و_بلوچستان","چابهار","مرکزی",8,319,11,23,752,1105,15,1120
"سیستان_و_بلوچستان","چابهار","مرکزی",9,544,18,24,779,1365,13,1378
"سیستان_و_بلوچستان","چابهار","مرکزی",10,341,12,6,624,983,7,990
"سیستان_و_بلوچستان","چابهار","مرکزی",11,275,15,14,619,923,10,933
"سیستان_و_بلوچستان","چابهار","مرکزی",12,509,17,9,714,1249,10,1259
"سیستان_و_بلوچستان","چابهار","مرکزی",13,377,10,28,772,1187,12,1199
"سیستان_و_بلوچستان","چابهار","مرکزی",14,307,16,9,805,1137,17,1154
"سیستان_و_بلوچستان","چابهار","مرکزی",15,179,10,12,558,759,9,768
"سیستان_و_بلوچستان","چابهار","مرکزی",16,150,8,12,417,587,1,588
"سیستان_و_بلوچستان","چابهار","مرکزی",17,306,8,18,395,727,6,733
"سیستان_و_بلوچستان","چابهار","مرکزی",18,430,14,10,637,1091,9,1100
"سیستان_و_بلوچستان","چابهار","مرکزی",19,169,6,30,733,938,6,944
"سیستان_و_بلوچستان","چابهار","مرکزی",20,200,22,9,508,739,4,743
"سیستان_و_بلوچستان","چابهار","مرکزی",21,124,5,9,747,885,5,890
"سیستان_و_بلوچستان","چابهار","مرکزی",22,192,8,17,609,826,2,828
"سیستان_و_بلوچستان","چابهار","مرکزی",23,394,13,16,513,936,11,947
"سیستان_و_بلوچستان","چابهار","مرکزی",24,433,11,19,763,1226,5,1231
"سیستان_و_بلوچستان","چابهار","مرکزی",25,121,6,32,669,828,72,900
"سیستان_و_بلوچستان","چابهار","مرکزی",26,142,10,23,833,1008,11,1019
"سیستان_و_بلوچستان","چابهار","مرکزی",27,124,6,11,854,995,1,996
"سیستان_و_بلوچستان","چابهار","مرکزی",28,74,1,2,523,600,4,604
"سیستان_و_بلوچستان","چابهار","مرکزی",29,136,4,11,703,854,5,859
"سیستان_و_بلوچستان","چابهار","مرکزی",30,319,41,4,510,874,26,900
"سیستان_و_بلوچستان","چابهار","مرکزی",31,60,8,10,202,280,8,288
"سیستان_و_بلوچستان","چابهار","مرکزی",32,136,3,6,291,436,5,441
"سیستان_و_بلوچستان","چابهار","مرکزی",33,81,0,3,104,188,2,190
"سیستان_و_بلوچستان","چابهار","مرکزی",34,104,4,3,178,289,0,289
"سیستان_و_بلوچستان","چابهار","مرکزی",35,88,3,13,236,340,3,343
"سیستان_و_بلوچستان","چابهار","مرکزی",36,224,10,10,323,567,3,570
"سیستان_و_بلوچستان","چابهار","مرکزی",37,310,5,10,272,597,5,602
"سیستان_و_بلوچستان","چابهار","مرکزی",38,112,7,9,265,393,0,393
"سیستان_و_بلوچستان","چابهار","مرکزی",39,198,8,16,940,1162,4,1166
"سیستان_و_بلوچستان","چابهار","مرکزی",40,82,1,23,712,818,9,827
"سیستان_و_بلوچستان","چابهار","مرکزی",41,273,12,20,701,1006,0,1006
"سیستان_و_بلوچستان","چابهار","مرکزی",42,112,7,1,882,1002,13,1015
"سیستان_و_بلوچستان","چابهار","مرکزی",43,164,0,12,629,805,3,808
"سیستان_و_بلوچستان","چابهار","مرکزی",44,74,2,10,556,642,4,646
"سیستان_و_بلوچستان","چابهار","مرکزی",45,51,0,2,313,366,0,366
"سیستان_و_بلوچستان","چابهار","مرکزی",46,105,0,7,277,389,2,391
"سیستان_و_بلوچستان","چابهار","مرکزی",47,41,4,19,677,741,9,750
"سیستان_و_بلوچستان","چابهار","مرکزی",48,114,3,60,342,519,1,520
"سیستان_و_بلوچستان","چابهار","مرکزی",49,117,4,5,594,720,5,725
"سیستان_و_بلوچستان","چابهار","مرکزی",50,286,1,3,234,524,1,525
"سیستان_و_بلوچستان","چابهار","مرکزی",51,125,1,81,483,690,5,695
"سیستان_و_بلوچستان","چابهار","مرکزی",52,105,3,40,563,711,0,711
"سیستان_و_بلوچستان","چابهار","مرکزی",53,160,1,5,333,499,4,503
"سیستان_و_بلوچستان","چابهار","مرکزی",54,149,1,119,479,748,5,753
"سیستان_و_بلوچستان","چابهار","مرکزی",55,60,0,34,422,516,0,516
"سیستان_و_بلوچستان","چابهار","مرکزی",56,109,0,0,337,446,1,447
"سیستان_و_بلوچستان","چابهار","مرکزی",57,130,18,1,497,646,0,646
"سیستان_و_بلوچستان","چابهار","مرکزی",58,130,7,3,279,419,2,421
"سیستان_و_بلوچستان","چابهار","مرکزی",59,677,3,8,394,1082,21,1103
"سیستان_و_بلوچستان","چابهار","مرکزی",60,93,0,1,479,573,3,576
"سیستان_و_بلوچستان","چابهار","دشتیاری",1,313,1,12,382,708,12,720
"سیستان_و_بلوچستان","چابهار","دشتیاری",2,163,3,10,390,566,3,569
"سیستان_و_بلوچستان","چابهار","دشتیاری",3,79,0,11,264,354,3,357
"سیستان_و_بلوچستان","چابهار","دشتیاری",4,71,1,25,710,807,0,807
"سیستان_و_بلوچستان","چابهار","دشتیاری",5,414,3,5,617,1039,5,1044
"سیستان_و_بلوچستان","چابهار","دشتیاری",6,49,1,12,710,772,1,773
"سیستان_و_بلوچستان","چابهار","دشتیاری",7,247,8,0,521,776,3,779
"سیستان_و_بلوچستان","چابهار","دشتیاری",8,653,0,3,164,820,0,820
"سیستان_و_بلوچستان","چابهار","دشتیاری",9,144,4,10,408,566,1,567
"سیستان_و_بلوچستان","چابهار","دشتیاری",10,366,3,19,474,862,0,862
"سیستان_و_بلوچستان","چابهار","دشتیاری",11,70,1,4,351,426,0,426
"سیستان_و_بلوچستان","چابهار","دشتیاری",12,358,1,4,128,491,2,493
"سیستان_و_بلوچستان","چابهار","دشتیاری",13,432,0,1,444,877,3,880
"سیستان_و_بلوچستان","چابهار","دشتیاری",14,10,0,0,344,354,0,354
"سیستان_و_بلوچستان","چابهار","دشتیاری",15,204,4,13,479,700,0,700
"سیستان_و_بلوچستان","چابهار","دشتیاری",16,25,0,10,786,821,0,821
"سیستان_و_بلوچستان","چابهار","دشتیاری",17,104,0,0,441,545,0,545
"سیستان_و_بلوچستان","چابهار","دشتیاری",18,84,3,2,280,369,3,372
"سیستان_و_بلوچستان","چابهار","دشتیاری",19,55,2,4,366,427,1,428
"سیستان_و_بلوچستان","چابهار","دشتیاری",20,14,1,5,435,455,1,456
"سیستان_و_بلوچستان","چابهار","دشتیاری",21,54,0,1,413,468,1,469
"سیستان_و_بلوچستان","چابهار","دشتیاری",22,498,2,9,318,827,2,829
"سیستان_و_بلوچستان","چابهار","دشتیاری",23,98,6,8,586,698,0,698
"سیستان_و_بلوچستان","چابهار","دشتیاری",24,444,1,3,196,644,1,645
"سیستان_و_بلوچستان","چابهار","دشتیاری",25,83,0,5,344,432,0,432
"سیستان_و_بلوچستان","چابهار","دشتیاری",26,77,9,6,689,781,3,784
"سیستان_و_بلوچستان","چابهار","دشتیاری",27,113,0,2,225,340,7,347
"سیستان_و_بلوچستان","چابهار","دشتیاری",28,261,4,1,221,487,1,488
"سیستان_و_بلوچستان","چابهار","دشتیاری",29,78,5,7,609,699,1,700
"سیستان_و_بلوچستان","چابهار","دشتیاری",30,34,0,1,534,569,7,576
"سیستان_و_بلوچستان","چابهار","دشتیاری",31,17,0,1,622,640,1,641
"سیستان_و_بلوچستان","چابهار","دشتیاری",32,125,4,4,257,390,2,392
"سیستان_و_بلوچستان","چابهار","دشتیاری",33,58,1,0,116,175,0,175
"سیستان_و_بلوچستان","چابهار","پلان",1,221,2,2,319,544,1,545
"سیستان_و_بلوچستان","چابهار","پلان",2,190,0,4,542,736,5,741
"سیستان_و_بلوچستان","چابهار","پلان",3,17,0,20,629,666,0,666
"سیستان_و_بلوچستان","چابهار","پلان",4,17,0,8,776,801,0,801
"سیستان_و_بلوچستان","چابهار","پلان",5,5,0,0,438,443,0,443
"سیستان_و_بلوچستان","چابهار","پلان",6,12,1,0,481,494,0,494
"سیستان_و_بلوچستان","چابهار","پلان",7,275,1,15,485,776,0,776
"سیستان_و_بلوچستان","چابهار","پلان",8,49,0,1,290,340,8,348
"سیستان_و_بلوچستان","چابهار","پلان",9,105,9,14,323,451,0,451
"سیستان_و_بلوچستان","چابهار","پلان",10,70,1,1,664,736,0,736
"سیستان_و_بلوچستان","چابهار","پلان",11,46,5,10,577,638,1,639
"سیستان_و_بلوچستان","چابهار","پلان",12,26,0,580,94,700,0,700
"سیستان_و_بلوچستان","چابهار","پلان",13,30,6,1,498,535,0,535
"سیستان_و_بلوچستان","چابهار","پلان",14,73,1,5,464,543,1,544
"سیستان_و_بلوچستان","چابهار","پلان",15,6,2,18,696,722,0,722
"سیستان_و_بلوچستان","چابهار","پلان",16,10,0,23,1074,1107,14,1121
"سیستان_و_بلوچستان","چابهار","پلان",17,194,1,56,487,738,3,741
"سیستان_و_بلوچستان","چابهار","پلان",18,74,0,1,456,531,1,532
"سیستان_و_بلوچستان","چابهار","پلان",19,54,5,11,812,882,0,882
"سیستان_و_بلوچستان","چابهار","پلان",20,88,1,5,453,547,3,550
"سیستان_و_بلوچستان","چابهار","پلان",21,61,0,21,674,756,0,756
"سیستان_و_بلوچستان","چابهار","پلان",22,188,1,94,617,900,0,900
"سیستان_و_بلوچستان","چابهار","پلان",23,321,6,9,514,850,0,850
"سیستان_و_بلوچستان","چابهار","پلان",24,212,0,6,504,722,0,722
"سیستان_و_بلوچستان","چابهار","پلان",25,15,0,0,732,747,0,747
"سیستان_و_بلوچستان","چابهار","پلان",26,43,3,3,551,600,0,600
"سیستان_و_بلوچستان","چابهار","پلان",27,41,2,1,384,428,0,428
"سیستان_و_بلوچستان","چابهار","پلان",28,34,0,1,445,480,0,480
"سیستان_و_بلوچستان","چابهار","پلان",29,126,7,4,739,876,0,876
"سیستان_و_بلوچستان","چابهار","پلان",30,196,5,121,237,559,0,559
"سیستان_و_بلوچستان","خاش","مرکزی",1,351,13,9,600,973,11,984
"سیستان_و_بلوچستان","خاش","مرکزی",2,425,15,16,781,1237,9,1246
"سیستان_و_بلوچستان","خاش","مرکزی",3,80,7,40,841,968,2,970
"سیستان_و_بلوچستان","خاش","مرکزی",4,92,2,8,838,940,4,944
"سیستان_و_بلوچستان","خاش","مرکزی",5,286,3,5,406,700,0,700
"سیستان_و_بلوچستان","خاش","مرکزی",6,171,9,30,1137,1347,3,1350
"سیستان_و_بلوچستان","خاش","مرکزی",7,109,2,23,857,991,11,1002
"سیستان_و_بلوچستان","خاش","مرکزی",8,82,5,9,760,856,2,858
"سیستان_و_بلوچستان","خاش","مرکزی",9,224,6,8,757,995,5,1000
"سیستان_و_بلوچستان","خاش","مرکزی",10,138,5,4,581,728,1,729
"سیستان_و_بلوچستان","خاش","مرکزی",11,249,5,9,945,1208,4,1212
"سیستان_و_بلوچستان","خاش","مرکزی",12,119,2,5,257,383,2,385
"سیستان_و_بلوچستان","خاش","مرکزی",13,58,3,2,776,839,5,844
"سیستان_و_بلوچستان","خاش","مرکزی",14,68,2,2,762,834,2,836
"سیستان_و_بلوچستان","خاش","مرکزی",15,195,15,5,973,1188,9,1197
"سیستان_و_بلوچستان","خاش","مرکزی",16,139,7,10,916,1072,6,1078
"سیستان_و_بلوچستان","خاش","مرکزی",17,210,4,11,891,1116,8,1124
"سیستان_و_بلوچستان","خاش","مرکزی",18,106,4,39,795,944,12,956
"سیستان_و_بلوچستان","خاش","مرکزی",19,194,4,4,808,1010,4,1014
"سیستان_و_بلوچستان","خاش","مرکزی",20,107,5,17,936,1065,8,1073
"سیستان_و_بلوچستان","خاش","مرکزی",21,101,1,12,496,610,3,613
"سیستان_و_بلوچستان","خاش","مرکزی",22,105,0,20,1064,1189,9,1198
"سیستان_و_بلوچستان","خاش","مرکزی",23,58,0,4,202,264,0,264
"سیستان_و_بلوچستان","خاش","مرکزی",24,1172,18,6,204,1400,3,1403
"سیستان_و_بلوچستان","خاش","مرکزی",25,191,5,8,259,463,3,466
"سیستان_و_بلوچستان","خاش","مرکزی",26,865,12,13,418,1308,23,1331
"سیستان_و_بلوچستان","خاش","مرکزی",27,29,0,2,129,160,1,161
"سیستان_و_بلوچستان","خاش","مرکزی",28,46,2,1,696,745,0,745
"سیستان_و_بلوچستان","خاش","مرکزی",29,31,6,4,575,616,0,616
"سیستان_و_بلوچستان","خاش","مرکزی",30,97,0,3,473,573,0,573
"سیستان_و_بلوچستان","خاش","مرکزی",31,49,1,2,248,300,1,301
"سیستان_و_بلوچستان","خاش","مرکزی",32,22,0,0,276,298,2,300
"سیستان_و_بلوچستان","خاش","مرکزی",33,298,4,7,612,921,10,931
"سیستان_و_بلوچستان","خاش","مرکزی",34,83,1,4,1151,1239,0,1239
"سیستان_و_بلوچستان","خاش","مرکزی",35,98,4,125,941,1168,7,1175
"سیستان_و_بلوچستان","خاش","مرکزی",36,9,0,2,292,303,1,304
"سیستان_و_بلوچستان","خاش","مرکزی",37,13,1,7,409,430,1,431
"سیستان_و_بلوچستان","خاش","مرکزی",38,29,0,0,464,493,2,495
"سیستان_و_بلوچستان","خاش","مرکزی",39,160,1,0,399,560,0,560
"سیستان_و_بلوچستان","خاش","مرکزی",40,59,1,0,368,428,0,428
"سیستان_و_بلوچستان","خاش","مرکزی",41,44,0,1,175,220,1,221
"سیستان_و_بلوچستان","خاش","مرکزی",42,166,2,11,425,604,1,605
"سیستان_و_بلوچستان","خاش","مرکزی",43,79,0,1,375,455,2,457
"سیستان_و_بلوچستان","خاش","مرکزی",44,36,3,4,413,456,0,456
"سیستان_و_بلوچستان","خاش","مرکزی",45,31,2,10,439,482,0,482
"سیستان_و_بلوچستان","خاش","مرکزی",46,65,3,1,314,383,4,387
"سیستان_و_بلوچستان","خاش","مرکزی",47,36,2,3,722,763,0,763
"سیستان_و_بلوچستان","خاش","مرکزی",48,93,1,18,780,892,0,892
"سیستان_و_بلوچستان","خاش","مرکزی",49,78,0,2,492,572,2,574
"سیستان_و_بلوچستان","خاش","مرکزی",50,101,1,2,422,526,0,526
"سیستان_و_بلوچستان","خاش","مرکزی",51,45,0,2,616,663,0,663
"سیستان_و_بلوچستان","خاش","مرکزی",52,170,1,1,244,416,0,416
"سیستان_و_بلوچستان","خاش","نوک_آباد",1,106,0,8,1003,1117,2,1119
"سیستان_و_بلوچستان","خاش","نوک_آباد",2,58,2,4,432,496,4,500
"سیستان_و_بلوچستان","خاش","نوک_آباد",3,51,0,2,550,603,5,608
"سیستان_و_بلوچستان","خاش","نوک_آباد",4,18,0,2,345,365,0,365
"سیستان_و_بلوچستان","خاش","نوک_آباد",5,70,0,3,360,433,2,435
"سیستان_و_بلوچستان","خاش","نوک_آباد",6,3,0,1,355,359,1,360
"سیستان_و_بلوچستان","خاش","نوک_آباد",7,2,0,1,408,411,0,411
"سیستان_و_بلوچستان","خاش","نوک_آباد",8,65,2,5,306,378,2,380
"سیستان_و_بلوچستان","خاش","نوک_آباد",9,6,1,6,509,522,3,525
"سیستان_و_بلوچستان","خاش","نوک_آباد",10,4,1,1,384,390,1,391
"سیستان_و_بلوچستان","خاش","نوک_آباد",11,43,2,6,595,646,3,649
"سیستان_و_بلوچستان","خاش","نوک_آباد",12,18,2,5,508,533,0,533
"سیستان_و_بلوچستان","خاش","نوک_آباد",13,8,0,2,618,628,0,628
"سیستان_و_بلوچستان","خاش","نوک_آباد",14,0,0,1,580,581,3,584
"سیستان_و_بلوچستان","خاش","نوک_آباد",15,75,3,2,605,685,1,686
"سیستان_و_بلوچستان","خاش","نوک_آباد",16,27,0,0,570,597,0,597
"سیستان_و_بلوچستان","خاش","نوک_آباد",17,48,2,12,681,743,0,743
"سیستان_و_بلوچستان","خاش","نوک_آباد",18,18,1,0,507,526,0,526
"سیستان_و_بلوچستان","خاش","نوک_آباد",19,21,0,0,619,640,0,640
"سیستان_و_بلوچستان","خاش","نوک_آباد",20,33,0,1,865,899,1,900
"سیستان_و_بلوچستان","خاش","نوک_آباد",21,33,0,3,861,897,4,901
"سیستان_و_بلوچستان","خاش","نوک_آباد",22,12,5,0,365,382,0,382
"سیستان_و_بلوچستان","خاش","نوک_آباد",23,54,1,1,755,811,0,811
"سیستان_و_بلوچستان","خاش","نوک_آباد",24,19,0,2,846,867,3,870
"سیستان_و_بلوچستان","خاش","نوک_آباد",25,54,0,2,419,475,0,475
"سیستان_و_بلوچستان","خاش","ایرندگان",1,101,0,3,189,293,1,294
"سیستان_و_بلوچستان","خاش","ایرندگان",2,304,4,17,237,562,5,567
"سیستان_و_بلوچستان","خاش","ایرندگان",3,260,2,40,312,614,0,614
"سیستان_و_بلوچستان","خاش","ایرندگان",4,172,6,7,383,568,3,571
"سیستان_و_بلوچستان","خاش","ایرندگان",5,140,2,13,437,592,0,592
"سیستان_و_بلوچستان","خاش","ایرندگان",6,121,3,51,412,587,1,588
"سیستان_و_بلوچستان","خاش","ایرندگان",7,12,2,5,244,263,2,265
"سیستان_و_بلوچستان","خاش","ایرندگان",8,15,3,5,327,350,0,350
"سیستان_و_بلوچستان","خاش","ایرندگان",9,101,3,2,180,286,0,286
"سیستان_و_بلوچستان","خاش","ایرندگان",10,11,0,2,285,298,0,298
"سیستان_و_بلوچستان","دلگان","مرکزی",1,497,4,4,82,587,1,588
"سیستان_و_بلوچستان","دلگان","مرکزی",2,900,11,3,54,968,0,968
"سیستان_و_بلوچستان","دلگان","مرکزی",3,453,0,1,99,553,0,553
"سیستان_و_بلوچستان","دلگان","مرکزی",4,815,3,0,30,848,0,848
"سیستان_و_بلوچستان","دلگان","مرکزی",5,1684,0,2,14,1700,0,1700
"سیستان_و_بلوچستان","دلگان","مرکزی",6,829,0,2,15,846,2,848
"سیستان_و_بلوچستان","دلگان","مرکزی",7,932,1,1,30,964,0,964
"سیستان_و_بلوچستان","دلگان","مرکزی",8,657,5,1,48,711,0,711
"سیستان_و_بلوچستان","دلگان","مرکزی",9,886,0,0,30,916,0,916
"سیستان_و_بلوچستان","دلگان","مرکزی",10,988,1,0,14,1003,0,1003
"سیستان_و_بلوچستان","دلگان","مرکزی",11,819,1,4,32,856,7,863
"سیستان_و_بلوچستان","دلگان","مرکزی",12,726,0,0,21,747,0,747
"سیستان_و_بلوچستان","دلگان","مرکزی",13,552,1,1,3,557,0,557
"سیستان_و_بلوچستان","دلگان","مرکزی",14,537,0,18,41,596,0,596
"سیستان_و_بلوچستان","دلگان","مرکزی",15,996,0,7,18,1021,0,1021
"سیستان_و_بلوچستان","دلگان","مرکزی",16,341,0,0,10,351,2,353
"سیستان_و_بلوچستان","دلگان","مرکزی",17,378,0,1,23,402,0,402
"سیستان_و_بلوچستان","دلگان","مرکزی",18,612,1,2,3,618,0,618
"سیستان_و_بلوچستان","دلگان","مرکزی",19,168,0,0,4,172,0,172
"سیستان_و_بلوچستان","دلگان","مرکزی",20,471,0,0,3,474,0,474
"سیستان_و_بلوچستان","دلگان","مرکزی",21,725,6,35,117,883,0,883
"سیستان_و_بلوچستان","دلگان","مرکزی",22,591,6,44,78,719,4,723
"سیستان_و_بلوچستان","دلگان","جلگه_چاه_هاشم",1,125,1,9,265,400,0,400
"سیستان_و_بلوچستان","دلگان","جلگه_چاه_هاشم",2,243,1,1,321,566,0,566
"سیستان_و_بلوچستان","دلگان","جلگه_چاه_هاشم",3,307,4,11,375,697,3,700
"سیستان_و_بلوچستان","دلگان","جلگه_چاه_هاشم",4,332,2,4,187,525,0,525
"سیستان_و_بلوچستان","دلگان","جلگه_چاه_هاشم",5,98,2,2,345,447,0,447
"سیستان_و_بلوچستان","دلگان","جلگه_چاه_هاشم",6,224,7,33,443,707,0,707
"سیستان_و_بلوچستان","دلگان","جلگه_چاه_هاشم",7,377,0,4,515,896,0,896
"سیستان_و_بلوچستان","دلگان","جلگه_چاه_هاشم",8,248,1,1,175,425,0,425
"سیستان_و_بلوچستان","دلگان","جلگه_چاه_هاشم",9,489,0,0,69,558,0,558
"سیستان_و_بلوچستان","دلگان","جلگه_چاه_هاشم",10,915,3,1,104,1023,0,1023
"سیستان_و_بلوچستان","دلگان","جلگه_چاه_هاشم",11,456,3,1,34,494,0,494
"سیستان_و_بلوچستان","دلگان","جلگه_چاه_هاشم",12,375,4,0,95,474,0,474
"سیستان_و_بلوچستان","دلگان","جلگه_چاه_هاشم",13,632,3,0,15,650,0,650
"سیستان_و_بلوچستان","دلگان","جلگه_چاه_هاشم",14,430,0,0,32,462,0,462
"سیستان_و_بلوچستان","زابل","مرکزی",1,758,15,12,317,1102,8,1110
"سیستان_و_بلوچستان","زابل","مرکزی",2,724,15,9,329,1077,16,1093
"سیستان_و_بلوچستان","زابل","مرکزی",3,748,3,5,268,1024,16,1040
"سیستان_و_بلوچستان","زابل","مرکزی",4,473,5,3,92,573,2,575
"سیستان_و_بلوچستان","زابل","مرکزی",5,613,15,3,90,721,8,729
"سیستان_و_بلوچستان","زابل","مرکزی",6,1074,14,4,189,1281,14,1295
"سیستان_و_بلوچستان","زابل","مرکزی",7,949,13,9,393,1364,17,1381
"سیستان_و_بلوچستان","زابل","مرکزی",8,1117,24,7,318,1466,13,1479
"سیستان_و_بلوچستان","زابل","مرکزی",9,952,11,8,186,1157,9,1166
"سیستان_و_بلوچستان","زابل","مرکزی",10,706,6,2,127,841,2,843
"سیستان_و_بلوچستان","زابل","مرکزی",11,1112,6,7,191,1316,8,1324
"سیستان_و_بلوچستان","زابل","مرکزی",12,869,2,1,169,1041,7,1048
"سیستان_و_بلوچستان","زابل","مرکزی",13,1325,3,0,151,1479,5,1484
"سیستان_و_بلوچستان","زابل","مرکزی",14,541,0,1,58,600,1,601
"سیستان_و_بلوچستان","زابل","مرکزی",15,843,13,5,122,983,5,988
"سیستان_و_بلوچستان","زابل","مرکزی",16,744,4,2,48,798,2,800
"سیستان_و_بلوچستان","زابل","مرکزی",17,914,8,8,258,1188,5,1193
"سیستان_و_بلوچستان","زابل","مرکزی",18,563,13,1,111,688,5,693
"سیستان_و_بلوچستان","زابل","مرکزی",19,653,22,4,202,881,1,882
"سیستان_و_بلوچستان","زابل","مرکزی",20,932,2,2,64,1000,6,1006
"سیستان_و_بلوچستان","زابل","مرکزی",21,1200,6,4,194,1404,11,1415
"سیستان_و_بلوچستان","زابل","مرکزی",22,241,6,1,153,401,4,405
"سیستان_و_بلوچستان","زابل","مرکزی",23,676,30,17,466,1189,38,1227
"سیستان_و_بلوچستان","زابل","مرکزی",24,1263,19,9,279,1570,11,1581
"سیستان_و_بلوچستان","زابل","مرکزی",25,768,10,1,102,881,5,886
"سیستان_و_بلوچستان","زابل","مرکزی",26,444,4,0,86,534,2,536
"سیستان_و_بلوچستان","زابل","مرکزی",27,587,22,8,313,930,19,949
"سیستان_و_بلوچستان","زابل","مرکزی",28,770,11,5,217,1003,13,1016
"سیستان_و_بلوچستان","زابل","مرکزی",29,1014,14,2,169,1199,12,1211
"سیستان_و_بلوچستان","زابل","مرکزی",30,1006,5,2,124,1137,13,1150
"سیستان_و_بلوچستان","زابل","مرکزی",31,603,7,3,227,840,10,850
"سیستان_و_بلوچستان","زابل","مرکزی",32,829,4,3,367,1203,9,1212
"سیستان_و_بلوچستان","زابل","مرکزی",33,767,2,2,256,1027,9,1036
"سیستان_و_بلوچستان","زابل","مرکزی",34,829,9,6,289,1133,8,1141
"سیستان_و_بلوچستان","زابل","مرکزی",35,701,16,0,307,1024,5,1029
"سیستان_و_بلوچستان","زابل","مرکزی",36,606,6,4,305,921,6,927
"سیستان_و_بلوچستان","زابل","مرکزی",37,506,6,9,195,716,10,726
"سیستان_و_بلوچستان","زابل","مرکزی",38,621,6,3,221,851,9,860
"سیستان_و_بلوچستان","زابل","مرکزی",39,147,3,1,22,173,4,177
"سیستان_و_بلوچستان","زابل","مرکزی",40,385,6,2,195,588,13,601
"سیستان_و_بلوچستان","زابل","مرکزی",41,939,10,2,346,1297,13,1310
"سیستان_و_بلوچستان","زابل","مرکزی",42,638,10,10,506,1164,10,1174
"سیستان_و_بلوچستان","زابل","مرکزی",43,252,4,0,154,410,14,424
"سیستان_و_بلوچستان","زابل","مرکزی",44,709,14,12,295,1030,19,1049
"سیستان_و_بلوچستان","زابل","مرکزی",45,1005,19,3,325,1352,21,1373
"سیستان_و_بلوچستان","زابل","مرکزی",46,736,7,9,308,1060,9,1069
"سیستان_و_بلوچستان","زابل","مرکزی",47,672,22,16,306,1016,9,1025
"سیستان_و_بلوچستان","زابل","مرکزی",48,840,14,6,339,1199,15,1214
"سیستان_و_بلوچستان","زابل","مرکزی",49,572,10,6,329,917,8,925
"سیستان_و_بلوچستان","زابل","مرکزی",50,462,5,3,147,617,5,622
"سیستان_و_بلوچستان","زابل","مرکزی",51,797,15,3,245,1060,5,1065
"سیستان_و_بلوچستان","زابل","مرکزی",52,913,4,2,107,1026,4,1030
"سیستان_و_بلوچستان","زابل","مرکزی",53,1177,12,5,246,1440,2,1442
"سیستان_و_بلوچستان","زابل","مرکزی",54,1011,9,1,128,1149,7,1156
"سیستان_و_بلوچستان","زابل","مرکزی",55,978,21,10,230,1239,8,1247
"سیستان_و_بلوچستان","زابل","مرکزی",56,564,7,7,209,787,13,800
"سیستان_و_بلوچستان","زابل","مرکزی",57,1102,7,11,278,1398,8,1406
"سیستان_و_بلوچستان","زابل","مرکزی",58,730,5,13,276,1024,8,1032
"سیستان_و_بلوچستان","زابل","مرکزی",59,805,9,15,247,1076,0,1076
"سیستان_و_بلوچستان","زابل","مرکزی",60,736,8,3,164,911,4,915
"سیستان_و_بلوچستان","زابل","مرکزی",61,944,15,4,269,1232,7,1239
"سیستان_و_بلوچستان","زابل","مرکزی",62,280,2,2,88,372,2,374
"سیستان_و_بلوچستان","زابل","مرکزی",63,1237,4,0,69,1310,1,1311
"سیستان_و_بلوچستان","زابل","مرکزی",64,570,5,2,73,650,5,655
"سیستان_و_بلوچستان","زابل","مرکزی",65,257,3,1,30,291,1,292
"سیستان_و_بلوچستان","زابل","مرکزی",66,424,43,7,309,783,23,806
"سیستان_و_بلوچستان","زابل","مرکزی",67,611,2,0,18,631,0,631
"سیستان_و_بلوچستان","زابل","مرکزی",68,709,1,0,7,717,0,717
"سیستان_و_بلوچستان","زابل","مرکزی",69,490,0,1,34,525,2,527
"سیستان_و_بلوچستان","زابل","مرکزی",70,493,3,7,63,566,2,568
"سیستان_و_بلوچستان","زابل","مرکزی",71,235,1,0,14,250,0,250
"سیستان_و_بلوچستان","زابل","مرکزی",72,767,0,7,217,991,5,996
"سیستان_و_بلوچستان","زابل","مرکزی",73,866,11,10,144,1031,21,1052
"سیستان_و_بلوچستان","زابل","مرکزی",74,897,0,2,32,931,6,937
"سیستان_و_بلوچستان","زابل","مرکزی",75,407,0,2,4,413,0,413
"سیستان_و_بلوچستان","زابل","مرکزی",76,494,3,2,20,519,0,519
"سیستان_و_بلوچستان","زابل","مرکزی",77,1070,0,1,37,1108,1,1109
"سیستان_و_بلوچستان","زابل","مرکزی",78,464,0,1,16,481,1,482
"سیستان_و_بلوچستان","زابل","مرکزی",79,623,0,1,18,642,0,642
"سیستان_و_بلوچستان","زابل","مرکزی",80,709,3,0,219,931,6,937
"سیستان_و_بلوچستان","زابل","مرکزی",81,859,3,0,86,948,4,952
"سیستان_و_بلوچستان","زابل","مرکزی",82,699,6,0,39,744,3,747
"سیستان_و_بلوچستان","زابل","مرکزی",83,464,6,1,62,533,3,536
"سیستان_و_بلوچستان","زابل","مرکزی",84,423,1,16,77,517,1,518
"سیستان_و_بلوچستان","زابل","مرکزی",85,529,0,0,28,557,0,557
"سیستان_و_بلوچستان","زابل","مرکزی",86,420,0,0,16,436,0,436
"سیستان_و_بلوچستان","زابل","مرکزی",87,309,1,0,171,481,6,487
"سیستان_و_بلوچستان","زابل","مرکزی",88,235,0,1,125,361,3,364
"سیستان_و_بلوچستان","زابل","شیب_آب",1,563,2,0,46,611,2,613
"سیستان_و_بلوچستان","زابل","شیب_آب",2,769,6,2,134,911,1,912
"سیستان_و_بلوچستان","زابل","شیب_آب",3,317,1,0,34,352,0,352
"سیستان_و_بلوچستان","زابل","شیب_آب",4,486,1,1,90,578,0,578
"سیستان_و_بلوچستان","زابل","شیب_آب",5,589,3,0,38,630,0,630
"سیستان_و_بلوچستان","زابل","شیب_آب",6,594,3,1,32,630,0,630
"سیستان_و_بلوچستان","زابل","شیب_آب",7,864,3,0,32,899,1,900
"سیستان_و_بلوچستان","زابل","شیب_آب",8,434,1,1,3,439,0,439
"سیستان_و_بلوچستان","زابل","شیب_آب",9,719,5,0,9,733,0,733
"سیستان_و_بلوچستان","زابل","شیب_آب",10,479,2,0,32,513,4,517
"سیستان_و_بلوچستان","زابل","شیب_آب",11,706,5,0,15,726,0,726
"سیستان_و_بلوچستان","زابل","شیب_آب",12,1126,4,0,26,1156,1,1157
"سیستان_و_بلوچستان","زابل","شیب_آب",13,1099,3,0,45,1147,2,1149
"سیستان_و_بلوچستان","زابل","شیب_آب",14,379,1,0,15,395,0,395
"سیستان_و_بلوچستان","زابل","شیب_آب",15,513,0,1,32,546,7,553
"سیستان_و_بلوچستان","زابل","شیب_آب",16,519,0,2,3,524,0,524
"سیستان_و_بلوچستان","زابل","شیب_آب",17,146,0,2,48,196,0,196
"سیستان_و_بلوچستان","زابل","شیب_آب",18,245,1,0,19,265,0,265
"سیستان_و_بلوچستان","زابل","شیب_آب",19,782,1,0,14,797,1,798
"سیستان_و_بلوچستان","زابل","شیب_آب",20,281,0,0,10,291,0,291
"سیستان_و_بلوچستان","زابل","شیب_آب",21,448,1,0,37,486,0,486
"سیستان_و_بلوچستان","زابل","شیب_آب",22,478,3,0,86,567,14,581
"سیستان_و_بلوچستان","زابل","شیب_آب",23,485,0,0,155,640,0,640
"سیستان_و_بلوچستان","زابل","شیب_آب",24,581,2,3,60,646,5,651
"سیستان_و_بلوچستان","زابل","شیب_آب",25,514,8,13,285,820,6,826
"سیستان_و_بلوچستان","زابل","شیب_آب",26,88,10,3,463,564,6,570
"سیستان_و_بلوچستان","زابل","شیب_آب",27,273,5,3,400,681,3,684
"سیستان_و_بلوچستان","زابل","شیب_آب",28,531,5,5,229,770,1,771
"سیستان_و_بلوچستان","زابل","شیب_آب",29,256,2,0,301,559,0,559
"سیستان_و_بلوچستان","زابل","شیب_آب",30,394,3,5,59,461,1,462
"سیستان_و_بلوچستان","زابل","شیب_آب",31,718,1,1,146,866,0,866
"سیستان_و_بلوچستان","زابل","شیب_آب",32,199,2,1,69,271,0,271
"سیستان_و_بلوچستان","زابل","شیب_آب",33,395,4,0,38,437,1,438
"سیستان_و_بلوچستان","زابل","شیب_آب",34,684,2,0,142,828,0,828
"سیستان_و_بلوچستان","زابل","شیب_آب",35,583,2,2,28,615,1,616
"سیستان_و_بلوچستان","زابل","شیب_آب",36,652,1,1,68,722,2,724
"سیستان_و_بلوچستان","زابل","شیب_آب",37,138,0,0,12,150,0,150
"سیستان_و_بلوچستان","زابل","شیب_آب",38,333,3,0,108,444,5,449
"سیستان_و_بلوچستان","زابل","شیب_آب",39,211,1,22,480,714,8,722
"سیستان_و_بلوچستان","زابل","پشت_آب",1,805,2,3,67,877,2,879
"سیستان_و_بلوچستان","زابل","پشت_آب",2,542,2,1,30,575,1,576
"سیستان_و_بلوچستان","زابل","پشت_آب",3,297,1,1,55,354,2,356
"سیستان_و_بلوچستان","زابل","پشت_آب",4,851,5,0,23,879,1,880
"سیستان_و_بلوچستان","زابل","پشت_آب",5,747,0,0,27,774,1,775
"سیستان_و_بلوچستان","زابل","پشت_آب",6,666,1,0,21,688,5,693
"سیستان_و_بلوچستان","زابل","پشت_آب",7,571,0,0,9,580,3,583
"سیستان_و_بلوچستان","زابل","پشت_آب",8,479,0,0,26,505,1,506
"سیستان_و_بلوچستان","زابل","پشت_آب",9,698,3,0,40,741,3,744
"سیستان_و_بلوچستان","زابل","پشت_آب",10,599,2,2,41,644,1,645
"سیستان_و_بلوچستان","زابل","پشت_آب",11,710,6,1,56,773,3,776
"سیستان_و_بلوچستان","زابل","پشت_آب",12,942,5,3,112,1062,18,1080
"سیستان_و_بلوچستان","زابل","پشت_آب",13,998,3,0,48,1049,0,1049
"سیستان_و_بلوچستان","زابل","پشت_آب",14,536,1,1,70,608,0,608
"سیستان_و_بلوچستان","زابل","پشت_آب",15,758,1,1,60,820,5,825
"سیستان_و_بلوچستان","زابل","پشت_آب",16,548,0,0,4,552,0,552
"سیستان_و_بلوچستان","زابل","پشت_آب",17,811,1,1,82,895,9,904
"سیستان_و_بلوچستان","زابل","پشت_آب",18,674,1,1,11,687,1,688
"سیستان_و_بلوچستان","زابل","پشت_آب",19,506,2,1,23,532,3,535
"سیستان_و_بلوچستان","زابل","پشت_آب",20,220,0,0,20,240,0,240
"سیستان_و_بلوچستان","زابل","پشت_آب",21,160,8,5,849,1022,2,1024
"سیستان_و_بلوچستان","زابل","پشت_آب",22,129,1,5,300,435,5,440
"سیستان_و_بلوچستان","زابل","پشت_آب",23,163,0,1,38,202,0,202
"سیستان_و_بلوچستان","زابل","پشت_آب",24,695,0,1,28,724,1,725
"سیستان_و_بلوچستان","زابل","پشت_آب",25,636,0,1,18,655,1,656
"سیستان_و_بلوچستان","زابل","پشت_آب",26,332,0,1,20,353,0,353
"سیستان_و_بلوچستان","زابل","پشت_آب",27,280,3,0,48,331,0,331
"سیستان_و_بلوچستان","زابل","پشت_آب",28,422,1,6,23,452,2,454
"سیستان_و_بلوچستان","زابل","پشت_آب",29,385,0,2,83,470,0,470
"سیستان_و_بلوچستان","زابل","پشت_آب",30,687,0,0,31,718,0,718
"سیستان_و_بلوچستان","زابل","پشت_آب",31,693,0,1,19,713,0,713
"سیستان_و_بلوچستان","زابل","پشت_آب",32,655,2,2,14,673,1,674
"سیستان_و_بلوچستان","زابل","پشت_آب",33,549,2,0,20,571,0,571
"سیستان_و_بلوچستان","زابلی","مرکزی",1,378,7,18,656,1059,7,1066
"سیستان_و_بلوچستان","زابلی","مرکزی",2,84,3,10,96,193,0,193
"سیستان_و_بلوچستان","زابلی","مرکزی",3,405,1,13,252,671,0,671
"سیستان_و_بلوچستان","زابلی","مرکزی",4,88,3,11,236,338,2,340
"سیستان_و_بلوچستان","زابلی","مرکزی",5,402,7,7,286,702,0,702
"سیستان_و_بلوچستان","زابلی","مرکزی",6,356,14,51,403,824,5,829
"سیستان_و_بلوچستان","زابلی","مرکزی",7,149,1,5,395,550,1,551
"سیستان_و_بلوچستان","زابلی","مرکزی",8,118,3,0,247,368,3,371
"سیستان_و_بلوچستان","زابلی","مرکزی",9,350,3,31,316,700,0,700
"سیستان_و_بلوچستان","زابلی","مرکزی",10,70,4,8,641,723,1,724
"سیستان_و_بلوچستان","زابلی","مرکزی",11,50,0,0,374,424,0,424
"سیستان_و_بلوچستان","زابلی","مرکزی",12,264,7,5,346,622,2,624
"سیستان_و_بلوچستان","زابلی","مرکزی",13,136,0,3,494,633,0,633
"سیستان_و_بلوچستان","زابلی","مرکزی",14,171,4,9,373,557,1,558
"سیستان_و_بلوچستان","زابلی","مرکزی",15,189,0,5,208,402,0,402
"سیستان_و_بلوچستان","زابلی","مرکزی",16,98,3,22,433,556,5,561
"سیستان_و_بلوچستان","زابلی","مرکزی",17,100,3,7,628,738,3,741
"سیستان_و_بلوچستان","زابلی","مرکزی",18,98,2,16,453,569,3,572
"سیستان_و_بلوچستان","زابلی","مرکزی",19,227,2,16,377,622,0,622
"سیستان_و_بلوچستان","زابلی","مرکزی",20,223,0,6,488,717,0,717
"سیستان_و_بلوچستان","زابلی","مرکزی",21,300,4,28,338,670,0,670
"سیستان_و_بلوچستان","زابلی","مرکزی",22,87,3,1,104,195,0,195
"سیستان_و_بلوچستان","زابلی","مرکزی",23,199,2,16,333,550,1,551
"سیستان_و_بلوچستان","زابلی","مرکزی",24,247,2,3,123,375,0,375
"سیستان_و_بلوچستان","زابلی","مرکزی",25,36,1,1,305,343,0,343
"سیستان_و_بلوچستان","زابلی","مرکزی",26,15,0,0,392,407,0,407
"سیستان_و_بلوچستان","زابلی","مرکزی",27,50,0,2,273,325,0,325
"سیستان_و_بلوچستان","زابلی","آشار",28,292,0,6,502,800,0,800
"سیستان_و_بلوچستان","زابلی","آشار",29,110,0,0,734,844,0,844
"سیستان_و_بلوچستان","زابلی","آشار",30,217,2,15,771,1005,0,1005
"سیستان_و_بلوچستان","زابلی","آشار",31,83,1,5,334,423,0,423
"سیستان_و_بلوچستان","زابلی","آشار",32,68,0,0,326,394,0,394
"سیستان_و_بلوچستان","زابلی","آشار",33,8,1,4,119,132,0,132
"سیستان_و_بلوچستان","زابلی","آشار",34,104,0,1,573,678,0,678
"سیستان_و_بلوچستان","زابلی","آشار",35,28,0,0,373,401,0,401
"سیستان_و_بلوچستان","زابلی","آشار",36,31,2,8,322,363,0,363
"سیستان_و_بلوچستان","زابلی","آشار",37,48,0,2,796,846,6,852
"سیستان_و_بلوچستان","زابلی","آشار",38,18,0,1,449,468,0,468
"سیستان_و_بلوچستان","زاهدان","مرکزی",1,1181,27,21,1129,2358,17,2375
"سیستان_و_بلوچستان","زاهدان","مرکزی",2,698,10,4,495,1207,8,1215
"سیستان_و_بلوچستان","زاهدان","مرکزی",3,89,2,9,1078,1178,4,1182
"سیستان_و_بلوچستان","زاهدان","مرکزی",4,149,1,12,952,1114,1,1115
"سیستان_و_بلوچستان","زاهدان","مرکزی",5,209,4,14,1328,1555,11,1566
"سیستان_و_بلوچستان","زاهدان","مرکزی",6,501,7,29,1123,1660,3,1663
"سیستان_و_بلوچستان","زاهدان","مرکزی",7,816,10,10,824,1660,6,1666
"سیستان_و_بلوچستان","زاهدان","مرکزی",8,520,6,14,1205,1745,11,1756
"سیستان_و_بلوچستان","زاهدان","مرکزی",9,59,8,34,1516,1617,10,1627
"سیستان_و_بلوچستان","زاهدان","مرکزی",10,182,3,21,800,1006,3,1009
"سیستان_و_بلوچستان","زاهدان","مرکزی",11,139,2,38,1144,1323,3,1326
"سیستان_و_بلوچستان","زاهدان","مرکزی",12,192,4,30,1453,1679,6,1685
"سیستان_و_بلوچستان","زاهدان","مرکزی",13,263,6,26,931,1226,6,1232
"سیستان_و_بلوچستان","زاهدان","مرکزی",14,1013,7,9,503,1532,8,1540
"سیستان_و_بلوچستان","زاهدان","مرکزی",15,864,5,11,655,1535,15,1550
"سیستان_و_بلوچستان","زاهدان","مرکزی",16,724,5,16,1079,1824,3,1827
"سیستان_و_بلوچستان","زاهدان","مرکزی",17,488,6,11,978,1483,7,1490
"سیستان_و_بلوچستان","زاهدان","مرکزی",18,1080,16,29,933,2058,16,2074
"سیستان_و_بلوچستان","زاهدان","مرکزی",19,990,9,4,315,1318,11,1329
"سیستان_و_بلوچستان","زاهدان","مرکزی",20,1068,10,18,906,2002,16,2018
"سیستان_و_بلوچستان","زاهدان","مرکزی",21,932,13,7,596,1548,13,1561
"سیستان_و_بلوچستان","زاهدان","مرکزی",22,633,4,7,423,1067,8,1075
"سیستان_و_بلوچستان","زاهدان","مرکزی",23,333,5,18,1243,1599,8,1607
"سیستان_و_بلوچستان","زاهدان","مرکزی",24,707,18,7,919,1651,4,1655
"سیستان_و_بلوچستان","زاهدان","مرکزی",25,710,6,13,820,1549,20,1569
"سیستان_و_بلوچستان","زاهدان","مرکزی",26,768,9,12,390,1179,6,1185
"سیستان_و_بلوچستان","زاهدان","مرکزی",27,122,3,7,895,1027,5,1032
"سیستان_و_بلوچستان","زاهدان","مرکزی",28,1185,20,38,624,1867,5,1872
"سیستان_و_بلوچستان","زاهدان","مرکزی",29,555,10,8,469,1042,17,1059
"سیستان_و_بلوچستان","زاهدان","مرکزی",30,636,14,17,668,1335,13,1348
"سیستان_و_بلوچستان","زاهدان","مرکزی",31,659,19,13,649,1340,11,1351
"سیستان_و_بلوچستان","زاهدان","مرکزی",32,863,20,14,538,1435,9,1444
"سیستان_و_بلوچستان","زاهدان","مرکزی",33,383,0,9,316,708,3,711
"سیستان_و_بلوچستان","زاهدان","مرکزی",34,460,11,14,1257,1742,2,1744
"سیستان_و_بلوچستان","زاهدان","مرکزی",35,837,17,28,748,1630,6,1636
"سیستان_و_بلوچستان","زاهدان","مرکزی",36,866,38,11,573,1488,6,1494
"سیستان_و_بلوچستان","زاهدان","مرکزی",37,1309,20,11,521,1861,17,1878
"سیستان_و_بلوچستان","زاهدان","مرکزی",38,1395,16,9,524,1944,9,1953
"سیستان_و_بلوچستان","زاهدان","مرکزی",39,1436,31,17,601,2085,15,2100
"سیستان_و_بلوچستان","زاهدان","مرکزی",40,671,14,12,472,1169,10,1179
"سیستان_و_بلوچستان","زاهدان","مرکزی",41,651,40,10,839,1540,25,1565
"سیستان_و_بلوچستان","زاهدان","مرکزی",42,894,38,37,929,1898,32,1930
"سیستان_و_بلوچستان","زاهدان","مرکزی",43,608,69,52,980,1709,31,1740
"سیستان_و_بلوچستان","زاهدان","مرکزی",44,1228,20,17,576,1841,26,1867
"سیستان_و_بلوچستان","زاهدان","مرکزی",45,229,9,7,167,412,4,416
"سیستان_و_بلوچستان","زاهدان","مرکزی",46,1208,42,17,539,1806,10,1816
"سیستان_و_بلوچستان","زاهدان","مرکزی",47,274,7,23,1145,1449,12,1461
"سیستان_و_بلوچستان","زاهدان","مرکزی",48,713,14,22,829,1578,15,1593
"سیستان_و_بلوچستان","زاهدان","مرکزی",49,936,13,10,369,1328,12,1340
"سیستان_و_بلوچستان","زاهدان","مرکزی",50,576,10,8,252,846,6,852
"سیستان_و_بلوچستان","زاهدان","مرکزی",51,1085,31,13,741,1870,15,1885
"سیستان_و_بلوچستان","زاهدان","مرکزی",52,952,21,13,528,1514,19,1533
"سیستان_و_بلوچستان","زاهدان","مرکزی",53,1127,9,3,278,1417,9,1426
"سیستان_و_بلوچستان","زاهدان","مرکزی",54,896,4,7,162,1069,7,1076
"سیستان_و_بلوچستان","زاهدان","مرکزی",55,1103,2,8,234,1347,8,1355
"سیستان_و_بلوچستان","زاهدان","مرکزی",56,1557,8,3,81,1649,10,1659
"سیستان_و_بلوچستان","زاهدان","مرکزی",57,840,4,8,172,1024,5,1029
"سیستان_و_بلوچستان","زاهدان","مرکزی",58,1140,8,7,265,1420,6,1426
"سیستان_و_بلوچستان","زاهدان","مرکزی",59,987,2,15,231,1235,5,1240
"سیستان_و_بلوچستان","زاهدان","مرکزی",60,1429,17,27,544,2017,15,2032
"سیستان_و_بلوچستان","زاهدان","مرکزی",61,1021,4,7,297,1329,7,1336
"سیستان_و_بلوچستان","زاهدان","مرکزی",62,827,8,13,256,1104,5,1109
"سیستان_و_بلوچستان","زاهدان","مرکزی",63,1104,8,7,362,1481,0,1481
"سیستان_و_بلوچستان","زاهدان","مرکزی",64,937,3,9,377,1326,10,1336
"سیستان_و_بلوچستان","زاهدان","مرکزی",65,1000,5,3,393,1401,4,1405
"سیستان_و_بلوچستان","زاهدان","مرکزی",66,1128,12,8,474,1622,9,1631
"سیستان_و_بلوچستان","زاهدان","مرکزی",67,667,11,7,278,963,4,967
"سیستان_و_بلوچستان","زاهدان","مرکزی",68,1571,9,13,567,2160,14,2174
"سیستان_و_بلوچستان","زاهدان","مرکزی",69,444,6,6,315,771,5,776
"سیستان_و_بلوچستان","زاهدان","مرکزی",70,924,1,9,359,1293,9,1302
"سیستان_و_بلوچستان","زاهدان","مرکزی",71,1097,8,4,271,1380,3,1383
"سیستان_و_بلوچستان","زاهدان","مرکزی",72,506,14,32,898,1450,8,1458
"سیستان_و_بلوچستان","زاهدان","مرکزی",73,498,4,27,819,1348,2,1350
"سیستان_و_بلوچستان","زاهدان","مرکزی",74,143,5,13,1452,1613,7,1620
"سیستان_و_بلوچستان","زاهدان","مرکزی",75,712,3,21,702,1438,2,1440
"سیستان_و_بلوچستان","زاهدان","مرکزی",76,546,3,16,666,1231,4,1235
"سیستان_و_بلوچستان","زاهدان","مرکزی",77,370,5,44,1064,1483,11,1494
"سیستان_و_بلوچستان","زاهدان","مرکزی",78,246,2,25,777,1050,3,1053
"سیستان_و_بلوچستان","زاهدان","مرکزی",79,622,9,15,785,1431,10,1441
"سیستان_و_بلوچستان","زاهدان","مرکزی",80,160,4,31,1651,1846,13,1859
"سیستان_و_بلوچستان","زاهدان","مرکزی",81,416,9,22,1351,1798,2,1800
"سیستان_و_بلوچستان","زاهدان","مرکزی",82,286,6,6,1056,1354,9,1363
"سیستان_و_بلوچستان","زاهدان","مرکزی",83,816,6,26,908,1756,12,1768
"سیستان_و_بلوچستان","زاهدان","مرکزی",84,207,4,15,1482,1708,10,1718
"سیستان_و_بلوچستان","زاهدان","مرکزی",85,662,23,16,960,1661,13,1674
"سیستان_و_بلوچستان","زاهدان","مرکزی",86,765,20,15,450,1250,11,1261
"سیستان_و_بلوچستان","زاهدان","مرکزی",87,460,7,7,755,1229,7,1236
"سیستان_و_بلوچستان","زاهدان","مرکزی",88,707,10,30,790,1537,11,1548
"سیستان_و_بلوچستان","زاهدان","مرکزی",89,1067,16,13,394,1490,11,1501
"سیستان_و_بلوچستان","زاهدان","مرکزی",90,1025,20,11,502,1558,7,1565
"سیستان_و_بلوچستان","زاهدان","مرکزی",91,932,26,4,512,1474,14,1488
"سیستان_و_بلوچستان","زاهدان","مرکزی",92,378,15,16,433,842,7,849
"سیستان_و_بلوچستان","زاهدان","مرکزی",93,664,29,32,1070,1795,8,1803
"سیستان_و_بلوچستان","زاهدان","مرکزی",94,489,20,9,586,1104,0,1104
"سیستان_و_بلوچستان","زاهدان","مرکزی",95,522,26,9,730,1287,22,1309
"سیستان_و_بلوچستان","زاهدان","مرکزی",96,902,39,13,946,1900,19,1919
"سیستان_و_بلوچستان","زاهدان","مرکزی",97,716,18,18,784,1536,15,1551
"سیستان_و_بلوچستان","زاهدان","مرکزی",98,131,3,13,567,714,5,719
"سیستان_و_بلوچستان","زاهدان","مرکزی",99,240,11,25,904,1180,9,1189
"سیستان_و_بلوچستان","زاهدان","مرکزی",100,52,1,13,1610,1676,6,1682
"سیستان_و_بلوچستان","زاهدان","مرکزی",101,251,3,21,1243,1518,7,1525
"سیستان_و_بلوچستان","زاهدان","مرکزی",102,554,13,14,836,1417,13,1430
"سیستان_و_بلوچستان","زاهدان","مرکزی",103,287,7,10,1087,1391,5,1396
"سیستان_و_بلوچستان","زاهدان","مرکزی",104,852,13,16,775,1656,12,1668
"سیستان_و_بلوچستان","زاهدان","مرکزی",105,261,4,8,365,638,4,642
"سیستان_و_بلوچستان","زاهدان","مرکزی",106,945,32,17,906,1900,18,1918
"سیستان_و_بلوچستان","زاهدان","مرکزی",107,920,23,23,524,1490,9,1499
"سیستان_و_بلوچستان","زاهدان","مرکزی",108,933,22,11,398,1364,6,1370
"سیستان_و_بلوچستان","زاهدان","مرکزی",109,592,11,27,1568,2198,25,2223
"سیستان_و_بلوچستان","زاهدان","مرکزی",110,833,28,26,717,1604,16,1620
"سیستان_و_بلوچستان","زاهدان","مرکزی",111,902,17,12,603,1534,12,1546
"سیستان_و_بلوچستان","زاهدان","مرکزی",112,812,23,9,826,1670,11,1681
"سیستان_و_بلوچستان","زاهدان","مرکزی",113,1073,5,18,1093,2189,26,2215
"سیستان_و_بلوچستان","زاهدان","مرکزی",114,1370,10,12,584,1976,13,1989
"سیستان_و_بلوچستان","زاهدان","مرکزی",115,818,14,6,728,1566,11,1577
"سیستان_و_بلوچستان","زاهدان","مرکزی",116,874,10,15,999,1898,21,1919
"سیستان_و_بلوچستان","زاهدان","مرکزی",117,662,13,6,893,1574,15,1589
"سیستان_و_بلوچستان","زاهدان","مرکزی",118,1114,39,18,880,2051,16,2067
"سیستان_و_بلوچستان","زاهدان","مرکزی",119,917,18,17,750,1702,12,1714
"سیستان_و_بلوچستان","زاهدان","مرکزی",120,1236,19,14,502,1771,17,1788
"سیستان_و_بلوچستان","زاهدان","مرکزی",121,647,12,16,505,1180,9,1189
"سیستان_و_بلوچستان","زاهدان","مرکزی",122,1161,44,14,536,1755,13,1768
"سیستان_و_بلوچستان","زاهدان","مرکزی",123,301,10,3,231,545,7,552
"سیستان_و_بلوچستان","زاهدان","مرکزی",124,760,10,8,642,1420,7,1427
"سیستان_و_بلوچستان","زاهدان","مرکزی",125,687,0,1,106,794,17,811
"سیستان_و_بلوچستان","زاهدان","مرکزی",126,809,9,7,291,1116,6,1122
"سیستان_و_بلوچستان","زاهدان","مرکزی",127,576,34,9,646,1265,10,1275
"سیستان_و_بلوچستان","زاهدان","مرکزی",128,957,37,12,649,1655,21,1676
"سیستان_و_بلوچستان","زاهدان","مرکزی",129,392,10,14,554,970,5,975
"سیستان_و_بلوچستان","زاهدان","مرکزی",130,719,14,12,727,1472,16,1488
"سیستان_و_بلوچستان","زاهدان","مرکزی",131,759,24,11,739,1533,19,1552
"سیستان_و_بلوچستان","زاهدان","مرکزی",132,618,30,16,1067,1731,14,1745
"سیستان_و_بلوچستان","زاهدان","مرکزی",133,211,10,4,645,870,14,884
"سیستان_و_بلوچستان","زاهدان","مرکزی",134,893,37,5,482,1417,15,1432
"سیستان_و_بلوچستان","زاهدان","مرکزی",135,1064,32,6,928,2030,15,2045
"سیستان_و_بلوچستان","زاهدان","مرکزی",136,738,34,9,927,1708,15,1723
"سیستان_و_بلوچستان","زاهدان","مرکزی",137,900,29,14,955,1898,39,1937
"سیستان_و_بلوچستان","زاهدان","مرکزی",138,1281,38,11,746,2076,11,2087
"سیستان_و_بلوچستان","زاهدان","مرکزی",139,875,30,4,622,1531,9,1540
"سیستان_و_بلوچستان","زاهدان","مرکزی",140,1119,19,12,502,1652,5,1657
"سیستان_و_بلوچستان","زاهدان","مرکزی",141,1419,30,18,808,2275,19,2294
"سیستان_و_بلوچستان","زاهدان","مرکزی",142,1658,35,33,949,2675,15,2690
"سیستان_و_بلوچستان","زاهدان","مرکزی",143,864,19,2,478,1363,11,1374
"سیستان_و_بلوچستان","زاهدان","مرکزی",144,1597,24,18,946,2585,15,2600
"سیستان_و_بلوچستان","زاهدان","مرکزی",145,716,11,3,404,1134,6,1140
"سیستان_و_بلوچستان","زاهدان","مرکزی",146,780,45,31,822,1678,17,1695
"سیستان_و_بلوچستان","زاهدان","مرکزی",147,795,68,54,1158,2075,27,2102
"سیستان_و_بلوچستان","زاهدان","مرکزی",148,1100,29,28,781,1938,24,1962
"سیستان_و_بلوچستان","زاهدان","مرکزی",149,983,31,22,877,1913,13,1926
"سیستان_و_بلوچستان","زاهدان","مرکزی",150,324,6,3,176,509,5,514
"سیستان_و_بلوچستان","زاهدان","مرکزی",151,307,10,10,314,641,9,650
"سیستان_و_بلوچستان","زاهدان","مرکزی",152,616,13,11,280,920,17,937
"سیستان_و_بلوچستان","زاهدان","مرکزی",153,579,6,2,107,694,6,700
"سیستان_و_بلوچستان","زاهدان","مرکزی",154,570,8,1,123,702,7,709
"سیستان_و_بلوچستان","زاهدان","مرکزی",155,408,12,3,146,569,5,574
"سیستان_و_بلوچستان","زاهدان","مرکزی",156,409,36,10,364,819,17,836
"سیستان_و_بلوچستان","زاهدان","مرکزی",157,350,14,4,219,587,9,596
"سیستان_و_بلوچستان","زاهدان","مرکزی",158,18,1,9,679,707,4,711
"سیستان_و_بلوچستان","زاهدان","مرکزی",159,59,0,2,721,782,2,784
"سیستان_و_بلوچستان","زاهدان","مرکزی",160,17,0,3,398,418,4,422
"سیستان_و_بلوچستان","زاهدان","مرکزی",161,151,1,2,430,584,0,584
"سیستان_و_بلوچستان","زاهدان","مرکزی",162,36,6,10,724,776,6,782
"سیستان_و_بلوچستان","زاهدان","مرکزی",163,16,2,2,630,650,0,650
"سیستان_و_بلوچستان","زاهدان","مرکزی",164,38,2,4,283,327,2,329
"سیستان_و_بلوچستان","زاهدان","مرکزی",165,14,0,8,211,233,2,235
"سیستان_و_بلوچستان","زاهدان","مرکزی",166,34,3,6,412,455,2,457
"سیستان_و_بلوچستان","زاهدان","مرکزی",167,39,0,0,131,170,0,170
"سیستان_و_بلوچستان","زاهدان","میرجاوه",1,72,2,6,750,830,6,836
"سیستان_و_بلوچستان","زاهدان","میرجاوه",2,117,2,7,590,716,8,724
"سیستان_و_بلوچستان","زاهدان","میرجاوه",3,186,7,7,299,499,9,508
"سیستان_و_بلوچستان","زاهدان","میرجاوه",4,209,5,2,266,482,1,483
"سیستان_و_بلوچستان","زاهدان","میرجاوه",5,93,2,1,496,592,11,603
"سیستان_و_بلوچستان","زاهدان","میرجاوه",6,95,2,4,390,491,6,497
"سیستان_و_بلوچستان","زاهدان","میرجاوه",7,143,5,9,539,696,9,705
"سیستان_و_بلوچستان","زاهدان","میرجاوه",8,99,5,6,493,603,0,603
"سیستان_و_بلوچستان","زاهدان","میرجاوه",9,140,2,2,85,229,2,231
"سیستان_و_بلوچستان","زاهدان","میرجاوه",10,46,0,15,977,1038,3,1041
"سیستان_و_بلوچستان","زاهدان","میرجاوه",11,56,1,2,627,686,10,696
"سیستان_و_بلوچستان","زاهدان","میرجاوه",12,107,3,11,995,1116,0,1116
"سیستان_و_بلوچستان","زاهدان","میرجاوه",13,45,0,0,286,331,2,333
"سیستان_و_بلوچستان","زاهدان","میرجاوه",14,18,2,5,512,537,4,541
"سیستان_و_بلوچستان","زاهدان","میرجاوه",15,92,2,16,726,836,5,841
"سیستان_و_بلوچستان","زاهدان","میرجاوه",16,25,1,1,444,471,3,474
"سیستان_و_بلوچستان","زاهدان","میرجاوه",17,21,1,2,676,700,0,700
"سیستان_و_بلوچستان","زاهدان","میرجاوه",18,10,0,3,364,377,0,377
"سیستان_و_بلوچستان","زاهدان","میرجاوه",19,6,0,0,316,322,0,322
"سیستان_و_بلوچستان","زاهدان","میرجاوه",20,28,1,6,458,493,7,500
"سیستان_و_بلوچستان","زاهدان","میرجاوه",21,9,0,0,184,193,0,193
"سیستان_و_بلوچستان","زاهدان","میرجاوه",22,16,0,0,470,486,0,486
"سیستان_و_بلوچستان","زاهدان","میرجاوه",23,17,1,10,562,590,0,590
"سیستان_و_بلوچستان","زاهدان","میرجاوه",24,84,5,4,553,646,3,649
"سیستان_و_بلوچستان","زاهدان","میرجاوه",25,258,1,10,444,713,3,716
"سیستان_و_بلوچستان","زاهدان","میرجاوه",26,22,1,16,851,890,0,890
"سیستان_و_بلوچستان","زاهدان","میرجاوه",27,43,2,0,219,264,0,264
"سیستان_و_بلوچستان","زاهدان","نصرت_آباد",1,265,8,12,194,479,3,482
"سیستان_و_بلوچستان","زاهدان","نصرت_آباد",2,220,0,18,307,545,7,552
"سیستان_و_بلوچستان","زاهدان","نصرت_آباد",3,194,4,15,297,510,0,510
"سیستان_و_بلوچستان","زاهدان","نصرت_آباد",4,125,2,9,251,387,0,387
"سیستان_و_بلوچستان","زاهدان","نصرت_آباد",5,16,0,0,79,95,0,95
"سیستان_و_بلوچستان","زاهدان","نصرت_آباد",6,104,3,12,294,413,0,413
"سیستان_و_بلوچستان","زاهدان","نصرت_آباد",7,89,0,2,89,180,1,181
"سیستان_و_بلوچستان","زاهدان","نصرت_آباد",8,6,0,3,203,212,0,212
"سیستان_و_بلوچستان","زاهدان","نصرت_آباد",9,16,1,1,152,170,0,170
"سیستان_و_بلوچستان","زاهدان","نصرت_آباد",10,3,1,3,178,185,6,191
"سیستان_و_بلوچستان","زاهدان","نصرت_آباد",11,18,1,3,132,154,3,157
"سیستان_و_بلوچستان","زاهدان","نصرت_آباد",12,396,2,1,33,432,0,432
"سیستان_و_بلوچستان","زاهدان","نصرت_آباد",13,7,0,2,430,439,0,439
"سیستان_و_بلوچستان","زاهدان","نصرت_آباد",14,10,3,1,361,375,3,378
"سیستان_و_بلوچستان","زاهدان","نصرت_آباد",15,58,0,0,270,328,0,328
"سیستان_و_بلوچستان","زاهدان","نصرت_آباد",16,8,2,1,264,275,2,277
"سیستان_و_بلوچستان","زاهدان","نصرت_آباد",17,9,0,11,226,246,0,246
"سیستان_و_بلوچستان","زاهدان","نصرت_آباد",18,188,7,7,328,530,3,533
"سیستان_و_بلوچستان","زاهدان","نصرت_آباد",19,2,0,1,554,557,0,557
"سیستان_و_بلوچستان","زاهدان","کورین",1,102,0,2,330,434,0,434
"سیستان_و_بلوچستان","زاهدان","کورین",2,35,0,5,525,565,1,566
"سیستان_و_بلوچستان","زاهدان","کورین",3,23,0,2,473,498,0,498
"سیستان_و_بلوچستان","زاهدان","کورین",4,47,0,3,500,550,0,550
"سیستان_و_بلوچستان","زاهدان","کورین",5,34,2,2,334,372,3,375
"سیستان_و_بلوچستان","زاهدان","کورین",6,10,0,1,265,276,3,279
"سیستان_و_بلوچستان","زاهدان","کورین",7,5,0,1,390,396,1,397
"سیستان_و_بلوچستان","زاهدان","کورین",8,3,1,3,219,226,0,226
"سیستان_و_بلوچستان","زاهدان","کورین",9,46,0,2,459,507,0,507
"سیستان_و_بلوچستان","زاهدان","کورین",10,22,1,13,234,270,5,275
"سیستان_و_بلوچستان","زاهدان","کورین",11,120,9,15,446,590,2,592
"سیستان_و_بلوچستان","زاهدان","کورین",12,14,1,15,311,341,1,342
"سیستان_و_بلوچستان","زاهدان","کورین",13,8,0,2,271,281,2,283
"سیستان_و_بلوچستان","زاهدان","کورین",14,1,0,3,539,543,0,543
"سیستان_و_بلوچستان","زاهدان","کورین",15,6,0,1,314,321,0,321
"سیستان_و_بلوچستان","زاهدان","کورین",16,9,0,2,269,280,1,281
"سیستان_و_بلوچستان","زاهدان","کورین",17,22,2,3,288,315,0,315
"سیستان_و_بلوچستان","زاهدان","کورین",18,1,0,0,435,436,0,436
"سیستان_و_بلوچستان","زاهدان","کورین",19,26,1,10,613,650,0,650
"سیستان_و_بلوچستان","زاهدان","کورین",20,5,1,2,334,342,0,342
"سیستان_و_بلوچستان","زهک","مرکزی",1,396,9,2,126,533,10,543
"سیستان_و_بلوچستان","زهک","مرکزی",2,948,6,1,123,1078,2,1080
"سیستان_و_بلوچستان","زهک","مرکزی",3,847,2,10,254,1113,11,1124
"سیستان_و_بلوچستان","زهک","مرکزی",4,347,3,3,98,451,1,452
"سیستان_و_بلوچستان","زهک","مرکزی",5,488,7,0,156,651,3,654
"سیستان_و_بلوچستان","زهک","مرکزی",6,665,3,2,199,869,4,873
"سیستان_و_بلوچستان","زهک","مرکزی",7,208,2,5,249,464,4,468
"سیستان_و_بلوچستان","زهک","مرکزی",8,284,3,0,46,333,0,333
"سیستان_و_بلوچستان","زهک","مرکزی",9,266,1,10,285,562,6,568
"سیستان_و_بلوچستان","زهک","مرکزی",10,189,2,1,83,275,5,280
"سیستان_و_بلوچستان","زهک","مرکزی",11,244,1,2,269,516,5,521
"سیستان_و_بلوچستان","زهک","مرکزی",12,467,0,3,256,726,12,738
"سیستان_و_بلوچستان","زهک","مرکزی",13,689,3,1,45,738,1,739
"سیستان_و_بلوچستان","زهک","مرکزی",14,475,2,0,29,506,4,510
"سیستان_و_بلوچستان","زهک","مرکزی",15,668,5,0,35,708,2,710
"سیستان_و_بلوچستان","زهک","مرکزی",16,369,1,0,16,386,3,389
"سیستان_و_بلوچستان","زهک","مرکزی",17,909,6,2,67,984,1,985
"سیستان_و_بلوچستان","زهک","مرکزی",18,526,0,1,46,573,4,577
"سیستان_و_بلوچستان","زهک","مرکزی",19,237,0,8,28,273,0,273
"سیستان_و_بلوچستان","زهک","مرکزی",20,327,0,1,295,623,6,629
"سیستان_و_بلوچستان","زهک","مرکزی",21,349,1,10,471,831,7,838
"سیستان_و_بلوچستان","زهک","مرکزی",22,226,3,22,339,590,2,592
"سیستان_و_بلوچستان","زهک","مرکزی",23,127,1,4,167,299,2,301
"سیستان_و_بلوچستان","زهک","مرکزی",24,641,1,10,336,988,5,993
"سیستان_و_بلوچستان","زهک","مرکزی",25,287,2,8,245,542,0,542
"سیستان_و_بلوچستان","زهک","مرکزی",26,696,3,1,155,855,0,855
"سیستان_و_بلوچستان","زهک","مرکزی",27,551,0,10,130,691,4,695
"سیستان_و_بلوچستان","زهک","مرکزی",28,441,2,1,80,524,0,524
"سیستان_و_بلوچستان","زهک","مرکزی",29,597,3,1,64,665,3,668
"سیستان_و_بلوچستان","زهک","مرکزی",30,544,0,1,66,611,0,611
"سیستان_و_بلوچستان","زهک","مرکزی",31,975,3,6,180,1164,5,1169
"سیستان_و_بلوچستان","زهک","مرکزی",32,641,4,4,313,962,0,962
"سیستان_و_بلوچستان","زهک","مرکزی",33,764,0,3,44,811,0,811
"سیستان_و_بلوچستان","زهک","مرکزی",34,497,1,0,53,551,2,553
"سیستان_و_بلوچستان","زهک","مرکزی",35,374,0,7,97,478,1,479
"سیستان_و_بلوچستان","زهک","مرکزی",36,328,1,2,72,403,0,403
"سیستان_و_بلوچستان","زهک","جزینک",1,520,1,0,78,599,1,600
"سیستان_و_بلوچستان","زهک","جزینک",2,529,0,0,45,574,2,576
"سیستان_و_بلوچستان","زهک","جزینک",3,298,1,1,77,377,0,377
"سیستان_و_بلوچستان","زهک","جزینک",4,322,1,1,12,336,0,336
"سیستان_و_بلوچستان","زهک","جزینک",5,537,4,1,172,714,0,714
"سیستان_و_بلوچستان","زهک","جزینک",6,800,3,2,104,909,3,912
"سیستان_و_بلوچستان","زهک","جزینک",7,206,1,3,98,308,0,308
"سیستان_و_بلوچستان","زهک","جزینک",8,310,0,9,414,733,4,737
"سیستان_و_بلوچستان","زهک","جزینک",9,400,4,0,68,472,0,472
"سیستان_و_بلوچستان","زهک","جزینک",10,294,0,6,180,480,0,480
"سیستان_و_بلوچستان","زهک","جزینک",11,398,3,1,11,413,0,413
"سیستان_و_بلوچستان","زهک","جزینک",12,558,1,6,27,592,4,596
"سیستان_و_بلوچستان","زهک","جزینک",13,507,0,0,12,519,0,519
"سیستان_و_بلوچستان","زهک","جزینک",14,497,3,1,22,523,6,529
"سیستان_و_بلوچستان","زهک","جزینک",15,560,4,0,22,586,0,586
"سیستان_و_بلوچستان","زهک","جزینک",16,529,0,0,21,550,0,550
"سیستان_و_بلوچستان","زهک","جزینک",17,782,5,1,98,886,5,891
"سیستان_و_بلوچستان","زهک","جزینک",18,365,1,0,27,393,0,393
"سیستان_و_بلوچستان","زهک","جزینک",19,337,3,3,24,367,0,367
"سیستان_و_بلوچستان","زهک","جزینک",20,436,0,0,62,498,5,503
"سیستان_و_بلوچستان","سراوان","مرکزی",1,100,4,16,443,563,6,569
"سیستان_و_بلوچستان","سراوان","مرکزی",2,278,9,38,426,751,9,760
"سیستان_و_بلوچستان","سراوان","مرکزی",3,161,0,15,602,778,10,788
"سیستان_و_بلوچستان","سراوان","مرکزی",4,319,7,19,680,1025,7,1032
"سیستان_و_بلوچستان","سراوان","مرکزی",5,118,5,22,649,794,4,798
"سیستان_و_بلوچستان","سراوان","مرکزی",6,218,6,28,879,1131,13,1144
"سیستان_و_بلوچستان","سراوان","مرکزی",7,212,15,9,836,1072,13,1085
"سیستان_و_بلوچستان","سراوان","مرکزی",8,136,2,6,214,358,4,362
"سیستان_و_بلوچستان","سراوان","مرکزی",9,133,6,17,543,699,11,710
"سیستان_و_بلوچستان","سراوان","مرکزی",10,156,2,18,714,890,8,898
"سیستان_و_بلوچستان","سراوان","مرکزی",11,123,3,12,259,397,3,400
"سیستان_و_بلوچستان","سراوان","مرکزی",12,109,10,15,1057,1191,10,1201
"سیستان_و_بلوچستان","سراوان","مرکزی",13,116,0,19,838,973,5,978
"سیستان_و_بلوچستان","سراوان","مرکزی",14,114,3,22,764,903,3,906
"سیستان_و_بلوچستان","سراوان","مرکزی",15,288,8,26,929,1251,14,1265
"سیستان_و_بلوچستان","سراوان","مرکزی",16,42,4,16,222,284,3,287
"سیستان_و_بلوچستان","سراوان","مرکزی",17,233,3,16,533,785,5,790
"سیستان_و_بلوچستان","سراوان","مرکزی",18,99,3,24,441,567,9,576
"سیستان_و_بلوچستان","سراوان","مرکزی",19,164,3,21,548,736,12,748
"سیستان_و_بلوچستان","سراوان","مرکزی",20,156,6,13,602,777,5,782
"سیستان_و_بلوچستان","سراوان","مرکزی",21,162,5,16,479,662,5,667
"سیستان_و_بلوچستان","سراوان","مرکزی",22,165,6,19,450,640,10,650
"سیستان_و_بلوچستان","سراوان","مرکزی",23,98,1,27,439,565,7,572
"سیستان_و_بلوچستان","سراوان","مرکزی",24,205,5,29,707,946,7,953
"سیستان_و_بلوچستان","سراوان","مرکزی",25,102,28,53,543,726,10,736
"سیستان_و_بلوچستان","سراوان","مرکزی",26,219,5,29,733,986,6,992
"سیستان_و_بلوچستان","سراوان","مرکزی",27,203,6,36,844,1089,8,1097
"سیستان_و_بلوچستان","سراوان","مرکزی",28,203,9,42,954,1208,14,1222
"سیستان_و_بلوچستان","سراوان","مرکزی",29,293,10,37,871,1211,8,1219
"سیستان_و_بلوچستان","سراوان","مرکزی",30,125,8,19,429,581,1,582
"سیستان_و_بلوچستان","سراوان","مرکزی",31,166,1,28,158,353,4,357
"سیستان_و_بلوچستان","سراوان","مرکزی",32,97,1,8,215,321,4,325
"سیستان_و_بلوچستان","سراوان","مرکزی",33,48,1,25,508,582,8,590
"سیستان_و_بلوچستان","سراوان","مرکزی",34,53,3,19,651,726,2,728
"سیستان_و_بلوچستان","سراوان","مرکزی",35,26,4,10,595,635,7,642
"سیستان_و_بلوچستان","سراوان","مرکزی",36,15,2,71,315,403,0,403
"سیستان_و_بلوچستان","سراوان","مرکزی",37,18,2,94,199,313,0,313
"سیستان_و_بلوچستان","سراوان","مرکزی",38,5,3,0,460,468,0,468
"سیستان_و_بلوچستان","سراوان","مرکزی",39,161,8,7,441,617,8,625
"سیستان_و_بلوچستان","سراوان","مرکزی",40,218,18,20,589,845,8,853
"سیستان_و_بلوچستان","سراوان","مرکزی",41,342,6,11,772,1131,9,1140
"سیستان_و_بلوچستان","سراوان","مرکزی",42,186,2,13,843,1044,3,1047
"سیستان_و_بلوچستان","سراوان","مرکزی",43,216,5,20,631,872,11,883
"سیستان_و_بلوچستان","سراوان","مرکزی",44,151,8,28,671,858,8,866
"سیستان_و_بلوچستان","سراوان","مرکزی",45,309,7,8,621,945,0,945
"سیستان_و_بلوچستان","سراوان","مرکزی",46,275,4,49,645,973,13,986
"سیستان_و_بلوچستان","سراوان","مرکزی",47,118,7,68,495,688,6,694
"سیستان_و_بلوچستان","سراوان","مرکزی",48,184,4,24,574,786,4,790
"سیستان_و_بلوچستان","سراوان","مرکزی",49,290,3,14,479,786,2,788
"سیستان_و_بلوچستان","سراوان","مرکزی",50,102,3,10,538,653,2,655
"سیستان_و_بلوچستان","سراوان","مرکزی",51,243,4,22,535,804,2,806
"سیستان_و_بلوچستان","سراوان","مرکزی",52,67,3,10,467,547,4,551
"سیستان_و_بلوچستان","سراوان","مرکزی",53,209,1,13,308,531,2,533
"سیستان_و_بلوچستان","سراوان","مرکزی",54,370,10,103,347,830,9,839
"سیستان_و_بلوچستان","سراوان","جالق",1,60,0,8,645,713,7,720
"سیستان_و_بلوچستان","سراوان","جالق",2,85,0,6,536,627,2,629
"سیستان_و_بلوچستان","سراوان","جالق",3,82,2,10,380,474,3,477
"سیستان_و_بلوچستان","سراوان","جالق",4,21,0,12,181,214,2,216
"سیستان_و_بلوچستان","سراوان","جالق",5,45,1,9,214,269,3,272
"سیستان_و_بلوچستان","سراوان","جالق",6,47,0,9,329,385,1,386
"سیستان_و_بلوچستان","سراوان","جالق",7,94,3,13,428,538,11,549
"سیستان_و_بلوچستان","سراوان","جالق",8,156,4,9,170,339,6,345
"سیستان_و_بلوچستان","سراوان","جالق",9,109,0,5,201,315,1,316
"سیستان_و_بلوچستان","سراوان","جالق",10,110,0,14,351,475,3,478
"سیستان_و_بلوچستان","سراوان","جالق",11,28,0,1,448,477,3,480
"سیستان_و_بلوچستان","سراوان","جالق",12,28,0,5,282,315,2,317
"سیستان_و_بلوچستان","سراوان","جالق",13,115,0,7,344,466,3,469
"سیستان_و_بلوچستان","سراوان","جالق",14,147,5,1,258,411,0,411
"سیستان_و_بلوچستان","سراوان","جالق",15,337,2,10,262,611,5,616
"سیستان_و_بلوچستان","سراوان","جالق",16,170,0,0,198,368,2,370
"سیستان_و_بلوچستان","سراوان","جالق",17,55,0,2,271,328,3,331
"سیستان_و_بلوچستان","سراوان","جالق",18,161,1,5,227,394,7,401
"سیستان_و_بلوچستان","سراوان","جالق",19,70,19,11,650,750,5,755
"سیستان_و_بلوچستان","سراوان","جالق",20,89,10,9,486,594,6,600
"سیستان_و_بلوچستان","سراوان","جالق",21,71,0,1,391,463,1,464
"سیستان_و_بلوچستان","سراوان","جالق",22,61,9,3,281,354,2,356
"سیستان_و_بلوچستان","سراوان","جالق",23,89,3,3,416,511,1,512
"سیستان_و_بلوچستان","سراوان","بم_پشت",1,85,4,4,251,344,1,345
"سیستان_و_بلوچستان","سراوان","بم_پشت",2,124,2,0,177,303,0,303
"سیستان_و_بلوچستان","سراوان","بم_پشت",3,51,0,4,380,435,4,439
"سیستان_و_بلوچستان","سراوان","بم_پشت",4,212,4,6,498,720,0,720
"سیستان_و_بلوچستان","سراوان","بم_پشت",5,100,0,8,359,467,0,467
"سیستان_و_بلوچستان","سراوان","بم_پشت",6,103,0,0,351,454,1,455
"سیستان_و_بلوچستان","سراوان","بم_پشت",7,88,0,118,320,526,0,526
"سیستان_و_بلوچستان","سراوان","بم_پشت",8,21,1,3,355,380,1,381
"سیستان_و_بلوچستان","سراوان","بم_پشت",9,8,1,1,607,617,1,618
"سیستان_و_بلوچستان","سراوان","بم_پشت",10,89,0,2,575,666,2,668
"سیستان_و_بلوچستان","سراوان","بم_پشت",11,146,4,31,736,917,1,918
"سیستان_و_بلوچستان","سراوان","بم_پشت",12,138,2,47,395,582,1,583
"سیستان_و_بلوچستان","سراوان","بم_پشت",13,306,0,8,379,693,4,697
"سیستان_و_بلوچستان","سراوان","بم_پشت",14,88,1,3,355,447,2,449
"سیستان_و_بلوچستان","سراوان","بم_پشت",15,13,1,25,303,342,8,350
"سیستان_و_بلوچستان","سراوان","بم_پشت",16,86,0,21,338,445,5,450
"سیستان_و_بلوچستان","سراوان","بم_پشت",17,169,0,15,249,433,6,439
"سیستان_و_بلوچستان","سراوان","بم_پشت",18,88,5,42,620,755,3,758
"سیستان_و_بلوچستان","سراوان","بم_پشت",19,72,1,8,551,632,0,632
"سیستان_و_بلوچستان","سراوان","بم_پشت",20,107,1,29,494,631,0,631
"سیستان_و_بلوچستان","سراوان","بم_پشت",21,5,0,0,493,498,0,498
"سیستان_و_بلوچستان","سراوان","بم_پشت",22,10,0,0,200,210,0,210
"سیستان_و_بلوچستان","سرباز","شهر_و_بخش_مرکزی",1,335,1,6,209,551,4,555
"سیستان_و_بلوچستان","سرباز","شهر_و_بخش_مرکزی",2,327,3,5,271,606,3,609
"سیستان_و_بلوچستان","سرباز","شهر_و_بخش_مرکزی",3,267,10,11,299,587,3,590
"سیستان_و_بلوچستان","سرباز","شهر_و_بخش_مرکزی",4,654,11,5,255,925,6,931
"سیستان_و_بلوچستان","سرباز","شهر_و_بخش_مرکزی",5,198,2,1,540,741,0,741
"سیستان_و_بلوچستان","سرباز","شهر_و_بخش_مرکزی",6,461,6,3,167,637,11,648
"سیستان_و_بلوچستان","سرباز","شهر_و_بخش_مرکزی",7,63,1,3,535,602,4,606
"سیستان_و_بلوچستان","سرباز","شهر_و_بخش_مرکزی",8,128,2,4,246,380,0,380
"سیستان_و_بلوچستان","سرباز","شهر_و_بخش_مرکزی",9,133,0,5,996,1134,0,1134
"سیستان_و_بلوچستان","سرباز","شهر_و_بخش_مرکزی",10,199,1,1,176,377,0,377
"سیستان_و_بلوچستان","سرباز","شهر_و_بخش_مرکزی",11,308,4,2,320,634,6,640
"سیستان_و_بلوچستان","سرباز","شهر_و_بخش_مرکزی",12,456,1,1,233,691,1,692
"سیستان_و_بلوچستان","سرباز","شهر_و_بخش_مرکزی",13,37,0,0,320,357,0,357
"سیستان_و_بلوچستان","سرباز","شهر_و_بخش_مرکزی",14,163,1,0,395,559,6,565
"سیستان_و_بلوچستان","سرباز","پارود",1,247,3,16,208,474,0,474
"سیستان_و_بلوچستان","سرباز","پارود",2,355,0,5,142,502,4,506
"سیستان_و_بلوچستان","سرباز","پارود",3,166,1,8,328,503,8,511
"سیستان_و_بلوچستان","سرباز","پارود",4,163,0,10,310,483,1,484
"سیستان_و_بلوچستان","سرباز","پارود",5,20,0,2,281,303,4,307
"سیستان_و_بلوچستان","سرباز","پارود",6,8,0,22,262,292,5,297
"سیستان_و_بلوچستان","سرباز","پارود",7,237,1,7,536,781,0,781
"سیستان_و_بلوچستان","سرباز","پارود",8,176,2,3,484,665,5,670
"سیستان_و_بلوچستان","سرباز","پارود",9,198,3,12,683,896,4,900
"سیستان_و_بلوچستان","سرباز","پارود",10,59,3,8,818,888,10,898
"سیستان_و_بلوچستان","سرباز","پارود",11,66,2,23,370,461,13,474
"سیستان_و_بلوچستان","سرباز","پارود",12,166,1,3,493,663,0,663
"سیستان_و_بلوچستان","سرباز","پارود",13,10,0,0,347,357,2,359
"سیستان_و_بلوچستان","سرباز","پارود",14,6,0,1,366,373,0,373
"سیستان_و_بلوچستان","سرباز","پارود",15,0,0,0,154,154,0,154
"سیستان_و_بلوچستان","سرباز","پارود",16,382,0,0,117,499,0,499
"سیستان_و_بلوچستان","سرباز","پارود",17,451,0,0,290,741,0,741
"سیستان_و_بلوچستان","سرباز","پارود",18,696,0,2,274,972,0,972
"سیستان_و_بلوچستان","سرباز","پیشین",1,65,0,6,647,718,1,719
"سیستان_و_بلوچستان","سرباز","پیشین",2,201,2,0,139,342,1,343
"سیستان_و_بلوچستان","سرباز","پیشین",3,142,0,16,380,538,2,540
"سیستان_و_بلوچستان","سرباز","پیشین",4,120,0,0,482,602,2,604
"سیستان_و_بلوچستان","سرباز","پیشین",5,103,4,11,585,703,3,706
"سیستان_و_بلوچستان","سرباز","پیشین",6,37,0,2,423,462,0,462
"سیستان_و_بلوچستان","سرباز","پیشین",7,17,0,1,667,685,0,685
"سیستان_و_بلوچستان","سرباز","پیشین",8,254,3,0,89,346,0,346
"سیستان_و_بلوچستان","سرباز","پیشین",9,21,0,4,107,132,0,132
"سیستان_و_بلوچستان","سرباز","پیشین",10,349,1,3,146,499,3,502
"سیستان_و_بلوچستان","سرباز","پیشین",11,297,0,1,292,590,0,590
"سیستان_و_بلوچستان","سرباز","سرباز",1,261,2,6,245,514,8,522
"سیستان_و_بلوچستان","سرباز","سرباز",2,817,0,23,458,1298,2,1300
"سیستان_و_بلوچستان","سرباز","سرباز",3,1225,3,1,237,1466,4,1470
"سیستان_و_بلوچستان","سرباز","سرباز",4,641,2,2,776,1421,0,1421
"سیستان_و_بلوچستان","سرباز","سرباز",5,281,4,17,849,1151,0,1151
"سیستان_و_بلوچستان","سرباز","سرباز",6,291,0,1,473,765,11,776
"سیستان_و_بلوچستان","سرباز","سرباز",7,120,0,0,480,600,0,600
"سیستان_و_بلوچستان","سرباز","سرباز",8,234,4,5,766,1009,0,1009
"سیستان_و_بلوچستان","سرباز","سرباز",9,522,0,6,584,1112,0,1112
"سیستان_و_بلوچستان","سرباز","سرباز",10,421,8,17,419,865,6,871
"سیستان_و_بلوچستان","سرباز","سرباز",11,206,0,2,666,874,2,876
"سیستان_و_بلوچستان","سرباز","سرباز",12,288,1,4,272,565,17,582
"سیستان_و_بلوچستان","سرباز","سرباز",13,581,1,2,533,1117,0,1117
"سیستان_و_بلوچستان","سرباز","سرباز",14,113,0,3,366,482,0,482
"سیستان_و_بلوچستان","سرباز","سرباز",15,348,0,0,352,700,0,700
"سیستان_و_بلوچستان","سرباز","سرباز",16,255,2,19,444,720,0,720
"سیستان_و_بلوچستان","سرباز","سرباز",17,23,0,0,521,544,0,544
"سیستان_و_بلوچستان","سرباز","سرباز",18,200,4,22,499,725,5,730
"سیستان_و_بلوچستان","سرباز","سرباز",19,5,1,1,417,424,0,424
"سیستان_و_بلوچستان","سرباز","سرباز",20,9,0,0,659,668,1,669
"سیستان_و_بلوچستان","سرباز","سرباز",21,32,0,22,239,293,0,293
"سیستان_و_بلوچستان","سرباز","سرباز",22,59,0,6,948,1013,11,1024
"سیستان_و_بلوچستان","سرباز","سرباز",23,46,0,2,451,499,0,499
"سیستان_و_بلوچستان","سرباز","سرباز",24,81,7,63,566,717,0,717
"سیستان_و_بلوچستان","سرباز","سرباز",25,354,1,19,1318,1692,0,1692
"سیستان_و_بلوچستان","سرباز","سرباز",26,442,0,24,936,1402,0,1402
"سیستان_و_بلوچستان","سرباز","سرباز",27,316,0,44,1796,2156,0,2156
"سیستان_و_بلوچستان","سرباز","سرباز",28,40,1,2,756,799,0,799
"سیستان_و_بلوچستان","سرباز","سرباز",29,68,0,1,629,698,0,698
"سیستان_و_بلوچستان","سرباز","سرباز",30,150,0,0,446,596,0,596
"سیستان_و_بلوچستان","سرباز","سرباز",31,272,0,7,420,699,0,699
"سیستان_و_بلوچستان","سرباز","سرباز",32,935,4,36,482,1457,0,1457
"سیستان_و_بلوچستان","سرباز","سرباز",33,67,0,23,1110,1200,0,1200
"سیستان_و_بلوچستان","سرباز","سرباز",34,258,6,23,361,648,0,648
"سیستان_و_بلوچستان","سرباز","سرباز",35,232,2,56,610,900,0,900
"سیستان_و_بلوچستان","سرباز","سرباز",36,202,1,5,506,714,0,714
"سیستان_و_بلوچستان","سیب_و_سوران","مرکزی",1,167,2,15,925,1109,13,1122
"سیستان_و_بلوچستان","سیب_و_سوران","مرکزی",2,151,1,7,580,739,7,746
"سیستان_و_بلوچستان","سیب_و_سوران","مرکزی",3,132,3,10,656,801,2,803
"سیستان_و_بلوچستان","سیب_و_سوران","مرکزی",4,208,2,11,548,769,2,771
"سیستان_و_بلوچستان","سیب_و_سوران","مرکزی",5,155,2,9,594,760,5,765
"سیستان_و_بلوچستان","سیب_و_سوران","مرکزی",6,110,2,14,433,559,6,565
"سیستان_و_بلوچستان","سیب_و_سوران","مرکزی",7,145,3,10,225,383,1,384
"سیستان_و_بلوچستان","سیب_و_سوران","مرکزی",8,59,0,6,408,473,0,473
"سیستان_و_بلوچستان","سیب_و_سوران","مرکزی",9,171,2,6,430,609,8,617
"سیستان_و_بلوچستان","سیب_و_سوران","مرکزی",10,88,1,4,390,483,0,483
"سیستان_و_بلوچستان","سیب_و_سوران","مرکزی",11,190,5,1,410,606,9,615
"سیستان_و_بلوچستان","سیب_و_سوران","مرکزی",12,74,6,2,491,573,0,573
"سیستان_و_بلوچستان","سیب_و_سوران","مرکزی",13,139,6,109,340,594,0,594
"سیستان_و_بلوچستان","سیب_و_سوران","مرکزی",14,402,1,35,730,1168,0,1168
"سیستان_و_بلوچستان","سیب_و_سوران","مرکزی",15,178,3,5,427,613,6,619
"سیستان_و_بلوچستان","سیب_و_سوران","مرکزی",16,129,1,3,332,465,0,465
"سیستان_و_بلوچستان","سیب_و_سوران","مرکزی",17,106,1,8,527,642,8,650
"سیستان_و_بلوچستان","سیب_و_سوران","مرکزی",18,233,2,4,708,947,2,949
"سیستان_و_بلوچستان","سیب_و_سوران","مرکزی",19,102,3,9,580,694,1,695
"سیستان_و_بلوچستان","سیب_و_سوران","مرکزی",20,123,1,8,242,374,1,375
"سیستان_و_بلوچستان","سیب_و_سوران","مرکزی",21,154,1,6,428,589,2,591
"سیستان_و_بلوچستان","سیب_و_سوران","مرکزی",22,133,1,2,302,438,0,438
"سیستان_و_بلوچستان","سیب_و_سوران","مرکزی",23,258,8,31,584,881,3,884
"سیستان_و_بلوچستان","سیب_و_سوران","مرکزی",24,218,4,0,332,554,2,556
"سیستان_و_بلوچستان","سیب_و_سوران","مرکزی",25,207,7,5,837,1056,0,1056
"سیستان_و_بلوچستان","سیب_و_سوران","مرکزی",26,101,3,8,549,661,2,663
"سیستان_و_بلوچستان","سیب_و_سوران","مرکزی",27,3,0,0,287,290,0,290
"سیستان_و_بلوچستان","سیب_و_سوران","مرکزی",28,39,0,3,359,401,1,402
"سیستان_و_بلوچستان","سیب_و_سوران","مرکزی",29,14,1,2,149,166,0,166
"سیستان_و_بلوچستان","سیب_و_سوران","مرکزی",30,118,0,0,49,167,0,167
"سیستان_و_بلوچستان","سیب_و_سوران","هیدوچ",1,50,3,4,190,247,3,250
"سیستان_و_بلوچستان","سیب_و_سوران","هیدوچ",2,38,1,5,251,295,1,296
"سیستان_و_بلوچستان","سیب_و_سوران","هیدوچ",3,317,2,5,154,478,3,481
"سیستان_و_بلوچستان","سیب_و_سوران","هیدوچ",4,207,2,29,62,300,0,300
"سیستان_و_بلوچستان","سیب_و_سوران","هیدوچ",5,281,0,1,131,413,0,413
"سیستان_و_بلوچستان","سیب_و_سوران","هیدوچ",6,148,1,3,460,612,0,612
"سیستان_و_بلوچستان","سیب_و_سوران","هیدوچ",7,84,1,0,239,324,1,325
"سیستان_و_بلوچستان","سیب_و_سوران","هیدوچ",8,123,1,2,461,587,1,588
"سیستان_و_بلوچستان","سیب_و_سوران","هیدوچ",9,131,0,2,270,403,0,403
"سیستان_و_بلوچستان","سیب_و_سوران","هیدوچ",10,185,0,4,236,425,3,428
"سیستان_و_بلوچستان","سیب_و_سوران","هیدوچ",11,219,2,14,251,486,2,488
"سیستان_و_بلوچستان","سیب_و_سوران","هیدوچ",12,464,2,7,198,671,0,671
"سیستان_و_بلوچستان","سیب_و_سوران","هیدوچ",13,179,1,14,204,398,3,401
"سیستان_و_بلوچستان","سیب_و_سوران","هیدوچ",14,350,5,2,267,624,0,624
"سیستان_و_بلوچستان","سیب_و_سوران","هیدوچ",15,100,1,7,466,574,0,574
"سیستان_و_بلوچستان","سیب_و_سوران","هیدوچ",16,200,1,5,278,484,0,484
"سیستان_و_بلوچستان","سیب_و_سوران","هیدوچ",17,73,0,1,344,418,0,418
"سیستان_و_بلوچستان","کنارک","مرکزی",1,100,4,13,535,652,3,655
"سیستان_و_بلوچستان","کنارک","مرکزی",2,172,8,13,371,564,9,573
"سیستان_و_بلوچستان","کنارک","مرکزی",3,553,16,11,329,909,8,917
"سیستان_و_بلوچستان","کنارک","مرکزی",4,202,2,9,396,609,5,614
"سیستان_و_بلوچستان","کنارک","مرکزی",5,152,5,7,756,920,4,924
"سیستان_و_بلوچستان","کنارک","مرکزی",6,180,11,2,326,519,3,522
"سیستان_و_بلوچستان","کنارک","مرکزی",7,152,2,19,505,678,4,682
"سیستان_و_بلوچستان","کنارک","مرکزی",8,50,0,14,147,211,2,213
"سیستان_و_بلوچستان","کنارک","مرکزی",9,159,1,7,496,663,6,669
"سیستان_و_بلوچستان","کنارک","مرکزی",10,155,3,4,598,760,1,761
"سیستان_و_بلوچستان","کنارک","مرکزی",11,251,17,6,657,931,19,950
"سیستان_و_بلوچستان","کنارک","مرکزی",12,79,0,1,259,339,0,339
"سیستان_و_بلوچستان","کنارک","مرکزی",13,140,4,3,280,427,2,429
"سیستان_و_بلوچستان","کنارک","مرکزی",14,790,18,5,245,1058,20,1078
"سیستان_و_بلوچستان","کنارک","مرکزی",15,720,15,13,195,943,15,958
"سیستان_و_بلوچستان","کنارک","مرکزی",16,182,6,4,520,712,3,715
"سیستان_و_بلوچستان","کنارک","مرکزی",17,156,1,7,201,365,2,367
"سیستان_و_بلوچستان","کنارک","مرکزی",18,476,8,4,173,661,7,668
"سیستان_و_بلوچستان","کنارک","مرکزی",19,191,3,10,302,506,3,509
"سیستان_و_بلوچستان","کنارک","مرکزی",20,96,4,7,473,580,3,583
"سیستان_و_بلوچستان","کنارک","مرکزی",21,106,1,6,666,779,3,782
"سیستان_و_بلوچستان","کنارک","مرکزی",22,41,0,1,436,478,2,480
"سیستان_و_بلوچستان","کنارک","مرکزی",23,514,6,10,508,1038,10,1048
"سیستان_و_بلوچستان","کنارک","مرکزی",24,42,0,10,339,391,1,392
"سیستان_و_بلوچستان","کنارک","مرکزی",25,208,4,4,529,745,5,750
"سیستان_و_بلوچستان","کنارک","مرکزی",26,111,2,2,565,680,3,683
"سیستان_و_بلوچستان","کنارک","مرکزی",27,79,2,7,805,893,10,903
"سیستان_و_بلوچستان","کنارک","مرکزی",28,128,5,5,492,630,1,631
"سیستان_و_بلوچستان","کنارک","مرکزی",29,117,1,1,239,358,3,361
"سیستان_و_بلوچستان","کنارک","مرکزی",30,33,1,2,358,394,1,395
"سیستان_و_بلوچستان","کنارک","مرکزی",31,10,1,1,427,439,2,441
"سیستان_و_بلوچستان","کنارک","مرکزی",32,238,0,2,314,554,0,554
"سیستان_و_بلوچستان","کنارک","مرکزی",33,70,1,0,570,641,10,651
"سیستان_و_بلوچستان","کنارک","مرکزی",34,78,1,1,274,354,0,354
"سیستان_و_بلوچستان","کنارک","مرکزی",35,93,7,5,403,508,0,508
"سیستان_و_بلوچستان","کنارک","مرکزی",36,27,1,3,233,264,0,264
"سیستان_و_بلوچستان","کنارک","مرکزی",37,13,1,0,213,227,0,227
"سیستان_و_بلوچستان","کنارک","زرآباد",1,221,2,1,268,492,2,494
"سیستان_و_بلوچستان","کنارک","زرآباد",2,49,0,0,231,280,0,280
"سیستان_و_بلوچستان","کنارک","زرآباد",3,193,1,1,37,232,1,233
"سیستان_و_بلوچستان","کنارک","زرآباد",4,252,4,1,190,447,0,447
"سیستان_و_بلوچستان","کنارک","زرآباد",5,206,6,2,296,510,1,511
"سیستان_و_بلوچستان","کنارک","زرآباد",6,142,3,3,137,285,0,285
"سیستان_و_بلوچستان","کنارک","زرآباد",7,287,1,2,109,399,0,399
"سیستان_و_بلوچستان","کنارک","زرآباد",8,236,2,2,126,366,0,366
"سیستان_و_بلوچستان","کنارک","زرآباد",9,95,1,3,158,257,0,257
"سیستان_و_بلوچستان","کنارک","زرآباد",10,24,0,1,618,643,5,648
"سیستان_و_بلوچستان","کنارک","زرآباد",11,19,1,1,186,207,1,208
"سیستان_و_بلوچستان","کنارک","زرآباد",12,242,4,4,156,406,0,406
"سیستان_و_بلوچستان","کنارک","زرآباد",13,88,0,0,50,138,0,138
"سیستان_و_بلوچستان","کنارک","زرآباد",14,32,0,3,146,181,5,186
"سیستان_و_بلوچستان","کنارک","زرآباد",15,51,3,3,213,270,0,270
"سیستان_و_بلوچستان","کنارک","زرآباد",16,88,3,3,411,505,0,505
"سیستان_و_بلوچستان","هیرمند","مرکزی",1,265,1,5,140,411,1,412
"سیستان_و_بلوچستان","هیرمند","مرکزی",2,455,2,10,300,767,8,775
"سیستان_و_بلوچستان","هیرمند","مرکزی",3,183,1,3,263,450,3,453
"سیستان_و_بلوچستان","هیرمند","مرکزی",4,478,0,4,150,632,3,635
"سیستان_و_بلوچستان","هیرمند","مرکزی",5,403,2,0,271,676,7,683
"سیستان_و_بلوچستان","هیرمند","مرکزی",6,88,0,0,12,100,3,103
"سیستان_و_بلوچستان","هیرمند","مرکزی",7,442,2,3,187,634,5,639
"سیستان_و_بلوچستان","هیرمند","مرکزی",8,309,1,8,365,683,2,685
"سیستان_و_بلوچستان","هیرمند","مرکزی",9,631,3,1,261,896,4,900
"سیستان_و_بلوچستان","هیرمند","مرکزی",10,392,4,3,306,705,1,706
"سیستان_و_بلوچستان","هیرمند","مرکزی",11,272,1,9,82,364,1,365
"سیستان_و_بلوچستان","هیرمند","مرکزی",12,309,4,8,346,667,6,673
"سیستان_و_بلوچستان","هیرمند","مرکزی",13,381,1,0,80,462,1,463
"سیستان_و_بلوچستان","هیرمند","مرکزی",14,174,1,2,236,413,7,420
"سیستان_و_بلوچستان","هیرمند","مرکزی",15,511,0,0,80,591,0,591
"سیستان_و_بلوچستان","هیرمند","مرکزی",16,738,7,1,277,1023,10,1033
"سیستان_و_بلوچستان","هیرمند","مرکزی",17,413,3,5,236,657,8,665
"سیستان_و_بلوچستان","هیرمند","مرکزی",18,462,3,4,89,558,5,563
"سیستان_و_بلوچستان","هیرمند","مرکزی",19,566,1,2,175,744,2,746
"سیستان_و_بلوچستان","هیرمند","مرکزی",20,894,3,3,129,1029,0,1029
"سیستان_و_بلوچستان","هیرمند","مرکزی",21,367,1,3,237,608,9,617
"سیستان_و_بلوچستان","هیرمند","مرکزی",22,419,1,7,443,870,9,879
"سیستان_و_بلوچستان","هیرمند","مرکزی",23,593,1,2,179,775,10,785
"سیستان_و_بلوچستان","هیرمند","مرکزی",24,377,0,3,153,533,2,535
"سیستان_و_بلوچستان","هیرمند","مرکزی",25,351,2,2,209,564,4,568
"سیستان_و_بلوچستان","هیرمند","مرکزی",26,60,1,1,151,213,0,213
"سیستان_و_بلوچستان","هیرمند","مرکزی",27,349,5,8,174,536,1,537
"سیستان_و_بلوچستان","هیرمند","مرکزی",28,585,0,0,95,680,1,681
"سیستان_و_بلوچستان","هیرمند","مرکزی",29,578,2,2,179,761,0,761
"سیستان_و_بلوچستان","هیرمند","مرکزی",30,383,1,5,281,670,4,674
"سیستان_و_بلوچستان","هیرمند","مرکزی",31,133,1,0,283,417,3,420
"سیستان_و_بلوچستان","هیرمند","مرکزی",32,153,4,1,176,334,3,337
"سیستان_و_بلوچستان","هیرمند","قرقری",1,529,0,2,102,633,3,636
"سیستان_و_بلوچستان","هیرمند","قرقری",2,304,0,1,143,448,2,450
"سیستان_و_بلوچستان","هیرمند","قرقری",3,418,0,2,58,478,0,478
"سیستان_و_بلوچستان","هیرمند","قرقری",4,493,0,1,85,579,1,580
"سیستان_و_بلوچستان","هیرمند","قرقری",5,473,2,1,87,563,0,563
"سیستان_و_بلوچستان","هیرمند","قرقری",6,104,0,1,129,234,0,234
"سیستان_و_بلوچستان","هیرمند","قرقری",7,104,0,3,315,422,0,422
"سیستان_و_بلوچستان","هیرمند","قرقری",8,307,0,0,12,319,2,321
"سیستان_و_بلوچستان","هیرمند","قرقری",9,616,2,0,82,700,3,703
"سیستان_و_بلوچستان","هیرمند","قرقری",10,282,1,0,75,358,3,361
"سیستان_و_بلوچستان","هیرمند","قرقری",11,289,10,6,105,410,0,410
"سیستان_و_بلوچستان","هیرمند","قرقری",12,554,2,1,92,649,2,651
"سیستان_و_بلوچستان","نیکشهر","مرکزی",1,365,6,6,411,788,7,795
"سیستان_و_بلوچستان","نیکشهر","مرکزی",2,222,10,10,359,601,4,605
"سیستان_و_بلوچستان","نیکشهر","مرکزی",3,87,5,2,75,169,4,173
"سیستان_و_بلوچستان","نیکشهر","مرکزی",4,176,14,9,238,437,5,442
"سیستان_و_بلوچستان","نیکشهر","مرکزی",5,633,0,7,235,875,7,882
"سیستان_و_بلوچستان","نیکشهر","مرکزی",6,133,8,11,372,524,6,530
"سیستان_و_بلوچستان","نیکشهر","مرکزی",7,408,15,40,489,952,12,964
"سیستان_و_بلوچستان","نیکشهر","مرکزی",8,191,13,13,246,463,0,463
"سیستان_و_بلوچستان","نیکشهر","مرکزی",9,110,13,10,255,388,2,390
"سیستان_و_بلوچستان","نیکشهر","مرکزی",10,320,10,12,226,568,3,571
"سیستان_و_بلوچستان","نیکشهر","مرکزی",11,121,6,9,458,594,1,595
"سیستان_و_بلوچستان","نیکشهر","مرکزی",12,414,5,9,267,695,2,697
"سیستان_و_بلوچستان","نیکشهر","مرکزی",13,690,4,2,566,1262,6,1268
"سیستان_و_بلوچستان","نیکشهر","مرکزی",14,397,2,5,268,672,1,673
"سیستان_و_بلوچستان","نیکشهر","مرکزی",15,214,4,4,303,525,0,525
"سیستان_و_بلوچستان","نیکشهر","مرکزی",16,410,8,7,368,793,2,795
"سیستان_و_بلوچستان","نیکشهر","مرکزی",17,251,18,7,658,934,8,942
"سیستان_و_بلوچستان","نیکشهر","مرکزی",18,180,5,4,316,505,0,505
"سیستان_و_بلوچستان","نیکشهر","مرکزی",19,478,2,1,193,674,7,681
"سیستان_و_بلوچستان","نیکشهر","مرکزی",20,180,16,38,500,734,0,734
"سیستان_و_بلوچستان","نیکشهر","مرکزی",21,102,104,20,748,974,1,975
"سیستان_و_بلوچستان","نیکشهر","مرکزی",22,303,4,11,620,938,0,938
"سیستان_و_بلوچستان","نیکشهر","مرکزی",23,70,7,1,562,640,0,640
"سیستان_و_بلوچستان","نیکشهر","مرکزی",24,207,8,4,369,588,0,588
"سیستان_و_بلوچستان","نیکشهر","مرکزی",25,215,12,6,241,474,0,474
"سیستان_و_بلوچستان","نیکشهر","مرکزی",26,459,4,2,344,809,4,813
"سیستان_و_بلوچستان","نیکشهر","مرکزی",27,415,3,10,481,909,4,913
"سیستان_و_بلوچستان","نیکشهر","مرکزی",28,411,7,17,542,977,5,982
"سیستان_و_بلوچستان","نیکشهر","مرکزی",29,342,2,4,405,753,0,753
"سیستان_و_بلوچستان","نیکشهر","مرکزی",30,321,0,1,207,529,0,529
"سیستان_و_بلوچستان","نیکشهر","مرکزی",31,147,1,1,167,316,3,319
"سیستان_و_بلوچستان","نیکشهر","مرکزی",32,150,0,2,290,442,3,445
"سیستان_و_بلوچستان","نیکشهر","بنت",1,281,9,21,280,591,5,596
"سیستان_و_بلوچستان","نیکشهر","بنت",2,142,7,6,245,400,2,402
"سیستان_و_بلوچستان","نیکشهر","بنت",3,147,2,9,248,406,4,410
"سیستان_و_بلوچستان","نیکشهر","بنت",4,271,6,1,214,492,7,499
"سیستان_و_بلوچستان","نیکشهر","بنت",5,372,0,0,176,548,7,555
"سیستان_و_بلوچستان","نیکشهر","بنت",6,350,2,1,152,505,0,505
"سیستان_و_بلوچستان","نیکشهر","بنت",7,138,2,3,438,581,0,581
"سیستان_و_بلوچستان","نیکشهر","بنت",8,530,1,1,114,646,2,648
"سیستان_و_بلوچستان","نیکشهر","بنت",9,431,2,2,273,708,0,708
"سیستان_و_بلوچستان","نیکشهر","بنت",10,273,0,1,128,402,2,404
"سیستان_و_بلوچستان","نیکشهر","بنت",11,319,4,8,455,786,0,786
"سیستان_و_بلوچستان","نیکشهر","بنت",12,133,3,3,418,557,0,557
"سیستان_و_بلوچستان","نیکشهر","بنت",13,184,2,3,455,644,0,644
"سیستان_و_بلوچستان","نیکشهر","بنت",14,96,3,7,536,642,0,642
"سیستان_و_بلوچستان","نیکشهر","بنت",15,363,0,1,114,478,0,478
"سیستان_و_بلوچستان","نیکشهر","فنوج",1,446,1,17,524,988,10,998
"سیستان_و_بلوچستان","نیکشهر","فنوج",2,379,0,8,341,728,0,728
"سیستان_و_بلوچستان","نیکشهر","فنوج",3,417,9,7,579,1012,1,1013
"سیستان_و_بلوچستان","نیکشهر","فنوج",4,341,0,19,255,615,9,624
"سیستان_و_بلوچستان","نیکشهر","فنوج",5,154,4,2,511,671,9,680
"سیستان_و_بلوچستان","نیکشهر","فنوج",6,190,0,0,141,331,0,331
"سیستان_و_بلوچستان","نیکشهر","فنوج",7,266,3,6,407,682,0,682
"سیستان_و_بلوچستان","نیکشهر","فنوج",8,56,2,3,439,500,0,500
"سیستان_و_بلوچستان","نیکشهر","فنوج",9,123,0,2,537,662,0,662
"سیستان_و_بلوچستان","نیکشهر","فنوج",10,225,6,4,568,803,0,803
"سیستان_و_بلوچستان","نیکشهر","فنوج",11,467,0,3,389,859,2,861
"سیستان_و_بلوچستان","نیکشهر","فنوج",12,55,1,1,323,380,0,380
"سیستان_و_بلوچستان","نیکشهر","فنوج",13,216,0,1,132,349,0,349
"سیستان_و_بلوچستان","نیکشهر","فنوج",14,307,3,3,347,660,28,688
"سیستان_و_بلوچستان","نیکشهر","فنوج",15,93,1,1,404,499,2,501
"سیستان_و_بلوچستان","نیکشهر","فنوج",16,296,5,5,388,694,4,698
"سیستان_و_بلوچستان","نیکشهر","فنوج",17,19,3,0,260,282,0,282
"سیستان_و_بلوچستان","نیکشهر","فنوج",18,71,1,8,318,398,0,398
"سیستان_و_بلوچستان","نیکشهر","فنوج",19,112,0,6,412,530,3,533
"سیستان_و_بلوچستان","نیکشهر","فنوج",20,4,0,4,280,288,1,289
"سیستان_و_بلوچستان","نیکشهر","فنوج",21,83,1,1,663,748,5,753
"سیستان_و_بلوچستان","نیکشهر","فنوج",22,33,1,5,378,417,0,417
"سیستان_و_بلوچستان","نیکشهر","فنوج",23,63,0,1,493,557,2,559
"سیستان_و_بلوچستان","نیکشهر","فنوج",24,288,3,9,590,890,0,890
"سیستان_و_بلوچستان","نیکشهر","فنوج",25,121,5,5,583,714,4,718
"سیستان_و_بلوچستان","نیکشهر","قصرقند",1,294,2,13,452,761,0,761
"سیستان_و_بلوچستان","نیکشهر","قصرقند",2,234,0,14,342,590,2,592
"سیستان_و_بلوچستان","نیکشهر","قصرقند",3,139,3,6,316,464,3,467
"سیستان_و_بلوچستان","نیکشهر","قصرقند",4,82,6,12,425,525,4,529
"سیستان_و_بلوچستان","نیکشهر","قصرقند",5,69,0,3,212,284,0,284
"سیستان_و_بلوچستان","نیکشهر","قصرقند",6,348,1,10,540,899,0,899
"سیستان_و_بلوچستان","نیکشهر","قصرقند",7,135,64,23,775,997,0,997
"سیستان_و_بلوچستان","نیکشهر","قصرقند",8,253,22,14,608,897,3,900
"سیستان_و_بلوچستان","نیکشهر","قصرقند",9,297,4,6,522,829,9,838
"سیستان_و_بلوچستان","نیکشهر","قصرقند",10,106,4,6,584,700,2,702
"سیستان_و_بلوچستان","نیکشهر","قصرقند",11,101,1,11,441,554,7,561
"سیستان_و_بلوچستان","نیکشهر","قصرقند",12,292,2,20,679,993,10,1003
"سیستان_و_بلوچستان","نیکشهر","قصرقند",13,281,7,6,804,1098,0,1098
"سیستان_و_بلوچستان","نیکشهر","قصرقند",14,157,4,2,652,815,3,818
"سیستان_و_بلوچستان","نیکشهر","قصرقند",15,46,3,1,172,222,0,222
"سیستان_و_بلوچستان","نیکشهر","قصرقند",16,9,5,1,421,436,0,436
"سیستان_و_بلوچستان","نیکشهر","قصرقند",17,21,11,4,137,173,0,173
"سیستان_و_بلوچستان","نیکشهر","قصرقند",18,24,2,6,450,482,0,482
"سیستان_و_بلوچستان","نیکشهر","قصرقند",19,90,0,3,481,574,0,574
"سیستان_و_بلوچستان","نیکشهر","قصرقند",20,51,2,9,438,500,0,500
"سیستان_و_بلوچستان","نیکشهر","قصرقند",21,201,0,3,280,484,1,485
"سیستان_و_بلوچستان","نیکشهر","قصرقند",22,100,2,5,462,569,0,569
"سیستان_و_بلوچستان","نیکشهر","لاشار",1,148,6,10,548,712,0,712
"سیستان_و_بلوچستان","نیکشهر","لاشار",2,160,2,2,559,723,0,723
"سیستان_و_بلوچستان","نیکشهر","لاشار",3,244,2,1,535,782,0,782
"سیستان_و_بلوچستان","نیکشهر","لاشار",4,627,0,1,169,797,3,800
"سیستان_و_بلوچستان","نیکشهر","لاشار",5,161,1,1,380,543,0,543
"سیستان_و_بلوچستان","نیکشهر","لاشار",6,61,0,2,259,322,0,322
"سیستان_و_بلوچستان","نیکشهر","لاشار",7,210,5,3,470,688,0,688
"سیستان_و_بلوچستان","نیکشهر","لاشار",8,303,0,2,336,641,5,646
"سیستان_و_بلوچستان","نیکشهر","لاشار",9,56,1,5,685,747,0,747
"سیستان_و_بلوچستان","نیکشهر","لاشار",10,45,2,0,553,600,0,600
"سیستان_و_بلوچستان","نیکشهر","لاشار",11,163,2,12,298,475,7,482
"سیستان_و_بلوچستان","نیکشهر","لاشار",12,106,1,4,211,322,0,322
"سیستان_و_بلوچستان","نیکشهر","لاشار",13,122,0,28,304,454,0,454
"سیستان_و_بلوچستان","نیکشهر","لاشار",14,194,0,3,49,246,2,248
"سیستان_و_بلوچستان","نیکشهر","لاشار",15,167,1,37,594,799,1,800
"سیستان_و_بلوچستان","نیکشهر","لاشار",16,73,2,3,520,598,0,598
"سیستان_و_بلوچستان","نیکشهر","لاشار",17,99,0,1,495,595,7,602
"سیستان_و_بلوچستان","نیکشهر","لاشار",18,280,1,2,507,790,3,793
"سیستان_و_بلوچستان","نیکشهر","لاشار",19,350,1,1,398,750,0,750
"سیستان_و_بلوچستان","نیکشهر","لاشار",20,255,1,2,198,456,0,456
"سیستان_و_بلوچستان","نیکشهر","لاشار",21,339,2,4,67,412,5,417
"سیستان_و_بلوچستان","نیکشهر","لاشار",22,70,0,3,631,704,0,704
"سیستان_و_بلوچستان","نیکشهر","لاشار",23,20,0,1,565,586,0,586
"سیستان_و_بلوچستان","نیکشهر","لاشار",24,23,7,1,367,398,0,398
"سیستان_و_بلوچستان","نیکشهر","لاشار",25,215,0,0,315,530,0,530
"سیستان_و_بلوچستان","نیکشهر","لاشار",26,27,0,0,133,160,3,163
"سیستان_و_بلوچستان","نیکشهر","لاشار",27,63,0,2,464,529,0,529
"سیستان_و_بلوچستان","نیکشهر","لاشار",28,21,0,3,571,595,0,595
"فارس","آباده","مرکزی",1,657,19,11,248,935,10,945
"فارس","آباده","مرکزی",2,660,9,4,141,814,4,818
"فارس","آباده","مرکزی",3,1052,14,3,298,1367,13,1380
"فارس","آباده","مرکزی",4,799,8,3,473,1283,16,1299
"فارس","آباده","مرکزی",5,1030,16,13,408,1467,12,1479
"فارس","آباده","مرکزی",6,623,21,8,474,1126,14,1140
"فارس","آباده","مرکزی",7,948,14,7,391,1360,6,1366
"فارس","آباده","مرکزی",8,482,16,28,367,893,10,903
"فارس","آباده","مرکزی",9,765,8,16,560,1349,18,1367
"فارس","آباده","مرکزی",10,224,8,9,238,479,8,487
"فارس","آباده","مرکزی",11,1093,30,7,598,1728,7,1735
"فارس","آباده","مرکزی",12,428,16,1,239,684,4,688
"فارس","آباده","مرکزی",13,658,19,15,542,1234,5,1239
"فارس","آباده","مرکزی",14,478,13,9,408,908,8,916
"فارس","آباده","مرکزی",15,1009,18,23,529,1579,20,1599
"فارس","آباده","مرکزی",16,676,14,10,422,1122,8,1130
"فارس","آباده","مرکزی",17,625,6,3,228,862,5,867
"فارس","آباده","مرکزی",18,846,10,2,302,1160,8,1168
"فارس","آباده","مرکزی",19,908,13,5,243,1169,7,1176
"فارس","آباده","مرکزی",20,1126,9,5,238,1378,7,1385
"فارس","آباده","مرکزی",21,360,6,3,146,515,3,518
"فارس","آباده","مرکزی",22,936,13,4,409,1362,11,1373
"فارس","آباده","مرکزی",23,775,14,11,255,1055,16,1071
"فارس","آباده","مرکزی",24,700,5,1,111,817,5,822
"فارس","آباده","مرکزی",25,617,4,3,238,862,8,870
"فارس","آباده","مرکزی",26,875,30,15,515,1435,12,1447
"فارس","آباده","مرکزی",27,556,5,6,125,692,6,698
"فارس","آباده","مرکزی",28,751,7,13,196,967,13,980
"فارس","آباده","مرکزی",29,949,4,8,222,1183,14,1197
"فارس","آباده","مرکزی",30,353,1,3,184,541,5,546
"فارس","آباده","مرکزی",31,913,12,14,301,1240,15,1255
"فارس","آباده","مرکزی",32,963,5,1,141,1110,7,1117
"فارس","آباده","مرکزی",33,984,4,13,259,1260,10,1270
"فارس","آباده","مرکزی",34,1024,4,8,238,1274,3,1277
"فارس","آباده","مرکزی",35,610,8,4,150,772,6,778
"فارس","آباده","مرکزی",36,948,4,10,197,1159,6,1165
"فارس","آباده","مرکزی",37,774,10,6,194,984,6,990
"فارس","آباده","مرکزی",38,1312,8,2,152,1474,14,1488
"فارس","آباده","مرکزی",39,554,4,0,51,609,5,614
"فارس","آباده","مرکزی",40,1280,14,5,164,1463,14,1477
"فارس","آباده","مرکزی",41,435,6,0,86,527,5,532
"فارس","آباده","مرکزی",42,858,11,2,231,1102,9,1111
"فارس","آباده","مرکزی",43,503,4,3,128,638,7,645
"فارس","آباده","مرکزی",44,420,4,2,70,496,4,500
"فارس","آباده","مرکزی",45,1184,3,3,166,1356,5,1361
"فارس","آباده","مرکزی",46,1127,4,1,137,1269,6,1275
"فارس","آباده","مرکزی",47,611,2,2,159,774,8,782
"فارس","آباده","مرکزی",48,603,2,1,66,672,3,675
"فارس","آباده","مرکزی",49,845,2,0,106,953,3,956
"فارس","آباده","مرکزی",50,773,1,1,170,945,3,948
"فارس","آباده","مرکزی",51,839,1,3,86,929,3,932
"فارس","آباده","مرکزی",52,342,1,1,73,417,3,420
"فارس","آباده","مرکزی",53,589,6,0,103,698,1,699
"فارس","آباده","مرکزی",54,559,5,4,167,735,2,737
"فارس","آباده","مرکزی",55,241,0,0,43,284,1,285
"فارس","آباده","مرکزی",56,179,8,2,94,283,7,290
"فارس","آباده","مرکزی",57,263,1,0,125,389,1,390
"فارس","آباده","مرکزی",58,1150,7,4,142,1303,2,1305
"فارس","آباده","مرکزی",59,344,1,0,12,357,0,357
"فارس","آباده","مرکزی",60,537,4,2,61,604,0,604
"فارس","ارسنجان","مرکزی",1,512,6,0,230,748,10,758
"فارس","ارسنجان","مرکزی",2,587,22,2,260,871,6,877
"فارس","ارسنجان","مرکزی",3,620,10,0,134,764,5,769
"فارس","ارسنجان","مرکزی",4,635,8,2,192,837,10,847
"فارس","ارسنجان","مرکزی",5,349,3,1,109,462,1,463
"فارس","ارسنجان","مرکزی",6,459,10,6,289,764,8,772
"فارس","ارسنجان","مرکزی",7,555,6,0,109,670,4,674
"فارس","ارسنجان","مرکزی",8,482,5,2,164,653,6,659
"فارس","ارسنجان","مرکزی",9,403,2,0,171,576,5,581
"فارس","ارسنجان","مرکزی",10,475,9,1,321,806,14,820
"فارس","ارسنجان","مرکزی",11,282,5,0,269,556,7,563
"فارس","ارسنجان","مرکزی",12,227,2,0,83,312,2,314
"فارس","ارسنجان","مرکزی",13,243,11,0,302,556,4,560
"فارس","ارسنجان","مرکزی",14,663,10,2,204,879,2,881
"فارس","ارسنجان","مرکزی",15,338,7,0,130,475,6,481
"فارس","ارسنجان","مرکزی",16,211,2,1,76,290,1,291
"فارس","ارسنجان","مرکزی",17,206,2,1,6,215,1,216
"فارس","ارسنجان","مرکزی",18,403,0,0,9,412,2,414
"فارس","ارسنجان","مرکزی",19,451,0,1,7,459,0,459
"فارس","ارسنجان","مرکزی",20,618,3,0,13,634,0,634
"فارس","ارسنجان","مرکزی",21,572,3,1,55,631,0,631
"فارس","ارسنجان","مرکزی",23,549,2,1,71,623,1,624
"فارس","ارسنجان","مرکزی",23,427,2,0,72,501,2,503
"فارس","ارسنجان","مرکزی",24,401,3,0,79,483,1,484
"فارس","ارسنجان","مرکزی",25,893,0,0,45,938,2,940
"فارس","ارسنجان","مرکزی",26,634,5,6,188,833,1,834
"فارس","ارسنجان","مرکزی",27,550,8,0,68,626,0,626
"فارس","ارسنجان","مرکزی",28,553,5,0,48,606,3,609
"فارس","ارسنجان","مرکزی",29,793,7,1,134,935,6,941
"فارس","ارسنجان","مرکزی",30,504,0,1,60,565,1,566
"فارس","ارسنجان","مرکزی",31,658,3,1,21,683,2,685
"فارس","ارسنجان","مرکزی",32,533,3,1,34,571,6,577
"فارس","ارسنجان","مرکزی",33,626,3,1,51,681,2,683
"فارس","ارسنجان","مرکزی",34,562,1,0,38,601,3,604
"فارس","ارسنجان","مرکزی",35,551,0,2,95,648,0,648
"فارس","ارسنجان","مرکزی",36,647,2,0,43,692,4,696
"فارس","ارسنجان","مرکزی",37,563,1,0,37,601,0,601
"فارس","ارسنجان","مرکزی",38,506,0,0,16,522,1,523
"فارس","ارسنجان","مرکزی",39,459,0,0,8,467,1,468
"فارس","ارسنجان","مرکزی",40,646,4,6,63,719,1,720
"فارس","ارسنجان","مرکزی",41,523,0,0,27,550,1,551
"فارس","ارسنجان","مرکزی",42,543,5,0,47,595,2,597
"فارس","استهبان","مرکزی",1,906,12,15,386,1319,9,1328
"فارس","استهبان","مرکزی",2,351,13,17,236,617,11,628
"فارس","استهبان","مرکزی",3,310,12,0,137,459,5,464
"فارس","استهبان","مرکزی",4,383,11,9,273,676,12,688
"فارس","استهبان","مرکزی",5,495,13,8,357,873,14,887
"فارس","استهبان","مرکزی",6,453,6,16,214,689,14,703
"فارس","استهبان","مرکزی",7,903,10,7,287,1207,24,1231
"فارس","استهبان","مرکزی",8,685,5,4,200,894,9,903
"فارس","استهبان","مرکزی",9,582,9,3,200,794,5,799
"فارس","استهبان","مرکزی",10,163,1,1,71,236,5,241
"فارس","استهبان","مرکزی",11,859,18,10,288,1175,12,1187
"فارس","استهبان","مرکزی",12,536,3,12,193,744,5,749
"فارس","استهبان","مرکزی",13,895,3,15,329,1242,6,1248
"فارس","استهبان","مرکزی",14,483,9,12,318,822,5,827
"فارس","استهبان","مرکزی",15,392,8,7,193,600,5,605
"فارس","استهبان","مرکزی",16,623,10,13,314,960,13,973
"فارس","استهبان","مرکزی",17,761,9,18,384,1172,13,1185
"فارس","استهبان","مرکزی",18,515,14,15,334,878,11,889
"فارس","استهبان","مرکزی",19,360,8,8,217,593,7,600
"فارس","استهبان","مرکزی",20,530,15,18,378,941,10,951
"فارس","استهبان","مرکزی",21,429,18,11,267,725,20,745
"فارس","استهبان","مرکزی",22,710,26,20,812,1568,25,1593
"فارس","استهبان","مرکزی",23,189,7,3,272,471,2,473
"فارس","استهبان","مرکزی",24,292,15,9,241,557,9,566
"فارس","استهبان","مرکزی",25,606,13,6,260,885,8,893
"فارس","استهبان","مرکزی",26,110,0,1,62,173,0,173
"فارس","استهبان","مرکزی",27,811,3,2,196,1012,5,1017
"فارس","استهبان","مرکزی",28,335,1,1,83,420,4,424
"فارس","استهبان","مرکزی",29,565,2,10,184,761,8,769
"فارس","استهبان","مرکزی",30,901,6,14,161,1082,12,1094
"فارس","استهبان","مرکزی",31,431,1,7,96,535,6,541
"فارس","استهبان","مرکزی",32,279,1,1,35,316,0,316
"فارس","استهبان","مرکزی",33,249,1,1,105,356,1,357
"فارس","استهبان","مرکزی",34,655,0,7,137,799,0,799
"فارس","استهبان","مرکزی",35,282,0,3,29,314,2,316
"فارس","استهبان","مرکزی",36,241,1,9,83,334,2,336
"فارس","استهبان","مرکزی",37,181,0,0,25,206,0,206
"فارس","استهبان","رونیز",1,967,4,3,274,1248,7,1255
"فارس","استهبان","رونیز",2,751,1,10,228,990,6,996
"فارس","استهبان","رونیز",3,562,5,10,242,819,8,827
"فارس","استهبان","رونیز",4,353,7,4,186,550,5,555
"فارس","استهبان","رونیز",5,477,10,1,40,528,0,528
"فارس","استهبان","رونیز",6,1068,4,4,142,1218,5,1223
"فارس","استهبان","رونیز",7,578,2,6,110,696,6,702
"فارس","استهبان","رونیز",8,950,6,6,86,1048,3,1051
"فارس","استهبان","رونیز",9,1063,4,2,157,1226,3,1229
"فارس","استهبان","رونیز",10,951,4,1,218,1174,9,1183
"فارس","استهبان","رونیز",11,728,9,0,137,874,11,885
"فارس","استهبان","رونیز",12,581,1,4,108,694,2,696
"فارس","استهبان","رونیز",13,925,1,2,133,1061,7,1068
"فارس","استهبان","رونیز",14,560,2,0,231,793,10,803
"فارس","استهبان","رونیز",15,370,1,2,29,402,2,404
"فارس","استهبان","رونیز",16,571,0,2,48,621,5,626
"فارس","استهبان","رونیز",17,306,3,2,64,375,7,382
"فارس","استهبان","رونیز",18,91,2,1,20,114,2,116
"فارس","اقلید","مرکزی",1,297,9,0,92,398,5,403
"فارس","اقلید","مرکزی",2,634,15,2,342,993,7,1000
"فارس","اقلید","مرکزی",3,765,20,8,336,1129,18,1147
"فارس","اقلید","مرکزی",4,1037,19,3,286,1345,14,1359
"فارس","اقلید","مرکزی",5,579,20,5,301,905,29,934
"فارس","اقلید","مرکزی",6,316,4,0,216,536,22,558
"فارس","اقلید","مرکزی",7,475,14,3,247,739,11,750
"فارس","اقلید","مرکزی",8,441,11,6,264,722,9,731
"فارس","اقلید","مرکزی",9,387,9,3,197,596,8,604
"فارس","اقلید","مرکزی",10,572,10,8,442,1032,12,1044
"فارس","اقلید","مرکزی",11,384,9,2,179,574,7,581
"فارس","اقلید","مرکزی",12,446,15,3,340,804,10,814
"فارس","اقلید","مرکزی",13,297,7,6,263,573,5,578
"فارس","اقلید","مرکزی",14,415,11,5,336,767,14,781
"فارس","اقلید","مرکزی",15,1033,15,7,580,1635,20,1655
"فارس","اقلید","مرکزی",16,534,10,3,337,884,16,900
"فارس","اقلید","مرکزی",17,623,3,2,432,1060,32,1092
"فارس","اقلید","مرکزی",18,549,15,4,272,840,15,855
"فارس","اقلید","مرکزی",19,211,2,1,256,470,8,478
"فارس","اقلید","مرکزی",20,635,13,2,599,1249,23,1272
"فارس","اقلید","مرکزی",21,216,4,3,206,429,9,438
"فارس","اقلید","مرکزی",22,695,20,7,717,1439,30,1469
"فارس","اقلید","مرکزی",23,371,14,6,598,989,15,1004
"فارس","اقلید","مرکزی",24,638,10,7,289,944,14,958
"فارس","اقلید","مرکزی",25,250,9,0,201,460,8,468
"فارس","اقلید","مرکزی",26,467,7,1,178,653,5,658
"فارس","اقلید","مرکزی",27,608,4,1,165,778,7,785
"فارس","اقلید","مرکزی",28,241,10,0,132,383,7,390
"فارس","اقلید","مرکزی",29,961,2,0,97,1060,3,1063
"فارس","اقلید","مرکزی",30,325,2,0,182,509,3,512
"فارس","اقلید","مرکزی",31,1170,16,4,304,1494,9,1503
"فارس","اقلید","مرکزی",32,1102,4,1,165,1272,1,1273
"فارس","اقلید","مرکزی",33,626,2,1,94,723,1,724
"فارس","اقلید","مرکزی",34,911,8,3,162,1084,2,1086
"فارس","اقلید","مرکزی",35,363,5,0,139,507,1,508
"فارس","اقلید","مرکزی",36,1167,0,0,150,1317,17,1334
"فارس","اقلید","مرکزی",37,249,0,0,119,368,3,371
"فارس","اقلید","مرکزی",38,812,1,2,18,833,4,837
"فارس","اقلید","حسن_آباد",1,516,11,2,51,580,1,581
"فارس","اقلید","حسن_آباد",2,544,3,1,53,601,3,604
"فارس","اقلید","حسن_آباد",3,594,2,0,74,670,3,673
"فارس","اقلید","حسن_آباد",4,698,3,0,24,725,0,725
"فارس","اقلید","حسن_آباد",5,842,1,0,122,965,8,973
"فارس","اقلید","حسن_آباد",6,266,2,0,38,306,1,307
"فارس","اقلید","حسن_آباد",7,475,5,0,49,529,3,532
"فارس","اقلید","حسن_آباد",8,438,3,0,96,537,0,537
"فارس","اقلید","حسن_آباد",9,1082,4,1,113,1200,0,1200
"فارس","اقلید","حسن_آباد",10,332,4,0,48,384,1,385
"فارس","اقلید","حسن_آباد",11,500,1,1,45,547,1,548
"فارس","اقلید","حسن_آباد",12,564,0,3,69,636,0,636
"فارس","اقلید","حسن_آباد",13,504,2,1,53,560,5,565
"فارس","اقلید","حسن_آباد",14,693,5,0,102,800,0,800
"فارس","اقلید","حسن_آباد",15,559,2,6,299,866,2,868
"فارس","اقلید","حسن_آباد",16,595,1,7,118,721,0,721
"فارس","اقلید","سده",1,448,1,0,40,489,3,492
"فارس","اقلید","سده",2,710,10,0,108,828,4,832
"فارس","اقلید","سده",3,452,4,0,143,599,3,602
"فارس","اقلید","سده",4,333,11,1,141,486,6,492
"فارس","اقلید","سده",5,519,0,2,84,605,0,605
"فارس","اقلید","سده",6,401,3,0,73,477,0,477
"فارس","اقلید","سده",7,839,6,3,123,971,4,975
"فارس","اقلید","سده",8,479,6,2,70,557,7,564
"فارس","اقلید","سده",9,1096,11,11,175,1293,7,1300
"فارس","اقلید","سده",10,368,3,2,91,464,3,467
"فارس","اقلید","سده",11,475,0,1,103,579,1,580
"فارس","اقلید","سده",12,762,3,2,98,865,3,868
"فارس","اقلید","سده",13,619,4,1,44,668,2,670
"فارس","اقلید","سده",14,642,2,1,69,714,5,719
"فارس","اقلید","سده",15,341,5,1,58,405,1,406
"فارس","اقلید","سده",16,300,1,0,47,348,1,349
"فارس","اقلید","سده",17,481,6,0,25,512,2,514
"فارس","اقلید","سده",18,352,0,0,34,386,0,386
"فارس","اقلید","سده",19,432,5,0,81,518,2,520
"فارس","بوانات","سرچهان",1,468,3,1,29,501,2,503
"فارس","بوانات","سرچهان",2,616,0,0,28,644,2,646
"فارس","بوانات","سرچهان",3,726,1,0,25,752,1,753
"فارس","بوانات","سرچهان",4,586,0,0,51,637,0,637
"فارس","بوانات","سرچهان",5,803,3,0,39,845,1,846
"فارس","بوانات","سرچهان",6,689,3,0,18,710,0,710
"فارس","بوانات","سرچهان",7,398,0,0,32,430,0,430
"فارس","بوانات","سرچهان",8,306,0,0,11,317,0,317
"فارس","بوانات","سرچهان",9,486,5,0,42,533,3,536
"فارس","بوانات","سرچهان",10,753,8,0,156,917,5,922
"فارس","بوانات","سرچهان",11,515,3,0,139,657,8,665
"فارس","بوانات","سرچهان",12,564,4,1,39,608,2,610
"فارس","بوانات","سرچهان",13,567,1,0,35,603,1,604
"فارس","بوانات","سرچهان",14,396,1,1,8,406,1,407
"فارس","بوانات","سرچهان",15,769,5,9,33,816,2,818
"فارس","بوانات","سرچهان",16,706,4,4,46,760,6,766
"فارس","بوانات","سرچهان",17,729,2,1,78,810,3,813
"فارس","بوانات","سرچهان",18,864,6,2,98,970,6,976
"فارس","بوانات","سرچهان",19,871,1,0,32,904,1,905
"فارس","بوانات","سرچهان",20,377,1,0,20,398,2,400
"فارس","بوانات","مرکزی",1,715,7,2,219,943,14,957
"فارس","بوانات","مرکزی",2,729,8,2,153,892,8,900
"فارس","بوانات","مرکزی",3,989,10,2,148,1149,8,1157
"فارس","بوانات","مرکزی",4,390,2,0,81,473,6,479
"فارس","بوانات","مرکزی",5,457,7,2,126,592,2,594
"فارس","بوانات","مرکزی",6,574,3,2,131,710,1,711
"فارس","بوانات","مرکزی",7,383,1,0,45,429,2,431
"فارس","بوانات","مرکزی",8,709,3,5,153,870,7,877
"فارس","بوانات","مرکزی",9,81,2,1,27,111,0,111
"فارس","بوانات","مرکزی",10,438,0,2,41,481,0,481
"فارس","بوانات","مرکزی",11,777,0,2,34,813,4,817
"فارس","بوانات","مرکزی",12,625,1,0,32,658,2,660
"فارس","بوانات","مرکزی",13,656,0,0,59,715,3,718
"فارس","بوانات","مرکزی",14,692,1,0,71,764,3,767
"فارس","بوانات","مرکزی",15,695,1,1,113,810,3,813
"فارس","بوانات","مرکزی",16,663,1,0,121,785,6,791
"فارس","بوانات","مرکزی",17,474,0,2,31,507,3,510
"فارس","بوانات","مرکزی",18,386,0,0,72,458,2,460
"فارس","بوانات","مرکزی",19,732,3,0,55,790,2,792
"فارس","بوانات","مرکزی",20,670,3,2,128,803,6,809
"فارس","بوانات","مرکزی",21,535,6,1,24,566,5,571
"فارس","بوانات","مرکزی",22,530,0,1,51,582,5,587
"فارس","بوانات","مرکزی",23,563,1,0,35,599,0,599
"فارس","بوانات","مرکزی",24,337,0,0,41,378,1,379
"فارس","بوانات","مرکزی",25,400,3,0,32,435,2,437
"فارس","بوانات","مرکزی",26,374,0,2,44,420,1,421
"فارس","پاسارگاد","مرکزی",1,562,4,5,259,830,4,834
"فارس","پاسارگاد","مرکزی",2,432,4,0,174,610,4,614
"فارس","پاسارگاد","مرکزی",3,605,14,3,253,875,9,884
"فارس","پاسارگاد","مرکزی",4,496,4,1,81,582,2,584
"فارس","پاسارگاد","مرکزی",5,622,8,4,222,856,7,863
"فارس","پاسارگاد","مرکزی",6,495,8,2,293,798,3,801
"فارس","پاسارگاد","مرکزی",7,744,3,1,308,1056,6,1062
"فارس","پاسارگاد","مرکزی",8,380,2,0,102,484,4,488
"فارس","پاسارگاد","مرکزی",9,386,0,1,142,529,1,530
"فارس","پاسارگاد","مرکزی",10,478,1,1,175,655,4,659
"فارس","پاسارگاد","مرکزی",11,684,3,1,88,776,0,776
"فارس","پاسارگاد","مرکزی",12,670,3,3,160,836,8,844
"فارس","پاسارگاد","مرکزی",13,535,2,2,98,637,8,645
"فارس","پاسارگاد","مرکزی",14,338,1,1,41,381,0,381
"فارس","پاسارگاد","مرکزی",15,154,2,1,34,191,1,192
"فارس","پاسارگاد","مرکزی",16,685,1,1,78,765,1,766
"فارس","پاسارگاد","مرکزی",17,268,0,0,42,310,2,312
"فارس","پاسارگاد","مرکزی",18,127,1,0,36,164,2,166
"فارس","پاسارگاد","مرکزی",19,448,3,0,69,520,0,520
"فارس","پاسارگاد","مرکزی",20,175,2,0,15,192,0,192
"فارس","پاسارگاد","مرکزی",21,270,3,0,110,383,1,384
"فارس","پاسارگاد","مرکزی",22,259,0,0,35,294,0,294
"فارس","پاسارگاد","مرکزی",23,453,1,0,38,492,3,495
"فارس","پاسارگاد","مرکزی",24,336,3,0,37,376,2,378
"فارس","پاسارگاد","مرکزی",25,389,2,0,34,425,1,426
"فارس","پاسارگاد","مرکزی",26,116,6,0,44,166,1,167
"فارس","پاسارگاد","مرکزی",27,574,2,1,51,628,3,631
"فارس","پاسارگاد","مرکزی",28,213,7,0,21,241,0,241
"فارس","پاسارگاد","مرکزی",29,310,0,2,34,346,2,348
"فارس","پاسارگاد","مرکزی",30,259,1,0,23,283,1,284
"فارس","پاسارگاد","هخامنش",1,417,3,3,102,525,4,529
"فارس","پاسارگاد","هخامنش",2,468,2,0,76,546,8,554
"فارس","پاسارگاد","هخامنش",3,511,5,1,44,561,3,564
"فارس","پاسارگاد","هخامنش",4,550,2,0,28,580,3,583
"فارس","پاسارگاد","هخامنش",5,548,1,1,136,686,2,688
"فارس","پاسارگاد","هخامنش",6,626,2,0,85,713,3,716
"فارس","پاسارگاد","هخامنش",7,156,0,0,20,176,1,177
"فارس","پاسارگاد","هخامنش",8,215,0,1,12,228,0,228
"فارس","پاسارگاد","هخامنش",9,173,2,0,26,201,3,204
"فارس","جهرم","مرکزی",1,975,5,5,60,1045,8,1053
"فارس","جهرم","مرکزی",2,1176,10,5,102,1293,11,1304
"فارس","جهرم","مرکزی",3,1038,12,9,413,1472,25,1497
"فارس","جهرم","مرکزی",4,983,10,5,202,1200,8,1208
"فارس","جهرم","مرکزی",5,933,11,9,253,1206,13,1219
"فارس","جهرم","مرکزی",6,440,6,2,155,603,9,612
"فارس","جهرم","مرکزی",7,630,8,1,54,693,16,709
"فارس","جهرم","مرکزی",8,345,10,5,115,475,7,482
"فارس","جهرم","مرکزی",9,421,4,5,59,489,10,499
"فارس","جهرم","مرکزی",10,277,4,9,126,416,12,428
"فارس","جهرم","مرکزی",11,781,7,17,248,1053,12,1065
"فارس","جهرم","مرکزی",12,210,5,3,89,307,7,314
"فارس","جهرم","مرکزی",13,704,3,0,39,746,5,751
"فارس","جهرم","مرکزی",14,1338,6,3,152,1499,13,1512
"فارس","جهرم","مرکزی",15,448,9,2,160,619,7,626
"فارس","جهرم","مرکزی",16,555,5,3,145,708,14,722
"فارس","جهرم","مرکزی",17,827,6,3,130,966,11,977
"فارس","جهرم","مرکزی",18,1036,14,8,236,1294,24,1318
"فارس","جهرم","مرکزی",19,927,19,4,357,1307,21,1328
"فارس","جهرم","مرکزی",20,485,27,10,276,798,15,813
"فارس","جهرم","مرکزی",21,798,24,12,376,1210,16,1226
"فارس","جهرم","مرکزی",22,932,12,7,150,1101,14,1115
"فارس","جهرم","مرکزی",23,532,17,10,226,785,21,806
"فارس","جهرم","مرکزی",24,726,11,8,200,945,17,962
"فارس","جهرم","مرکزی",25,728,16,4,269,1017,18,1035
"فارس","جهرم","مرکزی",26,1048,25,4,245,1322,28,1350
"فارس","جهرم","مرکزی",27,631,10,5,245,891,8,899
"فارس","جهرم","مرکزی",28,737,10,8,474,1229,32,1261
"فارس","جهرم","مرکزی",29,1349,28,1,396,1774,16,1790
"فارس","جهرم","مرکزی",30,580,3,3,109,695,5,700
"فارس","جهرم","مرکزی",31,718,13,10,259,1000,19,1019
"فارس","جهرم","مرکزی",32,1115,11,15,599,1740,35,1775
"فارس","جهرم","مرکزی",33,276,9,3,150,438,6,444
"فارس","جهرم","مرکزی",34,602,15,1,201,819,13,832
"فارس","جهرم","مرکزی",35,873,18,2,188,1081,15,1096
"فارس","جهرم","مرکزی",36,708,12,7,327,1054,21,1075
"فارس","جهرم","مرکزی",37,642,5,6,243,896,12,908
"فارس","جهرم","مرکزی",38,556,11,9,211,787,11,798
"فارس","جهرم","مرکزی",39,1122,17,10,385,1534,19,1553
"فارس","جهرم","مرکزی",40,393,8,1,173,575,13,588
"فارس","جهرم","مرکزی",41,697,15,8,431,1151,25,1176
"فارس","جهرم","مرکزی",42,726,7,8,283,1024,11,1035
"فارس","جهرم","مرکزی",43,696,10,11,227,944,14,958
"فارس","جهرم","مرکزی",44,990,13,8,276,1287,14,1301
"فارس","جهرم","مرکزی",45,1011,13,7,357,1388,9,1397
"فارس","جهرم","مرکزی",46,771,16,6,377,1170,24,1194
"فارس","جهرم","مرکزی",47,233,5,8,136,382,7,389
"فارس","جهرم","مرکزی",48,563,7,5,142,717,9,726
"فارس","جهرم","مرکزی",49,635,4,15,121,775,5,780
"فارس","جهرم","مرکزی",50,368,6,4,83,461,5,466
"فارس","جهرم","مرکزی",51,515,4,9,208,736,12,748
"فارس","جهرم","مرکزی",52,763,8,13,201,985,16,1001
"فارس","جهرم","مرکزی",53,446,3,1,87,537,2,539
"فارس","جهرم","مرکزی",54,910,8,14,117,1049,6,1055
"فارس","جهرم","مرکزی",55,486,3,1,55,545,3,548
"فارس","جهرم","مرکزی",56,699,11,10,357,1077,20,1097
"فارس","جهرم","مرکزی",57,377,2,3,52,434,4,438
"فارس","جهرم","مرکزی",58,655,6,3,69,733,5,738
"فارس","جهرم","مرکزی",59,1081,4,2,87,1174,10,1184
"فارس","جهرم","مرکزی",60,881,16,1,317,1215,18,1233
"فارس","جهرم","مرکزی",61,633,13,8,183,837,8,845
"فارس","جهرم","مرکزی",62,889,3,1,128,1021,11,1032
"فارس","جهرم","مرکزی",63,933,16,12,303,1264,23,1287
"فارس","جهرم","مرکزی",64,348,6,5,201,560,10,570
"فارس","جهرم","مرکزی",65,717,7,3,302,1029,24,1053
"فارس","جهرم","مرکزی",66,531,8,8,140,687,5,692
"فارس","جهرم","مرکزی",67,382,7,3,140,532,12,544
"فارس","جهرم","مرکزی",68,663,4,7,158,832,14,846
"فارس","جهرم","مرکزی",69,658,8,1,87,754,6,760
"فارس","جهرم","مرکزی",70,567,4,1,58,630,4,634
"فارس","جهرم","مرکزی",71,1177,1,3,122,1303,12,1315
"فارس","جهرم","مرکزی",72,507,2,1,31,541,4,545
"فارس","جهرم","مرکزی",73,2041,7,3,117,2168,4,2172
"فارس","جهرم","مرکزی",74,1265,2,3,85,1355,3,1358
"فارس","جهرم","مرکزی",75,747,1,0,27,775,3,778
"فارس","جهرم","مرکزی",76,651,0,0,37,688,5,693
"فارس","جهرم","مرکزی",77,673,1,0,23,697,3,700
"فارس","جهرم","مرکزی",78,883,0,0,68,951,3,954
"فارس","جهرم","مرکزی",79,486,0,1,7,494,0,494
"فارس","جهرم","مرکزی",80,651,0,3,18,672,2,674
"فارس","جهرم","مرکزی",81,624,0,0,14,638,1,639
"فارس","جهرم","خفر",1,1125,0,1,69,1195,2,1197
"فارس","جهرم","خفر",2,659,1,0,56,716,1,717
"فارس","جهرم","خفر",3,831,1,1,46,879,4,883
"فارس","جهرم","خفر",4,529,1,2,59,591,0,591
"فارس","جهرم","خفر",5,1050,4,0,78,1132,4,1136
"فارس","جهرم","خفر",6,954,1,1,85,1041,4,1045
"فارس","جهرم","خفر",7,829,8,19,217,1073,2,1075
"فارس","جهرم","خفر",8,852,7,2,117,978,9,987
"فارس","جهرم","خفر",9,740,1,0,153,894,4,898
"فارس","جهرم","خفر",10,1122,6,2,269,1399,11,1410
"فارس","جهرم","خفر",11,992,6,2,118,1118,7,1125
"فارس","جهرم","خفر",12,869,6,1,242,1118,13,1131
"فارس","جهرم","خفر",13,573,2,2,25,602,4,606
"فارس","جهرم","خفر",14,1232,5,1,65,1303,6,1309
"فارس","جهرم","خفر",15,900,1,0,25,926,6,932
"فارس","جهرم","خفر",16,1103,10,6,175,1294,16,1310
"فارس","جهرم","خفر",17,1138,4,9,190,1341,9,1350
"فارس","جهرم","خفر",18,866,2,1,72,941,4,945
"فارس","جهرم","خفر",19,887,16,3,343,1249,17,1266
"فارس","جهرم","خفر",20,806,6,2,245,1059,9,1068
"فارس","جهرم","خفر",21,623,6,2,62,693,7,700
"فارس","جهرم","خفر",22,550,1,2,47,600,2,602
"فارس","جهرم","خفر",23,377,1,2,118,498,1,499
"فارس","جهرم","خفر",24,636,6,3,152,797,4,801
"فارس","جهرم","خفر",25,411,0,1,27,439,1,440
"فارس","جهرم","خفر",26,723,2,6,44,775,3,778
"فارس","جهرم","خفر",27,265,4,4,89,362,2,364
"فارس","جهرم","خفر",28,608,3,1,51,663,4,667
"فارس","جهرم","خفر",29,164,1,1,20,186,1,187
"فارس","جهرم","خفر",30,119,2,0,17,138,3,141
"فارس","جهرم","سمینکان",1,856,3,0,67,926,4,930
"فارس","جهرم","سمینکان",2,930,0,0,32,962,0,962
"فارس","جهرم","سمینکان",3,945,0,1,36,982,2,984
"فارس","جهرم","سمینکان",4,488,3,1,47,539,0,539
"فارس","جهرم","سمینکان",5,400,2,0,27,429,1,430
"فارس","جهرم","سمینکان",6,661,0,0,37,698,6,704
"فارس","جهرم","سمینکان",7,761,1,1,31,794,0,794
"فارس","جهرم","سمینکان",8,810,2,2,51,865,0,865
"فارس","جهرم","سمینکان",9,827,1,0,9,837,0,837
"فارس","جهرم","سمینکان",10,526,0,0,33,559,2,561
"فارس","جهرم","سمینکان",11,721,1,1,61,784,0,784
"فارس","جهرم","سمینکان",12,480,1,0,3,484,2,486
"فارس","جهرم","سمینکان",13,846,3,2,47,898,3,901
"فارس","جهرم","سمینکان",14,178,0,0,9,187,0,187
"فارس","جهرم","کردیان",1,1374,6,7,135,1522,9,1531
"فارس","جهرم","کردیان",2,735,5,3,146,889,12,901
"فارس","جهرم","کردیان",3,736,5,5,156,902,12,914
"فارس","جهرم","کردیان",4,604,2,0,64,670,9,679
"فارس","جهرم","کردیان",5,1010,3,7,126,1146,15,1161
"فارس","جهرم","کردیان",6,695,2,0,101,798,4,802
"فارس","جهرم","کردیان",7,1173,3,2,51,1229,2,1231
"فارس","جهرم","کردیان",8,268,3,0,29,300,0,300
"فارس","جهرم","کردیان",9,405,1,0,12,418,0,418
"فارس","جهرم","کردیان",10,365,3,0,80,448,3,451
"فارس","جهرم","کردیان",11,454,1,1,52,508,3,511
"فارس","خرمبید","مرکزی",1,973,12,5,300,1290,10,1300
"فارس","خرمبید","مرکزی",2,1175,14,3,318,1510,8,1518
"فارس","خرمبید","مرکزی",3,1198,10,3,314,1525,8,1533
"فارس","خرمبید","مرکزی",4,1183,23,2,322,1530,9,1539
"فارس","خرمبید","مرکزی",5,386,6,0,105,497,2,499
"فارس","خرمبید","مرکزی",6,574,1,1,141,717,4,721
"فارس","خرمبید","مرکزی",7,437,1,1,78,517,3,520
"فارس","خرمبید","مرکزی",8,314,1,0,132,447,3,450
"فارس","خرمبید","مرکزی",9,766,5,4,201,976,5,981
"فارس","خرمبید","مرکزی",10,1279,14,2,276,1571,9,1580
"فارس","خرمبید","مرکزی",11,865,4,2,115,986,5,991
"فارس","خرمبید","مرکزی",12,1079,2,0,150,1231,7,1238
"فارس","خرمبید","مرکزی",13,1004,1,0,103,1108,5,1113
"فارس","خرمبید","مرکزی",14,485,12,0,200,697,12,709
"فارس","خرمبید","مرکزی",15,170,4,1,46,221,3,224
"فارس","خرمبید","مرکزی",16,726,7,1,47,781,1,782
"فارس","خرمبید","مرکزی",17,757,1,0,51,809,2,811
"فارس","خرمبید","مرکزی",18,909,2,0,22,933,3,936
"فارس","خرمبید","مرکزی",19,456,2,2,50,510,1,511
"فارس","خرمبید","مرکزی",20,447,2,0,29,478,0,478
"فارس","خرمبید","مشهد_مرغاب",1,1151,18,6,199,1374,12,1386
"فارس","خرمبید","مشهد_مرغاب",2,967,5,2,123,1097,3,1100
"فارس","خرمبید","مشهد_مرغاب",3,869,12,3,117,1001,9,1010
"فارس","خرمبید","مشهد_مرغاب",4,1018,8,3,96,1125,7,1132
"فارس","خرمبید","مشهد_مرغاب",5,494,2,0,62,558,0,558
"فارس","خرمبید","مشهد_مرغاب",6,504,2,2,100,608,3,611
"فارس","خرمبید","مشهد_مرغاب",7,1106,2,1,153,1262,6,1268
"فارس","خرمبید","مشهد_مرغاب",8,744,6,3,86,839,4,843
"فارس","خرمبید","مشهد_مرغاب",9,665,6,0,123,794,4,798
"فارس","خرمبید","مشهد_مرغاب",10,451,3,1,64,519,1,520
"فارس","خرمبید","مشهد_مرغاب",11,609,9,0,41,659,1,660
"فارس","خرمبید","مشهد_مرغاب",12,388,1,4,27,420,2,422
"فارس","خرمبید","مشهد_مرغاب",13,809,2,2,37,850,0,850
"فارس","خنج","مرکزی",1,119,2,8,597,726,6,732
"فارس","خنج","مرکزی",2,508,11,13,673,1205,4,1209
"فارس","خنج","مرکزی",3,317,6,25,601,949,11,960
"فارس","خنج","مرکزی",4,276,8,14,592,890,6,896
"فارس","خنج","مرکزی",5,167,5,23,421,616,5,621
"فارس","خنج","مرکزی",6,648,7,10,405,1070,3,1073
"فارس","خنج","مرکزی",7,412,2,8,779,1201,11,1212
"فارس","خنج","مرکزی",8,228,5,10,441,684,4,688
"فارس","خنج","مرکزی",9,480,3,105,345,933,3,936
"فارس","خنج","مرکزی",10,484,5,0,107,596,0,596
"فارس","خنج","مرکزی",11,202,0,0,55,257,0,257
"فارس","خنج","مرکزی",12,387,2,0,32,421,,421
"فارس","خنج","مرکزی",13,649,6,0,76,731,0,731
"فارس","خنج","مرکزی",14,664,2,0,70,736,0,736
"فارس","خنج","مرکزی",15,344,1,0,26,371,0,371
"فارس","خنج","مرکزی",16,393,1,0,41,435,5,440
"فارس","خنج","مرکزی",17,117,0,1,77,195,1,196
"فارس","خنج","مرکزی",18,154,1,2,97,254,7,261
"فارس","خنج","مرکزی",19,492,1,10,380,883,8,891
"فارس","خنج","محمله",1,490,3,2,178,673,4,677
"فارس","خنج","محمله",2,575,3,2,22,602,2,604
"فارس","خنج","محمله",3,498,1,2,254,755,6,761
"فارس","خنج","محمله",4,372,0,0,33,405,0,405
"فارس","خنج","محمله",5,531,1,0,39,571,3,574
"فارس","خنج","محمله",6,421,1,0,58,480,3,483
"فارس","خنج","محمله",7,906,7,1,91,1005,2,1007
"فارس","داراب","مرکزی",1,792,21,16,498,1327,10,1337
"فارس","داراب","مرکزی",2,745,27,8,634,1414,10,1424
"فارس","داراب","مرکزی",3,1021,20,12,809,1862,25,1887
"فارس","داراب","مرکزی",4,1056,22,31,772,1881,15,1896
"فارس","داراب","مرکزی",5,956,20,18,653,1647,18,1665
"فارس","داراب","مرکزی",6,988,13,34,682,1717,16,1733
"فارس","داراب","مرکزی",7,772,22,21,708,1523,16,1539
"فارس","داراب","مرکزی",8,1142,20,14,444,1620,22,1642
"فارس","داراب","مرکزی",9,442,8,7,234,691,3,694
"فارس","داراب","مرکزی",10,1223,4,17,258,1502,9,1511
"فارس","داراب","مرکزی",11,772,7,5,140,924,7,931
"فارس","داراب","مرکزی",12,961,15,4,187,1167,24,1191
"فارس","داراب","مرکزی",13,1186,24,7,280,1497,6,1503
"فارس","داراب","مرکزی",14,912,7,19,285,1223,9,1232
"فارس","داراب","مرکزی",15,889,18,20,450,1377,24,1401
"فارس","داراب","مرکزی",16,657,17,11,422,1107,21,1128
"فارس","داراب","مرکزی",17,759,16,20,494,1289,22,1311
"فارس","داراب","مرکزی",18,522,12,13,444,991,10,1001
"فارس","داراب","مرکزی",19,774,21,29,670,1494,23,1517
"فارس","داراب","مرکزی",20,1066,18,30,640,1754,22,1776
"فارس","داراب","مرکزی",21,750,28,22,690,1490,25,1515
"فارس","داراب","مرکزی",22,900,23,29,634,1586,11,1597
"فارس","داراب","مرکزی",23,421,9,3,169,602,4,606
"فارس","داراب","مرکزی",24,1111,10,7,269,1397,6,1403
"فارس","داراب","مرکزی",25,823,2,13,97,935,8,943
"فارس","داراب","مرکزی",26,876,1,2,98,977,0,977
"فارس","داراب","مرکزی",27,829,4,2,59,894,3,897
"فارس","داراب","مرکزی",28,926,2,1,78,1007,0,1007
"فارس","داراب","مرکزی",29,695,6,6,156,863,1,864
"فارس","داراب","مرکزی",30,584,4,0,15,603,1,604
"فارس","داراب","مرکزی",31,400,1,1,44,446,8,454
"فارس","داراب","مرکزی",32,1058,8,4,105,1175,3,1178
"فارس","داراب","مرکزی",33,697,10,5,109,821,0,821
"فارس","داراب","مرکزی",34,778,8,2,162,950,13,963
"فارس","داراب","مرکزی",35,381,7,2,132,522,6,528
"فارس","داراب","مرکزی",36,993,3,0,73,1069,1,1070
"فارس","داراب","مرکزی",37,473,0,0,43,516,2,518
"فارس","داراب","مرکزی",38,630,3,1,285,919,2,921
"فارس","داراب","مرکزی",39,740,5,4,368,1117,4,1121
"فارس","داراب","مرکزی",40,411,3,2,164,580,2,582
"فارس","داراب","مرکزی",41,635,6,18,357,1016,5,1021
"فارس","داراب","مرکزی",42,696,2,23,274,995,7,1002
"فارس","داراب","مرکزی",43,770,6,2,164,942,2,944
"فارس","داراب","مرکزی",44,1016,1,31,135,1183,10,1193
"فارس","داراب","مرکزی",45,969,6,4,269,1248,10,1258
"فارس","داراب","مرکزی",46,623,6,0,58,687,3,690
"فارس","داراب","مرکزی",47,1136,8,9,151,1304,15,1319
"فارس","داراب","مرکزی",48,958,9,19,167,1153,5,1158
"فارس","داراب","مرکزی",49,698,1,1,55,755,0,755
"فارس","داراب","مرکزی",50,1345,11,0,96,1452,14,1466
"فارس","داراب","مرکزی",51,425,5,2,55,487,5,492
"فارس","داراب","مرکزی",52,637,2,1,55,695,4,699
"فارس","داراب","مرکزی",53,873,4,1,95,973,7,980
"فارس","داراب","مرکزی",54,1072,6,3,118,1199,5,1204
"فارس","داراب","مرکزی",55,1073,8,4,264,1349,22,1371
"فارس","داراب","مرکزی",56,749,9,5,140,903,11,914
"فارس","داراب","مرکزی",57,975,13,2,282,1272,23,1295
"فارس","داراب","مرکزی",58,901,17,3,281,1202,25,1227
"فارس","داراب","مرکزی",59,782,16,8,257,1063,28,1091
"فارس","داراب","مرکزی",60,1022,8,8,283,1321,9,1330
"فارس","داراب","مرکزی",61,588,13,2,223,826,11,837
"فارس","داراب","مرکزی",62,1174,2,6,80,1262,3,1265
"فارس","داراب","مرکزی",63,708,7,1,120,836,3,839
"فارس","داراب","مرکزی",64,882,3,2,134,1021,3,1024
"فارس","داراب","مرکزی",65,748,10,2,188,948,5,953
"فارس","داراب","مرکزی",66,493,6,4,279,782,5,787
"فارس","داراب","مرکزی",67,951,3,0,71,1025,1,1026
"فارس","داراب","مرکزی",68,902,9,1,132,1044,8,1052
"فارس","داراب","مرکزی",69,359,10,2,215,586,0,586
"فارس","داراب","مرکزی",70,1418,6,1,54,1479,7,1486
"فارس","داراب","مرکزی",71,1089,9,10,220,1328,8,1336
"فارس","داراب","مرکزی",72,1217,2,0,117,1336,6,1342
"فارس","داراب","مرکزی",73,564,1,1,17,583,2,585
"فارس","داراب","مرکزی",74,732,9,0,54,795,7,802
"فارس","داراب","رستاق",1,401,6,9,218,634,8,642
"فارس","داراب","رستاق",2,857,3,3,251,1114,15,1129
"فارس","داراب","رستاق",3,379,0,3,89,471,2,473
"فارس","داراب","رستاق",4,109,1,3,32,145,1,146
"فارس","داراب","رستاق",5,329,1,2,31,363,3,366
"فارس","داراب","رستاق",6,1019,10,4,124,1157,10,1167
"فارس","داراب","رستاق",7,257,1,2,61,321,1,322
"فارس","داراب","رستاق",8,685,2,4,96,787,3,790
"فارس","داراب","رستاق",9,709,3,5,69,786,4,790
"فارس","داراب","رستاق",10,227,2,0,8,237,0,237
"فارس","داراب","رستاق",11,273,1,1,12,287,0,287
"فارس","داراب","رستاق",12,526,5,9,66,606,2,608
"فارس","داراب","رستاق",13,164,0,2,24,190,1,191
"فارس","داراب","رستاق",14,904,2,1,84,991,3,994
"فارس","داراب","رستاق",15,202,3,2,63,270,0,270
"فارس","داراب","رستاق",16,182,0,1,16,199,0,199
"فارس","داراب","فورگ",1,777,2,1,66,846,1,847
"فارس","داراب","فورگ",2,503,2,1,40,546,5,551
"فارس","داراب","فورگ",3,906,3,0,53,962,0,962
"فارس","داراب","فورگ",4,706,1,1,38,746,7,753
"فارس","داراب","فورگ",5,856,2,1,38,897,8,905
"فارس","داراب","فورگ",6,788,2,0,78,868,7,875
"فارس","داراب","فورگ",7,604,1,0,35,640,5,645
"فارس","داراب","فورگ",8,451,0,1,38,490,0,490
"فارس","داراب","فورگ",9,807,0,4,28,839,2,841
"فارس","داراب","فورگ",10,870,1,3,23,897,1,898
"فارس","داراب","فورگ",11,260,1,1,15,277,0,277
"فارس","داراب","فورگ",12,889,3,1,28,921,2,923
"فارس","داراب","فورگ",13,524,2,0,13,539,1,540
"فارس","داراب","فورگ",14,440,0,1,14,455,0,455
"فارس","داراب","فورگ",15,464,3,0,98,565,0,565
"فارس","داراب","فورگ",16,852,4,3,85,944,0,944
"فارس","رستم","سورنا",1,438,6,1,202,647,0,647
"فارس","رستم","سورنا",2,412,9,2,177,600,0,600
"فارس","رستم","سورنا",3,456,6,0,124,586,0,586
"فارس","رستم","سورنا",4,1214,5,0,152,1371,0,1371
"فارس","رستم","سورنا",5,1060,8,3,229,1300,0,1300
"فارس","رستم","سورنا",6,578,3,0,92,673,0,673
"فارس","رستم","سورنا",7,819,8,2,214,1043,0,1043
"فارس","رستم","سورنا",8,971,6,0,111,1088,0,1088
"فارس","رستم","سورنا",9,975,1,2,62,1040,0,1040
"فارس","رستم","سورنا",10,1186,0,2,106,1294,2,1296
"فارس","رستم","سورنا",11,581,10,0,158,749,1,750
"فارس","رستم","سورنا",12,1149,25,22,2,1198,0,1198
"فارس","رستم","سورنا",13,966,23,1,56,1046,0,1046
"فارس","رستم","سورنا",14,838,1,0,100,939,0,939
"فارس","رستم","سورنا",15,1090,7,1,28,1126,0,1126
"فارس","رستم","سورنا",16,593,10,1,98,702,1,703
"فارس","رستم","سورنا",17,646,12,53,210,921,0,921
"فارس","رستم","سورنا",18,398,6,2,64,470,2,472
"فارس","رستم","سورنا",19,436,10,2,75,523,2,525
"فارس","رستم","سورنا",20,158,0,4,76,238,1,239
"فارس","رستم","سورنا",21,82,0,0,35,117,0,117
"فارس","رستم","سورنا",22,270,2,10,107,389,0,389
"فارس","رستم","سورنا",23,148,0,8,237,393,0,393
"فارس","رستم","مرکزی",1,813,8,18,411,1250,0,1250
"فارس","رستم","مرکزی",2,278,3,2,173,456,6,462
"فارس","رستم","مرکزی",3,431,2,8,215,656,0,656
"فارس","رستم","مرکزی",4,435,16,13,277,741,1,742
"فارس","رستم","مرکزی",5,428,6,6,256,696,2,698
"فارس","رستم","مرکزی",6,1084,8,5,147,1244,6,1250
"فارس","رستم","مرکزی",7,367,4,0,80,451,0,451
"فارس","رستم","مرکزی",8,496,5,5,253,759,1,760
"فارس","رستم","مرکزی",9,268,6,3,107,384,3,387
"فارس","رستم","مرکزی",10,462,18,13,307,800,0,800
"فارس","رستم","مرکزی",11,893,4,12,270,1179,2,1181
"فارس","رستم","مرکزی",12,195,7,4,129,335,0,335
"فارس","رستم","مرکزی",13,861,5,4,234,1104,3,1107
"فارس","رستم","مرکزی",14,906,7,7,510,1430,0,1430
"فارس","رستم","مرکزی",15,785,10,18,383,1196,0,1196
"فارس","رستم","مرکزی",16,396,6,21,242,665,2,667
"فارس","رستم","مرکزی",17,610,3,17,285,915,0,915
"فارس","رستم","مرکزی",18,475,8,5,114,602,0,602
"فارس","رستم","مرکزی",19,280,6,2,370,658,2,660
"فارس","رستم","مرکزی",20,279,7,4,203,493,1,494
"فارس","رستم","مرکزی",21,239,6,5,247,497,0,497
"فارس","رستم","مرکزی",22,92,1,2,144,239,0,239
"فارس","رستم","مرکزی",23,356,10,1,110,477,0,477
"فارس","رستم","مرکزی",24,146,0,3,81,230,0,230
"فارس","رستم","مرکزی",25,239,4,0,197,440,1,441
"فارس","رستم","مرکزی",26,730,28,1,312,1071,0,1071
"فارس","رستم","مرکزی",27,719,12,4,374,1109,1,1110
"فارس","رستم","مرکزی",28,47,1,0,14,62,0,62
"فارس","رستم","مرکزی",29,975,1,1,223,1200,0,1200
"فارس","رستم","مرکزی",30,441,3,1,184,629,0,629
"فارس","رستم","مرکزی",31,507,6,8,452,973,0,973
"فارس","رستم","مرکزی",32,1591,3,2,35,1631,0,1631
"فارس","زرین_دشت","مرکزی",1,709,8,5,202,924,4,928
"فارس","زرین_دشت","مرکزی",2,509,0,3,213,725,8,733
"فارس","زرین_دشت","مرکزی",3,647,2,3,74,726,2,728
"فارس","زرین_دشت","مرکزی",4,791,6,12,149,958,4,962
"فارس","زرین_دشت","مرکزی",5,513,5,4,94,616,4,620
"فارس","زرین_دشت","مرکزی",6,769,13,4,329,1115,5,1120
"فارس","زرین_دشت","مرکزی",7,817,4,7,178,1006,4,1010
"فارس","زرین_دشت","مرکزی",8,851,9,13,357,1230,7,1237
"فارس","زرین_دشت","مرکزی",9,683,9,7,152,851,8,859
"فارس","زرین_دشت","مرکزی",10,592,4,9,245,850,7,857
"فارس","زرین_دشت","مرکزی",11,581,0,6,91,678,4,682
"فارس","زرین_دشت","مرکزی",12,417,4,2,54,477,3,480
"فارس","زرین_دشت","مرکزی",13,451,0,0,32,483,4,487
"فارس","زرین_دشت","مرکزی",14,66,1,0,6,73,0,73
"فارس","زرین_دشت","مرکزی",15,458,0,0,25,483,1,484
"فارس","زرین_دشت","مرکزی",16,550,3,0,14,567,0,567
"فارس","زرین_دشت","مرکزی",17,713,1,1,40,755,0,755
"فارس","زرین_دشت","مرکزی",18,991,3,1,53,1048,0,1048
"فارس","زرین_دشت","مرکزی",19,362,1,0,25,388,0,388
"فارس","زرین_دشت","مرکزی",20,754,1,1,37,793,3,796
"فارس","زرین_دشت","مرکزی",21,772,4,6,52,834,2,836
"فارس","زرین_دشت","مرکزی",22,492,0,0,49,541,0,541
"فارس","زرین_دشت","مرکزی",23,763,1,0,163,927,1,928
"فارس","زرین_دشت","مرکزی",24,703,0,2,47,752,2,754
"فارس","زرین_دشت","مرکزی",25,274,0,0,12,286,0,286
"فارس","زرین_دشت","مرکزی",26,325,2,0,32,359,0,359
"فارس","زرین_دشت","مرکزی",27,465,2,2,77,546,0,546
"فارس","زرین_دشت","مرکزی",28,517,1,1,43,562,6,568
"فارس","زرین_دشت","مرکزی",29,598,1,1,19,619,0,619
"فارس","زرین_دشت","مرکزی",30,413,1,2,103,519,2,521
"فارس","زرین_دشت","مرکزی",31,584,10,0,24,618,1,619
"فارس","زرین_دشت","مرکزی",32,669,6,1,26,702,1,703
"فارس","زرین_دشت","مرکزی",33,806,18,5,175,1004,3,1007
"فارس","زرین_دشت","مرکزی",34,899,3,2,95,999,2,1001
"فارس","زرین_دشت","مرکزی",35,807,6,1,103,917,1,918
"فارس","زرین_دشت","مرکزی",36,815,12,0,72,899,2,901
"فارس","زرین_دشت","مرکزی",37,214,0,0,3,217,0,217
"فارس","زرین_دشت","ایزدخواست",1,804,12,3,122,941,5,946
"فارس","زرین_دشت","ایزدخواست",2,1118,13,2,87,1220,4,1224
"فارس","زرین_دشت","ایزدخواست",3,620,3,0,31,654,2,656
"فارس","زرین_دشت","ایزدخواست",4,813,4,6,44,867,4,871
"فارس","زرین_دشت","ایزدخواست",5,497,1,2,40,540,0,540
"فارس","زرین_دشت","ایزدخواست",6,558,2,7,42,609,1,610
"فارس","زرین_دشت","ایزدخواست",7,140,0,0,3,143,1,144
"فارس","زرین_دشت","ایزدخواست",8,990,2,5,47,1044,4,1048
"فارس","زرین_دشت","ایزدخواست",9,656,2,0,29,687,1,688
"فارس","زرین_دشت","ایزدخواست",10,679,1,0,50,730,2,732
"فارس","زرین_دشت","ایزدخواست",11,394,0,1,30,425,1,426
"فارس","زرین_دشت","ایزدخواست",12,335,0,0,23,358,2,360
"فارس","سپیدان","مرکزی",1,484,5,2,141,632,3,635
"فارس","سپیدان","مرکزی",2,478,11,1,297,787,6,793
"فارس","سپیدان","مرکزی",3,717,19,4,333,1073,17,1090
"فارس","سپیدان","مرکزی",4,635,7,2,185,829,8,837
"فارس","سپیدان","مرکزی",5,587,6,2,174,769,3,772
"فارس","سپیدان","مرکزی",6,427,13,2,143,585,7,592
"فارس","سپیدان","مرکزی",7,668,7,4,249,928,8,936
"فارس","سپیدان","مرکزی",8,404,3,0,189,596,2,598
"فارس","سپیدان","مرکزی",9,342,2,0,71,415,1,416
"فارس","سپیدان","مرکزی",10,638,7,3,233,881,4,885
"فارس","سپیدان","مرکزی",11,362,1,2,152,517,1,518
"فارس","سپیدان","مرکزی",12,199,0,0,40,239,6,245
"فارس","سپیدان","مرکزی",13,616,0,0,217,833,1,834
"فارس","سپیدان","مرکزی",14,407,3,1,93,504,0,504
"فارس","سپیدان","مرکزی",15,501,2,4,48,555,2,557
"فارس","سپیدان","مرکزی",16,535,1,0,213,749,2,751
"فارس","سپیدان","مرکزی",17,358,0,2,55,415,1,416
"فارس","سپیدان","مرکزی",18,272,8,1,113,394,1,395
"فارس","سپیدان","مرکزی",19,1201,5,0,193,1399,6,1405
"فارس","سپیدان","مرکزی",20,811,1,9,122,943,3,946
"فارس","سپیدان","مرکزی",21,430,0,0,32,462,2,464
"فارس","سپیدان","بیضا",1,674,6,6,290,976,5,981
"فارس","سپیدان","بیضا",2,646,2,0,206,854,0,854
"فارس","سپیدان","بیضا",3,530,2,1,97,630,4,634
"فارس","سپیدان","بیضا",4,610,0,4,39,653,3,656
"فارس","سپیدان","بیضا",5,1226,5,0,124,1355,4,1359
"فارس","سپیدان","بیضا",6,1254,6,1,160,1421,3,1424
"فارس","سپیدان","بیضا",7,554,5,1,84,644,3,647
"فارس","سپیدان","بیضا",8,574,5,1,361,941,3,944
"فارس","سپیدان","بیضا",9,730,6,0,170,906,7,913
"فارس","سپیدان","بیضا",10,995,19,5,269,1288,10,1298
"فارس","سپیدان","بیضا",11,698,16,3,148,865,3,868
"فارس","سپیدان","بیضا",12,799,6,3,62,870,1,871
"فارس","سپیدان","بیضا",13,705,2,1,117,825,0,825
"فارس","سپیدان","بیضا",14,872,3,0,55,930,2,932
"فارس","سپیدان","بیضا",15,780,2,1,154,937,5,942
"فارس","سپیدان","بیضا",16,924,3,1,213,1141,4,1145
"فارس","سپیدان","بیضا",17,808,5,2,196,1011,7,1018
"فارس","سپیدان","بیضا",18,946,9,5,111,1071,3,1074
"فارس","سپیدان","بیضا",19,1033,4,12,248,1297,2,1299
"فارس","سپیدان","بیضا",20,533,1,0,210,744,2,746
"فارس","سپیدان","بیضا",21,590,5,1,303,899,1,900
"فارس","سپیدان","بیضا",22,730,3,2,107,842,3,845
"فارس","سپیدان","بیضا",23,1017,9,1,221,1248,3,1251
"فارس","سپیدان","بیضا",24,1102,13,0,276,1391,4,1395
"فارس","سپیدان","بیضا",25,804,0,0,107,911,3,914
"فارس","سپیدان","بیضا",26,949,6,2,132,1089,2,1091
"فارس","سپیدان","همایجان",1,819,8,1,172,1000,3,1003
"فارس","سپیدان","همایجان",2,770,1,0,87,858,7,865
"فارس","سپیدان","همایجان",3,676,3,0,86,765,1,766
"فارس","سپیدان","همایجان",4,798,12,2,203,1015,2,1017
"فارس","سپیدان","همایجان",5,692,2,1,105,800,0,800
"فارس","سپیدان","همایجان",6,719,0,1,107,827,1,828
"فارس","سپیدان","همایجان",7,412,1,0,114,527,3,530
"فارس","سپیدان","همایجان",8,616,6,3,112,737,4,741
"فارس","سپیدان","همایجان",9,637,3,2,405,1047,2,1049
"فارس","سپیدان","همایجان",10,604,3,2,279,888,3,891
"فارس","سپیدان","همایجان",11,366,2,2,174,544,5,549
"فارس","سپیدان","همایجان",12,687,3,0,108,798,2,800
"فارس","سپیدان","همایجان",13,455,4,6,236,701,5,706
"فارس","سپیدان","همایجان",14,566,2,4,214,786,3,789
"فارس","سپیدان","همایجان",15,482,8,3,96,589,2,591
"فارس","سپیدان","همایجان",16,619,3,0,90,712,1,713
"فارس","سپیدان","همایجان",17,786,14,1,157,958,8,966
"فارس","سپیدان","همایجان",18,646,5,1,304,956,3,959
"فارس","سپیدان","همایجان",19,825,0,2,127,954,6,960
"فارس","سپیدان","همایجان",20,275,1,0,64,340,0,340
"فارس","سپیدان","همایجان",21,317,2,0,172,491,1,492
"فارس","سپیدان","همایجان",22,460,4,1,146,611,3,614
"فارس","سپیدان","همایجان",23,234,0,5,58,297,3,300
"فارس","سپیدان","همایجان",24,151,4,2,45,202,0,202
"فارس","سپیدان","همایجان",25,615,4,0,175,794,3,797
"فارس","سپیدان","همایجان",26,290,1,0,65,356,0,356
"فارس","سپیدان","همایجان",27,809,9,6,575,1399,5,1404
"فارس","سپیدان","همایجان",28,585,2,3,245,835,5,840
"فارس","سروستان","مرکزی",1,620,6,28,274,928,19,947
"فارس","سروستان","مرکزی",2,501,3,12,111,627,11,638
"فارس","سروستان","مرکزی",3,331,6,28,181,546,13,559
"فارس","سروستان","مرکزی",4,488,12,82,248,830,12,842
"فارس","سروستان","مرکزی",5,655,7,21,184,867,8,875
"فارس","سروستان","مرکزی",6,214,1,5,95,315,1,316
"فارس","سروستان","مرکزی",7,324,4,35,152,515,7,522
"فارس","سروستان","مرکزی",8,521,9,22,168,720,7,727
"فارس","سروستان","مرکزی",9,679,14,33,287,1013,12,1025
"فارس","سروستان","مرکزی",10,424,4,9,134,571,13,584
"فارس","سروستان","مرکزی",11,620,3,14,211,848,19,867
"فارس","سروستان","مرکزی",12,351,5,12,106,474,8,482
"فارس","سروستان","مرکزی",13,338,11,26,119,494,3,497
"فارس","سروستان","مرکزی",14,549,5,11,92,657,8,665
"فارس","سروستان","مرکزی",15,307,1,5,47,360,0,360
"فارس","سروستان","مرکزی",16,221,4,7,76,308,3,311
"فارس","سروستان","مرکزی",17,162,4,0,13,179,1,180
"فارس","سروستان","مرکزی",18,294,4,2,60,360,6,366
"فارس","سروستان","مرکزی",19,695,2,29,41,767,1,768
"فارس","سروستان","مرکزی",20,271,0,1,32,304,3,307
"فارس","سروستان","مرکزی",21,640,1,2,55,698,2,700
"فارس","سروستان","مرکزی",22,977,2,12,60,1051,2,1053
"فارس","سروستان","مرکزی",23,855,2,7,99,963,3,966
"فارس","سروستان","مرکزی",24,170,0,0,14,184,3,187
"فارس","سروستان","مرکزی",25,232,1,2,16,251,0,251
"فارس","سروستان","کوهنجان",1,326,1,0,39,366,3,369
"فارس","سروستان","کوهنجان",2,544,4,0,50,598,0,598
"فارس","سروستان","کوهنجان",3,810,6,3,155,974,8,982
"فارس","سروستان","کوهنجان",4,573,8,3,183,767,8,775
"فارس","سروستان","کوهنجان",5,324,9,2,107,442,8,450
"فارس","سروستان","کوهنجان",6,565,2,61,90,718,8,726
"فارس","سروستان","کوهنجان",7,89,1,0,43,133,0,133
"فارس","سروستان","کوهنجان",8,614,1,2,96,713,1,714
"فارس","سروستان","کوهنجان",9,663,3,2,171,839,4,843
"فارس","سروستان","کوهنجان",10,429,4,0,155,588,2,590
"فارس","سروستان","کوهنجان",11,412,1,0,63,476,1,477
"فارس","سروستان","کوهنجان",12,355,1,2,47,405,4,409
"فارس","سروستان","کوهنجان",13,72,3,0,50,125,1,126
"فارس","شیراز","مرکزی",1,2153,31,18,932,3134,21,3155
"فارس","شیراز","مرکزی",2,1305,22,8,589,1924,13,1937
"فارس","شیراز","مرکزی",3,1667,24,16,774,2481,19,2500
"فارس","شیراز","مرکزی",4,1439,31,13,576,2059,18,2077
"فارس","شیراز","مرکزی",5,1220,32,5,739,1996,22,2018
"فارس","شیراز","مرکزی",6,1085,24,10,534,1653,21,1674
"فارس","شیراز","مرکزی",7,1961,21,21,599,2602,20,2622
"فارس","شیراز","مرکزی",8,1409,29,14,962,2414,34,2448
"فارس","شیراز","مرکزی",9,1435,30,20,775,2260,6,2266
"فارس","شیراز","مرکزی",10,1212,24,11,879,2126,18,2144
"فارس","شیراز","مرکزی",11,1897,14,9,551,2471,16,2487
"فارس","شیراز","مرکزی",12,1483,35,16,940,2474,21,2495
"فارس","شیراز","مرکزی",13,1537,37,7,571,2152,12,2164
"فارس","شیراز","مرکزی",14,1321,23,18,720,2082,13,2095
"فارس","شیراز","مرکزی",15,840,16,12,685,1553,17,1570
"فارس","شیراز","مرکزی",16,1811,10,8,447,2276,10,2286
"فارس","شیراز","مرکزی",17,1430,23,10,671,2134,18,2152
"فارس","شیراز","مرکزی",18,1048,43,20,842,1953,17,1970
"فارس","شیراز","مرکزی",19,1172,20,8,759,1959,18,1977
"فارس","شیراز","مرکزی",20,1521,29,6,751,2307,15,2322
"فارس","شیراز","مرکزی",21,1205,35,9,699,1948,0,1948
"فارس","شیراز","مرکزی",22,1262,25,10,690,1987,4,1991
"فارس","شیراز","مرکزی",23,1092,27,19,972,2110,12,2122
"فارس","شیراز","مرکزی",24,1019,37,17,1041,2114,13,2127
"فارس","شیراز","مرکزی",25,1256,25,21,1002,2304,29,2333
"فارس","شیراز","مرکزی",26,1181,33,7,828,2049,13,2062
"فارس","شیراز","مرکزی",27,1346,36,16,1032,2430,20,2450
"فارس","شیراز","مرکزی",28,580,20,17,750,1367,12,1379
"فارس","شیراز","مرکزی",29,723,21,7,1130,1881,18,1899
"فارس","شیراز","مرکزی",30,685,33,28,1076,1822,15,1837
"فارس","شیراز","مرکزی",31,921,47,27,1081,2076,22,2098
"فارس","شیراز","مرکزی",32,745,39,13,1015,1812,17,1829
"فارس","شیراز","مرکزی",33,1203,40,21,1174,2438,17,2455
"فارس","شیراز","مرکزی",34,866,31,22,855,1774,27,1801
"فارس","شیراز","مرکزی",35,975,51,38,1403,2467,22,2489
"فارس","شیراز","مرکزی",36,806,36,11,1234,2087,0,2087
"فارس","شیراز","مرکزی",37,768,53,13,1728,2562,19,2581
"فارس","شیراز","مرکزی",38,922,43,13,1233,2211,25,2236
"فارس","شیراز","مرکزی",39,1015,58,17,1258,2348,30,2378
"فارس","شیراز","مرکزی",40,841,34,19,1111,2005,20,2025
"فارس","شیراز","مرکزی",41,646,61,31,1383,2121,32,2153
"فارس","شیراز","مرکزی",42,1706,15,8,506,2235,14,2249
"فارس","شیراز","مرکزی",43,1274,26,12,595,1907,17,1924
"فارس","شیراز","مرکزی",44,1556,18,18,565,2157,11,2168
"فارس","شیراز","مرکزی",45,1412,43,8,1076,2539,26,2565
"فارس","شیراز","مرکزی",46,962,22,31,973,1988,17,2005
"فارس","شیراز","مرکزی",47,1088,10,21,965,2084,12,2096
"فارس","شیراز","مرکزی",48,1462,24,10,1064,2560,15,2575
"فارس","شیراز","مرکزی",49,1190,25,13,815,2043,16,2059
"فارس","شیراز","مرکزی",50,825,29,12,891,1757,13,1770
"فارس","شیراز","مرکزی",51,1402,14,6,491,1913,11,1924
"فارس","شیراز","مرکزی",52,1096,21,13,941,2071,17,2088
"فارس","شیراز","مرکزی",53,675,46,22,1107,1850,11,1861
"فارس","شیراز","مرکزی",54,872,38,14,1084,2008,38,2046
"فارس","شیراز","مرکزی",55,666,23,25,1095,1809,18,1827
"فارس","شیراز","مرکزی",56,1031,22,11,650,1714,22,1736
"فارس","شیراز","مرکزی",57,622,10,4,216,852,3,855
"فارس","شیراز","مرکزی",58,556,20,15,826,1417,16,1433
"فارس","شیراز","مرکزی",59,581,39,19,1285,1924,18,1942
"فارس","شیراز","مرکزی",60,514,18,15,659,1206,11,1217
"فارس","شیراز","مرکزی",61,777,43,25,884,1729,23,1752
"فارس","شیراز","مرکزی",62,625,28,18,820,1491,13,1504
"فارس","شیراز","مرکزی",63,811,40,35,1173,2059,28,2087
"فارس","شیراز","مرکزی",64,605,25,27,1062,1719,13,1732
"فارس","شیراز","مرکزی",65,641,36,39,1344,2060,22,2082
"فارس","شیراز","مرکزی",66,705,30,13,1147,1895,19,1914
"فارس","شیراز","مرکزی",67,620,54,40,1623,2337,12,2349
"فارس","شیراز","مرکزی",68,554,26,18,975,1573,26,1599
"فارس","شیراز","مرکزی",69,515,51,29,2116,2711,21,2732
"فارس","شیراز","مرکزی",70,680,61,43,1416,2200,39,2239
"فارس","شیراز","مرکزی",71,877,89,156,1163,2285,44,2329
"فارس","شیراز","مرکزی",72,266,32,27,867,1192,22,1214
"فارس","شیراز","مرکزی",73,309,34,45,1674,2062,15,2077
"فارس","شیراز","مرکزی",74,450,27,11,898,1386,14,1400
"فارس","شیراز","مرکزی",75,448,29,41,1448,1966,16,1982
"فارس","شیراز","مرکزی",76,435,38,19,1011,1503,16,1519
"فارس","شیراز","مرکزی",77,812,38,20,1224,2094,8,2102
"فارس","شیراز","مرکزی",78,837,21,30,931,1819,22,1841
"فارس","شیراز","مرکزی",79,337,32,15,924,1308,22,1330
"فارس","شیراز","مرکزی",80,383,25,30,1282,1720,2,1722
"فارس","شیراز","مرکزی",81,459,26,26,966,1477,16,1493
"فارس","شیراز","مرکزی",82,507,34,31,1241,1813,15,1828
"فارس","شیراز","مرکزی",83,548,55,41,1576,2220,21,2241
"فارس","شیراز","مرکزی",84,358,44,13,1078,1493,15,1508
"فارس","شیراز","مرکزی",85,470,32,38,1041,1581,16,1597
"فارس","شیراز","مرکزی",86,464,33,24,784,1305,12,1317
"فارس","شیراز","مرکزی",87,561,31,42,1403,2037,14,2051
"فارس","شیراز","مرکزی",88,463,34,25,1164,1686,13,1699
"فارس","شیراز","مرکزی",89,777,35,37,1627,2476,21,2497
"فارس","شیراز","مرکزی",90,770,37,25,886,1718,23,1741
"فارس","شیراز","مرکزی",91,487,27,18,1027,1559,32,1591
"فارس","شیراز","مرکزی",92,671,28,45,1236,1980,21,2001
"فارس","شیراز","مرکزی",93,261,28,6,753,1048,10,1058
"فارس","شیراز","مرکزی",94,405,39,12,1236,1692,11,1703
"فارس","شیراز","مرکزی",95,496,24,18,1223,1761,12,1773
"فارس","شیراز","مرکزی",96,516,45,33,1799,2393,15,2408
"فارس","شیراز","مرکزی",97,446,63,39,1529,2077,16,2093
"فارس","شیراز","مرکزی",98,439,36,25,1501,2001,20,2021
"فارس","شیراز","مرکزی",99,477,42,21,1192,1732,30,1762
"فارس","شیراز","مرکزی",100,336,27,28,1676,2067,11,2078
"فارس","شیراز","مرکزی",101,294,37,42,1838,2211,14,2225
"فارس","شیراز","مرکزی",102,177,14,16,1267,1474,9,1483
"فارس","شیراز","مرکزی",103,719,48,16,997,1780,27,1807
"فارس","شیراز","مرکزی",104,773,50,22,1569,2414,11,2425
"فارس","شیراز","مرکزی",105,612,56,32,1370,2070,9,2079
"فارس","شیراز","مرکزی",106,688,45,21,1142,1896,16,1912
"فارس","شیراز","مرکزی",107,669,24,7,491,1191,23,1214
"فارس","شیراز","مرکزی",108,685,32,5,452,1174,13,1187
"فارس","شیراز","مرکزی",109,753,116,5,580,1454,26,1480
"فارس","شیراز","مرکزی",110,1000,30,14,1152,2196,23,2219
"فارس","شیراز","مرکزی",111,808,25,13,789,1635,16,1651
"فارس","شیراز","مرکزی",112,1078,34,23,746,1881,38,1919
"فارس","شیراز","مرکزی",113,760,39,13,853,1665,12,1677
"فارس","شیراز","مرکزی",114,620,37,12,933,1602,13,1615
"فارس","شیراز","مرکزی",115,599,19,22,840,1480,25,1505
"فارس","شیراز","مرکزی",116,546,12,16,445,1019,15,1034
"فارس","شیراز","مرکزی",117,673,20,13,479,1185,17,1202
"فارس","شیراز","مرکزی",118,979,16,8,474,1477,23,1500
"فارس","شیراز","مرکزی",119,819,21,9,756,1605,15,1620
"فارس","شیراز","مرکزی",120,786,44,20,949,1799,12,1811
"فارس","شیراز","مرکزی",121,296,30,24,690,1040,12,1052
"فارس","شیراز","مرکزی",122,606,31,17,871,1525,26,1551
"فارس","شیراز","مرکزی",123,476,22,27,745,1270,17,1287
"فارس","شیراز","مرکزی",124,599,40,14,730,1383,18,1401
"فارس","شیراز","مرکزی",125,1270,20,4,654,1948,27,1975
"فارس","شیراز","مرکزی",126,706,27,7,437,1177,9,1186
"فارس","شیراز","مرکزی",127,1220,19,14,568,1821,22,1843
"فارس","شیراز","مرکزی",128,723,20,7,395,1145,7,1152
"فارس","شیراز","مرکزی",129,870,10,6,410,1296,10,1306
"فارس","شیراز","مرکزی",130,496,6,5,260,767,10,777
"فارس","شیراز","مرکزی",131,803,11,5,312,1131,15,1146
"فارس","شیراز","مرکزی",132,1114,3,2,260,1379,16,1395
"فارس","شیراز","مرکزی",133,1033,14,9,399,1455,13,1468
"فارس","شیراز","مرکزی",134,1173,14,8,427,1622,22,1644
"فارس","شیراز","مرکزی",135,566,17,4,272,859,6,865
"فارس","شیراز","مرکزی",136,517,17,7,259,800,10,810
"فارس","شیراز","مرکزی",137,1210,9,3,200,1422,16,1438
"فارس","شیراز","مرکزی",138,1090,13,9,355,1467,8,1475
"فارس","شیراز","مرکزی",139,779,25,4,431,1239,8,1247
"فارس","شیراز","مرکزی",140,442,5,9,207,663,6,669
"فارس","شیراز","مرکزی",141,733,21,7,450,1211,21,1232
"فارس","شیراز","مرکزی",142,628,15,7,303,953,11,964
"فارس","شیراز","مرکزی",143,874,24,10,523,1431,15,1446
"فارس","شیراز","مرکزی",144,915,16,9,349,1289,14,1303
"فارس","شیراز","مرکزی",145,623,9,4,183,819,6,825
"فارس","شیراز","مرکزی",146,992,19,16,614,1641,16,1657
"فارس","شیراز","مرکزی",147,397,10,2,225,634,1,635
"فارس","شیراز","مرکزی",148,798,21,4,267,1090,10,1100
"فارس","شیراز","مرکزی",149,1217,15,9,319,1560,10,1570
"فارس","شیراز","مرکزی",150,494,18,4,292,808,5,813
"فارس","شیراز","مرکزی",151,430,17,5,384,836,16,852
"فارس","شیراز","مرکزی",152,962,18,10,362,1352,8,1360
"فارس","شیراز","مرکزی",153,1013,26,6,285,1330,14,1344
"فارس","شیراز","مرکزی",154,1104,27,12,395,1538,11,1549
"فارس","شیراز","مرکزی",155,1121,18,12,359,1510,9,1519
"فارس","شیراز","مرکزی",156,1366,33,8,376,1783,23,1806
"فارس","شیراز","مرکزی",157,1303,7,11,263,1584,14,1598
"فارس","شیراز","مرکزی",158,762,15,7,269,1053,10,1063
"فارس","شیراز","مرکزی",159,1015,20,7,575,1617,11,1628
"فارس","شیراز","مرکزی",160,584,18,18,582,1202,18,1220
"فارس","شیراز","مرکزی",161,737,40,13,689,1479,14,1493
"فارس","شیراز","مرکزی",162,611,8,3,228,850,2,852
"فارس","شیراز","مرکزی",163,595,9,5,260,869,10,879
"فارس","شیراز","مرکزی",164,766,17,9,288,1080,12,1092
"فارس","شیراز","مرکزی",165,1047,17,18,606,1688,19,1707
"فارس","شیراز","مرکزی",166,524,5,7,263,799,7,806
"فارس","شیراز","مرکزی",167,978,26,10,617,1631,17,1648
"فارس","شیراز","مرکزی",168,1024,11,10,345,1390,13,1403
"فارس","شیراز","مرکزی",169,1084,4,5,235,1328,9,1337
"فارس","شیراز","مرکزی",170,826,9,6,335,1176,8,1184
"فارس","شیراز","مرکزی",171,830,15,19,277,1141,9,1150
"فارس","شیراز","مرکزی",172,1579,21,13,509,2122,14,2136
"فارس","شیراز","مرکزی",173,1135,13,10,425,1583,14,1597
"فارس","شیراز","مرکزی",174,855,17,3,315,1190,9,1199
"فارس","شیراز","مرکزی",175,1250,20,16,333,1619,17,1636
"فارس","شیراز","مرکزی",176,1110,20,8,491,1629,5,1634
"فارس","شیراز","مرکزی",177,498,12,12,215,737,13,750
"فارس","شیراز","مرکزی",178,941,32,15,985,1973,15,1988
"فارس","شیراز","مرکزی",179,1106,27,25,1012,2170,21,2191
"فارس","شیراز","مرکزی",180,577,13,7,604,1201,18,1219
"فارس","شیراز","مرکزی",181,844,32,9,697,1582,24,1606
"فارس","شیراز","مرکزی",182,677,13,16,376,1082,18,1100
"فارس","شیراز","مرکزی",183,1024,16,11,481,1532,16,1548
"فارس","شیراز","مرکزی",184,492,16,10,531,1049,12,1061
"فارس","شیراز","مرکزی",185,678,19,9,439,1145,16,1161
"فارس","شیراز","مرکزی",186,1322,12,14,423,1771,13,1784
"فارس","شیراز","مرکزی",187,1002,4,2,159,1167,12,1179
"فارس","شیراز","مرکزی",188,680,30,17,684,1411,17,1428
"فارس","شیراز","مرکزی",189,469,26,22,905,1422,20,1442
"فارس","شیراز","مرکزی",190,841,30,12,666,1549,10,1559
"فارس","شیراز","مرکزی",191,1152,22,27,451,1652,18,1670
"فارس","شیراز","مرکزی",192,1248,16,8,393,1665,10,1675
"فارس","شیراز","مرکزی",193,1035,23,17,638,1713,7,1720
"فارس","شیراز","مرکزی",194,712,20,8,491,1231,18,1249
"فارس","شیراز","مرکزی",195,1139,22,16,283,1460,11,1471
"فارس","شیراز","مرکزی",196,965,14,10,433,1422,33,1455
"فارس","شیراز","مرکزی",197,1357,36,10,498,1901,27,1928
"فارس","شیراز","مرکزی",198,715,29,4,324,1072,12,1084
"فارس","شیراز","مرکزی",199,1072,39,11,666,1788,14,1802
"فارس","شیراز","مرکزی",200,826,27,3,628,1484,18,1502
"فارس","شیراز","مرکزی",201,864,31,9,638,1542,25,1567
"فارس","شیراز","مرکزی",202,777,35,19,785,1616,14,1630
"فارس","شیراز","مرکزی",203,957,30,13,703,1703,26,1729
"فارس","شیراز","مرکزی",204,825,36,12,879,1752,20,1772
"فارس","شیراز","مرکزی",205,701,35,21,806,1563,16,1579
"فارس","شیراز","مرکزی",206,822,28,22,879,1751,30,1781
"فارس","شیراز","مرکزی",207,979,39,15,984,2017,17,2034
"فارس","شیراز","مرکزی",208,818,37,11,843,1709,24,1733
"فارس","شیراز","مرکزی",209,763,28,16,718,1525,20,1545
"فارس","شیراز","مرکزی",210,949,20,7,524,1500,17,1517
"فارس","شیراز","مرکزی",211,888,20,11,331,1250,9,1259
"فارس","شیراز","مرکزی",212,1256,21,7,425,1709,11,1720
"فارس","شیراز","مرکزی",213,1031,30,7,482,1550,25,1575
"فارس","شیراز","مرکزی",214,889,20,11,566,1486,19,1505
"فارس","شیراز","مرکزی",215,966,30,10,561,1567,24,1591
"فارس","شیراز","مرکزی",216,1100,15,8,627,1750,25,1775
"فارس","شیراز","مرکزی",217,1229,10,4,456,1699,15,1714
"فارس","شیراز","مرکزی",218,1581,29,12,910,2532,39,2571
"فارس","شیراز","مرکزی",219,1376,28,24,787,2215,24,2239
"فارس","شیراز","مرکزی",220,1329,14,8,601,1952,20,1972
"فارس","شیراز","مرکزی",221,874,22,5,486,1387,12,1399
"فارس","شیراز","مرکزی",222,915,25,4,416,1360,9,1369
"فارس","شیراز","مرکزی",223,1038,27,5,581,1651,1,1652
"فارس","شیراز","مرکزی",224,898,26,11,641,1576,19,1595
"فارس","شیراز","مرکزی",225,1127,25,9,719,1880,19,1899
"فارس","شیراز","مرکزی",226,1389,38,2,665,2094,11,2105
"فارس","شیراز","مرکزی",227,1415,25,9,401,1850,13,1863
"فارس","شیراز","مرکزی",228,1254,7,10,254,1525,8,1533
"فارس","شیراز","مرکزی",229,1532,18,20,582,2152,17,2169
"فارس","شیراز","مرکزی",230,1688,9,9,297,2003,19,2022
"فارس","شیراز","مرکزی",231,995,31,17,536,1579,18,1597
"فارس","شیراز","مرکزی",232,944,17,20,628,1609,16,1625
"فارس","شیراز","مرکزی",233,867,20,20,573,1480,15,1495
"فارس","شیراز","مرکزی",234,924,15,3,491,1433,12,1445
"فارس","شیراز","مرکزی",235,1463,26,17,628,2134,12,2146
"فارس","شیراز","مرکزی",236,1244,24,10,547,1825,12,1837
"فارس","شیراز","مرکزی",237,1500,13,9,412,1934,22,1956
"فارس","شیراز","مرکزی",238,959,22,8,425,1414,8,1422
"فارس","شیراز","مرکزی",239,1070,11,8,536,1625,15,1640
"فارس","شیراز","مرکزی",240,1741,18,8,323,2090,14,2104
"فارس","شیراز","مرکزی",241,1599,9,5,181,1794,15,1809
"فارس","شیراز","مرکزی",242,1461,14,5,339,1819,14,1833
"فارس","شیراز","مرکزی",243,584,11,6,277,878,7,885
"فارس","شیراز","مرکزی",244,739,36,11,541,1327,23,1350
"فارس","شیراز","مرکزی",245,887,43,5,966,1901,24,1925
"فارس","شیراز","مرکزی",246,766,28,14,727,1535,12,1547
"فارس","شیراز","مرکزی",247,710,49,35,1422,2216,18,2234
"فارس","شیراز","مرکزی",248,446,21,56,1446,1969,19,1988
"فارس","شیراز","مرکزی",249,437,37,51,1573,2098,15,2113
"فارس","شیراز","مرکزی",250,709,44,44,1546,2343,15,2358
"فارس","شیراز","مرکزی",251,356,30,24,1254,1664,14,1678
"فارس","شیراز","مرکزی",252,876,26,44,1687,2633,17,2650
"فارس","شیراز","مرکزی",253,861,66,39,1092,2058,20,2078
"فارس","شیراز","مرکزی",254,996,60,16,1145,2217,35,2252
"فارس","شیراز","مرکزی",255,1076,39,12,695,1822,15,1837
"فارس","شیراز","مرکزی",256,1142,45,42,1617,2846,17,2863
"فارس","شیراز","مرکزی",257,794,36,28,1529,2387,17,2404
"فارس","شیراز","مرکزی",258,753,45,18,824,1640,5,1645
"فارس","شیراز","مرکزی",259,910,25,3,521,1459,12,1471
"فارس","شیراز","مرکزی",260,442,35,37,1397,1911,8,1919
"فارس","شیراز","مرکزی",261,442,36,26,1513,2017,10,2027
"فارس","شیراز","مرکزی",262,758,36,35,1579,2408,23,2431
"فارس","شیراز","مرکزی",263,1301,16,9,520,1846,13,1859
"فارس","شیراز","مرکزی",264,900,32,22,1108,2062,14,2076
"فارس","شیراز","مرکزی",265,533,47,49,1749,2378,17,2395
"فارس","شیراز","مرکزی",266,602,36,30,1400,2068,15,2083
"فارس","شیراز","مرکزی",267,895,44,55,1746,2740,24,2764
"فارس","شیراز","مرکزی",268,593,30,23,1368,2014,12,2026
"فارس","شیراز","مرکزی",269,653,46,26,1451,2176,22,2198
"فارس","شیراز","مرکزی",270,1105,30,21,1002,2158,19,2177
"فارس","شیراز","مرکزی",271,951,43,27,1102,2123,12,2135
"فارس","شیراز","مرکزی",272,994,43,30,1566,2633,22,2655
"فارس","شیراز","مرکزی",273,968,41,29,1147,2185,16,2201
"فارس","شیراز","مرکزی",274,960,31,32,1354,2377,27,2404
"فارس","شیراز","مرکزی",275,975,29,18,1433,2455,45,2500
"فارس","شیراز","مرکزی",276,865,49,16,1484,2414,25,2439
"فارس","شیراز","مرکزی",277,1305,46,19,1709,3079,37,3116
"فارس","شیراز","مرکزی",278,929,34,28,1184,2175,21,2196
"فارس","شیراز","مرکزی",279,1047,32,17,1492,2588,14,2602
"فارس","شیراز","مرکزی",280,759,36,46,1615,2456,17,2473
"فارس","شیراز","مرکزی",281,415,43,27,1446,1931,20,1951
"فارس","شیراز","مرکزی",282,814,66,45,1477,2402,20,2422
"فارس","شیراز","مرکزی",283,667,38,24,1644,2373,13,2386
"فارس","شیراز","مرکزی",284,402,23,37,1588,2050,9,2059
"فارس","شیراز","مرکزی",285,523,47,33,1369,1972,23,1995
"فارس","شیراز","مرکزی",286,253,18,17,948,1236,13,1249
"فارس","شیراز","مرکزی",287,467,29,34,1777,2307,21,2328
"فارس","شیراز","مرکزی",288,415,31,38,2014,2498,11,2509
"فارس","شیراز","مرکزی",289,665,52,30,1472,2219,19,2238
"فارس","شیراز","مرکزی",290,349,36,37,1502,1924,17,1941
"فارس","شیراز","مرکزی",291,734,42,38,1970,2784,15,2799
"فارس","شیراز","مرکزی",292,1126,41,29,1123,2319,15,2334
"فارس","شیراز","مرکزی",293,598,41,38,1508,2185,17,2202
"فارس","شیراز","مرکزی",294,763,38,15,1106,1922,11,1933
"فارس","شیراز","مرکزی",295,798,23,15,853,1689,12,1701
"فارس","شیراز","مرکزی",296,1075,25,10,937,2047,12,2059
"فارس","شیراز","مرکزی",297,887,22,26,854,1789,11,1800
"فارس","شیراز","مرکزی",298,991,31,27,963,2012,19,2031
"فارس","شیراز","مرکزی",299,537,24,55,1463,2079,14,2093
"فارس","شیراز","مرکزی",300,432,19,13,591,1055,22,1077
"فارس","شیراز","مرکزی",301,1199,22,6,520,1747,7,1754
"فارس","شیراز","مرکزی",302,949,28,12,826,1815,15,1830
"فارس","شیراز","مرکزی",303,840,36,11,970,1857,15,1872
"فارس","شیراز","مرکزی",304,1376,20,13,742,2151,20,2171
"فارس","شیراز","مرکزی",305,916,27,7,965,1915,19,1934
"فارس","شیراز","مرکزی",306,784,21,9,799,1613,21,1634
"فارس","شیراز","مرکزی",307,867,31,21,837,1756,14,1770
"فارس","شیراز","مرکزی",308,1031,19,9,705,1764,10,1774
"فارس","شیراز","مرکزی",309,915,36,12,883,1846,20,1866
"فارس","شیراز","مرکزی",310,1358,19,9,523,1909,14,1923
"فارس","شیراز","مرکزی",311,1175,22,5,547,1749,14,1763
"فارس","شیراز","مرکزی",312,1049,41,6,512,1608,27,1635
"فارس","شیراز","مرکزی",313,1336,24,21,765,2146,20,2166
"فارس","شیراز","مرکزی",314,1211,11,4,285,1511,12,1523
"فارس","شیراز","مرکزی",315,977,15,12,365,1369,14,1383
"فارس","شیراز","مرکزی",316,1703,9,6,261,1979,18,1997
"فارس","شیراز","مرکزی",317,969,13,3,249,1234,9,1243
"فارس","شیراز","مرکزی",318,1458,13,3,324,1798,14,1812
"فارس","شیراز","مرکزی",319,1306,14,5,328,1653,14,1667
"فارس","شیراز","مرکزی",320,777,10,12,482,1281,19,1300
"فارس","شیراز","مرکزی",321,1383,19,7,375,1784,11,1795
"فارس","شیراز","مرکزی",322,1114,14,1,350,1479,16,1495
"فارس","شیراز","مرکزی",323,2125,12,6,447,2590,10,2600
"فارس","شیراز","مرکزی",324,1153,16,4,380,1553,18,1571
"فارس","شیراز","مرکزی",325,1386,9,13,276,1684,13,1697
"فارس","شیراز","مرکزی",326,1273,10,6,211,1500,4,1504
"فارس","شیراز","مرکزی",327,1143,14,0,260,1417,12,1429
"فارس","شیراز","مرکزی",328,1501,7,3,342,1853,7,1860
"فارس","شیراز","مرکزی",329,1332,10,12,388,1742,15,1757
"فارس","شیراز","مرکزی",330,927,9,3,214,1153,12,1165
"فارس","شیراز","مرکزی",331,634,1,0,159,794,3,797
"فارس","شیراز","مرکزی",332,1411,10,2,262,1685,7,1692
"فارس","شیراز","مرکزی",333,822,12,7,581,1422,17,1439
"فارس","شیراز","مرکزی",334,1377,35,7,893,2312,26,2338
"فارس","شیراز","مرکزی",335,488,7,10,291,796,0,796
"فارس","شیراز","مرکزی",336,765,17,7,525,1314,7,1321
"فارس","شیراز","مرکزی",337,902,15,10,604,1531,23,1554
"فارس","شیراز","مرکزی",338,1597,24,11,738,2370,22,2392
"فارس","شیراز","مرکزی",339,1008,20,27,776,1831,10,1841
"فارس","شیراز","مرکزی",340,1311,19,8,716,2054,9,2063
"فارس","شیراز","مرکزی",341,697,10,1,315,1023,12,1035
"فارس","شیراز","مرکزی",342,1260,12,11,565,1848,10,1858
"فارس","شیراز","مرکزی",343,866,12,9,511,1398,16,1414
"فارس","شیراز","مرکزی",344,1274,21,7,515,1817,15,1832
"فارس","شیراز","مرکزی",345,1382,26,7,701,2116,17,2133
"فارس","شیراز","مرکزی",346,1405,38,7,487,1937,12,1949
"فارس","شیراز","مرکزی",347,1104,28,6,700,1838,18,1856
"فارس","شیراز","مرکزی",348,814,10,1,415,1240,9,1249
"فارس","شیراز","مرکزی",349,1301,48,8,673,2030,22,2052
"فارس","شیراز","مرکزی",350,787,13,7,383,1190,12,1202
"فارس","شیراز","مرکزی",351,1004,50,11,551,1616,16,1632
"فارس","شیراز","مرکزی",352,1165,10,5,492,1672,17,1689
"فارس","شیراز","مرکزی",353,1333,19,11,515,1878,16,1894
"فارس","شیراز","مرکزی",354,649,4,1,304,958,12,970
"فارس","شیراز","مرکزی",355,1453,16,4,443,1916,5,1921
"فارس","شیراز","مرکزی",356,1567,15,5,499,2086,9,2095
"فارس","شیراز","مرکزی",357,1291,10,2,241,1544,9,1553
"فارس","شیراز","مرکزی",358,1559,16,10,328,1913,11,1924
"فارس","شیراز","مرکزی",359,1159,11,0,267,1437,7,1444
"فارس","شیراز","مرکزی",360,1460,16,5,328,1809,20,1829
"فارس","شیراز","مرکزی",361,948,16,6,378,1348,10,1358
"فارس","شیراز","مرکزی",362,1350,7,3,325,1685,12,1697
"فارس","شیراز","مرکزی",363,937,15,9,332,1293,5,1298
"فارس","شیراز","مرکزی",364,1511,34,5,244,1794,6,1800
"فارس","شیراز","مرکزی",365,933,10,7,232,1182,6,1188
"فارس","شیراز","مرکزی",366,803,11,3,241,1058,10,1068
"فارس","شیراز","مرکزی",367,318,10,8,245,581,13,594
"فارس","شیراز","مرکزی",368,1289,15,9,625,1938,17,1955
"فارس","شیراز","مرکزی",369,1214,17,3,520,1754,16,1770
"فارس","شیراز","مرکزی",370,1365,16,14,611,2006,23,2029
"فارس","شیراز","مرکزی",371,1011,25,10,831,1877,22,1899
"فارس","شیراز","مرکزی",372,553,23,13,539,1128,18,1146
"فارس","شیراز","مرکزی",373,637,17,6,627,1287,17,1304
"فارس","شیراز","مرکزی",374,585,27,19,789,1420,10,1430
"فارس","شیراز","مرکزی",375,406,35,19,715,1175,12,1187
"فارس","شیراز","مرکزی",376,958,24,15,848,1845,10,1855
"فارس","شیراز","مرکزی",377,751,11,8,434,1204,17,1221
"فارس","شیراز","مرکزی",378,646,23,4,520,1193,15,1208
"فارس","شیراز","مرکزی",379,596,28,30,900,1554,11,1565
"فارس","شیراز","مرکزی",380,715,22,13,743,1493,6,1499
"فارس","شیراز","مرکزی",381,547,22,1,532,1102,11,1113
"فارس","شیراز","مرکزی",382,657,15,7,324,1003,14,1017
"فارس","شیراز","مرکزی",383,780,44,31,1139,1994,20,2014
"فارس","شیراز","مرکزی",384,691,18,2,404,1115,11,1126
"فارس","شیراز","مرکزی",385,476,26,5,410,917,13,930
"فارس","شیراز","مرکزی",386,672,28,3,779,1482,11,1493
"فارس","شیراز","مرکزی",387,592,22,6,501,1121,10,1131
"فارس","شیراز","مرکزی",388,962,18,11,658,1649,11,1660
"فارس","شیراز","مرکزی",389,1121,16,8,389,1534,13,1547
"فارس","شیراز","مرکزی",390,1388,8,2,192,1590,10,1600
"فارس","شیراز","مرکزی",391,1413,11,6,305,1735,5,1740
"فارس","شیراز","مرکزی",392,1706,5,6,261,1978,10,1988
"فارس","شیراز","مرکزی",393,1616,4,8,163,1791,5,1796
"فارس","شیراز","مرکزی",394,1272,5,6,190,1473,9,1482
"فارس","شیراز","مرکزی",395,1080,6,1,160,1247,5,1252
"فارس","شیراز","مرکزی",396,969,9,0,189,1167,12,1179
"فارس","شیراز","مرکزی",397,1655,12,5,320,1992,14,2006
"فارس","شیراز","مرکزی",398,966,8,1,169,1144,9,1153
"فارس","شیراز","مرکزی",399,1230,13,15,354,1612,7,1619
"فارس","شیراز","مرکزی",400,1379,8,2,267,1656,12,1668
"فارس","شیراز","مرکزی",401,1241,16,3,393,1653,13,1666
"فارس","شیراز","مرکزی",402,930,6,10,408,1354,13,1367
"فارس","شیراز","مرکزی",403,902,30,17,857,1806,25,1831
"فارس","شیراز","مرکزی",404,515,33,8,585,1141,13,1154
"فارس","شیراز","مرکزی",405,973,34,15,765,1787,7,1794
"فارس","شیراز","مرکزی",406,809,12,12,640,1473,9,1482
"فارس","شیراز","مرکزی",407,1050,44,14,928,2036,23,2059
"فارس","شیراز","مرکزی",408,814,24,10,668,1516,10,1526
"فارس","شیراز","مرکزی",409,1070,26,9,736,1841,18,1859
"فارس","شیراز","مرکزی",410,932,30,10,742,1714,11,1725
"فارس","شیراز","مرکزی",411,1020,32,18,619,1689,10,1699
"فارس","شیراز","مرکزی",412,1069,20,21,1205,2315,27,2342
"فارس","شیراز","مرکزی",413,1144,31,9,708,1892,108,2000
"فارس","شیراز","مرکزی",414,958,24,4,589,1575,25,1600
"فارس","شیراز","مرکزی",415,882,11,1,541,1435,11,1446
"فارس","شیراز","مرکزی",416,1527,19,16,601,2163,19,2182
"فارس","شیراز","مرکزی",417,1100,9,6,374,1489,22,1511
"فارس","شیراز","مرکزی",418,1412,25,4,629,2070,7,2077
"فارس","شیراز","مرکزی",419,808,28,2,481,1319,15,1334
"فارس","شیراز","مرکزی",420,1428,12,5,264,1709,7,1716
"فارس","شیراز","مرکزی",421,1625,3,3,227,1858,12,1870
"فارس","شیراز","مرکزی",422,578,8,5,193,784,6,790
"فارس","شیراز","مرکزی",423,1075,17,11,453,1556,15,1571
"فارس","شیراز","مرکزی",424,233,5,3,90,331,3,334
"فارس","شیراز","مرکزی",425,1966,10,3,364,2343,10,2353
"فارس","شیراز","مرکزی",426,1889,10,8,919,2826,18,2844
"فارس","شیراز","مرکزی",427,1422,17,17,721,2177,20,2197
"فارس","شیراز","مرکزی",428,771,22,5,643,1441,9,1450
"فارس","شیراز","مرکزی",429,1349,18,6,895,2268,16,2284
"فارس","شیراز","مرکزی",430,1293,27,10,783,2113,8,2121
"فارس","شیراز","مرکزی",431,771,14,15,1045,1845,17,1862
"فارس","شیراز","مرکزی",432,775,14,1,641,1431,6,1437
"فارس","شیراز","مرکزی",433,905,9,3,390,1307,6,1313
"فارس","شیراز","مرکزی",434,1614,13,6,367,2000,12,2012
"فارس","شیراز","مرکزی",435,927,11,11,185,1134,4,1138
"فارس","شیراز","مرکزی",436,1242,25,9,502,1778,9,1787
"فارس","شیراز","مرکزی",437,946,2,7,336,1291,11,1302
"فارس","شیراز","مرکزی",438,777,7,6,194,984,7,991
"فارس","شیراز","مرکزی",439,431,0,0,101,532,4,536
"فارس","شیراز","مرکزی",440,1265,12,6,193,1476,11,1487
"فارس","شیراز","مرکزی",441,893,12,4,269,1178,12,1190
"فارس","شیراز","مرکزی",442,708,5,0,196,909,4,913
"فارس","شیراز","مرکزی",443,1137,3,0,94,1234,6,1240
"فارس","شیراز","مرکزی",444,691,11,0,56,758,1,759
"فارس","شیراز","مرکزی",445,503,3,0,26,532,0,532
"فارس","شیراز","مرکزی",446,1183,4,3,123,1313,0,1313
"فارس","شیراز","مرکزی",447,982,12,3,190,1187,8,1195
"فارس","شیراز","مرکزی",448,1379,11,0,261,1651,7,1658
"فارس","شیراز","مرکزی",449,1273,13,6,341,1633,11,1644
"فارس","شیراز","مرکزی",450,1358,7,5,270,1640,16,1656
"فارس","شیراز","مرکزی",451,862,4,1,68,935,4,939
"فارس","شیراز","مرکزی",452,1371,3,3,75,1452,3,1455
"فارس","شیراز","مرکزی",453,1358,1,0,131,1490,4,1494
"فارس","شیراز","مرکزی",454,1379,3,3,86,1471,9,1480
"فارس","شیراز","مرکزی",455,1401,12,1,177,1591,7,1598
"فارس","شیراز","مرکزی",456,687,6,1,142,836,5,841
"فارس","شیراز","مرکزی",457,1686,11,0,82,1779,10,1789
"فارس","شیراز","مرکزی",458,1070,6,1,81,1158,8,1166
"فارس","شیراز","مرکزی",459,1229,2,0,112,1343,5,1348
"فارس","شیراز","مرکزی",460,811,1,0,114,926,5,931
"فارس","شیراز","مرکزی",461,1170,0,1,76,1247,3,1250
"فارس","شیراز","مرکزی",462,1101,2,4,137,1244,1,1245
"فارس","شیراز","مرکزی",463,1405,2,6,201,1614,2,1616
"فارس","شیراز","مرکزی",464,1000,6,7,174,1187,11,1198
"فارس","شیراز","مرکزی",465,932,2,4,134,1072,6,1078
"فارس","شیراز","مرکزی",466,296,3,0,84,383,1,384
"فارس","شیراز","مرکزی",467,1179,6,4,164,1353,5,1358
"فارس","شیراز","مرکزی",468,1435,6,10,250,1701,4,1705
"فارس","شیراز","مرکزی",469,1008,4,8,162,1182,4,1186
"فارس","شیراز","مرکزی",470,1435,5,11,266,1717,6,1723
"فارس","شیراز","مرکزی",471,1485,6,5,265,1761,13,1774
"فارس","شیراز","مرکزی",472,678,2,0,119,799,1,800
"فارس","شیراز","مرکزی",473,1048,2,5,111,1166,10,1176
"فارس","شیراز","مرکزی",474,659,5,0,76,740,3,743
"فارس","شیراز","مرکزی",475,1436,8,8,248,1700,2,1702
"فارس","شیراز","مرکزی",476,737,1,4,30,772,4,776
"فارس","شیراز","مرکزی",477,596,2,2,42,642,3,645
"فارس","شیراز","مرکزی",478,1509,2,0,28,1539,3,1542
"فارس","شیراز","مرکزی",479,885,12,1,272,1170,9,1179
"فارس","شیراز","مرکزی",480,1129,6,5,426,1566,11,1577
"فارس","شیراز","مرکزی",481,997,10,0,370,1377,11,1388
"فارس","شیراز","مرکزی",482,1129,2,4,213,1348,6,1354
"فارس","شیراز","مرکزی",483,953,6,6,71,1036,4,1040
"فارس","شیراز","مرکزی",484,876,7,0,92,975,1,976
"فارس","شیراز","مرکزی",485,703,1,1,91,796,11,807
"فارس","شیراز","مرکزی",486,964,7,1,44,1016,7,1023
"فارس","شیراز","مرکزی",487,396,4,2,81,483,4,487
"فارس","شیراز","مرکزی",488,1191,1,3,103,1298,2,1300
"فارس","شیراز","ارژن",1,524,1,1,139,665,4,669
"فارس","شیراز","ارژن",2,1064,3,1,125,1193,7,1200
"فارس","شیراز","ارژن",3,1155,12,7,403,1577,7,1584
"فارس","شیراز","ارژن",4,735,7,1,279,1022,5,1027
"فارس","شیراز","ارژن",5,127,1,0,10,138,0,138
"فارس","شیراز","ارژن",6,705,2,2,262,971,8,979
"فارس","شیراز","ارژن",7,906,3,0,161,1070,10,1080
"فارس","شیراز","ارژن",8,557,4,0,239,800,1,801
"فارس","شیراز","ارژن",9,340,1,0,80,421,2,423
"فارس","شیراز","ارژن",10,798,6,2,163,969,11,980
"فارس","شیراز","ارژن",11,639,10,0,144,793,0,793
"فارس","شیراز","ارژن",12,266,1,1,202,470,4,474
"فارس","شیراز","ارژن",13,481,3,0,58,542,6,548
"فارس","شیراز","ارژن",14,1440,7,7,271,1725,1,1726
"فارس","شیراز","ارژن",15,630,2,0,39,671,2,673
"فارس","شیراز","ارژن",16,365,3,1,42,411,2,413
"فارس","شیراز","ارژن",17,353,1,5,75,434,4,438
"فارس","شیراز","ارژن",18,526,1,0,66,593,1,594
"فارس","شیراز","ارژن",19,663,1,0,64,728,0,728
"فارس","شیراز","ارژن",20,422,0,0,26,448,1,449
"فارس","شیراز","ارژن",21,589,7,0,38,634,2,636
"فارس","شیراز","ارژن",22,593,1,1,24,619,4,623
"فارس","شیراز","ارژن",23,623,2,1,49,675,2,677
"فارس","شیراز","ارژن",24,578,0,0,43,621,1,622
"فارس","شیراز","زرقان",1,1152,29,7,570,1758,18,1776
"فارس","شیراز","زرقان",2,705,12,3,305,1025,9,1034
"فارس","شیراز","زرقان",3,1309,19,4,374,1706,13,1719
"فارس","شیراز","زرقان",4,1149,19,7,426,1601,16,1617
"فارس","شیراز","زرقان",5,1148,18,8,589,1763,12,1775
"فارس","شیراز","زرقان",6,906,37,9,669,1621,17,1638
"فارس","شیراز","زرقان",7,1089,17,6,748,1860,18,1878
"فارس","شیراز","زرقان",8,1348,20,4,345,1717,15,1732
"فارس","شیراز","زرقان",9,1223,7,1,365,1596,11,1607
"فارس","شیراز","زرقان",10,1496,14,13,320,1843,13,1856
"فارس","شیراز","زرقان",11,918,13,2,330,1263,3,1266
"فارس","شیراز","زرقان",12,613,4,3,344,964,7,971
"فارس","شیراز","زرقان",13,546,1,1,185,733,3,736
"فارس","شیراز","زرقان",14,831,5,0,107,943,2,945
"فارس","شیراز","زرقان",15,1100,4,0,21,1125,2,1127
"فارس","شیراز","زرقان",16,685,7,0,82,774,4,778
"فارس","شیراز","زرقان",17,574,0,1,66,641,0,641
"فارس","شیراز","زرقان",18,506,0,0,99,605,1,606
"فارس","شیراز","زرقان",19,1315,6,2,101,1424,5,1429
"فارس","شیراز","زرقان",20,689,7,3,81,780,0,780
"فارس","شیراز","زرقان",21,479,2,0,62,543,0,543
"فارس","شیراز","زرقان",22,419,0,2,31,452,1,453
"فارس","شیراز","زرقان",23,386,1,0,34,421,0,421
"فارس","شیراز","زرقان",24,432,0,0,11,443,0,443
"فارس","شیراز","زرقان",25,440,0,2,13,455,0,455
"فارس","شیراز","زرقان",26,136,6,0,115,257,1,258
"فارس","شیراز","زرقان",27,562,31,2,323,918,21,939
"فارس","شیراز","کوار",1,279,2,1,82,364,0,364
"فارس","شیراز","کوار",2,331,5,12,150,498,4,502
"فارس","شیراز","کوار",3,974,8,11,168,1161,4,1165
"فارس","شیراز","کوار",4,795,5,5,196,1001,2,1003
"فارس","شیراز","کوار",5,589,4,3,133,729,4,733
"فارس","شیراز","کوار",6,715,10,37,375,1137,7,1144
"فارس","شیراز","کوار",7,910,21,5,349,1285,9,1294
"فارس","شیراز","کوار",8,653,6,27,338,1024,9,1033
"فارس","شیراز","کوار",9,372,2,0,479,853,3,856
"فارس","شیراز","کوار",10,695,13,5,340,1053,3,1056
"فارس","شیراز","کوار",11,433,7,1,123,564,2,566
"فارس","شیراز","کوار",12,627,6,13,234,880,4,884
"فارس","شیراز","کوار",13,794,2,12,248,1056,3,1059
"فارس","شیراز","کوار",14,599,5,12,202,818,8,826
"فارس","شیراز","کوار",15,441,2,4,167,614,1,615
"فارس","شیراز","کوار",16,988,13,2,151,1154,5,1159
"فارس","شیراز","کوار",17,885,4,0,150,1039,5,1044
"فارس","شیراز","کوار",18,1082,3,1,49,1135,5,1140
"فارس","شیراز","کوار",19,1138,2,0,181,1321,4,1325
"فارس","شیراز","کوار",20,585,0,0,56,641,1,642
"فارس","شیراز","کوار",21,1434,3,1,195,1633,7,1640
"فارس","شیراز","کوار",22,721,4,2,135,862,5,867
"فارس","شیراز","کوار",23,1150,2,0,141,1293,6,1299
"فارس","شیراز","کوار",24,1037,2,3,138,1180,2,1182
"فارس","شیراز","کوار",25,819,7,1,75,902,2,904
"فارس","شیراز","کوار",26,724,6,2,82,814,1,815
"فارس","شیراز","کوار",27,456,0,0,41,497,1,498
"فارس","شیراز","کوار",28,424,3,2,35,464,0,464
"فارس","شیراز","کوار",29,1322,8,5,57,1392,2,1394
"فارس","شیراز","کوار",30,984,11,3,105,1103,2,1105
"فارس","شیراز","کوار",31,845,2,9,90,946,5,951
"فارس","شیراز","کوار",32,1535,3,0,113,1651,0,1651
"فارس","شیراز","کوار",33,1550,6,0,93,1649,5,1654
"فارس","شیراز","کوار",34,411,2,14,192,619,1,620
"فارس","شیراز","کوار",35,771,1,2,29,803,2,805
"فارس","شیراز","کوار",36,474,5,3,159,641,8,649
"فارس","شیراز","کوار",37,536,2,0,62,600,0,600
"فارس","شیراز","کوار",38,395,1,1,36,433,1,434
"فارس","شیراز","کوار",39,459,7,0,118,584,0,584
"فارس","شیراز","کوار",40,838,4,2,234,1078,8,1086
"فارس","شیراز","کوار",41,307,1,0,45,353,2,355
"فارس","شیراز","کوار",42,653,3,7,56,719,1,720
"فارس","شیراز","کوار",43,566,4,6,45,621,4,625
"فارس","شیراز","کوار",44,660,0,6,46,712,2,714
"فارس","شیراز","کوار",45,802,1,2,115,920,3,923
"فارس","شیراز","کوار",46,657,4,46,21,728,7,735
"فارس","شیراز","کربال",1,810,5,1,184,1000,4,1004
"فارس","شیراز","کربال",2,461,4,2,145,612,2,614
"فارس","شیراز","کربال",3,855,2,3,518,1378,6,1384
"فارس","شیراز","کربال",4,356,2,1,173,532,9,541
"فارس","شیراز","کربال",5,354,3,0,92,449,1,450
"فارس","شیراز","کربال",6,565,2,2,128,697,3,700
"فارس","شیراز","کربال",7,1065,6,0,186,1257,2,1259
"فارس","شیراز","کربال",8,1012,5,5,202,1224,1,1225
"فارس","شیراز","کربال",9,501,3,3,246,753,5,758
"فارس","شیراز","کربال",10,508,2,4,226,740,8,748
"فارس","شیراز","کربال",11,972,7,6,351,1336,4,1340
"فارس","شیراز","کربال",12,441,4,3,135,583,6,589
"فارس","شیراز","کربال",13,424,3,0,116,543,5,548
"فارس","شیراز","کربال",14,619,2,1,84,706,2,708
"فارس","شیراز","کربال",15,198,0,0,51,249,2,251
"فارس","شیراز","کربال",16,697,1,0,111,809,1,810
"فارس","شیراز","کربال",17,956,5,0,24,985,3,988
"فارس","شیراز","کربال",18,1162,3,16,164,1345,3,1348
"فارس","شیراز","کربال",19,245,3,0,37,285,0,285
"فارس","شیراز","کربال",20,624,1,1,35,661,3,664
"فارس","شیراز","کربال",21,440,0,0,35,475,1,476
"فارس","شیراز","کربال",22,924,2,0,71,997,3,1000
"فارس","شیراز","کربال",23,555,0,1,49,605,2,607
"فارس","شیراز","کربال",24,708,2,4,109,823,0,823
"فارس","شیراز","کربال",25,1178,1,6,111,1296,4,1300
"فارس","شیراز","کربال",26,1074,2,1,60,1137,3,1140
"فارس","شیراز","کربال",27,1057,0,0,43,1100,0,1100
"فارس","شیراز","کربال",28,803,0,0,41,844,6,850
"فارس","شیراز","کربال",29,1383,1,0,41,1425,0,1425
"فارس","شیراز","کربال",30,626,0,0,43,669,0,669
"فارس","شیراز","کربال",31,842,3,0,95,940,3,943
"فارس","شیراز","کربال",32,674,3,0,144,821,7,828
"فارس","شیراز","کربال",33,374,0,0,13,387,0,387
"فارس","شیراز","کربال",34,373,0,0,18,391,1,392
"فارس","شیراز","کربال",35,782,1,1,24,808,1,809
"فارس","شیراز","کربال",36,649,0,0,40,689,1,690
"فارس","شیراز","کربال",37,682,2,0,87,771,0,771
"فارس","شیراز","کربال",38,838,0,4,25,867,10,877
"فارس","شیراز","کربال",39,722,1,0,61,784,3,787
"فارس","شیراز","کربال",40,459,0,3,71,533,0,533
"فارس","شیراز","کربال",41,325,1,4,41,371,4,375
"فارس","شیراز","کربال",42,790,2,1,111,904,3,907
"فارس","شیراز","کربال",43,524,0,0,19,543,0,543
"فارس","شیراز","کربال",44,1067,1,3,112,1183,5,1188
"فارس","شیراز","کربال",45,179,0,0,27,206,0,206
"فارس","فراشبند","مرکزی",1,787,6,3,302,1098,15,1113
"فارس","فراشبند","مرکزی",2,651,10,11,327,999,10,1009
"فارس","فراشبند","مرکزی",3,483,6,3,249,741,12,753
"فارس","فراشبند","مرکزی",4,541,2,2,162,707,3,710
"فارس","فراشبند","مرکزی",5,262,1,0,177,440,1,441
"فارس","فراشبند","مرکزی",6,336,2,2,166,506,5,511
"فارس","فراشبند","مرکزی",7,396,10,5,274,685,9,694
"فارس","فراشبند","مرکزی",8,290,5,1,155,451,1,452
"فارس","فراشبند","مرکزی",9,672,5,4,177,858,9,867
"فارس","فراشبند","مرکزی",10,350,4,1,208,563,8,571
"فارس","فراشبند","مرکزی",11,292,5,3,123,423,6,429
"فارس","فراشبند","مرکزی",12,470,12,4,225,711,14,725
"فارس","فراشبند","مرکزی",13,226,1,2,98,327,3,330
"فارس","فراشبند","مرکزی",14,283,5,2,231,521,8,529
"فارس","فراشبند","مرکزی",15,260,6,1,178,445,6,451
"فارس","فراشبند","مرکزی",16,425,2,5,114,546,3,549
"فارس","فراشبند","مرکزی",17,236,3,0,96,335,0,335
"فارس","فراشبند","مرکزی",18,266,3,2,84,355,2,357
"فارس","فراشبند","مرکزی",19,98,2,0,24,124,0,124
"فارس","فراشبند","مرکزی",20,444,8,4,144,600,1,601
"فارس","فراشبند","مرکزی",21,235,5,3,65,308,1,309
"فارس","فراشبند","مرکزی",22,102,0,0,55,157,0,157
"فارس","فراشبند","مرکزی",23,396,2,0,87,485,4,489
"فارس","فراشبند","مرکزی",24,629,4,1,257,891,8,899
"فارس","فراشبند","مرکزی",25,514,5,4,190,713,3,716
"فارس","فراشبند","مرکزی",26,298,3,2,242,545,2,547
"فارس","فراشبند","مرکزی",27,438,3,0,115,556,0,556
"فارس","فراشبند","مرکزی",28,93,0,0,23,116,0,116
"فارس","فراشبند","مرکزی",29,192,1,0,30,223,2,225
"فارس","فراشبند","مرکزی",30,163,0,0,84,247,0,247
"فارس","فراشبند","مرکزی",31,178,1,0,124,303,1,304
"فارس","فراشبند","مرکزی",32,366,0,1,53,420,0,420
"فارس","فراشبند","مرکزی",33,312,1,3,72,388,1,389
"فارس","فراشبند","مرکزی",34,238,0,0,64,302,5,307
"فارس","فراشبند","مرکزی",35,288,7,6,188,489,5,494
"فارس","فراشبند","مرکزی",36,418,3,3,195,619,2,621
"فارس","فراشبند","مرکزی",37,415,0,1,79,495,1,496
"فارس","فراشبند","مرکزی",38,165,1,0,75,241,0,241
"فارس","فراشبند","مرکزی",39,161,1,1,28,191,0,191
"فارس","فراشبند","مرکزی",40,351,0,0,44,395,3,398
"فارس","فراشبند","مرکزی",41,53,0,1,32,86,0,86
"فارس","فراشبند","دهرم",1,965,3,0,53,1021,2,1023
"فارس","فراشبند","دهرم",2,509,0,0,34,543,0,543
"فارس","فراشبند","دهرم",3,303,1,0,41,345,1,346
"فارس","فراشبند","دهرم",4,245,4,1,158,408,1,409
"فارس","فراشبند","دهرم",5,261,0,0,24,285,1,286
"فارس","فراشبند","دهرم",6,160,0,0,22,182,0,182
"فارس","فراشبند","دهرم",7,755,4,0,42,801,0,801
"فارس","فراشبند","دهرم",8,182,1,0,22,205,0,205
"فارس","فراشبند","دهرم",9,655,8,1,105,769,0,769
"فارس","فسا","مرکزی",1,534,12,9,186,741,8,749
"فارس","فسا","مرکزی",2,507,7,6,191,711,11,722
"فارس","فسا","مرکزی",3,414,5,7,237,663,21,684
"فارس","فسا","مرکزی",4,604,15,14,303,936,13,949
"فارس","فسا","مرکزی",5,648,13,8,400,1069,18,1087
"فارس","فسا","مرکزی",6,920,12,14,201,1147,18,1165
"فارس","فسا","مرکزی",7,563,9,5,154,731,12,743
"فارس","فسا","مرکزی",8,1140,15,19,214,1388,10,1398
"فارس","فسا","مرکزی",9,468,6,2,91,567,4,571
"فارس","فسا","مرکزی",10,828,11,4,250,1093,7,1100
"فارس","فسا","مرکزی",11,1015,7,4,175,1201,6,1207
"فارس","فسا","مرکزی",12,1173,3,3,174,1353,8,1361
"فارس","فسا","مرکزی",13,1019,4,10,111,1144,6,1150
"فارس","فسا","مرکزی",14,712,9,8,214,943,8,951
"فارس","فسا","مرکزی",15,898,21,16,455,1390,12,1402
"فارس","فسا","مرکزی",16,796,10,11,275,1092,8,1100
"فارس","فسا","مرکزی",17,1290,6,3,279,1578,9,1587
"فارس","فسا","مرکزی",18,1036,5,6,290,1337,8,1345
"فارس","فسا","مرکزی",19,952,17,31,570,1570,24,1594
"فارس","فسا","مرکزی",20,1126,9,27,384,1546,24,1570
"فارس","فسا","مرکزی",21,492,12,8,269,781,13,794
"فارس","فسا","مرکزی",22,523,10,12,235,780,10,790
"فارس","فسا","مرکزی",23,1036,5,18,388,1447,13,1460
"فارس","فسا","مرکزی",24,583,12,21,378,994,9,1003
"فارس","فسا","مرکزی",25,922,34,43,707,1706,32,1738
"فارس","فسا","مرکزی",26,1007,24,23,624,1678,30,1708
"فارس","فسا","مرکزی",27,1086,27,27,644,1784,11,1795
"فارس","فسا","مرکزی",28,542,18,51,608,1219,12,1231
"فارس","فسا","مرکزی",29,1174,35,31,639,1879,26,1905
"فارس","فسا","مرکزی",30,977,30,11,543,1561,21,1582
"فارس","فسا","مرکزی",31,936,31,31,743,1741,27,1768
"فارس","فسا","مرکزی",32,1038,21,32,522,1613,23,1636
"فارس","فسا","مرکزی",33,846,38,67,676,1627,18,1645
"فارس","فسا","مرکزی",34,695,12,26,466,1199,6,1205
"فارس","فسا","مرکزی",35,916,25,11,431,1383,18,1401
"فارس","فسا","مرکزی",36,764,17,14,357,1152,18,1170
"فارس","فسا","مرکزی",37,842,8,9,277,1136,15,1151
"فارس","فسا","مرکزی",38,1326,12,21,416,1775,11,1786
"فارس","فسا","مرکزی",39,631,9,12,311,963,21,984
"فارس","فسا","مرکزی",40,746,3,3,44,796,6,802
"فارس","فسا","مرکزی",41,813,5,0,28,846,2,848
"فارس","فسا","مرکزی",42,562,9,21,274,866,20,886
"فارس","فسا","مرکزی",43,293,4,4,185,486,16,502
"فارس","فسا","مرکزی",44,1022,22,36,557,1637,21,1658
"فارس","فسا","مرکزی",45,409,13,24,235,681,11,692
"فارس","فسا","مرکزی",46,518,15,4,211,748,12,760
"فارس","فسا","مرکزی",47,996,11,24,317,1348,17,1365
"فارس","فسا","مرکزی",48,427,7,4,160,598,10,608
"فارس","فسا","مرکزی",49,365,4,1,86,456,8,464
"فارس","فسا","مرکزی",50,1462,5,1,89,1557,11,1568
"فارس","فسا","مرکزی",51,1350,5,2,69,1426,7,1433
"فارس","فسا","مرکزی",52,1120,0,3,82,1205,6,1211
"فارس","فسا","مرکزی",53,1132,0,5,136,1273,5,1278
"فارس","فسا","مرکزی",54,1188,5,4,116,1313,10,1323
"فارس","فسا","مرکزی",55,1016,5,7,143,1171,12,1183
"فارس","فسا","مرکزی",56,800,7,27,144,978,3,981
"فارس","فسا","مرکزی",57,599,0,1,25,625,4,629
"فارس","فسا","مرکزی",58,333,2,0,58,393,1,394
"فارس","فسا","مرکزی",59,838,5,7,143,993,6,999
"فارس","فسا","مرکزی",60,479,4,1,31,515,4,519
"فارس","فسا","مرکزی",61,86,0,0,8,94,0,94
"فارس","فسا","مرکزی",62,1205,2,5,74,1286,3,1289
"فارس","فسا","مرکزی",63,362,3,1,82,448,0,448
"فارس","فسا","مرکزی",64,359,0,4,203,566,2,568
"فارس","فسا","مرکزی",65,712,7,19,158,896,4,900
"فارس","فسا","مرکزی",66,304,0,0,53,357,1,358
"فارس","فسا","مرکزی",67,331,2,1,55,389,2,391
"فارس","فسا","مرکزی",68,179,4,0,70,253,2,255
"فارس","فسا","مرکزی",69,579,0,0,62,641,0,641
"فارس","فسا","ششده_و_قره_بلاغ",1,770,0,227,137,1134,6,1140
"فارس","فسا","ششده_و_قره_بلاغ",2,568,0,176,128,872,5,877
"فارس","فسا","ششده_و_قره_بلاغ",3,413,0,221,90,724,2,726
"فارس","فسا","ششده_و_قره_بلاغ",4,540,0,133,85,758,5,763
"فارس","فسا","ششده_و_قره_بلاغ",5,196,2,1,20,219,0,219
"فارس","فسا","ششده_و_قره_بلاغ",6,464,1,80,52,597,3,600
"فارس","فسا","ششده_و_قره_بلاغ",7,752,3,3,122,880,7,887
"فارس","فسا","ششده_و_قره_بلاغ",8,487,0,2,74,563,0,563
"فارس","فسا","ششده_و_قره_بلاغ",9,897,8,0,87,992,7,999
"فارس","فسا","ششده_و_قره_بلاغ",10,907,4,8,89,1008,3,1011
"فارس","فسا","ششده_و_قره_بلاغ",11,738,1,0,38,777,1,778
"فارس","فسا","ششده_و_قره_بلاغ",12,571,1,12,46,630,0,630
"فارس","فسا","ششده_و_قره_بلاغ",13,591,4,2,90,687,6,693
"فارس","فسا","ششده_و_قره_بلاغ",14,360,5,6,127,498,2,500
"فارس","فسا","ششده_و_قره_بلاغ",15,758,4,9,90,861,3,864
"فارس","فسا","ششده_و_قره_بلاغ",16,884,0,4,60,948,5,953
"فارس","فسا","ششده_و_قره_بلاغ",17,810,2,2,157,971,3,974
"فارس","فسا","ششده_و_قره_بلاغ",18,881,4,4,135,1024,6,1030
"فارس","فسا","ششده_و_قره_بلاغ",19,510,5,0,60,575,2,577
"فارس","فسا","ششده_و_قره_بلاغ",20,1221,5,13,81,1320,2,1322
"فارس","فسا","ششده_و_قره_بلاغ",21,692,2,3,176,873,4,877
"فارس","فسا","ششده_و_قره_بلاغ",22,873,4,11,173,1061,2,1063
"فارس","فسا","ششده_و_قره_بلاغ",23,582,3,3,92,680,4,684
"فارس","فسا","ششده_و_قره_بلاغ",24,412,1,8,53,474,1,475
"فارس","فسا","ششده_و_قره_بلاغ",25,615,2,25,62,704,7,711
"فارس","فسا","ششده_و_قره_بلاغ",26,544,0,16,70,630,0,630
"فارس","فسا","شیبکوه",1,848,6,5,273,1132,15,1147
"فارس","فسا","شیبکوه",2,917,8,11,223,1159,9,1168
"فارس","فسا","شیبکوه",3,846,8,16,411,1281,9,1290
"فارس","فسا","شیبکوه",4,427,4,9,272,712,11,723
"فارس","فسا","شیبکوه",5,528,5,4,189,726,7,733
"فارس","فسا","شیبکوه",6,560,2,10,308,880,20,900
"فارس","فسا","شیبکوه",7,106,0,0,40,146,1,147
"فارس","فسا","شیبکوه",8,976,4,4,198,1182,10,1192
"فارس","فسا","شیبکوه",9,997,12,12,144,1165,10,1175
"فارس","فسا","شیبکوه",10,1167,9,3,145,1324,10,1334
"فارس","فسا","شیبکوه",11,1252,5,3,195,1455,9,1464
"فارس","فسا","شیبکوه",12,756,4,8,145,913,11,924
"فارس","فسا","شیبکوه",13,498,4,0,95,597,3,600
"فارس","فسا","شیبکوه",14,194,2,3,45,244,2,246
"فارس","فسا","شیبکوه",15,979,6,25,217,1227,3,1230
"فارس","فسا","شیبکوه",16,296,0,0,77,373,1,374
"فارس","فسا","شیبکوه",17,1048,3,0,40,1091,4,1095
"فارس","فسا","شیبکوه",18,198,2,1,175,376,4,380
"فارس","فسا","شیبکوه",19,819,2,2,75,898,2,900
"فارس","فسا","شیبکوه",20,94,0,0,13,107,0,107
"فارس","فسا","شیبکوه",21,931,2,0,73,1006,4,1010
"فارس","فسا","نوبندگان",1,843,8,4,208,1063,8,1071
"فارس","فسا","نوبندگان",2,762,2,3,142,909,4,913
"فارس","فسا","نوبندگان",3,797,7,4,78,886,6,892
"فارس","فسا","نوبندگان",4,651,4,3,72,730,2,732
"فارس","فسا","نوبندگان",5,483,0,0,63,546,3,549
"فارس","فسا","نوبندگان",6,364,2,1,32,399,2,401
"فارس","فسا","نوبندگان",7,750,3,1,64,818,3,821
"فارس","فسا","نوبندگان",8,284,7,1,52,344,2,346
"فارس","فسا","نوبندگان",9,313,2,0,64,379,3,382
"فارس","فسا","نوبندگان",10,97,1,0,16,114,1,115
"فارس","فسا","نوبندگان",11,422,4,0,66,492,6,498
"فارس","فسا","نوبندگان",12,259,0,0,9,268,1,269
"فارس","فسا","نوبندگان",13,551,0,1,59,611,2,613
"فارس","فسا","نوبندگان",14,188,1,0,23,212,1,213
"فارس","فیروز_آباد","مرکزی",1,811,11,2,529,1353,14,1367
"فارس","فیروز_آباد","مرکزی",2,835,9,4,258,1106,10,1116
"فارس","فیروز_آباد","مرکزی",3,479,9,6,206,700,8,708
"فارس","فیروز_آباد","مرکزی",4,393,7,1,156,557,6,563
"فارس","فیروز_آباد","مرکزی",5,426,7,1,273,707,7,714
"فارس","فیروز_آباد","مرکزی",6,1048,14,3,306,1371,14,1385
"فارس","فیروز_آباد","مرکزی",7,907,5,2,452,1366,14,1380
"فارس","فیروز_آباد","مرکزی",8,905,5,5,160,1075,6,1081
"فارس","فیروز_آباد","مرکزی",9,1008,2,0,256,1266,10,1276
"فارس","فیروز_آباد","مرکزی",10,372,2,2,102,478,8,486
"فارس","فیروز_آباد","مرکزی",11,486,2,2,211,701,8,709
"فارس","فیروز_آباد","مرکزی",12,703,11,0,318,1032,17,1049
"فارس","فیروز_آباد","مرکزی",13,953,14,2,285,1254,9,1263
"فارس","فیروز_آباد","مرکزی",14,432,5,0,112,549,1,550
"فارس","فیروز_آباد","مرکزی",15,178,2,0,26,206,0,206
"فارس","فیروز_آباد","مرکزی",16,464,7,0,300,771,8,779
"فارس","فیروز_آباد","مرکزی",17,941,16,5,534,1496,12,1508
"فارس","فیروز_آباد","مرکزی",18,431,8,3,294,736,7,743
"فارس","فیروز_آباد","مرکزی",19,281,13,0,348,642,7,649
"فارس","فیروز_آباد","مرکزی",20,653,2,1,395,1051,2,1053
"فارس","فیروز_آباد","مرکزی",21,716,9,1,249,975,5,980
"فارس","فیروز_آباد","مرکزی",22,562,4,0,211,777,6,783
"فارس","فیروز_آباد","مرکزی",23,712,14,0,307,1033,11,1044
"فارس","فیروز_آباد","مرکزی",24,701,8,4,317,1030,9,1039
"فارس","فیروز_آباد","مرکزی",25,1172,6,2,257,1437,6,1443
"فارس","فیروز_آباد","مرکزی",26,912,12,3,378,1305,11,1316
"فارس","فیروز_آباد","مرکزی",27,595,8,1,346,950,14,964
"فارس","فیروز_آباد","مرکزی",28,707,1,1,165,874,10,884
"فارس","فیروز_آباد","مرکزی",29,679,9,3,248,939,15,954
"فارس","فیروز_آباد","مرکزی",30,334,0,0,24,358,1,359
"فارس","فیروز_آباد","مرکزی",31,660,2,0,106,768,4,772
"فارس","فیروز_آباد","مرکزی",32,633,5,1,143,782,10,792
"فارس","فیروز_آباد","مرکزی",33,595,6,2,252,855,15,870
"فارس","فیروز_آباد","مرکزی",34,547,10,0,196,753,15,768
"فارس","فیروز_آباد","مرکزی",35,765,10,1,269,1045,11,1056
"فارس","فیروز_آباد","مرکزی",36,752,2,3,232,989,4,993
"فارس","فیروز_آباد","مرکزی",37,1018,6,1,195,1220,5,1225
"فارس","فیروز_آباد","مرکزی",38,427,1,1,148,577,6,583
"فارس","فیروز_آباد","مرکزی",39,716,7,2,504,1229,9,1238
"فارس","فیروز_آباد","مرکزی",40,465,9,0,206,680,5,685
"فارس","فیروز_آباد","مرکزی",41,458,0,0,206,664,5,669
"فارس","فیروز_آباد","مرکزی",42,546,8,0,202,756,5,761
"فارس","فیروز_آباد","مرکزی",43,61,1,0,28,90,0,90
"فارس","فیروز_آباد","مرکزی",44,422,4,0,73,499,0,499
"فارس","فیروز_آباد","مرکزی",45,339,2,0,67,408,7,415
"فارس","فیروز_آباد","مرکزی",46,817,3,4,212,1036,12,1048
"فارس","فیروز_آباد","مرکزی",47,769,3,0,205,977,0,977
"فارس","فیروز_آباد","مرکزی",48,481,2,1,118,602,6,608
"فارس","فیروز_آباد","مرکزی",49,303,2,0,114,419,0,419
"فارس","فیروز_آباد","مرکزی",50,635,2,1,56,694,2,696
"فارس","فیروز_آباد","مرکزی",51,247,0,4,45,296,2,298
"فارس","فیروز_آباد","مرکزی",52,377,0,0,13,390,0,390
"فارس","فیروز_آباد","مرکزی",53,943,1,0,18,962,1,963
"فارس","فیروز_آباد","مرکزی",54,747,2,0,28,777,7,784
"فارس","فیروز_آباد","مرکزی",55,178,4,0,102,284,0,284
"فارس","فیروز_آباد","مرکزی",56,226,0,0,23,249,0,249
"فارس","فیروز_آباد","مرکزی",57,176,0,0,34,210,1,211
"فارس","فیروز_آباد","مرکزی",58,657,2,0,41,700,1,701
"فارس","فیروز_آباد","مرکزی",59,633,2,0,101,736,2,738
"فارس","فیروز_آباد","مرکزی",60,212,1,0,46,259,1,260
"فارس","فیروز_آباد","مرکزی",61,694,3,1,196,894,16,910
"فارس","فیروز_آباد","مرکزی",62,552,2,0,49,603,2,605
"فارس","فیروز_آباد","مرکزی",63,487,1,0,22,510,0,510
"فارس","فیروز_آباد","مرکزی",64,783,4,0,14,801,3,804
"فارس","فیروز_آباد","مرکزی",65,771,3,0,125,899,6,905
"فارس","فیروز_آباد","مرکزی",66,112,1,0,13,126,1,127
"فارس","فیروز_آباد","مرکزی",67,460,0,0,86,546,0,546
"فارس","فیروز_آباد","مرکزی",68,359,3,0,19,381,0,381
"فارس","فیروز_آباد","مرکزی",69,559,4,2,163,728,1,729
"فارس","فیروز_آباد","مرکزی",70,662,3,5,83,753,11,764
"فارس","فیروز_آباد","مرکزی",71,491,3,1,94,589,4,593
"فارس","فیروز_آباد","مرکزی",72,522,5,0,57,584,1,585
"فارس","فیروز_آباد","مرکزی",73,492,1,0,30,523,2,525
"فارس","فیروز_آباد","مرکزی",74,374,0,1,57,432,4,436
"فارس","فیروز_آباد","مرکزی",75,396,0,0,38,434,0,434
"فارس","فیروز_آباد","میمند",1,394,4,0,95,493,6,499
"فارس","فیروز_آباد","میمند",2,746,6,1,241,994,5,999
"فارس","فیروز_آباد","میمند",3,476,2,1,122,601,4,605
"فارس","فیروز_آباد","میمند",4,1008,2,2,178,1190,10,1200
"فارس","فیروز_آباد","میمند",5,263,1,0,44,308,2,310
"فارس","فیروز_آباد","میمند",6,550,0,0,47,597,2,599
"فارس","فیروز_آباد","میمند",7,485,0,0,30,515,5,520
"فارس","فیروز_آباد","میمند",8,449,2,1,13,465,3,468
"فارس","فیروز_آباد","میمند",9,460,6,0,42,508,2,510
"فارس","فیروز_آباد","میمند",10,684,2,0,7,693,2,695
"فارس","فیروز_آباد","میمند",11,778,0,0,5,783,0,783
"فارس","فیروز_آباد","میمند",12,460,0,0,9,469,5,474
"فارس","فیروز_آباد","میمند",13,507,1,0,4,512,1,513
"فارس","فیروز_آباد","میمند",14,694,2,0,8,704,3,707
"فارس","فیروز_آباد","میمند",15,440,0,0,7,447,0,447
"فارس","فیروز_آباد","میمند",16,440,0,1,25,466,1,467
"فارس","فیروز_آباد","میمند",17,552,6,1,24,583,0,583
"فارس","فیروز_آباد","میمند",18,483,1,0,36,520,0,520
"فارس","فیروز_آباد","میمند",19,243,0,0,18,261,0,261
"فارس","فیروز_آباد","میمند",20,365,0,0,16,381,1,382
"فارس","فیروز_آباد","میمند",21,837,4,1,51,893,0,893
"فارس","فیروز_آباد","میمند",22,731,4,7,134,876,0,876
"فارس","فیروز_آباد","میمند",23,641,6,0,63,710,1,711
"فارس","فیروز_آباد","میمند",24,581,4,0,72,657,1,658
"فارس","فیروز_آباد","میمند",25,577,1,0,25,603,0,603
"فارس","فیروز_آباد","میمند",26,446,0,0,77,523,1,524
"فارس","فیروز_آباد","میمند",27,364,7,0,45,416,0,416
"فارس","فیروز_آباد","میمند",28,229,4,0,49,282,0,282
"فارس","فیروز_آباد","میمند",29,204,0,0,7,211,1,212
"فارس","فیروز_آباد","میمند",30,146,1,0,40,187,1,188
"فارس","قیروکارزین","مرکزی",1,600,5,4,424,1033,13,1046
"فارس","قیروکارزین","مرکزی",2,389,3,0,222,614,7,621
"فارس","قیروکارزین","مرکزی",3,376,4,2,261,643,6,649
"فارس","قیروکارزین","مرکزی",4,249,3,1,183,436,3,439
"فارس","قیروکارزین","مرکزی",5,591,5,1,385,982,13,995
"فارس","قیروکارزین","مرکزی",6,847,4,1,331,1183,1,1184
"فارس","قیروکارزین","مرکزی",7,353,0,16,384,753,6,759
"فارس","قیروکارزین","مرکزی",8,616,4,2,321,943,6,949
"فارس","قیروکارزین","مرکزی",9,373,0,2,101,476,1,477
"فارس","قیروکارزین","مرکزی",10,447,5,3,141,596,7,603
"فارس","قیروکارزین","مرکزی",11,704,6,3,115,828,4,832
"فارس","قیروکارزین","مرکزی",12,410,2,2,178,592,8,600
"فارس","قیروکارزین","مرکزی",13,232,2,0,121,355,1,356
"فارس","قیروکارزین","مرکزی",14,391,3,6,202,602,8,610
"فارس","قیروکارزین","مرکزی",15,804,13,1,205,1023,5,1028
"فارس","قیروکارزین","مرکزی",16,487,7,2,128,624,4,628
"فارس","قیروکارزین","مرکزی",17,841,1,1,148,991,4,995
"فارس","قیروکارزین","مرکزی",18,707,4,1,86,798,2,800
"فارس","قیروکارزین","مرکزی",19,456,7,0,78,541,1,542
"فارس","قیروکارزین","مرکزی",20,469,2,1,92,564,2,566
"فارس","قیروکارزین","مرکزی",21,192,1,0,31,224,1,225
"فارس","قیروکارزین","مرکزی",22,545,4,1,109,659,7,666
"فارس","قیروکارزین","مرکزی",23,795,2,3,119,919,5,924
"فارس","قیروکارزین","مرکزی",24,709,3,0,133,845,4,849
"فارس","قیروکارزین","مرکزی",25,321,2,3,59,385,3,388
"فارس","قیروکارزین","مرکزی",26,626,2,2,117,747,9,756
"فارس","قیروکارزین","مرکزی",27,265,0,1,63,329,4,333
"فارس","قیروکارزین","مرکزی",28,126,1,1,40,168,0,168
"فارس","قیروکارزین","مرکزی",29,662,0,3,66,731,4,735
"فارس","قیروکارزین","مرکزی",30,473,1,0,63,537,2,539
"فارس","قیروکارزین","مرکزی",31,118,0,0,77,195,1,196
"فارس","قیروکارزین","مرکزی",32,185,0,0,33,218,0,218
"فارس","قیروکارزین","مرکزی",33,822,2,0,28,852,1,853
"فارس","قیروکارزین","مرکزی",34,648,2,2,17,669,3,672
"فارس","قیروکارزین","مرکزی",35,341,0,0,66,407,0,407
"فارس","قیروکارزین","مرکزی",36,769,3,0,110,882,2,884
"فارس","قیروکارزین","مرکزی",37,1018,2,0,137,1157,5,1162
"فارس","قیروکارزین","مرکزی",38,663,0,1,159,823,4,827
"فارس","قیروکارزین","مرکزی",39,156,1,0,27,184,0,184
"فارس","قیروکارزین","مرکزی",40,626,0,0,45,671,1,672
"فارس","قیروکارزین","مرکزی",41,372,1,0,35,408,0,408
"فارس","قیروکارزین","مرکزی",42,815,0,8,86,909,2,911
"فارس","قیروکارزین","مرکزی",43,382,0,0,45,427,1,428
"فارس","قیروکارزین","مرکزی",44,486,0,0,52,538,1,539
"فارس","قیروکارزین","مرکزی",45,484,3,0,84,571,2,573
"فارس","قیروکارزین","مرکزی",46,484,0,0,55,539,1,540
"فارس","قیروکارزین","مرکزی",47,154,1,0,49,204,0,204
"فارس","قیروکارزین","مرکزی",48,217,0,0,32,249,0,249
"فارس","قیروکارزین","مرکزی",49,385,0,0,34,419,0,419
"فارس","قیروکارزین","افزر",1,262,0,0,113,375,4,379
"فارس","قیروکارزین","افزر",2,792,4,0,190,986,8,994
"فارس","قیروکارزین","افزر",3,574,0,1,163,738,0,738
"فارس","قیروکارزین","افزر",4,262,3,0,72,337,6,343
"فارس","قیروکارزین","افزر",5,527,0,0,52,579,6,585
"فارس","قیروکارزین","افزر",6,329,3,0,45,377,1,378
"فارس","قیروکارزین","افزر",7,645,0,0,63,708,0,708
"فارس","قیروکارزین","افزر",8,606,0,0,81,687,2,689
"فارس","قیروکارزین","افزر",9,498,0,0,69,567,0,567
"فارس","قیروکارزین","افزر",10,134,0,0,46,180,0,180
"فارس","قیروکارزین","افزر",11,119,0,0,44,163,1,164
"فارس","قیروکارزین","افزر",12,595,0,0,6,601,0,601
"فارس","قیروکارزین","افزر",13,473,2,0,113,588,0,588
"فارس","قیروکارزین","افزر",14,210,0,2,9,221,0,221
"فارس","قیروکارزین","افزر",15,461,1,0,84,546,3,549
"فارس","قیروکارزین","افزر",16,345,3,2,37,387,1,388
"فارس","کازرون","مرکزی",1,520,11,4,474,1009,19,1028
"فارس","کازرون","مرکزی",2,675,46,8,184,913,19,932
"فارس","کازرون","مرکزی",3,207,5,0,106,318,3,321
"فارس","کازرون","مرکزی",4,928,15,13,582,1538,11,1549
"فارس","کازرون","مرکزی",5,834,15,4,514,1367,17,1384
"فارس","کازرون","مرکزی",6,734,13,8,497,1252,12,1264
"فارس","کازرون","مرکزی",7,506,13,5,466,990,16,1006
"فارس","کازرون","مرکزی",8,592,13,5,603,1213,21,1234
"فارس","کازرون","مرکزی",9,892,18,11,575,1496,11,1507
"فارس","کازرون","مرکزی",10,585,5,1,212,803,14,817
"فارس","کازرون","مرکزی",11,557,4,0,216,777,9,786
"فارس","کازرون","مرکزی",12,948,6,4,376,1334,18,1352
"فارس","کازرون","مرکزی",13,813,5,3,315,1136,18,1154
"فارس","کازرون","مرکزی",14,1011,17,4,484,1516,13,1529
"فارس","کازرون","مرکزی",15,990,6,4,582,1582,18,1600
"فارس","کازرون","مرکزی",16,618,12,10,530,1170,25,1195
"فارس","کازرون","مرکزی",17,625,13,2,384,1024,13,1037
"فارس","کازرون","مرکزی",18,998,11,13,716,1738,21,1759
"فارس","کازرون","مرکزی",19,874,9,3,437,1323,24,1347
"فارس","کازرون","مرکزی",20,1009,19,1,343,1372,28,1400
"فارس","کازرون","مرکزی",21,387,5,4,283,679,8,687
"فارس","کازرون","مرکزی",22,599,7,5,432,1043,21,1064
"فارس","کازرون","مرکزی",23,825,15,5,516,1361,20,1381
"فارس","کازرون","مرکزی",24,757,8,2,247,1014,18,1032
"فارس","کازرون","مرکزی",25,1007,5,5,467,1484,23,1507
"فارس","کازرون","مرکزی",26,363,11,0,258,632,10,642
"فارس","کازرون","مرکزی",27,455,12,2,252,721,11,732
"فارس","کازرون","مرکزی",28,720,4,13,343,1080,12,1092
"فارس","کازرون","مرکزی",29,400,9,3,283,695,19,714
"فارس","کازرون","مرکزی",30,620,12,3,217,852,8,860
"فارس","کازرون","مرکزی",31,937,7,5,445,1394,12,1406
"فارس","کازرون","مرکزی",32,968,15,5,369,1357,20,1377
"فارس","کازرون","مرکزی",33,811,8,5,315,1139,7,1146
"فارس","کازرون","مرکزی",34,606,12,18,423,1059,15,1074
"فارس","کازرون","مرکزی",35,596,9,14,455,1074,22,1096
"فارس","کازرون","مرکزی",36,361,12,5,237,615,10,625
"فارس","کازرون","مرکزی",37,768,17,8,546,1339,15,1354
"فارس","کازرون","مرکزی",38,965,17,4,480,1466,18,1484
"فارس","کازرون","مرکزی",39,1062,8,3,255,1328,9,1337
"فارس","کازرون","مرکزی",40,662,12,1,215,890,14,904
"فارس","کازرون","مرکزی",41,701,4,1,183,889,8,897
"فارس","کازرون","مرکزی",42,1396,6,3,149,1554,11,1565
"فارس","کازرون","مرکزی",43,804,0,2,33,839,4,843
"فارس","کازرون","مرکزی",44,1221,2,0,97,1320,5,1325
"فارس","کازرون","مرکزی",45,215,0,0,9,224,1,225
"فارس","کازرون","مرکزی",46,633,1,3,103,740,6,746
"فارس","کازرون","مرکزی",47,662,1,0,52,715,7,722
"فارس","کازرون","مرکزی",48,426,8,1,66,501,3,504
"فارس","کازرون","مرکزی",49,359,0,0,29,388,1,389
"فارس","کازرون","مرکزی",50,475,0,0,43,518,3,521
"فارس","کازرون","مرکزی",51,396,1,1,45,443,2,445
"فارس","کازرون","مرکزی",52,677,4,6,83,770,8,778
"فارس","کازرون","مرکزی",53,1075,3,1,156,1235,10,1245
"فارس","کازرون","مرکزی",54,750,1,0,95,846,3,849
"فارس","کازرون","مرکزی",55,469,3,3,127,602,7,609
"فارس","کازرون","مرکزی",56,300,2,1,82,385,1,386
"فارس","کازرون","مرکزی",57,454,2,0,112,568,4,572
"فارس","کازرون","مرکزی",58,261,0,1,76,338,1,339
"فارس","کازرون","مرکزی",59,652,4,2,194,852,6,858
"فارس","کازرون","مرکزی",60,856,3,4,172,1035,2,1037
"فارس","کازرون","مرکزی",61,553,3,8,100,664,1,665
"فارس","کازرون","مرکزی",62,741,3,0,115,859,4,863
"فارس","کازرون","مرکزی",63,738,2,0,120,860,2,862
"فارس","کازرون","مرکزی",64,382,1,0,150,533,2,535
"فارس","کازرون","مرکزی",65,491,0,0,80,571,2,573
"فارس","کازرون","مرکزی",66,722,1,1,83,807,4,811
"فارس","کازرون","مرکزی",67,668,2,3,126,799,0,799
"فارس","کازرون","مرکزی",68,674,1,2,243,920,7,927
"فارس","کازرون","مرکزی",69,596,1,1,224,822,2,824
"فارس","کازرون","مرکزی",70,823,3,0,159,985,4,989
"فارس","کازرون","جره_و_بالاده",1,737,3,2,475,1217,4,1221
"فارس","کازرون","جره_و_بالاده",2,499,6,3,402,910,3,913
"فارس","کازرون","جره_و_بالاده",3,243,2,1,228,474,2,476
"فارس","کازرون","جره_و_بالاده",4,565,5,0,245,815,10,825
"فارس","کازرون","جره_و_بالاده",5,449,0,0,171,620,0,620
"فارس","کازرون","جره_و_بالاده",6,674,1,0,143,818,0,818
"فارس","کازرون","جره_و_بالاده",7,367,4,1,110,482,0,482
"فارس","کازرون","جره_و_بالاده",8,450,1,1,155,607,1,608
"فارس","کازرون","جره_و_بالاده",9,514,2,0,95,611,3,614
"فارس","کازرون","جره_و_بالاده",10,588,0,2,310,900,0,900
"فارس","کازرون","جره_و_بالاده",11,398,5,2,224,629,3,632
"فارس","کازرون","جره_و_بالاده",12,486,3,0,76,565,0,565
"فارس","کازرون","جره_و_بالاده",13,397,5,1,111,514,2,516
"فارس","کازرون","جره_و_بالاده",14,428,2,2,154,586,3,589
"فارس","کازرون","جره_و_بالاده",15,508,1,0,32,541,2,543
"فارس","کازرون","جره_و_بالاده",16,271,5,10,169,455,2,457
"فارس","کازرون","جره_و_بالاده",17,346,1,0,88,435,4,439
"فارس","کازرون","جره_و_بالاده",18,561,2,0,113,676,7,683
"فارس","کازرون","جره_و_بالاده",19,445,1,0,92,538,0,538
"فارس","کازرون","جره_و_بالاده",20,452,0,0,45,497,0,497
"فارس","کازرون","جره_و_بالاده",21,585,0,0,43,628,4,632
"فارس","کازرون","جره_و_بالاده",22,491,0,0,65,556,0,556
"فارس","کازرون","جره_و_بالاده",23,281,0,0,46,327,0,327
"فارس","کازرون","جره_و_بالاده",24,317,0,0,131,448,0,448
"فارس","کازرون","جره_و_بالاده",25,451,0,0,74,525,1,526
"فارس","کازرون","جره_و_بالاده",26,278,3,0,85,366,1,367
"فارس","کازرون","جره_و_بالاده",27,509,4,1,137,651,4,655
"فارس","کازرون","جره_و_بالاده",28,212,1,0,36,249,2,251
"فارس","کازرون","جره_و_بالاده",29,163,0,0,103,266,2,268
"فارس","کازرون","جره_و_بالاده",30,69,0,0,58,127,0,127
"فارس","کازرون","جره_و_بالاده",31,236,1,0,106,343,1,344
"فارس","کازرون","جره_و_بالاده",32,268,2,0,193,463,2,465
"فارس","کازرون","جره_و_بالاده",33,84,1,0,5,90,0,90
"فارس","کازرون","جره_و_بالاده",34,419,5,1,84,509,1,510
"فارس","کازرون","جره_و_بالاده",35,234,8,1,189,432,2,434
"فارس","کازرون","جره_و_بالاده",36,229,1,0,65,295,0,295
"فارس","کازرون","خشت_و_کمارج",1,554,9,2,259,824,4,828
"فارس","کازرون","خشت_و_کمارج",2,527,6,1,79,613,1,614
"فارس","کازرون","خشت_و_کمارج",3,396,7,1,317,721,8,729
"فارس","کازرون","خشت_و_کمارج",4,400,5,1,162,568,3,571
"فارس","کازرون","خشت_و_کمارج",5,469,3,0,214,686,4,690
"فارس","کازرون","خشت_و_کمارج",6,562,8,0,134,704,4,708
"فارس","کازرون","خشت_و_کمارج",7,1117,13,0,220,1350,7,1357
"فارس","کازرون","خشت_و_کمارج",8,690,7,0,89,786,1,787
"فارس","کازرون","خشت_و_کمارج",9,556,5,3,117,681,5,686
"فارس","کازرون","خشت_و_کمارج",10,755,1,0,128,884,8,892
"فارس","کازرون","خشت_و_کمارج",11,547,1,0,105,653,2,655
"فارس","کازرون","خشت_و_کمارج",12,775,2,0,120,897,5,902
"فارس","کازرون","خشت_و_کمارج",13,862,6,0,99,967,12,979
"فارس","کازرون","خشت_و_کمارج",14,501,4,0,159,664,4,668
"فارس","کازرون","خشت_و_کمارج",15,598,3,2,97,700,2,702
"فارس","کازرون","خشت_و_کمارج",16,837,1,1,170,1009,4,1013
"فارس","کازرون","خشت_و_کمارج",17,733,1,4,95,833,4,837
"فارس","کازرون","خشت_و_کمارج",18,711,4,0,191,906,2,908
"فارس","کازرون","خشت_و_کمارج",19,441,9,3,85,538,3,541
"فارس","کازرون","خشت_و_کمارج",20,422,3,0,50,475,0,475
"فارس","کازرون","خشت_و_کمارج",21,540,1,0,95,636,4,640
"فارس","کازرون","خشت_و_کمارج",22,388,0,0,102,490,3,493
"فارس","کازرون","خشت_و_کمارج",23,579,3,0,121,703,0,703
"فارس","کازرون","خشت_و_کمارج",24,86,2,2,16,106,2,108
"فارس","کازرون","خشت_و_کمارج",25,425,4,0,75,504,2,506
"فارس","کازرون","کوهمره",1,531,4,0,77,612,4,616
"فارس","کازرون","کوهمره",2,633,3,1,90,727,1,728
"فارس","کازرون","کوهمره",3,655,3,0,71,729,1,730
"فارس","کازرون","کوهمره",4,641,3,1,109,754,3,757
"فارس","کازرون","کوهمره",5,361,3,2,104,470,0,470
"فارس","کازرون","کوهمره",6,373,1,0,133,507,1,508
"فارس","کازرون","کوهمره",7,506,3,0,78,587,2,589
"فارس","کازرون","کوهمره",8,286,1,1,94,382,2,384
"فارس","کازرون","کوهمره",9,579,6,0,42,627,2,629
"فارس","کازرون","کوهمره",10,465,0,0,20,485,0,485
"فارس","کازرون","کوهمره",11,349,0,0,4,353,0,353
"فارس","کازرون","کوهمره",12,630,0,0,38,668,3,671
"فارس","کازرون","کوهمره",13,417,1,2,20,440,0,440
"فارس","کازرون","کوهمره",14,339,0,0,122,461,2,463
"فارس","کازرون","کوهمره",15,253,1,0,31,285,0,285
"فارس","کازرون","کوهمره",16,286,1,0,21,308,2,310
"فارس","کازرون","کوهمره",17,430,1,0,68,499,3,502
"فارس","کازرون","کوهمره",18,472,3,0,154,629,5,634
"فارس","کازرون","کوهمره",19,245,1,0,49,295,0,295
"فارس","کازرون","کوهمره",20,291,1,3,81,376,0,376
"فارس","کازرون","چنارشاهیجان",1,804,6,0,280,1090,9,1099
"فارس","کازرون","چنارشاهیجان",2,738,10,4,358,1110,8,1118
"فارس","کازرون","چنارشاهیجان",3,754,6,2,334,1096,7,1103
"فارس","کازرون","چنارشاهیجان",4,499,6,11,392,908,3,911
"فارس","کازرون","چنارشاهیجان",5,691,8,5,411,1115,12,1127
"فارس","کازرون","چنارشاهیجان",6,789,6,2,360,1157,6,1163
"فارس","کازرون","چنارشاهیجان",7,614,6,7,293,920,5,925
"فارس","کازرون","چنارشاهیجان",8,743,13,2,226,984,4,988
"فارس","کازرون","چنارشاهیجان",9,648,7,6,467,1128,3,1131
"فارس","کازرون","چنارشاهیجان",10,627,2,8,153,790,2,792
"فارس","کازرون","چنارشاهیجان",11,719,2,3,283,1007,2,1009
"فارس","کازرون","چنارشاهیجان",12,451,4,2,343,800,4,804
"فارس","کازرون","چنارشاهیجان",13,533,1,3,233,770,3,773
"فارس","کازرون","چنارشاهیجان",14,607,3,0,154,764,1,765
"فارس","کازرون","چنارشاهیجان",15,359,1,4,168,532,2,534
"فارس","کازرون","چنارشاهیجان",16,720,3,0,143,866,4,870
"فارس","کازرون","چنارشاهیجان",17,622,9,0,232,863,2,865
"فارس","کازرون","چنارشاهیجان",18,343,0,0,84,427,0,427
"فارس","کازرون","چنارشاهیجان",19,474,0,1,30,505,2,507
"فارس","کازرون","چنارشاهیجان",20,414,2,0,50,466,2,468
"فارس","کازرون","چنارشاهیجان",21,748,8,4,270,1030,5,1035
"فارس","کازرون","چنارشاهیجان",22,880,4,1,232,1117,9,1126
"فارس","کازرون","چنارشاهیجان",23,790,3,4,237,1034,4,1038
"فارس","کازرون","چنارشاهیجان",24,716,6,0,168,890,3,893
"فارس","کازرون","چنارشاهیجان",25,415,0,1,75,491,3,494
"فارس","کازرون","چنارشاهیجان",26,703,2,1,141,847,6,853
"فارس","کازرون","چنارشاهیجان",27,364,0,0,63,427,2,429
"فارس","کازرون","چنارشاهیجان",28,361,3,3,156,523,6,529
"فارس","لارستان","شهر_لار",1,682,13,4,243,942,11,953
"فارس","لارستان","شهر_لار",2,878,19,13,434,1344,14,1358
"فارس","لارستان","شهر_لار",3,803,18,13,301,1135,13,1148
"فارس","لارستان","شهر_لار",4,1325,28,21,522,1896,22,1918
"فارس","لارستان","شهر_لار",5,1510,10,6,259,1785,16,1801
"فارس","لارستان","شهر_لار",6,871,9,11,253,1144,2,1146
"فارس","لارستان","شهر_لار",7,1408,5,16,365,1794,10,1804
"فارس","لارستان","شهر_لار",8,1006,11,11,249,1277,15,1292
"فارس","لارستان","شهر_لار",9,458,13,1,139,611,4,615
"فارس","لارستان","شهر_لار",10,667,17,22,364,1070,21,1091
"فارس","لارستان","شهر_لار",11,466,6,14,188,674,9,683
"فارس","لارستان","شهر_لار",12,378,9,1,220,608,8,616
"فارس","لارستان","شهر_لار",13,238,7,2,89,336,8,344
"فارس","لارستان","شهر_لار",14,799,41,3,622,1465,21,1486
"فارس","لارستان","شهر_لار",15,728,43,13,714,1498,23,1521
"فارس","لارستان","شهر_لار",16,1040,36,6,763,1845,28,1873
"فارس","لارستان","شهر_لار",17,787,4,18,430,1239,11,1250
"فارس","لارستان","شهر_لار",18,711,49,16,655,1431,17,1448
"فارس","لارستان","شهر_لار",19,1097,34,15,657,1803,27,1830
"فارس","لارستان","شهر_لار",20,971,25,6,711,1713,29,1742
"فارس","لارستان","شهر_لار",21,226,7,0,156,389,5,394
"فارس","لارستان","شهر_لار",22,317,21,3,248,589,12,601
"فارس","لارستان","شهر_لار",23,207,6,1,95,309,10,319
"فارس","لارستان","شهر_لار",24,781,38,21,686,1526,23,1549
"فارس","لارستان","شهر_لار",25,610,18,6,647,1281,18,1299
"فارس","لارستان","شهر_لار",26,400,16,5,289,710,11,721
"فارس","لارستان","بخش_مرکزی",27,268,8,9,836,1121,9,1130
"فارس","لارستان","شهر_لار",28,147,2,5,532,686,6,692
"فارس","لارستان","شهر_لار",29,644,14,6,268,932,17,949
"فارس","لارستان","شهر_لار",30,96,2,9,493,600,5,605
"فارس","لارستان","شهر_لار",31,791,22,5,615,1433,14,1447
"فارس","لارستان","شهر_لار",32,1362,16,8,292,1678,8,1686
"فارس","لارستان","شهر_لار",33,509,11,0,113,633,10,643
"فارس","لارستان","شهر_لار",34,873,10,0,106,989,4,993
"فارس","لارستان","شهر_لار",35,554,3,7,233,797,2,799
"فارس","لارستان","شهر_لار",36,600,4,5,565,1174,7,1181
"فارس","لارستان","شهر_لار",37,198,1,3,497,699,6,705
"فارس","لارستان","شهر_لار",38,281,6,2,41,330,8,338
"فارس","لارستان","شهر_لار",39,1339,8,0,313,1660,20,1680
"فارس","لارستان","شهر_لار",40,947,8,1,303,1259,7,1266
"فارس","لارستان","شهر_لار",41,558,7,3,202,770,1,771
"فارس","لارستان","شهر_لار",42,876,8,8,103,995,3,998
"فارس","لارستان","شهر_لار",43,657,7,9,46,719,3,722
"فارس","لارستان","شهر_لار",44,553,2,2,63,620,3,623
"فارس","لارستان","شهر_لار",45,604,5,1,65,675,2,677
"فارس","لارستان","شهر_لار",46,897,6,0,60,963,0,963
"فارس","لارستان","شهر_لار",47,341,2,2,28,373,0,373
"فارس","لارستان","شهر_لار",48,104,0,0,24,128,0,128
"فارس","لارستان","بخش_گراش",1,993,6,8,184,1191,5,1196
"فارس","لارستان","بخش_گراش",2,1194,11,33,195,1433,5,1438
"فارس","لارستان","بخش_گراش",3,1393,19,8,157,1577,8,1585
"فارس","لارستان","بخش_گراش",4,947,7,4,150,1108,6,1114
"فارس","لارستان","بخش_گراش",5,756,6,11,110,883,5,888
"فارس","لارستان","بخش_گراش",6,366,5,28,113,512,1,513
"فارس","لارستان","بخش_گراش",7,860,8,11,193,1072,6,1078
"فارس","لارستان","بخش_گراش",8,1282,13,20,248,1563,20,1583
"فارس","لارستان","بخش_گراش",9,803,1,4,125,933,5,938
"فارس","لارستان","بخش_گراش",10,306,6,3,55,370,3,373
"فارس","لارستان","بخش_گراش",11,548,2,2,91,643,0,643
"فارس","لارستان","بخش_گراش",12,714,3,5,86,808,2,810
"فارس","لارستان","بخش_گراش",13,852,12,0,134,998,3,1001
"فارس","لارستان","بخش_گراش",14,549,8,4,75,636,4,640
"فارس","لارستان","بخش_گراش",15,244,3,3,48,298,1,299
"فارس","لارستان","بخش_گراش",16,260,0,0,22,282,0,282
"فارس","لارستان","بخش_گراش",17,357,0,0,11,368,1,369
"فارس","لارستان","بخش_گراش",18,948,3,6,99,1056,4,1060
"فارس","لارستان","بخش_گراش",19,684,1,0,40,725,2,727
"فارس","لارستان","بخش_گراش",20,700,5,0,52,757,5,762
"فارس","لارستان","بخش_گراش",21,70,0,0,112,182,0,182
"فارس","لارستان","بخش_گراش",22,597,16,2,47,662,0,662
"فارس","لارستان","بخش_گراش",23,664,3,1,69,737,0,737
"فارس","لارستان","بخش_گراش",24,406,2,0,2,410,0,410
"فارس","لارستان","بخش_گراش",25,543,3,2,18,566,0,566
"فارس","لارستان","بخش_گراش",26,659,1,0,60,720,0,720
"فارس","لارستان","بخش_گراش",27,216,0,0,22,238,1,239
"فارس","لارستان","بخش_بنارویه",1,804,5,1,206,1016,10,1026
"فارس","لارستان","بخش_بنارویه",2,766,2,10,165,943,4,947
"فارس","لارستان","بخش_بنارویه",3,738,1,2,172,913,6,919
"فارس","لارستان","بخش_بنارویه",4,604,3,3,112,722,1,723
"فارس","لارستان","بخش_بنارویه",5,676,2,0,152,830,3,833
"فارس","لارستان","بخش_بنارویه",6,1148,16,5,186,1355,9,1364
"فارس","لارستان","بخش_بنارویه",7,103,0,0,32,135,1,136
"فارس","لارستان","بخش_بنارویه",8,123,0,7,16,146,0,146
"فارس","لارستان","بخش_بنارویه",9,483,0,0,44,527,2,529
"فارس","لارستان","بخش_بنارویه",10,90,1,1,76,168,0,168
"فارس","لارستان","بخش_بنارویه",11,621,8,2,101,732,3,735
"فارس","لارستان","بخش_بنارویه",12,227,3,3,487,720,4,724
"فارس","لارستان","بخش_بنارویه",13,364,0,2,103,469,2,471
"فارس","لارستان","بخش_صحرای_باغ",1,276,3,1,597,877,6,883
"فارس","لارستان","بخش_صحرای_باغ",2,557,5,7,76,645,4,649
"فارس","لارستان","بخش_صحرای_باغ",3,122,3,21,369,515,6,521
"فارس","لارستان","بخش_صحرای_باغ",4,120,0,1,482,603,1,604
"فارس","لارستان","بخش_صحرای_باغ",5,444,0,0,64,508,2,510
"فارس","لارستان","بخش_صحرای_باغ",6,538,3,0,92,633,1,634
"فارس","لارستان","بخش_صحرای_باغ",7,286,3,3,598,890,4,894
"فارس","لارستان","بخش_صحرای_باغ",8,315,6,10,351,682,6,688
"فارس","لارستان","بخش_اوز",1,442,12,12,1218,1684,15,1699
"فارس","لارستان","بخش_اوز",2,400,16,9,792,1217,14,1231
"فارس","لارستان","بخش_اوز",3,211,9,9,691,920,7,927
"فارس","لارستان","بخش_اوز",4,308,8,12,736,1064,16,1080
"فارس","لارستان","بخش_اوز",5,105,2,6,548,661,10,671
"فارس","لارستان","بخش_اوز",6,292,0,2,222,516,9,525
"فارس","لارستان","بخش_اوز",7,347,5,9,558,919,6,925
"فارس","لارستان","بخش_اوز",8,243,3,3,334,583,4,587
"فارس","لارستان","بخش_اوز",9,341,2,4,629,976,8,984
"فارس","لارستان","بخش_اوز",10,274,5,2,727,1008,6,1014
"فارس","لارستان","بخش_اوز",11,21,0,0,199,220,0,220
"فارس","لارستان","بخش_اوز",12,158,2,2,406,568,2,570
"فارس","لارستان","بخش_اوز",13,206,2,13,387,608,4,612
"فارس","لارستان","بخش_اوز",14,67,2,3,282,354,4,358
"فارس","لارستان","بخش_اوز",15,80,1,1,68,150,0,150
"فارس","لارستان","بخش_اوز",16,360,3,2,525,890,13,903
"فارس","لارستان","بخش_اوز",17,363,3,3,521,890,7,897
"فارس","لارستان","بخش_اوز",18,103,2,3,216,324,2,326
"فارس","لارستان","بخش_جویم",1,941,2,6,291,1240,13,1253
"فارس","لارستان","بخش_جویم",2,463,0,0,157,620,6,626
"فارس","لارستان","بخش_جویم",3,633,3,3,141,780,12,792
"فارس","لارستان","بخش_جویم",4,319,8,0,147,474,4,478
"فارس","لارستان","بخش_جویم",5,409,1,1,93,504,4,508
"فارس","لارستان","بخش_جویم",6,1231,1,1,72,1305,2,1307
"فارس","لارستان","بخش_جویم",7,169,4,17,931,1121,3,1124
"فارس","لارستان","بخش_جویم",8,243,7,1,639,890,9,899
"فارس","لارستان","بخش_جویم",9,438,2,0,553,993,0,993
"فارس","لارستان","بخش_جویم",10,244,0,1,209,454,2,456
"فارس","لارستان","بخش_جویم",11,233,1,0,141,375,6,381
"فارس","لارستان","بخش_جویم",12,232,3,0,293,528,0,528
"فارس","لارستان","بخش_جویم",13,57,0,0,5,62,0,62
"فارس","لارستان","بخش_جویم",14,261,1,5,78,345,2,347
"فارس","لارستان","بخش_جویم",15,66,0,0,2,68,0,68
"فارس","لارستان","بخش_جویم",16,497,0,1,27,525,0,525
"فارس","لارستان","بخش_جویم",17,298,0,0,18,316,0,316
"فارس","لارستان","بخش_پیرم",1,724,6,94,171,995,5,1000
"فارس","لارستان","بخش_پیرم",2,530,14,1,204,749,3,752
"فارس","لارستان","بخش_پیرم",3,1063,6,26,205,1300,0,1300
"فارس","لارستان","بخش_پیرم",4,361,2,21,80,464,1,465
"فارس","لارستان","بخش_پیرم",5,365,3,0,137,505,0,505
"فارس","لارستان","بخش_پیرم",6,494,1,0,18,513,0,513
"فارس","لارستان","بخش_پیرم",7,601,1,0,23,625,2,627
"فارس","لارستان","بخش_پیرم",8,763,1,0,13,777,1,778
"فارس","لارستان","بخش_پیرم",9,412,0,2,15,429,0,429
"فارس","لارستان","بخش_پیرم",10,153,3,1,244,401,1,402
"فارس","لارستان","بخش_پیرم",11,440,12,7,72,531,4,535
"فارس","لامرد","مرکزی",1,652,19,6,284,961,7,968
"فارس","لامرد","مرکزی",2,604,28,2,256,890,11,901
"فارس","لامرد","مرکزی",3,654,23,7,266,950,2,952
"فارس","لامرد","مرکزی",4,739,14,10,293,1056,12,1068
"فارس","لامرد","مرکزی",5,692,19,20,441,1172,13,1185
"فارس","لامرد","مرکزی",6,965,23,3,255,1246,7,1253
"فارس","لامرد","مرکزی",7,836,10,3,190,1039,6,1045
"فارس","لامرد","مرکزی",8,775,9,1,158,943,5,948
"فارس","لامرد","مرکزی",9,872,9,3,115,999,5,1004
"فارس","لامرد","مرکزی",10,699,5,7,182,893,3,896
"فارس","لامرد","مرکزی",11,986,16,0,178,1180,4,1184
"فارس","لامرد","مرکزی",12,935,29,5,255,1224,10,1234
"فارس","لامرد","مرکزی",13,563,4,1,75,643,3,646
"فارس","لامرد","مرکزی",14,711,11,0,170,892,6,898
"فارس","لامرد","مرکزی",15,675,4,0,233,912,2,914
"فارس","لامرد","مرکزی",16,657,13,2,480,1152,9,1161
"فارس","لامرد","مرکزی",17,376,10,5,126,517,2,519
"فارس","لامرد","مرکزی",18,931,13,1,231,1176,7,1183
"فارس","لامرد","مرکزی",19,638,10,1,235,884,0,884
"فارس","لامرد","مرکزی",20,936,3,7,116,1062,3,1065
"فارس","لامرد","مرکزی",21,725,9,3,175,912,8,920
"فارس","لامرد","مرکزی",22,543,8,11,156,718,0,718
"فارس","لامرد","مرکزی",23,288,2,2,129,421,4,425
"فارس","لامرد","مرکزی",24,403,0,3,86,492,3,495
"فارس","لامرد","مرکزی",25,811,12,7,247,1077,4,1081
"فارس","لامرد","مرکزی",26,561,10,3,122,696,4,700
"فارس","لامرد","مرکزی",27,312,10,3,66,391,0,391
"فارس","لامرد","مرکزی",28,453,17,2,110,582,1,583
"فارس","لامرد","مرکزی",29,1055,5,2,84,1146,2,1148
"فارس","لامرد","مرکزی",30,515,8,2,135,660,4,664
"فارس","لامرد","مرکزی",31,99,6,3,65,173,3,176
"فارس","لامرد","اشکنان",1,315,0,2,217,534,3,537
"فارس","لامرد","اشکنان",2,435,0,0,14,449,0,449
"فارس","لامرد","اشکنان",3,372,3,6,154,535,0,535
"فارس","لامرد","اشکنان",4,236,5,4,193,438,3,441
"فارس","لامرد","اشکنان",5,452,22,1,125,600,4,604
"فارس","لامرد","اشکنان",6,336,3,4,457,800,0,800
"فارس","لامرد","اشکنان",7,358,2,0,335,695,5,700
"فارس","لامرد","اشکنان",8,453,7,5,331,796,4,800
"فارس","لامرد","اشکنان",9,483,7,4,381,875,6,881
"فارس","لامرد","اشکنان",10,398,8,1,263,670,4,674
"فارس","لامرد","اشکنان",11,607,2,2,483,1094,7,1101
"فارس","لامرد","اشکنان",12,340,5,0,386,731,3,734
"فارس","لامرد","اشکنان",13,207,0,0,16,223,0,223
"فارس","لامرد","اشکنان",14,381,3,4,56,444,1,445
"فارس","لامرد","اشکنان",15,839,5,0,46,890,0,890
"فارس","لامرد","اشکنان",16,449,3,0,38,490,1,491
"فارس","لامرد","اشکنان",17,682,2,0,14,698,1,699
"فارس","لامرد","علامرودشت",1,629,7,0,294,930,6,936
"فارس","لامرد","علامرودشت",2,298,13,0,311,622,4,626
"فارس","لامرد","علامرودشت",3,827,3,0,67,897,0,897
"فارس","لامرد","علامرودشت",4,468,1,1,20,490,0,490
"فارس","لامرد","علامرودشت",5,867,5,4,175,1051,1,1052
"فارس","لامرد","علامرودشت",6,470,0,1,77,548,0,548
"فارس","لامرد","علامرودشت",7,128,1,1,24,154,1,155
"فارس","لامرد","علامرودشت",8,545,0,0,26,571,1,572
"فارس","لامرد","علامرودشت",9,573,1,0,32,606,1,607
"فارس","لامرد","علامرودشت",10,553,11,0,42,606,2,608
"فارس","لامرد","علامرودشت",11,615,0,1,29,645,0,645
"فارس","لامرد","علامرودشت",12,778,2,2,156,938,0,938
"فارس","لامرد","علامرودشت",13,413,6,1,72,492,5,497
"فارس","لامرد","علامرودشت",14,447,10,1,140,598,2,600
"فارس","لامرد","علامرودشت",15,497,1,1,122,621,4,625
"فارس","لامرد","علامرودشت",16,484,3,1,95,583,1,584
"فارس","مرودشت","مرکزی",1,578,5,0,402,985,12,997
"فارس","مرودشت","مرکزی",2,310,6,4,263,583,6,589
"فارس","مرودشت","مرکزی",3,355,11,2,201,569,6,575
"فارس","مرودشت","مرکزی",4,627,10,4,318,959,12,971
"فارس","مرودشت","مرکزی",5,313,7,0,241,561,9,570
"فارس","مرودشت","مرکزی",6,581,7,3,217,808,6,814
"فارس","مرودشت","مرکزی",7,829,15,14,503,1361,12,1373
"فارس","مرودشت","مرکزی",8,404,20,3,244,671,2,673
"فارس","مرودشت","مرکزی",9,385,14,4,272,675,11,686
"فارس","مرودشت","مرکزی",10,491,6,1,156,654,5,659
"فارس","مرودشت","مرکزی",11,820,6,0,250,1076,6,1082
"فارس","مرودشت","مرکزی",12,625,4,0,144,773,8,781
"فارس","مرودشت","مرکزی",13,510,12,5,229,756,6,762
"فارس","مرودشت","مرکزی",14,700,6,2,133,841,11,852
"فارس","مرودشت","مرکزی",15,804,12,7,247,1070,7,1077
"فارس","مرودشت","مرکزی",16,636,5,2,208,851,6,857
"فارس","مرودشت","مرکزی",17,663,4,2,146,815,4,819
"فارس","مرودشت","مرکزی",18,407,2,1,113,523,3,526
"فارس","مرودشت","مرکزی",19,352,5,1,80,438,9,447
"فارس","مرودشت","مرکزی",20,290,10,4,162,466,4,470
"فارس","مرودشت","مرکزی",21,387,11,2,196,596,4,600
"فارس","مرودشت","مرکزی",22,904,9,3,225,1141,14,1155
"فارس","مرودشت","مرکزی",23,605,9,5,381,1000,6,1006
"فارس","مرودشت","مرکزی",24,225,5,6,168,404,3,407
"فارس","مرودشت","مرکزی",25,193,1,0,122,316,5,321
"فارس","مرودشت","مرکزی",26,429,1,3,83,516,7,523
"فارس","مرودشت","مرکزی",27,784,5,2,188,979,6,985
"فارس","مرودشت","مرکزی",28,643,2,1,131,777,5,782
"فارس","مرودشت","مرکزی",29,585,0,3,214,802,4,806
"فارس","مرودشت","مرکزی",30,1077,9,14,343,1443,7,1450
"فارس","مرودشت","مرکزی",31,167,9,2,108,286,2,288
"فارس","مرودشت","مرکزی",32,568,4,7,299,878,1,879
"فارس","مرودشت","مرکزی",33,799,11,5,188,1003,4,1007
"فارس","مرودشت","مرکزی",34,527,26,6,432,991,12,1003
"فارس","مرودشت","مرکزی",35,594,20,8,484,1106,8,1114
"فارس","مرودشت","مرکزی",36,778,4,1,188,971,5,976
"فارس","مرودشت","مرکزی",37,588,9,0,238,835,10,845
"فارس","مرودشت","مرکزی",38,392,3,1,127,523,6,529
"فارس","مرودشت","مرکزی",39,114,0,0,73,187,4,191
"فارس","مرودشت","مرکزی",40,487,2,1,229,719,6,725
"فارس","مرودشت","مرکزی",41,179,7,2,92,280,4,284
"فارس","مرودشت","مرکزی",42,906,7,3,330,1246,11,1257
"فارس","مرودشت","مرکزی",43,498,8,1,121,628,5,633
"فارس","مرودشت","مرکزی",44,174,5,2,67,248,3,251
"فارس","مرودشت","مرکزی",45,600,13,4,328,945,10,955
"فارس","مرودشت","مرکزی",46,342,5,1,209,557,6,563
"فارس","مرودشت","مرکزی",47,215,6,1,130,352,10,362
"فارس","مرودشت","مرکزی",48,829,16,6,531,1382,16,1398
"فارس","مرودشت","مرکزی",49,428,14,6,253,701,12,713
"فارس","مرودشت","مرکزی",50,838,9,1,345,1193,16,1209
"فارس","مرودشت","مرکزی",51,656,5,1,167,829,6,835
"فارس","مرودشت","مرکزی",52,363,3,0,234,600,2,602
"فارس","مرودشت","مرکزی",53,209,4,3,235,451,3,454
"فارس","مرودشت","مرکزی",54,330,4,6,263,603,7,610
"فارس","مرودشت","مرکزی",55,698,6,5,379,1088,10,1098
"فارس","مرودشت","مرکزی",56,478,8,3,323,812,9,821
"فارس","مرودشت","مرکزی",57,291,5,0,136,432,5,437
"فارس","مرودشت","مرکزی",58,710,12,2,320,1044,7,1051
"فارس","مرودشت","مرکزی",59,536,9,2,358,905,8,913
"فارس","مرودشت","مرکزی",60,607,3,2,293,905,8,913
"فارس","مرودشت","مرکزی",61,470,4,1,151,626,5,631
"فارس","مرودشت","مرکزی",62,141,7,1,170,319,3,322
"فارس","مرودشت","مرکزی",63,328,9,4,332,673,5,678
"فارس","مرودشت","مرکزی",64,314,3,5,138,460,3,463
"فارس","مرودشت","مرکزی",65,299,13,5,272,589,8,597
"فارس","مرودشت","مرکزی",66,398,10,2,364,774,10,784
"فارس","مرودشت","مرکزی",67,212,5,2,142,361,4,365
"فارس","مرودشت","مرکزی",68,751,21,5,582,1359,19,1378
"فارس","مرودشت","مرکزی",69,183,5,2,195,385,4,389
"فارس","مرودشت","مرکزی",70,926,15,6,415,1362,12,1374
"فارس","مرودشت","مرکزی",71,665,14,7,472,1158,13,1171
"فارس","مرودشت","مرکزی",72,624,15,6,493,1138,14,1152
"فارس","مرودشت","مرکزی",73,358,18,3,383,762,8,770
"فارس","مرودشت","مرکزی",74,582,33,5,370,990,10,1000
"فارس","مرودشت","مرکزی",75,1076,3,0,162,1241,4,1245
"فارس","مرودشت","مرکزی",76,698,4,8,203,913,13,926
"فارس","مرودشت","مرکزی",77,866,5,4,169,1044,5,1049
"فارس","مرودشت","مرکزی",78,168,2,0,76,246,2,248
"فارس","مرودشت","مرکزی",79,855,1,0,118,974,3,977
"فارس","مرودشت","مرکزی",80,515,3,0,80,598,2,600
"فارس","مرودشت","مرکزی",81,506,16,8,394,924,6,930
"فارس","مرودشت","مرکزی",82,459,14,11,374,858,15,873
"فارس","مرودشت","مرکزی",83,955,17,1,410,1383,16,1399
"فارس","مرودشت","مرکزی",84,452,9,3,218,682,3,685
"فارس","مرودشت","مرکزی",85,642,8,7,485,1142,8,1150
"فارس","مرودشت","مرکزی",86,767,24,4,460,1255,10,1265
"فارس","مرودشت","مرکزی",87,666,21,7,452,1146,19,1165
"فارس","مرودشت","مرکزی",88,371,6,6,223,606,3,609
"فارس","مرودشت","مرکزی",89,736,19,4,295,1054,18,1072
"فارس","مرودشت","مرکزی",90,246,3,1,151,401,4,405
"فارس","مرودشت","مرکزی",91,142,2,2,75,221,4,225
"فارس","مرودشت","مرکزی",92,734,6,10,331,1081,5,1086
"فارس","مرودشت","مرکزی",93,77,3,1,121,202,3,205
"فارس","مرودشت","مرکزی",94,635,1,2,139,777,2,779
"فارس","مرودشت","مرکزی",95,1087,4,2,132,1225,5,1230
"فارس","مرودشت","مرکزی",96,1174,7,3,148,1332,15,1347
"فارس","مرودشت","مرکزی",97,1347,6,4,186,1543,12,1555
"فارس","مرودشت","مرکزی",98,1130,12,5,313,1460,9,1469
"فارس","مرودشت","مرکزی",99,508,11,2,128,649,3,652
"فارس","مرودشت","مرکزی",100,887,1,2,57,947,1,948
"فارس","مرودشت","مرکزی",101,1267,6,1,212,1486,13,1499
"فارس","مرودشت","مرکزی",102,388,4,0,47,439,6,445
"فارس","مرودشت","مرکزی",103,812,4,1,64,881,3,884
"فارس","مرودشت","مرکزی",104,721,1,3,23,748,1,749
"فارس","مرودشت","مرکزی",105,190,1,1,11,203,1,204
"فارس","مرودشت","مرکزی",106,1139,8,0,53,1200,6,1206
"فارس","مرودشت","مرکزی",107,940,4,2,54,1000,1,1001
"فارس","مرودشت","مرکزی",108,444,3,3,156,606,3,609
"فارس","مرودشت","مرکزی",109,793,7,3,304,1107,11,1118
"فارس","مرودشت","مرکزی",110,764,2,0,122,888,1,889
"فارس","مرودشت","مرکزی",111,1127,8,1,138,1274,4,1278
"فارس","مرودشت","مرکزی",112,698,14,2,160,874,8,882
"فارس","مرودشت","مرکزی",113,1007,1,1,53,1062,,1062
"فارس","مرودشت","مرکزی",114,1049,4,0,65,1118,4,1122
"فارس","مرودشت","مرکزی",115,484,2,0,50,536,4,540
"فارس","مرودشت","مرکزی",116,803,7,5,193,1008,4,1012
"فارس","مرودشت","مرکزی",117,896,9,0,112,1017,8,1025
"فارس","مرودشت","مرکزی",118,987,9,2,85,1083,5,1088
"فارس","مرودشت","مرکزی",119,1344,5,1,172,1522,9,1531
"فارس","مرودشت","مرکزی",120,601,1,1,79,682,4,686
"فارس","مرودشت","مرکزی",121,1003,1,0,73,1077,,1077
"فارس","مرودشت","مرکزی",122,504,3,0,49,556,1,557
"فارس","مرودشت","مرکزی",123,301,1,0,31,333,1,334
"فارس","مرودشت","مرکزی",124,904,4,9,88,1005,3,1008
"فارس","مرودشت","مرکزی",125,300,0,0,20,320,1,321
"فارس","مرودشت","مرکزی",126,708,13,3,265,989,10,999
"فارس","مرودشت","مرکزی",127,627,4,1,180,812,7,819
"فارس","مرودشت","مرکزی",128,567,2,1,92,662,2,664
"فارس","مرودشت","مرکزی",129,649,2,0,126,777,11,788
"فارس","مرودشت","مرکزی",130,371,7,4,95,477,4,481
"فارس","مرودشت","مرکزی",131,1091,6,0,296,1393,6,1399
"فارس","مرودشت","مرکزی",132,595,3,2,122,722,1,723
"فارس","مرودشت","مرکزی",133,457,3,4,173,637,14,651
"فارس","مرودشت","مرکزی",134,1416,12,5,164,1597,4,1601
"فارس","مرودشت","مرکزی",135,733,3,3,85,824,1,825
"فارس","مرودشت","مرکزی",136,973,10,0,155,1138,12,1150
"فارس","مرودشت","مرکزی",137,361,2,4,111,478,4,482
"فارس","مرودشت","مرکزی",138,398,7,0,169,574,1,575
"فارس","مرودشت","درودزن",1,871,9,3,165,1048,11,1059
"فارس","مرودشت","درودزن",2,281,4,0,43,328,0,328
"فارس","مرودشت","درودزن",3,708,0,2,45,755,3,758
"فارس","مرودشت","درودزن",4,975,7,2,246,1230,4,1234
"فارس","مرودشت","درودزن",5,330,0,0,62,392,1,393
"فارس","مرودشت","درودزن",6,327,2,1,80,410,2,412
"فارس","مرودشت","درودزن",7,646,2,6,86,740,2,742
"فارس","مرودشت","درودزن",8,632,2,1,75,710,3,713
"فارس","مرودشت","درودزن",9,916,5,4,159,1084,7,1091
"فارس","مرودشت","درودزن",10,791,7,2,113,913,8,921
"فارس","مرودشت","درودزن",11,772,1,0,75,848,5,853
"فارس","مرودشت","درودزن",12,777,2,0,65,844,6,850
"فارس","مرودشت","درودزن",13,973,4,1,123,1101,6,1107
"فارس","مرودشت","درودزن",14,163,0,1,39,203,4,207
"فارس","مرودشت","درودزن",15,828,0,1,49,878,1,879
"فارس","مرودشت","درودزن",16,909,0,0,52,961,2,963
"فارس","مرودشت","درودزن",17,567,2,1,56,626,2,628
"فارس","مرودشت","درودزن",18,621,0,1,30,652,0,652
"فارس","مرودشت","درودزن",19,432,1,0,9,442,3,445
"فارس","مرودشت","درودزن",20,766,2,2,43,813,2,815
"فارس","مرودشت","درودزن",21,645,1,0,36,682,1,683
"فارس","مرودشت","درودزن",22,555,11,2,22,590,2,592
"فارس","مرودشت","درودزن",23,792,2,2,118,914,4,918
"فارس","مرودشت","درودزن",24,654,2,0,73,729,6,735
"فارس","مرودشت","درودزن",25,927,2,0,47,976,0,976
"فارس","مرودشت","درودزن",26,882,2,0,85,969,0,969
"فارس","مرودشت","درودزن",27,302,0,1,34,337,0,337
"فارس","مرودشت","درودزن",28,698,1,3,33,735,0,735
"فارس","مرودشت","درودزن",29,596,6,0,99,701,3,704
"فارس","مرودشت","درودزن",30,803,2,3,181,989,7,996
"فارس","مرودشت","درودزن",31,607,3,2,105,717,1,718
"فارس","مرودشت","سیدان",1,992,7,0,207,1206,3,1209
"فارس","مرودشت","سیدان",2,896,11,1,310,1218,10,1228
"فارس","مرودشت","سیدان",3,410,13,2,130,555,4,559
"فارس","مرودشت","سیدان",4,573,2,1,183,759,1,760
"فارس","مرودشت","سیدان",5,425,7,0,65,497,3,500
"فارس","مرودشت","سیدان",6,952,4,3,131,1090,9,1099
"فارس","مرودشت","سیدان",7,628,4,3,162,797,2,799
"فارس","مرودشت","سیدان",8,537,9,0,67,613,2,615
"فارس","مرودشت","سیدان",9,957,9,1,203,1170,12,1182
"فارس","مرودشت","سیدان",10,602,2,2,225,831,8,839
"فارس","مرودشت","سیدان",11,1212,6,1,143,1362,7,1369
"فارس","مرودشت","سیدان",12,1233,12,3,99,1347,2,1349
"فارس","مرودشت","سیدان",13,802,4,2,123,931,9,940
"فارس","مرودشت","سیدان",14,1219,3,0,95,1317,6,1323
"فارس","مرودشت","سیدان",15,907,7,5,88,1007,4,1011
"فارس","مرودشت","سیدان",16,900,1,2,72,975,4,979
"فارس","مرودشت","سیدان",17,1064,1,5,126,1196,2,1198
"فارس","مرودشت","سیدان",18,567,12,1,80,660,5,665
"فارس","مرودشت","کامفیروز",1,468,1,3,86,558,0,558
"فارس","مرودشت","کامفیروز",2,307,4,0,80,391,0,391
"فارس","مرودشت","کامفیروز",3,486,3,1,165,655,1,656
"فارس","مرودشت","کامفیروز",4,467,0,2,63,532,2,534
"فارس","مرودشت","کامفیروز",5,570,7,1,87,665,0,665
"فارس","مرودشت","کامفیروز",6,412,4,1,46,463,2,465
"فارس","مرودشت","کامفیروز",7,246,4,0,42,292,0,292
"فارس","مرودشت","کامفیروز",8,699,6,0,190,895,0,895
"فارس","مرودشت","کامفیروز",9,824,1,8,97,930,1,931
"فارس","مرودشت","کامفیروز",10,512,4,3,53,572,0,572
"فارس","مرودشت","کامفیروز",11,841,3,0,71,915,0,915
"فارس","مرودشت","کامفیروز",12,515,2,2,64,583,0,583
"فارس","مرودشت","کامفیروز",13,677,2,5,66,750,2,752
"فارس","مرودشت","کامفیروز",14,326,1,0,138,465,0,465
"فارس","مرودشت","کامفیروز",15,494,4,3,52,553,1,554
"فارس","مرودشت","کامفیروز",16,481,4,0,18,503,0,503
"فارس","مرودشت","کامفیروز",17,506,5,1,15,527,0,527
"فارس","مرودشت","کامفیروز",18,369,1,1,32,403,1,404
"فارس","مرودشت","کامفیروز",19,574,3,2,87,666,5,671
"فارس","مرودشت","کامفیروز",20,252,0,0,39,291,0,291
"فارس","مرودشت","کامفیروز",21,421,2,1,63,487,2,489
"فارس","مرودشت","کامفیروز",22,231,0,0,23,254,0,254
"فارس","مرودشت","کامفیروز",23,436,13,1,45,495,2,497
"فارس","مرودشت","کامفیروز",24,370,3,1,94,468,0,468
"فارس","مرودشت","کامفیروز",25,485,5,1,52,543,1,544
"فارس","مرودشت","کامفیروز",26,326,4,0,38,368,1,369
"فارس","مرودشت","کامفیروز",27,280,1,0,78,359,4,363
"فارس","مرودشت","کامفیروز",28,956,6,1,160,1123,8,1131
"فارس","مرودشت","کامفیروز",29,387,6,1,29,423,0,423
"فارس","مرودشت","کامفیروز",30,547,4,0,57,608,2,610
"فارس","مرودشت","کامفیروز",31,464,1,0,34,499,1,500
"فارس","مرودشت","کامفیروز",32,256,0,1,69,326,4,330
"فارس","مرودشت","کامفیروز",33,558,4,3,101,666,3,669
"فارس","ممسنی","مرکزی",1,457,25,26,480,988,7,995
"فارس","ممسنی","مرکزی",2,385,5,10,197,597,3,600
"فارس","ممسنی","مرکزی",3,555,6,20,411,992,5,997
"فارس","ممسنی","مرکزی",4,407,20,28,511,966,5,971
"فارس","ممسنی","مرکزی",5,285,8,5,321,619,5,624
"فارس","ممسنی","مرکزی",6,333,24,28,409,794,6,800
"فارس","ممسنی","مرکزی",7,362,11,20,348,741,5,746
"فارس","ممسنی","مرکزی",8,373,14,11,392,790,3,793
"فارس","ممسنی","مرکزی",9,348,19,17,408,792,6,798
"فارس","ممسنی","مرکزی",10,666,4,14,207,891,6,897
"فارس","ممسنی","مرکزی",11,714,9,9,250,982,5,987
"فارس","ممسنی","مرکزی",12,154,8,7,188,357,0,357
"فارس","ممسنی","مرکزی",13,149,1,0,116,266,0,266
"فارس","ممسنی","مرکزی",14,241,6,13,180,440,2,442
"فارس","ممسنی","مرکزی",15,427,14,16,322,779,3,782
"فارس","ممسنی","مرکزی",16,328,20,10,391,749,5,754
"فارس","ممسنی","مرکزی",17,448,18,14,404,884,2,886
"فارس","ممسنی","مرکزی",18,277,31,18,454,780,9,789
"فارس","ممسنی","مرکزی",19,329,22,11,377,739,17,756
"فارس","ممسنی","مرکزی",20,390,15,6,184,595,3,598
"فارس","ممسنی","مرکزی",21,378,9,6,342,735,3,738
"فارس","ممسنی","مرکزی",22,169,14,17,303,503,2,505
"فارس","ممسنی","مرکزی",23,116,5,3,226,350,5,355
"فارس","ممسنی","مرکزی",24,279,8,8,383,678,1,679
"فارس","ممسنی","مرکزی",25,323,11,10,461,805,4,809
"فارس","ممسنی","مرکزی",26,223,24,23,532,802,2,804
"فارس","ممسنی","مرکزی",27,177,6,8,324,515,5,520
"فارس","ممسنی","مرکزی",28,394,12,19,386,811,2,813
"فارس","ممسنی","مرکزی",29,436,11,6,337,790,6,796
"فارس","ممسنی","مرکزی",30,392,8,5,267,672,7,679
"فارس","ممسنی","مرکزی",31,333,3,9,347,692,5,697
"فارس","ممسنی","مرکزی",32,230,0,3,293,526,3,529
"فارس","ممسنی","مرکزی",33,380,37,16,463,896,4,900
"فارس","ممسنی","مرکزی",34,357,13,11,324,705,0,705
"فارس","ممسنی","مرکزی",35,299,22,8,289,618,2,620
"فارس","ممسنی","مرکزی",36,235,9,6,275,525,3,528
"فارس","ممسنی","مرکزی",37,441,12,5,323,781,10,791
"فارس","ممسنی","مرکزی",38,257,21,14,455,747,3,750
"فارس","ممسنی","مرکزی",39,496,9,4,385,894,5,899
"فارس","ممسنی","مرکزی",40,397,21,17,459,894,3,897
"فارس","ممسنی","مرکزی",41,348,5,6,229,588,0,588
"فارس","ممسنی","مرکزی",42,459,11,1,200,671,4,675
"فارس","ممسنی","مرکزی",43,482,3,4,224,713,4,717
"فارس","ممسنی","مرکزی",44,625,1,1,244,871,0,871
"فارس","ممسنی","مرکزی",45,226,6,1,184,417,2,419
"فارس","ممسنی","مرکزی",46,564,2,3,121,690,1,691
"فارس","ممسنی","مرکزی",47,103,0,2,36,141,1,142
"فارس","ممسنی","مرکزی",48,141,0,0,16,157,0,157
"فارس","ممسنی","مرکزی",49,197,7,7,283,494,2,496
"فارس","ممسنی","مرکزی",50,290,8,11,232,541,0,541
"فارس","ممسنی","مرکزی",51,418,11,9,192,630,2,632
"فارس","ممسنی","مرکزی",52,289,1,10,152,452,2,454
"فارس","ممسنی","مرکزی",53,494,4,34,385,917,1,918
"فارس","ممسنی","مرکزی",54,225,5,12,271,513,9,522
"فارس","ممسنی","مرکزی",55,246,0,14,215,475,151,626
"فارس","ممسنی","مرکزی",56,390,3,91,287,771,6,777
"فارس","ممسنی","مرکزی",57,432,4,31,304,771,3,774
"فارس","ممسنی","مرکزی",58,341,2,10,569,922,4,926
"فارس","ممسنی","مرکزی",59,578,0,4,130,712,5,717
"فارس","ممسنی","مرکزی",60,414,4,26,346,790,2,792
"فارس","ممسنی","مرکزی",61,422,4,21,186,633,3,636
"فارس","ممسنی","مرکزی",62,733,6,9,289,1037,10,1047
"فارس","ممسنی","مرکزی",63,158,1,2,388,549,0,549
"فارس","ممسنی","مرکزی",64,370,9,7,243,629,0,629
"فارس","ممسنی","مرکزی",65,407,14,5,180,606,3,609
"فارس","ممسنی","مرکزی",66,212,6,6,346,570,3,573
"فارس","ممسنی","مرکزی",67,157,2,0,239,398,0,398
"فارس","ممسنی","مرکزی",68,234,4,0,556,794,0,794
"فارس","ممسنی","مرکزی",69,339,5,9,297,650,4,654
"فارس","ممسنی","مرکزی",70,191,1,9,251,452,1,453
"فارس","ممسنی","مرکزی",71,427,7,12,397,843,12,855
"فارس","ممسنی","مرکزی",72,312,7,26,348,693,2,695
"فارس","ممسنی","مرکزی",73,192,0,2,187,381,2,383
"فارس","ممسنی","مرکزی",74,298,2,4,255,559,4,563
"فارس","ممسنی","مرکزی",75,213,5,4,152,374,0,374
"فارس","ممسنی","مرکزی",76,767,16,0,463,1246,0,1246
"فارس","ممسنی","مرکزی",77,319,8,0,151,478,2,480
"فارس","ممسنی","مرکزی",78,296,26,7,300,629,3,632
"فارس","ممسنی","مرکزی",79,192,3,1,160,356,0,356
"فارس","ممسنی","مرکزی",80,166,1,1,90,258,1,259
"فارس","ممسنی","مرکزی",81,596,1,0,101,698,0,698
"فارس","ممسنی","مرکزی",82,350,3,0,87,440,2,442
"فارس","ممسنی","مرکزی",83,710,5,1,64,780,0,780
"فارس","ممسنی","مرکزی",84,102,1,1,45,149,0,149
"فارس","ممسنی","مرکزی",85,209,2,0,56,267,2,269
"فارس","ممسنی","مرکزی",86,168,4,3,124,299,0,299
"فارس","ممسنی","مرکزی",87,121,3,0,25,149,0,149
"فارس","ممسنی","مرکزی",88,869,15,7,187,1078,0,1078
"فارس","ممسنی","مرکزی",89,229,3,1,42,275,0,275
"فارس","ممسنی","مرکزی",90,630,6,2,138,776,5,781
"فارس","ممسنی","مرکزی",91,522,9,10,58,599,0,599
"فارس","ممسنی","مرکزی",92,378,5,3,247,633,4,637
"فارس","ممسنی","مرکزی",93,68,0,0,14,82,5,87
"فارس","ممسنی","مرکزی",94,192,2,0,74,268,2,270
"فارس","ممسنی","مرکزی",95,263,2,1,50,316,0,316
"فارس","ممسنی","مرکزی",96,442,11,1,61,515,1,516
"فارس","ممسنی","مرکزی",97,160,0,0,28,188,2,190
"فارس","ممسنی","مرکزی",98,342,5,0,50,397,3,400
"فارس","ممسنی","دشمن_زیاری",1,206,7,2,123,338,2,340
"فارس","ممسنی","دشمن_زیاری",2,434,0,1,67,502,0,502
"فارس","ممسنی","دشمن_زیاری",3,311,1,1,83,396,3,399
"فارس","ممسنی","دشمن_زیاری",4,419,9,8,86,522,0,522
"فارس","ممسنی","دشمن_زیاری",5,454,7,2,87,550,0,550
"فارس","ممسنی","دشمن_زیاری",6,303,3,10,115,431,2,433
"فارس","ممسنی","دشمن_زیاری",7,366,2,6,69,443,3,446
"فارس","ممسنی","دشمن_زیاری",8,732,11,7,192,942,4,946
"فارس","ممسنی","دشمن_زیاری",9,432,7,7,141,587,3,590
"فارس","ممسنی","دشمن_زیاری",10,720,16,15,212,963,13,976
"فارس","ممسنی","دشمن_زیاری",11,239,7,3,84,333,3,336
"فارس","ممسنی","دشمن_زیاری",12,173,13,11,98,295,1,296
"فارس","ممسنی","دشمن_زیاری",13,350,0,2,48,400,0,400
"فارس","ممسنی","دشمن_زیاری",14,598,7,3,114,722,3,725
"فارس","ممسنی","دشمن_زیاری",15,667,10,16,98,791,0,791
"فارس","ممسنی","ماهور_میلاتی",1,328,3,2,152,485,0,485
"فارس","ممسنی","ماهور_میلاتی",2,296,1,0,98,395,2,397
"فارس","ممسنی","ماهور_میلاتی",3,117,0,0,50,167,4,171
"فارس","ممسنی","ماهور_میلاتی",4,134,0,0,36,170,4,174
"فارس","ممسنی","ماهور_میلاتی",5,137,0,0,20,157,0,157
"فارس","ممسنی","ماهور_میلاتی",6,45,0,0,19,64,0,64
"فارس","ممسنی","ماهور_میلاتی",7,99,1,0,8,108,0,108
"فارس","ممسنی","ماهور_میلاتی",8,168,0,0,32,200,0,200
"فارس","ممسنی","ماهور_میلاتی",9,276,11,0,84,371,0,371
"فارس","ممسنی","ماهور_میلاتی",10,875,11,1,107,994,4,998
"فارس","ممسنی","ماهور_میلاتی",11,21,0,1,53,75,2,77
"فارس","ممسنی","ماهور_میلاتی",12,149,1,0,30,180,0,180
"فارس","ممسنی","ماهور_میلاتی",13,196,6,0,90,292,1,293
"فارس","ممسنی","ماهور_میلاتی",14,12,0,0,4,16,0,16
"فارس","ممسنی","ماهور_میلاتی",15,182,0,0,56,238,0,238
"فارس","ممسنی","ماهور_میلاتی",16,45,0,0,18,63,2,65
"فارس","ممسنی","ماهور_میلاتی",17,65,0,0,12,77,0,77
"فارس","ممسنی","ماهور_میلاتی",18,48,0,0,15,63,0,63
"فارس","ممسنی","ماهور_میلاتی",19,227,0,0,88,315,0,315
"فارس","مهر","مرکزی",1,422,9,2,715,1148,8,1156
"فارس","مهر","مرکزی",2,272,23,3,888,1186,8,1194
"فارس","مهر","مرکزی",3,225,22,6,771,1024,7,1031
"فارس","مهر","مرکزی",4,242,6,14,482,744,3,747
"فارس","مهر","مرکزی",5,524,3,1,346,874,3,877
"فارس","مهر","مرکزی",6,364,4,1,456,825,9,834
"فارس","مهر","مرکزی",7,401,6,4,232,643,2,645
"فارس","مهر","مرکزی",8,300,4,0,200,504,0,504
"فارس","مهر","مرکزی",9,399,3,1,152,555,2,557
"فارس","مهر","مرکزی",10,605,12,8,159,784,15,799
"فارس","مهر","گله_دار",1,192,6,5,766,969,15,984
"فارس","مهر","گله_دار",2,533,16,1,303,853,6,859
"فارس","مهر","گله_دار",3,381,13,15,480,889,10,899
"فارس","مهر","گله_دار",4,729,6,23,565,1323,9,1332
"فارس","مهر","گله_دار",5,98,10,5,446,559,8,567
"فارس","مهر","گله_دار",6,698,2,0,184,884,4,888
"فارس","مهر","گله_دار",7,627,19,6,536,1188,2,1190
"فارس","مهر","گله_دار",8,678,9,2,203,892,7,899
"فارس","مهر","گله_دار",9,549,3,2,298,852,4,856
"فارس","مهر","گله_دار",10,530,3,0,188,721,2,723
"فارس","مهر","گله_دار",11,933,16,2,43,994,1,995
"فارس","مهر","اسیر",1,560,18,0,309,887,4,891
"فارس","مهر","اسیر",2,133,3,0,587,723,4,727
"فارس","مهر","اسیر",3,378,13,2,461,854,1,855
"فارس","مهر","اسیر",4,358,7,2,327,694,6,700
"فارس","مهر","اسیر",5,968,6,1,245,1220,3,1223
"فارس","مهر","اسیر",6,969,2,3,116,1090,2,1092
"فارس","مهر","اسیر",7,526,2,0,105,633,3,636
"فارس","مهر","اسیر",8,535,2,2,75,614,1,615
"فارس","مهر","اسیر",9,292,3,1,79,375,1,376
"فارس","مهر","اسیر",1,384,3,9,453,849,4,853
"فارس","مهر","وراوی",2,440,6,2,303,751,10,761
"فارس","مهر","وراوی",3,1458,9,1,149,1617,3,1620
"فارس","مهر","وراوی",4,333,8,1,174,516,0,516
"فارس","مهر","وراوی",5,305,9,1,128,443,3,446
"فارس","مهر","وراوی",6,732,2,2,85,821,0,821
"فارس","مهر","وراوی",7,401,2,1,180,584,6,590
"فارس","مهر","وراوی",8,463,2,3,386,854,11,865
"فارس","مهر","وراوی",9,538,1,2,122,663,4,667
"فارس","مهر","وراوی",10,722,9,1,227,959,5,964
"فارس","مهر","وراوی",11,331,4,7,83,425,5,430
"فارس","نی_ریز","مرکزی",1,892,6,8,195,1101,6,1107
"فارس","نی_ریز","مرکزی",2,552,3,4,172,731,5,736
"فارس","نی_ریز","مرکزی",3,375,7,1,403,786,12,798
"فارس","نی_ریز","مرکزی",4,545,13,8,211,777,9,786
"فارس","نی_ریز","مرکزی",5,1069,6,7,156,1238,12,1250
"فارس","نی_ریز","مرکزی",6,315,6,3,74,398,2,400
"فارس","نی_ریز","مرکزی",7,754,3,28,165,950,1,951
"فارس","نی_ریز","مرکزی",8,214,2,3,130,349,4,353
"فارس","نی_ریز","مرکزی",9,918,9,7,349,1283,8,1291
"فارس","نی_ریز","مرکزی",10,683,7,9,295,994,10,1004
"فارس","نی_ریز","مرکزی",11,969,16,7,343,1335,3,1338
"فارس","نی_ریز","مرکزی",12,620,3,6,160,789,10,799
"فارس","نی_ریز","مرکزی",13,727,17,9,417,1170,16,1186
"فارس","نی_ریز","مرکزی",14,762,11,7,408,1188,12,1200
"فارس","نی_ریز","مرکزی",15,1005,14,9,394,1422,9,1431
"فارس","نی_ریز","مرکزی",16,909,2,6,216,1133,9,1142
"فارس","نی_ریز","مرکزی",17,556,5,10,190,761,9,770
"فارس","نی_ریز","مرکزی",18,857,5,14,131,1007,5,1012
"فارس","نی_ریز","مرکزی",19,575,3,1,135,714,5,719
"فارس","نی_ریز","مرکزی",20,834,7,5,229,1075,4,1079
"فارس","نی_ریز","مرکزی",21,1223,7,1,338,1569,12,1581
"فارس","نی_ریز","مرکزی",22,1002,15,6,311,1334,9,1343
"فارس","نی_ریز","مرکزی",23,603,6,4,237,850,5,855
"فارس","نی_ریز","مرکزی",24,1052,1,7,73,1133,0,1133
"فارس","نی_ریز","مرکزی",25,625,15,10,396,1046,10,1056
"فارس","نی_ریز","مرکزی",26,295,2,3,228,528,10,538
"فارس","نی_ریز","مرکزی",27,575,4,9,175,763,14,777
"فارس","نی_ریز","مرکزی",28,537,3,9,226,775,6,781
"فارس","نی_ریز","مرکزی",29,459,3,1,137,600,8,608
"فارس","نی_ریز","مرکزی",30,302,3,2,43,350,1,351
"فارس","نی_ریز","مرکزی",31,433,1,0,38,472,3,475
"فارس","نی_ریز","مرکزی",32,644,1,0,39,684,0,684
"فارس","نی_ریز","مرکزی",33,459,1,0,39,499,0,499
"فارس","نی_ریز","مرکزی",34,520,0,2,36,558,0,558
"فارس","نی_ریز","مرکزی",35,766,0,0,50,816,1,817
"فارس","نی_ریز","مرکزی",36,269,0,1,10,280,1,281
"فارس","نی_ریز","مرکزی",37,229,0,0,5,234,1,235
"فارس","نی_ریز","آباده_طشک",1,459,0,1,59,519,1,520
"فارس","نی_ریز","آباده_طشک",2,518,0,1,10,529,0,529
"فارس","نی_ریز","آباده_طشک",3,866,7,1,218,1092,5,1097
"فارس","نی_ریز","آباده_طشک",4,896,7,1,200,1104,6,1110
"فارس","نی_ریز","آباده_طشک",5,587,0,1,105,693,6,699
"فارس","نی_ریز","آباده_طشک",6,997,8,1,161,1167,9,1176
"فارس","نی_ریز","آباده_طشک",7,422,1,1,7,431,0,431
"فارس","نی_ریز","آباده_طشک",8,634,9,0,98,741,2,743
"فارس","نی_ریز","آباده_طشک",9,1031,1,2,130,1164,2,1166
"فارس","نی_ریز","آباده_طشک",10,879,2,0,63,944,1,945
"فارس","نی_ریز","آباده_طشک",11,1157,3,2,132,1294,6,1300
"فارس","نی_ریز","آباده_طشک",12,698,2,2,37,739,1,740
"فارس","نی_ریز","آباده_طشک",13,281,1,4,22,308,0,308
"فارس","نی_ریز","آباده_طشک",14,861,2,1,33,897,2,899
"فارس","نی_ریز","آباده_طشک",15,550,5,2,23,580,1,581
"فارس","نی_ریز","آباده_طشک",16,595,0,0,75,670,0,670
"فارس","نی_ریز","آباده_طشک",17,715,1,0,28,744,0,744
"فارس","نی_ریز","آباده_طشک",18,805,2,2,31,840,2,842
"فارس","نی_ریز","آباده_طشک",19,490,0,1,49,540,1,541
"فارس","نی_ریز","آباده_طشک",20,680,0,0,42,722,3,725
"فارس","نی_ریز","آباده_طشک",21,514,1,1,12,528,0,528
"فارس","نی_ریز","آباده_طشک",22,682,0,0,3,685,1,686
"فارس","نی_ریز","آباده_طشک",23,765,4,0,93,862,1,863
"فارس","نی_ریز","آباده_طشک",24,626,1,0,131,758,2,760
"فارس","نی_ریز","آباده_طشک",25,298,0,0,51,349,1,350
"فارس","نی_ریز","آباده_طشک",26,200,1,0,18,219,0,219
"فارس","نی_ریز","پشتکوه",1,768,9,14,137,928,4,932
"فارس","نی_ریز","پشتکوه",2,660,9,6,154,829,6,835
"فارس","نی_ریز","پشتکوه",3,515,4,3,106,628,9,637
"فارس","نی_ریز","پشتکوه",4,149,0,5,44,198,3,201
"فارس","نی_ریز","پشتکوه",5,245,0,0,22,267,1,268
"فارس","نی_ریز","پشتکوه",6,504,3,2,89,598,3,601
"فارس","نی_ریز","پشتکوه",7,136,1,0,15,152,0,152
"فارس","نی_ریز","پشتکوه",8,985,6,20,156,1167,6,1173
"فارس","نی_ریز","پشتکوه",9,130,1,4,25,160,0,160
"فارس","نی_ریز","پشتکوه",10,160,0,0,13,173,0,173
"فارس","نی_ریز","قطرویه",1,163,0,0,9,172,0,172
"فارس","نی_ریز","قطرویه",2,843,2,2,135,982,0,982
"فارس","نی_ریز","قطرویه",3,800,7,4,181,992,8,1000
"فارس","نی_ریز","قطرویه",4,83,1,0,22,106,0,106
"فارس","نی_ریز","قطرویه",5,585,0,0,14,599,1,600
"فارس","نی_ریز","قطرویه",6,292,1,0,12,305,2,307
"فارس","نی_ریز","قطرویه",7,581,2,4,59,646,2,648
"فارس","نی_ریز","قطرویه",8,321,1,0,47,369,2,371
"فارس","نی_ریز","قطرویه",9,377,1,0,78,456,0,456
"فارس","نی_ریز","قطرویه",10,346,1,1,26,374,1,375
"فارس","نی_ریز","قطرویه",11,256,1,1,29,287,1,288
"فارس","نی_ریز","قطرویه",12,269,0,0,30,299,0,299
"فارس","نی_ریز","قطرویه",13,692,3,1,71,767,3,770
"فارس","نی_ریز","قطرویه",14,802,2,1,64,869,3,872
"فارس","نی_ریز","قطرویه",15,327,1,0,24,352,1,353
"فارس","نی_ریز","قطرویه",16,557,2,0,75,634,2,636
"فارس","نی_ریز","قطرویه",17,342,0,0,37,379,1,380
"فارس","نی_ریز","قطرویه",18,550,1,0,32,583,1,584
"فارس","نی_ریز","قطرویه",19,327,1,0,18,346,0,346
"فارس","نی_ریز","قطرویه",20,294,0,0,57,351,1,352
"فارس","نی_ریز","قطرویه",21,272,1,0,12,285,0,285
"قزوین","آبیک","مرکزی",1,1256,26,7,671,1960,14,1974
"قزوین","آبیک","مرکزی",2,667,23,1,248,939,11,950
"قزوین","آبیک","مرکزی",3,846,19,9,411,1285,8,1293
"قزوین","آبیک","مرکزی",4,904,23,5,590,1522,19,1541
"قزوین","آبیک","مرکزی",5,832,10,2,350,1194,12,1206
"قزوین","آبیک","مرکزی",6,428,3,0,112,543,1,544
"قزوین","آبیک","مرکزی",7,555,8,3,296,862,6,868
"قزوین","آبیک","مرکزی",8,1196,10,6,504,1716,14,1730
"قزوین","آبیک","مرکزی",9,1040,32,3,611,1686,17,1703
"قزوین","آبیک","مرکزی",10,885,4,3,307,1199,8,1207
"قزوین","آبیک","مرکزی",11,1053,4,6,147,1210,6,1216
"قزوین","آبیک","مرکزی",12,638,8,2,215,863,8,871
"قزوین","آبیک","مرکزی",13,592,9,3,373,977,10,987
"قزوین","آبیک","مرکزی",14,751,3,0,243,997,3,1000
"قزوین","آبیک","مرکزی",15,968,3,2,489,1462,12,1474
"قزوین","آبیک","مرکزی",16,892,11,2,370,1275,10,1285
"قزوین","آبیک","مرکزی",17,878,16,3,440,1337,15,1352
"قزوین","آبیک","مرکزی",18,851,14,2,333,1200,11,1211
"قزوین","آبیک","مرکزی",19,839,27,5,425,1296,16,1312
"قزوین","آبیک","مرکزی",20,926,12,15,347,1300,13,1313
"قزوین","آبیک","مرکزی",21,618,13,7,234,872,3,875
"قزوین","آبیک","مرکزی",22,440,13,8,242,703,6,709
"قزوین","آبیک","مرکزی",23,780,3,2,336,1121,10,1131
"قزوین","آبیک","مرکزی",24,810,10,3,231,1054,7,1061
"قزوین","آبیک","مرکزی",25,121,1,2,35,159,1,160
"قزوین","آبیک","مرکزی",26,1412,28,3,462,1905,10,1915
"قزوین","آبیک","مرکزی",27,964,33,4,413,1414,16,1430
"قزوین","آبیک","مرکزی",28,1166,15,4,309,1494,6,1500
"قزوین","آبیک","مرکزی",29,747,5,4,263,1019,8,1027
"قزوین","آبیک","مرکزی",30,641,7,1,328,977,6,983
"قزوین","آبیک","مرکزی",31,909,5,0,140,1054,2,1056
"قزوین","آبیک","مرکزی",32,234,0,0,31,265,0,265
"قزوین","آبیک","مرکزی",33,276,5,0,66,347,2,349
"قزوین","آبیک","مرکزی",34,423,15,6,261,705,8,713
"قزوین","آبیک","مرکزی",35,493,0,2,114,609,3,612
"قزوین","آبیک","مرکزی",36,484,8,9,128,629,5,634
"قزوین","آبیک","مرکزی",37,128,3,1,51,183,0,183
"قزوین","آبیک","مرکزی",38,314,0,1,49,364,2,366
"قزوین","آبیک","مرکزی",39,43,1,0,27,71,0,71
"قزوین","آبیک","مرکزی",40,138,5,2,78,223,5,228
"قزوین","آبیک","مرکزی",41,37,0,1,6,44,0,44
"قزوین","آبیک","مرکزی",42,242,3,0,98,343,7,350
"قزوین","آبیک","مرکزی",43,83,1,0,22,106,0,106
"قزوین","آبیک","مرکزی",44,118,8,0,42,168,2,170
"قزوین","آبیک","مرکزی",45,483,1,1,83,568,1,569
"قزوین","آبیک","مرکزی",46,272,2,0,50,324,0,324
"قزوین","آبیک","مرکزی",47,457,5,0,108,570,0,570
"قزوین","آبیک","مرکزی",48,293,3,0,136,432,3,435
"قزوین","آبیک","مرکزی",49,292,3,0,124,419,4,423
"قزوین","آبیک","بشاریات",1,839,10,4,205,1058,3,1061
"قزوین","آبیک","بشاریات",2,724,13,4,216,957,5,962
"قزوین","آبیک","بشاریات",3,515,3,0,114,632,4,636
"قزوین","آبیک","بشاریات",4,122,0,1,35,158,1,159
"قزوین","آبیک","بشاریات",5,632,2,3,125,762,2,764
"قزوین","آبیک","بشاریات",6,348,2,3,53,406,6,412
"قزوین","آبیک","بشاریات",7,408,0,3,61,472,3,475
"قزوین","آبیک","بشاریات",8,386,2,0,20,408,4,412
"قزوین","آبیک","بشاریات",9,709,2,2,250,963,4,967
"قزوین","آبیک","بشاریات",10,389,12,1,112,514,10,524
"قزوین","آبیک","بشاریات",11,213,2,0,51,266,6,272
"قزوین","آبیک","بشاریات",12,282,3,0,28,313,1,314
"قزوین","آبیک","بشاریات",13,461,4,0,60,525,5,530
"قزوین","آبیک","بشاریات",14,485,3,1,56,545,1,546
"قزوین","آبیک","بشاریات",15,446,1,0,47,494,1,495
"قزوین","آبیک","بشاریات",16,591,0,1,121,713,5,718
"قزوین","آبیک","بشاریات",17,856,0,1,68,925,3,928
"قزوین","آبیک","بشاریات",18,450,2,1,77,530,3,533
"قزوین","آبیک","بشاریات",19,657,4,2,166,829,12,841
"قزوین","البرز","مرکزی",1,428,5,2,89,524,4,528
"قزوین","البرز","مرکزی",2,429,2,2,57,490,2,492
"قزوین","البرز","مرکزی",3,477,2,1,134,614,13,627
"قزوین","البرز","مرکزی",4,532,8,5,178,723,13,736
"قزوین","البرز","مرکزی",5,590,7,0,135,732,1,733
"قزوین","البرز","مرکزی",6,1181,15,3,140,1339,13,1352
"قزوین","البرز","مرکزی",7,341,4,0,158,503,1,504
"قزوین","البرز","مرکزی",8,311,2,0,99,412,2,414
"قزوین","البرز","مرکزی",9,989,23,2,270,1284,23,1307
"قزوین","البرز","مرکزی",10,996,4,1,136,1137,5,1142
"قزوین","البرز","مرکزی",11,679,19,7,317,1022,20,1042
"قزوین","البرز","مرکزی",12,764,11,2,202,979,5,984
"قزوین","البرز","مرکزی",13,432,5,2,239,678,11,689
"قزوین","البرز","مرکزی",14,447,9,0,156,612,6,618
"قزوین","البرز","مرکزی",15,506,6,1,71,584,1,585
"قزوین","البرز","مرکزی",16,927,23,3,622,1575,25,1600
"قزوین","البرز","مرکزی",17,953,10,1,402,1366,8,1374
"قزوین","البرز","مرکزی",18,448,7,4,361,820,11,831
"قزوین","البرز","مرکزی",19,490,7,0,210,707,6,713
"قزوین","البرز","مرکزی",20,745,4,1,257,1007,11,1018
"قزوین","البرز","مرکزی",21,790,8,1,165,964,8,972
"قزوین","البرز","مرکزی",22,266,1,1,126,394,4,398
"قزوین","البرز","مرکزی",23,320,3,1,84,408,7,415
"قزوین","البرز","مرکزی",24,519,3,0,130,652,7,659
"قزوین","البرز","مرکزی",25,445,4,1,154,604,7,611
"قزوین","البرز","مرکزی",26,1053,8,4,214,1279,5,1284
"قزوین","البرز","مرکزی",27,799,15,6,290,1110,14,1124
"قزوین","البرز","مرکزی",28,862,12,2,172,1048,1,1049
"قزوین","البرز","مرکزی",29,492,6,1,255,754,7,761
"قزوین","البرز","مرکزی",30,365,3,0,75,443,5,448
"قزوین","البرز","مرکزی",31,684,13,4,277,978,11,989
"قزوین","البرز","مرکزی",32,693,8,2,194,897,3,900
"قزوین","البرز","مرکزی",33,579,3,3,100,685,12,697
"قزوین","البرز","مرکزی",34,862,13,4,265,1144,14,1158
"قزوین","البرز","مرکزی",35,1246,31,1,572,1850,21,1871
"قزوین","البرز","مرکزی",36,1163,13,5,406,1587,12,1599
"قزوین","البرز","مرکزی",37,629,22,10,464,1125,18,1143
"قزوین","البرز","مرکزی",38,758,21,3,432,1214,14,1228
"قزوین","البرز","مرکزی",39,751,27,11,713,1502,26,1528
"قزوین","البرز","مرکزی",40,594,12,0,281,887,13,900
"قزوین","البرز","مرکزی",41,784,12,1,323,1120,11,1131
"قزوین","البرز","مرکزی",42,1057,36,6,670,1769,22,1791
"قزوین","البرز","مرکزی",43,773,23,5,598,1399,24,1423
"قزوین","البرز","مرکزی",44,815,16,5,433,1269,19,1288
"قزوین","البرز","مرکزی",45,146,6,0,73,225,0,225
"قزوین","البرز","مرکزی",46,174,4,1,60,239,0,239
"قزوین","البرز","مرکزی",47,600,5,0,138,743,8,751
"قزوین","البرز","مرکزی",48,1076,10,1,184,1271,6,1277
"قزوین","البرز","مرکزی",49,673,1,1,121,796,4,800
"قزوین","البرز","مرکزی",50,945,4,3,180,1132,11,1143
"قزوین","البرز","مرکزی",51,865,1,1,94,961,4,965
"قزوین","البرز","مرکزی",52,771,2,2,85,860,4,864
"قزوین","البرز","مرکزی",53,684,3,0,98,785,3,788
"قزوین","البرز","مرکزی",54,465,1,1,63,530,1,531
"قزوین","البرز","مرکزی",55,958,10,1,175,1144,8,1152
"قزوین","البرز","مرکزی",56,491,4,0,58,553,3,556
"قزوین","البرز","مرکزی",57,785,5,3,113,906,3,909
"قزوین","البرز","مرکزی",58,551,4,0,60,615,2,617
"قزوین","البرز","مرکزی",59,322,3,2,51,378,4,382
"قزوین","البرز","مرکزی",60,1072,0,10,81,1163,6,1169
"قزوین","البرز","مرکزی",61,942,0,3,99,1044,3,1047
"قزوین","البرز","مرکزی",62,787,8,0,106,901,1,902
"قزوین","البرز","مرکزی",63,113,4,0,37,154,0,154
"قزوین","البرز","مرکزی",64,1187,1,1,86,1275,6,1281
"قزوین","البرز","محمدیه",1,650,15,8,503,1176,17,1193
"قزوین","البرز","محمدیه",2,1108,36,4,715,1863,19,1882
"قزوین","البرز","محمدیه",3,951,24,6,614,1595,29,1624
"قزوین","البرز","محمدیه",4,1234,45,7,828,2114,27,2141
"قزوین","البرز","محمدیه",5,860,27,6,432,1325,29,1354
"قزوین","البرز","محمدیه",6,845,14,8,452,1319,19,1338
"قزوین","البرز","محمدیه",7,609,20,8,404,1041,9,1050
"قزوین","البرز","محمدیه",8,629,15,4,348,996,11,1007
"قزوین","البرز","محمدیه",9,681,36,7,342,1066,12,1078
"قزوین","البرز","محمدیه",10,644,16,3,348,1011,12,1023
"قزوین","البرز","محمدیه",11,632,16,4,445,1097,13,1110
"قزوین","البرز","محمدیه",12,1330,35,2,668,2035,19,2054
"قزوین","البرز","محمدیه",13,750,15,0,303,1068,13,1081
"قزوین","البرز","محمدیه",14,642,19,1,346,1008,17,1025
"قزوین","البرز","محمدیه",15,927,28,5,577,1537,13,1550
"قزوین","البرز","محمدیه",16,951,20,5,370,1346,12,1358
"قزوین","البرز","محمدیه",17,796,24,11,428,1259,16,1275
"قزوین","البرز","محمدیه",18,696,19,4,382,1101,29,1130
"قزوین","البرز","محمدیه",19,577,14,5,478,1074,6,1080
"قزوین","البرز","محمدیه",20,541,3,3,164,711,6,717
"قزوین","البرز","محمدیه",21,576,4,0,91,671,4,675
"قزوین","البرز","محمدیه",22,429,11,0,110,550,8,558
"قزوین","البرز","محمدیه",23,420,0,0,101,521,3,524
"قزوین","البرز","محمدیه",24,631,5,0,247,883,11,894
"قزوین","البرز","محمدیه",25,709,3,0,138,850,3,853
"قزوین","البرز","محمدیه",26,889,10,0,242,1141,8,1149
"قزوین","البرز","محمدیه",27,170,2,2,37,211,2,213
"قزوین","البرز","محمدیه",28,630,0,1,96,727,1,728
"قزوین","البرز","محمدیه",29,616,11,2,152,781,16,797
"قزوین","البرز","محمدیه",30,819,4,1,112,936,3,939
"قزوین","البرز","محمدیه",31,784,5,3,172,964,6,970
"قزوین","البرز","محمدیه",32,582,5,2,148,737,6,743
"قزوین","البرز","محمدیه",33,625,1,2,91,719,3,722
"قزوین","البرز","محمدیه",34,940,10,1,199,1150,9,1159
"قزوین","البرز","محمدیه",35,803,6,2,101,912,2,914
"قزوین","البرز","محمدیه",36,1190,18,1,227,1436,8,1444
"قزوین","البرز","محمدیه",37,1252,15,2,122,1391,1,1392
"قزوین","البرز","محمدیه",38,1331,4,4,213,1552,8,1560
"قزوین","البرز","محمدیه",39,1494,2,2,157,1655,5,1660
"قزوین","البرز","محمدیه",40,1018,7,2,188,1215,5,1220
"قزوین","البرز","محمدیه",41,466,3,0,55,524,1,525
"قزوین","البرز","محمدیه",42,1177,5,4,161,1347,7,1354
"قزوین","البرز","محمدیه",43,925,4,0,209,1138,6,1144
"قزوین","البرز","محمدیه",44,630,8,0,90,728,7,735
"قزوین","البرز","محمدیه",45,1128,11,1,83,1223,6,1229
"قزوین","البرز","محمدیه",46,630,0,1,97,728,10,738
"قزوین","البرز","محمدیه",47,225,3,2,66,296,1,297
"قزوین","البرز","محمدیه",48,278,2,0,64,344,1,345
"قزوین","بوئین_زهرا","مرکزی",1,1133,25,11,576,1745,26,1771
"قزوین","بوئین_زهرا","مرکزی",2,772,19,11,562,1364,26,1390
"قزوین","بوئین_زهرا","مرکزی",3,653,5,1,267,926,13,939
"قزوین","بوئین_زهرا","مرکزی",4,805,4,0,248,1057,7,1064
"قزوین","بوئین_زهرا","مرکزی",5,868,18,3,342,1231,19,1250
"قزوین","بوئین_زهرا","مرکزی",6,818,5,1,184,1008,4,1012
"قزوین","بوئین_زهرا","مرکزی",7,634,16,5,289,944,4,948
"قزوین","بوئین_زهرا","مرکزی",8,647,11,10,365,1033,9,1042
"قزوین","بوئین_زهرا","مرکزی",9,789,1,1,194,985,9,994
"قزوین","بوئین_زهرا","مرکزی",10,368,10,0,401,779,3,782
"قزوین","بوئین_زهرا","مرکزی",11,927,4,0,286,1217,11,1228
"قزوین","بوئین_زهرا","مرکزی",12,875,11,0,154,1040,14,1054
"قزوین","بوئین_زهرا","مرکزی",13,692,5,0,267,964,4,968
"قزوین","بوئین_زهرا","مرکزی",14,523,6,0,83,612,1,613
"قزوین","بوئین_زهرا","مرکزی",15,1578,13,3,275,1869,6,1875
"قزوین","بوئین_زهرا","مرکزی",16,609,5,0,93,707,2,709
"قزوین","بوئین_زهرا","مرکزی",17,186,2,0,44,232,1,233
"قزوین","بوئین_زهرا","مرکزی",18,1147,13,0,148,1308,4,1312
"قزوین","بوئین_زهرا","مرکزی",19,954,4,2,146,1106,5,1111
"قزوین","بوئین_زهرا","مرکزی",20,461,0,0,28,489,1,490
"قزوین","بوئین_زهرا","مرکزی",21,953,5,0,97,1055,2,1057
"قزوین","بوئین_زهرا","مرکزی",22,919,4,0,92,1015,4,1019
"قزوین","بوئین_زهرا","مرکزی",23,1061,5,11,176,1253,5,1258
"قزوین","بوئین_زهرا","مرکزی",24,809,13,1,156,979,5,984
"قزوین","بوئین_زهرا","مرکزی",25,987,2,4,147,1140,7,1147
"قزوین","بوئین_زهرا","مرکزی",26,597,6,0,96,699,1,700
"قزوین","بوئین_زهرا","مرکزی",27,1055,0,3,149,1207,1,1208
"قزوین","بوئین_زهرا","مرکزی",28,919,2,3,185,1109,7,1116
"قزوین","بوئین_زهرا","مرکزی",29,695,3,4,131,833,1,834
"قزوین","بوئین_زهرا","مرکزی",30,477,1,0,108,586,1,587
"قزوین","بوئین_زهرا","آبگرم",1,902,17,3,547,1469,10,1479
"قزوین","بوئین_زهرا","آبگرم",2,431,10,0,309,750,7,757
"قزوین","بوئین_زهرا","آبگرم",3,465,4,2,134,605,1,606
"قزوین","بوئین_زهرا","آبگرم",4,548,4,2,255,809,8,817
"قزوین","بوئین_زهرا","آبگرم",5,467,1,0,27,495,1,496
"قزوین","بوئین_زهرا","آبگرم",6,488,1,0,70,559,0,559
"قزوین","بوئین_زهرا","آبگرم",7,550,0,0,87,637,1,638
"قزوین","بوئین_زهرا","آبگرم",8,463,3,0,79,545,7,552
"قزوین","بوئین_زهرا","آبگرم",9,431,1,0,90,522,1,523
"قزوین","بوئین_زهرا","آبگرم",10,415,0,0,38,453,1,454
"قزوین","بوئین_زهرا","آبگرم",11,315,1,0,24,340,1,341
"قزوین","بوئین_زهرا","آبگرم",12,571,3,1,93,668,5,673
"قزوین","بوئین_زهرا","آبگرم",13,338,1,0,27,366,1,367
"قزوین","بوئین_زهرا","آبگرم",14,816,6,3,118,943,6,949
"قزوین","بوئین_زهرا","آبگرم",15,369,0,0,58,427,5,432
"قزوین","بوئین_زهرا","آبگرم",16,325,3,1,75,404,3,407
"قزوین","بوئین_زهرا","آبگرم",17,532,2,0,13,547,1,548
"قزوین","بوئین_زهرا","آوج",1,303,5,0,104,412,1,413
"قزوین","بوئین_زهرا","آوج",2,346,3,1,148,498,4,502
"قزوین","بوئین_زهرا","آوج",3,806,7,1,297,1111,14,1125
"قزوین","بوئین_زهرا","آوج",4,329,2,0,98,429,5,434
"قزوین","بوئین_زهرا","آوج",5,817,4,1,49,871,1,872
"قزوین","بوئین_زهرا","آوج",6,510,2,0,40,552,1,553
"قزوین","بوئین_زهرا","آوج",7,1011,0,2,83,1096,1,1097
"قزوین","بوئین_زهرا","آوج",8,432,2,0,137,571,1,572
"قزوین","بوئین_زهرا","آوج",9,623,2,0,51,676,3,679
"قزوین","بوئین_زهرا","آوج",10,689,3,0,32,724,4,728
"قزوین","بوئین_زهرا","آوج",11,404,1,1,52,458,1,459
"قزوین","بوئین_زهرا","آوج",12,484,2,0,50,536,3,539
"قزوین","بوئین_زهرا","آوج",13,444,1,0,158,603,2,605
"قزوین","بوئین_زهرا","آوج",14,360,2,0,82,444,0,444
"قزوین","بوئین_زهرا","آوج",15,548,4,1,94,647,1,648
"قزوین","بوئین_زهرا","آوج",16,254,2,0,135,391,1,392
"قزوین","بوئین_زهرا","آوج",17,319,2,0,39,360,0,360
"قزوین","بوئین_زهرا","آوج",18,291,2,1,36,330,6,336
"قزوین","بوئین_زهرا","آوج",19,402,0,0,55,457,0,457
"قزوین","بوئین_زهرا","آوج",20,667,3,1,90,761,0,761
"قزوین","بوئین_زهرا","آوج",21,377,0,0,53,430,0,430
"قزوین","بوئین_زهرا","آوج",22,371,0,0,27,398,6,404
"قزوین","بوئین_زهرا","آوج",23,319,0,0,44,363,2,365
"قزوین","بوئین_زهرا","آوج",24,288,1,0,42,331,7,338
"قزوین","بوئین_زهرا","دشتایی",1,593,8,2,397,1000,13,1013
"قزوین","بوئین_زهرا","دشتایی",2,540,6,0,87,633,4,637
"قزوین","بوئین_زهرا","دشتایی",3,574,3,0,148,725,7,732
"قزوین","بوئین_زهرا","دشتایی",4,544,11,1,158,714,2,716
"قزوین","بوئین_زهرا","دشتایی",5,651,8,1,109,769,9,778
"قزوین","بوئین_زهرا","دشتایی",6,775,0,1,83,859,2,861
"قزوین","بوئین_زهرا","دشتایی",7,583,1,0,29,613,0,613
"قزوین","بوئین_زهرا","دشتایی",8,591,2,0,26,619,6,625
"قزوین","بوئین_زهرا","دشتایی",9,615,0,0,28,643,4,647
"قزوین","بوئین_زهرا","دشتایی",10,595,2,0,52,649,1,650
"قزوین","بوئین_زهرا","دشتایی",11,637,0,0,58,695,0,695
"قزوین","بوئین_زهرا","دشتایی",12,916,0,0,29,945,3,948
"قزوین","بوئین_زهرا","دشتایی",13,651,1,0,32,684,1,685
"قزوین","بوئین_زهرا","دشتایی",14,616,2,1,49,668,3,671
"قزوین","بوئین_زهرا","دشتایی",15,650,0,1,51,702,4,706
"قزوین","بوئین_زهرا","دشتایی",16,779,2,1,51,833,4,837
"قزوین","بوئین_زهرا","دشتایی",17,633,1,1,61,696,0,696
"قزوین","بوئین_زهرا","دشتایی",18,673,1,0,43,717,0,717
"قزوین","بوئین_زهرا","دشتایی",19,868,4,1,90,963,2,965
"قزوین","بوئین_زهرا","دشتایی",20,546,0,1,14,561,0,561
"قزوین","بوئین_زهرا","رامند",1,788,6,2,185,981,8,989
"قزوین","بوئین_زهرا","رامند",2,467,4,43,319,833,4,837
"قزوین","بوئین_زهرا","رامند",3,651,7,4,300,962,11,973
"قزوین","بوئین_زهرا","رامند",4,506,4,2,302,814,11,825
"قزوین","بوئین_زهرا","رامند",5,613,5,7,179,804,3,807
"قزوین","بوئین_زهرا","رامند",6,277,2,6,90,375,3,378
"قزوین","بوئین_زهرا","رامند",7,623,11,6,181,821,5,826
"قزوین","بوئین_زهرا","رامند",8,652,8,0,155,815,13,828
"قزوین","بوئین_زهرا","رامند",9,865,5,0,141,1011,4,1015
"قزوین","بوئین_زهرا","رامند",10,530,2,3,292,827,8,835
"قزوین","بوئین_زهرا","رامند",11,487,1,1,93,582,2,584
"قزوین","بوئین_زهرا","رامند",12,562,4,0,79,645,2,647
"قزوین","بوئین_زهرا","رامند",13,462,5,0,51,518,3,521
"قزوین","بوئین_زهرا","رامند",14,478,0,0,15,493,0,493
"قزوین","بوئین_زهرا","رامند",15,393,3,0,17,413,2,415
"قزوین","بوئین_زهرا","رامند",16,501,1,0,42,544,6,550
"قزوین","بوئین_زهرا","رامند",17,286,0,0,40,326,3,329
"قزوین","بوئین_زهرا","شال",1,1214,5,2,98,1319,3,1322
"قزوین","بوئین_زهرا","شال",2,596,1,1,105,703,2,705
"قزوین","بوئین_زهرا","شال",3,486,9,0,127,622,6,628
"قزوین","بوئین_زهرا","شال",4,936,2,1,101,1040,4,1044
"قزوین","بوئین_زهرا","شال",5,277,0,0,64,341,0,341
"قزوین","بوئین_زهرا","شال",6,137,4,2,526,669,3,672
"قزوین","بوئین_زهرا","شال",7,762,1,3,99,865,0,865
"قزوین","بوئین_زهرا","شال",8,558,2,1,468,1029,2,1031
"قزوین","بوئین_زهرا","شال",9,807,6,0,338,1151,6,1157
"قزوین","بوئین_زهرا","شال",10,734,4,2,256,996,6,1002
"قزوین","بوئین_زهرا","شال",11,379,1,3,102,485,0,485
"قزوین","بوئین_زهرا","شال",12,741,2,0,65,808,1,809
"قزوین","بوئین_زهرا","شال",13,378,3,0,84,465,4,469
"قزوین","بوئین_زهرا","شال",14,306,2,0,55,363,1,364
"قزوین","بوئین_زهرا","شال",15,432,11,0,122,565,10,575
"قزوین","بوئین_زهرا","شال",16,435,9,0,60,504,0,504
"قزوین","بوئین_زهرا","شال",17,1044,1,2,137,1184,10,1194
"قزوین","بوئین_زهرا","شال",18,546,0,1,42,589,0,589
"قزوین","بوئین_زهرا","شال",19,292,0,0,30,322,2,324
"قزوین","بوئین_زهرا","شال",20,278,1,0,19,298,0,298
"قزوین","بوئین_زهرا","شال",21,483,8,6,225,722,16,738
"قزوین","تاکستان","شهر",1,118,3,1,102,224,1,225
"قزوین","تاکستان","شهر",2,528,5,1,371,905,9,914
"قزوین","تاکستان","شهر",3,645,22,0,521,1188,12,1200
"قزوین","تاکستان","شهر",4,213,4,1,212,430,5,435
"قزوین","تاکستان","شهر",5,478,7,6,423,914,9,923
"قزوین","تاکستان","شهر",6,186,7,3,142,338,0,338
"قزوین","تاکستان","شهر",7,325,6,1,277,609,19,628
"قزوین","تاکستان","شهر",8,326,3,1,222,552,2,554
"قزوین","تاکستان","شهر",9,336,9,2,388,735,7,742
"قزوین","تاکستان","شهر",10,184,8,1,191,384,5,389
"قزوین","تاکستان","شهر",11,214,6,3,275,498,10,508
"قزوین","تاکستان","شهر",12,646,15,3,746,1410,19,1429
"قزوین","تاکستان","شهر",13,316,10,3,360,689,8,697
"قزوین","تاکستان","شهر",14,747,16,13,590,1366,10,1376
"قزوین","تاکستان","شهر",15,277,10,1,289,577,3,580
"قزوین","تاکستان","شهر",16,201,8,2,173,384,2,386
"قزوین","تاکستان","شهر",17,331,8,7,360,706,11,717
"قزوین","تاکستان","شهر",18,117,4,2,185,308,3,311
"قزوین","تاکستان","شهر",19,145,7,2,270,424,3,427
"قزوین","تاکستان","شهر",20,161,6,1,220,388,8,396
"قزوین","تاکستان","شهر",21,242,9,1,370,622,9,631
"قزوین","تاکستان","شهر",22,409,11,5,533,958,20,978
"قزوین","تاکستان","شهر",23,517,18,7,568,1110,4,1114
"قزوین","تاکستان","شهر",24,94,7,0,206,307,6,313
"قزوین","تاکستان","شهر",25,742,19,5,326,1092,11,1103
"قزوین","تاکستان","شهر",26,506,4,1,109,620,2,622
"قزوین","تاکستان","شهر",27,364,9,2,162,537,1,538
"قزوین","تاکستان","شهر",28,401,9,1,152,563,5,568
"قزوین","تاکستان","شهر",29,960,3,11,300,1274,10,1284
"قزوین","تاکستان","شهر",30,833,7,0,282,1122,7,1129
"قزوین","تاکستان","شهر",31,437,5,1,187,630,3,633
"قزوین","تاکستان","شهر",32,878,12,0,350,1240,10,1250
"قزوین","تاکستان","شهر",33,782,11,7,291,1091,9,1100
"قزوین","تاکستان","شهر",34,464,5,2,216,687,9,696
"قزوین","تاکستان","شهر",35,376,1,0,120,497,13,510
"قزوین","تاکستان","شهر",36,124,2,0,51,177,2,179
"قزوین","تاکستان","شهر",37,288,8,4,259,559,0,559
"قزوین","تاکستان","شهر",38,499,5,0,169,673,5,678
"قزوین","تاکستان","شهر",39,679,3,0,119,801,5,806
"قزوین","تاکستان","شهر",40,350,2,1,167,520,7,527
"قزوین","تاکستان","شهر",41,447,10,6,315,778,11,789
"قزوین","تاکستان","شهر",42,398,3,1,274,676,2,678
"قزوین","تاکستان","شهر",43,314,9,3,193,519,10,529
"قزوین","تاکستان","شهر",44,791,8,1,277,1077,7,1084
"قزوین","تاکستان","شهر",45,177,3,1,79,260,3,263
"قزوین","تاکستان","شهر",46,378,3,0,105,486,8,494
"قزوین","تاکستان","شهر",47,691,6,1,280,978,3,981
"قزوین","تاکستان","شهر",48,905,3,2,89,999,9,1008
"قزوین","تاکستان","شهر",49,312,0,0,141,453,3,456
"قزوین","تاکستان","شهر",50,406,6,5,277,694,6,700
"قزوین","تاکستان","شهر",51,82,0,2,76,160,0,160
"قزوین","تاکستان","شهر",52,403,9,2,218,632,6,638
"قزوین","تاکستان","شهر",53,772,13,2,361,1148,10,1158
"قزوین","تاکستان","شهر",54,55,1,0,44,100,0,100
"قزوین","تاکستان","شهر",55,405,2,1,116,524,3,527
"قزوین","تاکستان","شهر",56,176,6,0,27,209,0,209
"قزوین","تاکستان","شهر",57,479,1,2,134,616,11,627
"قزوین","تاکستان","شهر",58,401,4,1,141,547,4,551
"قزوین","تاکستان","شهر",59,319,4,6,113,442,3,445
"قزوین","تاکستان","شهر",60,391,2,2,70,465,1,466
"قزوین","تاکستان","شهر",61,619,4,2,220,845,3,848
"قزوین","تاکستان","شهر",62,128,3,0,63,194,0,194
"قزوین","تاکستان","مرکزی",63,170,0,1,50,221,4,225
"قزوین","تاکستان","مرکزی",64,350,5,0,104,459,1,460
"قزوین","تاکستان","مرکزی",65,429,2,0,123,554,1,555
"قزوین","تاکستان","مرکزی",66,400,5,3,163,571,5,576
"قزوین","تاکستان","مرکزی",67,548,3,0,194,745,6,751
"قزوین","تاکستان","مرکزی",68,258,2,1,91,352,2,354
"قزوین","تاکستان","مرکزی",69,143,0,0,66,209,1,210
"قزوین","تاکستان","مرکزی",70,253,1,0,78,332,0,332
"قزوین","تاکستان","مرکزی",71,519,6,0,21,546,1,547
"قزوین","تاکستان","مرکزی",72,569,0,0,18,587,0,587
"قزوین","تاکستان","مرکزی",73,807,1,0,110,918,9,927
"قزوین","تاکستان","مرکزی",74,697,7,0,56,760,10,770
"قزوین","تاکستان","مرکزی",75,328,3,0,46,377,2,379
"قزوین","تاکستان","مرکزی",76,582,2,0,33,617,0,617
"قزوین","تاکستان","مرکزی",77,370,0,3,46,419,1,420
"قزوین","تاکستان","مرکزی",78,686,2,3,46,737,3,740
"قزوین","تاکستان","مرکزی",79,173,1,2,25,201,1,202
"قزوین","تاکستان","مرکزی",80,408,1,0,103,512,1,513
"قزوین","تاکستان","مرکزی",81,164,1,1,63,229,0,229
"قزوین","تاکستان","مرکزی",82,420,3,0,30,453,1,454
"قزوین","تاکستان","مرکزی",83,310,1,1,69,381,3,384
"قزوین","تاکستان","مرکزی",84,1002,3,0,34,1039,11,1050
"قزوین","تاکستان","مرکزی",85,394,1,0,20,415,1,416
"قزوین","تاکستان","مرکزی",86,601,1,0,55,657,0,657
"قزوین","تاکستان","مرکزی",87,105,2,0,23,130,0,130
"قزوین","تاکستان","مرکزی",88,437,2,0,21,460,1,461
"قزوین","تاکستان","مرکزی",89,618,7,2,87,714,4,718
"قزوین","تاکستان","مرکزی",90,823,10,2,123,958,9,967
"قزوین","تاکستان","مرکزی",91,1014,1,0,19,1034,2,1036
"قزوین","تاکستان","مرکزی",92,516,8,0,48,572,0,572
"قزوین","تاکستان","ضیا_آباد",1,775,10,6,217,1008,7,1015
"قزوین","تاکستان","ضیا_آباد",2,926,3,2,101,1032,5,1037
"قزوین","تاکستان","ضیا_آباد",3,420,3,0,176,599,13,612
"قزوین","تاکستان","ضیا_آباد",4,214,1,0,47,262,2,264
"قزوین","تاکستان","ضیا_آباد",5,540,2,5,125,672,4,676
"قزوین","تاکستان","ضیا_آباد",6,275,2,0,114,391,3,394
"قزوین","تاکستان","ضیا_آباد",7,908,8,0,197,1113,7,1120
"قزوین","تاکستان","ضیا_آباد",8,632,7,3,181,823,10,833
"قزوین","تاکستان","ضیا_آباد",9,477,3,0,64,544,1,545
"قزوین","تاکستان","ضیا_آباد",10,454,0,0,73,527,2,529
"قزوین","تاکستان","ضیا_آباد",11,394,1,0,65,460,5,465
"قزوین","تاکستان","ضیا_آباد",12,382,0,0,47,429,1,430
"قزوین","تاکستان","ضیا_آباد",13,192,2,0,28,222,1,223
"قزوین","تاکستان","ضیا_آباد",14,521,0,3,50,574,6,580
"قزوین","تاکستان","ضیا_آباد",15,514,6,0,44,564,5,569
"قزوین","تاکستان","ضیا_آباد",16,602,3,1,144,750,0,750
"قزوین","تاکستان","ضیا_آباد",17,236,3,0,41,280,1,281
"قزوین","تاکستان","ضیا_آباد",18,235,1,0,11,247,0,247
"قزوین","تاکستان","ضیا_آباد",19,529,0,0,61,590,2,592
"قزوین","تاکستان","ضیا_آباد",20,658,0,0,73,731,3,734
"قزوین","تاکستان","ضیا_آباد",21,481,3,1,53,538,1,539
"قزوین","تاکستان","ضیا_آباد",22,358,4,0,92,454,1,455
"قزوین","تاکستان","ضیا_آباد",23,207,2,1,28,238,0,238
"قزوین","تاکستان","ضیا_آباد",24,717,21,0,24,762,4,766
"قزوین","تاکستان","ضیا_آباد",25,402,1,0,29,432,1,433
"قزوین","تاکستان","اسفرورین",1,939,2,3,229,1173,4,1177
"قزوین","تاکستان","اسفرورین",2,912,1,0,169,1082,8,1090
"قزوین","تاکستان","اسفرورین",3,296,4,0,70,370,1,371
"قزوین","تاکستان","اسفرورین",4,724,2,2,204,932,2,934
"قزوین","تاکستان","اسفرورین",5,550,3,1,92,646,3,649
"قزوین","تاکستان","اسفرورین",6,740,10,7,123,880,0,880
"قزوین","تاکستان","اسفرورین",7,397,5,0,79,481,3,484
"قزوین","تاکستان","اسفرورین",8,421,1,5,72,499,3,502
"قزوین","تاکستان","اسفرورین",9,522,7,2,89,620,3,623
"قزوین","تاکستان","اسفرورین",10,753,4,6,77,840,3,843
"قزوین","تاکستان","اسفرورین",11,620,4,2,145,771,9,780
"قزوین","تاکستان","اسفرورین",12,954,1,0,90,1045,8,1053
"قزوین","تاکستان","اسفرورین",13,275,1,0,11,287,3,290
"قزوین","تاکستان","اسفرورین",14,851,3,0,29,883,0,883
"قزوین","تاکستان","اسفرورین",15,859,3,2,140,1004,5,1009
"قزوین","تاکستان","اسفرورین",16,720,6,0,72,798,1,799
"قزوین","تاکستان","اسفرورین",17,333,1,0,36,370,0,370
"قزوین","تاکستان","اسفرورین",18,664,3,0,75,742,0,742
"قزوین","تاکستان","اسفرورین",19,586,3,1,42,632,2,634
"قزوین","تاکستان","اسفرورین",20,976,3,0,108,1087,3,1090
"قزوین","تاکستان","اسفرورین",21,461,2,1,139,603,17,620
"قزوین","تاکستان","اسفرورین",22,504,1,0,103,608,2,610
"قزوین","تاکستان","اسفرورین",23,756,1,1,28,786,1,787
"قزوین","تاکستان","اسفرورین",24,472,2,2,144,620,2,622
"قزوین","تاکستان","خرمدشت",1,410,3,9,68,490,1,491
"قزوین","تاکستان","خرمدشت",2,326,1,7,65,399,7,406
"قزوین","تاکستان","خرمدشت",3,631,4,9,98,742,2,744
"قزوین","تاکستان","خرمدشت",4,330,1,7,19,357,1,358
"قزوین","تاکستان","خرمدشت",5,343,1,3,26,373,3,376
"قزوین","تاکستان","خرمدشت",6,188,2,4,81,275,2,277
"قزوین","تاکستان","خرمدشت",7,301,1,3,65,370,2,372
"قزوین","تاکستان","خرمدشت",8,514,6,8,85,613,3,616
"قزوین","تاکستان","خرمدشت",9,660,1,2,78,741,1,742
"قزوین","تاکستان","خرمدشت",10,544,2,0,31,577,4,581
"قزوین","تاکستان","خرمدشت",11,870,1,0,77,948,1,949
"قزوین","تاکستان","خرمدشت",12,991,3,2,111,1107,6,1113
"قزوین","تاکستان","خرمدشت",13,654,5,0,65,724,2,726
"قزوین","تاکستان","خرمدشت",14,751,3,0,87,841,2,843
"قزوین","تاکستان","خرمدشت",15,912,4,0,88,1004,0,1004
"قزوین","تاکستان","خرمدشت",16,1058,0,1,144,1203,5,1208
"قزوین","تاکستان","خرمدشت",17,635,9,0,37,681,2,683
"قزوین","تاکستان","خرمدشت",18,211,3,0,10,224,0,224
"قزوین","تاکستان","خرمدشت",19,647,3,0,136,786,1,787
"قزوین","تاکستان","خرمدشت",20,638,1,0,53,692,1,693
"قزوین","تاکستان","خرمدشت",21,34,0,1,16,51,0,51
"قزوین","قزوین","مرکزی",1,637,22,2,241,902,5,907
"قزوین","قزوین","مرکزی",2,1000,14,1,211,1226,7,1233
"قزوین","قزوین","مرکزی",3,1046,21,1,349,1417,17,1434
"قزوین","قزوین","مرکزی",4,501,7,1,144,653,0,653
"قزوین","قزوین","مرکزی",5,910,10,0,148,1068,3,1071
"قزوین","قزوین","مرکزی",6,504,10,1,161,676,5,681
"قزوین","قزوین","مرکزی",7,576,2,1,229,808,12,820
"قزوین","قزوین","مرکزی",8,329,2,1,80,412,5,417
"قزوین","قزوین","مرکزی",9,732,9,1,128,870,8,878
"قزوین","قزوین","مرکزی",10,777,8,4,218,1007,10,1017
"قزوین","قزوین","مرکزی",11,609,12,0,185,806,9,815
"قزوین","قزوین","مرکزی",12,450,11,1,193,655,13,668
"قزوین","قزوین","مرکزی",13,744,10,0,119,873,4,877
"قزوین","قزوین","مرکزی",14,667,9,1,144,821,7,828
"قزوین","قزوین","مرکزی",15,493,8,0,128,629,6,635
"قزوین","قزوین","مرکزی",16,469,15,0,162,646,6,652
"قزوین","قزوین","مرکزی",17,550,13,1,221,785,9,794
"قزوین","قزوین","مرکزی",18,727,11,3,302,1043,17,1060
"قزوین","قزوین","مرکزی",19,544,9,6,145,704,9,713
"قزوین","قزوین","مرکزی",20,644,16,3,255,918,7,925
"قزوین","قزوین","مرکزی",21,1024,10,6,192,1232,14,1246
"قزوین","قزوین","مرکزی",22,972,19,10,270,1271,13,1284
"قزوین","قزوین","مرکزی",23,695,17,0,195,907,5,912
"قزوین","قزوین","مرکزی",24,689,16,5,292,1002,14,1016
"قزوین","قزوین","مرکزی",25,528,6,1,105,640,13,653
"قزوین","قزوین","مرکزی",26,553,12,0,191,756,19,775
"قزوین","قزوین","مرکزی",27,812,5,0,175,992,8,1000
"قزوین","قزوین","مرکزی",28,558,3,0,44,605,1,606
"قزوین","قزوین","مرکزی",29,509,9,1,79,598,4,602
"قزوین","قزوین","مرکزی",30,844,3,4,80,931,5,936
"قزوین","قزوین","مرکزی",31,928,1,2,156,1087,12,1099
"قزوین","قزوین","مرکزی",32,688,3,2,88,781,3,784
"قزوین","قزوین","مرکزی",33,621,14,2,177,814,11,825
"قزوین","قزوین","مرکزی",34,276,8,1,85,370,0,370
"قزوین","قزوین","مرکزی",35,857,18,0,162,1037,10,1047
"قزوین","قزوین","مرکزی",36,616,17,3,177,813,17,830
"قزوین","قزوین","مرکزی",37,552,6,2,150,710,4,714
"قزوین","قزوین","مرکزی",38,423,5,4,237,669,11,680
"قزوین","قزوین","مرکزی",39,512,16,0,299,827,6,833
"قزوین","قزوین","مرکزی",40,426,14,5,392,837,14,851
"قزوین","قزوین","مرکزی",41,722,11,1,190,924,8,932
"قزوین","قزوین","مرکزی",42,538,34,10,449,1031,10,1041
"قزوین","قزوین","مرکزی",43,292,7,2,141,442,2,444
"قزوین","قزوین","مرکزی",44,315,8,0,107,430,3,433
"قزوین","قزوین","مرکزی",45,407,11,3,203,624,6,630
"قزوین","قزوین","مرکزی",46,231,8,1,80,320,1,321
"قزوین","قزوین","مرکزی",47,499,17,8,221,745,12,757
"قزوین","قزوین","مرکزی",48,438,17,0,217,672,8,680
"قزوین","قزوین","مرکزی",49,192,4,1,85,282,5,287
"قزوین","قزوین","مرکزی",50,770,39,2,337,1148,21,1169
"قزوین","قزوین","مرکزی",51,492,12,1,189,694,7,701
"قزوین","قزوین","مرکزی",52,452,18,10,237,717,14,731
"قزوین","قزوین","مرکزی",53,526,14,3,153,696,13,709
"قزوین","قزوین","مرکزی",54,487,20,10,228,745,13,758
"قزوین","قزوین","مرکزی",55,404,10,2,238,654,15,669
"قزوین","قزوین","مرکزی",56,363,19,4,189,575,7,582
"قزوین","قزوین","مرکزی",57,416,13,4,261,694,13,707
"قزوین","قزوین","مرکزی",58,547,24,6,283,860,12,872
"قزوین","قزوین","مرکزی",59,549,21,10,413,993,17,1010
"قزوین","قزوین","مرکزی",60,522,18,4,239,783,18,801
"قزوین","قزوین","مرکزی",61,598,27,7,577,1209,15,1224
"قزوین","قزوین","مرکزی",62,400,28,4,215,647,3,650
"قزوین","قزوین","مرکزی",63,382,36,8,228,654,2,656
"قزوین","قزوین","مرکزی",64,640,16,4,105,765,5,770
"قزوین","قزوین","مرکزی",65,574,20,4,141,739,12,751
"قزوین","قزوین","مرکزی",66,397,15,2,99,513,8,521
"قزوین","قزوین","مرکزی",67,237,16,5,129,387,2,389
"قزوین","قزوین","مرکزی",68,188,6,4,107,305,2,307
"قزوین","قزوین","مرکزی",69,487,29,3,456,975,6,981
"قزوین","قزوین","مرکزی",70,519,15,4,217,755,14,769
"قزوین","قزوین","مرکزی",71,450,24,4,253,731,15,746
"قزوین","قزوین","مرکزی",72,616,11,1,214,842,13,855
"قزوین","قزوین","مرکزی",73,784,27,6,375,1192,15,1207
"قزوین","قزوین","مرکزی",74,682,19,10,355,1066,23,1089
"قزوین","قزوین","مرکزی",75,771,40,7,562,1380,19,1399
"قزوین","قزوین","مرکزی",76,613,39,6,534,1192,25,1217
"قزوین","قزوین","مرکزی",77,902,17,3,235,1157,10,1167
"قزوین","قزوین","مرکزی",78,645,23,3,263,934,19,953
"قزوین","قزوین","مرکزی",79,978,25,6,250,1259,15,1274
"قزوین","قزوین","مرکزی",80,895,33,5,411,1344,21,1365
"قزوین","قزوین","مرکزی",81,518,42,5,521,1086,14,1100
"قزوین","قزوین","مرکزی",82,459,15,4,304,782,23,805
"قزوین","قزوین","مرکزی",83,606,28,3,468,1105,11,1116
"قزوین","قزوین","مرکزی",84,573,35,11,479,1098,19,1117
"قزوین","قزوین","مرکزی",85,327,13,3,301,644,8,652
"قزوین","قزوین","مرکزی",86,377,20,1,545,943,12,955
"قزوین","قزوین","مرکزی",87,602,3,4,130,739,9,748
"قزوین","قزوین","مرکزی",88,439,7,1,79,526,10,536
"قزوین","قزوین","مرکزی",89,329,6,1,161,497,11,508
"قزوین","قزوین","مرکزی",90,269,28,19,575,891,10,901
"قزوین","قزوین","مرکزی",91,575,27,3,319,924,5,929
"قزوین","قزوین","مرکزی",92,564,40,10,580,1194,22,1216
"قزوین","قزوین","مرکزی",93,446,36,10,749,1241,14,1255
"قزوین","قزوین","مرکزی",94,340,22,2,306,670,9,679
"قزوین","قزوین","مرکزی",95,660,5,5,152,822,7,829
"قزوین","قزوین","مرکزی",96,593,11,6,215,825,13,838
"قزوین","قزوین","مرکزی",97,598,26,4,383,1011,13,1024
"قزوین","قزوین","مرکزی",98,752,14,2,207,975,5,980
"قزوین","قزوین","مرکزی",99,682,16,1,296,995,16,1011
"قزوین","قزوین","مرکزی",100,1085,13,3,230,1331,19,1350
"قزوین","قزوین","مرکزی",101,1066,27,3,450,1546,14,1560
"قزوین","قزوین","مرکزی",102,406,6,4,198,614,15,629
"قزوین","قزوین","مرکزی",103,352,10,8,231,601,8,609
"قزوین","قزوین","مرکزی",104,466,7,0,109,582,11,593
"قزوین","قزوین","مرکزی",105,1038,19,0,286,1343,20,1363
"قزوین","قزوین","مرکزی",106,408,13,3,147,571,11,582
"قزوین","قزوین","مرکزی",107,366,14,2,119,501,7,508
"قزوین","قزوین","مرکزی",108,477,8,5,154,644,15,659
"قزوین","قزوین","مرکزی",109,542,7,0,86,635,6,641
"قزوین","قزوین","مرکزی",110,650,14,4,149,817,7,824
"قزوین","قزوین","مرکزی",111,1034,6,2,100,1142,7,1149
"قزوین","قزوین","مرکزی",112,989,3,5,187,1184,10,1194
"قزوین","قزوین","مرکزی",113,496,2,0,74,572,5,577
"قزوین","قزوین","مرکزی",114,422,4,4,95,525,5,530
"قزوین","قزوین","مرکزی",115,624,2,0,52,678,0,678
"قزوین","قزوین","مرکزی",116,706,4,2,115,827,11,838
"قزوین","قزوین","مرکزی",117,428,6,0,68,502,8,510
"قزوین","قزوین","مرکزی",118,335,4,1,93,433,7,440
"قزوین","قزوین","مرکزی",119,1497,11,5,329,1842,18,1860
"قزوین","قزوین","مرکزی",120,589,12,4,205,810,11,821
"قزوین","قزوین","مرکزی",121,705,21,4,249,979,7,986
"قزوین","قزوین","مرکزی",122,573,21,10,333,937,14,951
"قزوین","قزوین","مرکزی",123,519,7,1,182,709,8,717
"قزوین","قزوین","مرکزی",124,236,19,10,306,571,5,576
"قزوین","قزوین","مرکزی",125,260,9,12,362,643,8,651
"قزوین","قزوین","مرکزی",126,390,25,12,604,1031,20,1051
"قزوین","قزوین","مرکزی",127,346,32,20,711,1109,18,1127
"قزوین","قزوین","مرکزی",128,512,25,7,440,984,12,996
"قزوین","قزوین","مرکزی",129,418,29,4,536,987,13,1000
"قزوین","قزوین","مرکزی",130,412,26,9,535,982,16,998
"قزوین","قزوین","مرکزی",131,315,21,10,418,764,13,777
"قزوین","قزوین","مرکزی",132,376,28,9,732,1145,9,1154
"قزوین","قزوین","مرکزی",133,448,40,11,878,1377,22,1399
"قزوین","قزوین","مرکزی",134,518,37,9,1014,1578,12,1590
"قزوین","قزوین","مرکزی",135,235,29,11,505,780,11,791
"قزوین","قزوین","مرکزی",136,479,34,18,640,1171,20,1191
"قزوین","قزوین","مرکزی",137,314,12,6,492,824,14,838
"قزوین","قزوین","مرکزی",138,344,23,15,916,1298,12,1310
"قزوین","قزوین","مرکزی",139,461,39,22,988,1510,24,1534
"قزوین","قزوین","مرکزی",140,429,35,24,884,1372,7,1379
"قزوین","قزوین","مرکزی",141,277,21,10,489,797,8,805
"قزوین","قزوین","مرکزی",142,482,18,3,253,756,11,767
"قزوین","قزوین","مرکزی",143,396,23,4,297,720,4,724
"قزوین","قزوین","مرکزی",144,589,12,4,306,911,14,925
"قزوین","قزوین","مرکزی",145,545,18,7,323,893,10,903
"قزوین","قزوین","مرکزی",146,462,22,7,240,731,8,739
"قزوین","قزوین","مرکزی",147,302,16,1,186,505,1,506
"قزوین","قزوین","مرکزی",148,223,12,6,207,448,9,457
"قزوین","قزوین","مرکزی",149,513,15,8,473,1009,18,1027
"قزوین","قزوین","مرکزی",150,549,19,10,322,900,18,918
"قزوین","قزوین","مرکزی",151,518,15,24,460,1017,16,1033
"قزوین","قزوین","مرکزی",152,487,25,3,233,748,14,762
"قزوین","قزوین","مرکزی",153,652,25,18,539,1234,28,1262
"قزوین","قزوین","مرکزی",154,371,27,9,305,712,8,720
"قزوین","قزوین","مرکزی",155,836,13,2,234,1085,10,1095
"قزوین","قزوین","مرکزی",156,710,17,4,254,985,18,1003
"قزوین","قزوین","مرکزی",157,958,19,11,314,1302,14,1316
"قزوین","قزوین","مرکزی",158,353,9,7,301,670,7,677
"قزوین","قزوین","مرکزی",159,401,21,8,424,854,11,865
"قزوین","قزوین","مرکزی",160,292,28,12,753,1085,11,1096
"قزوین","قزوین","مرکزی",161,326,27,15,853,1221,13,1234
"قزوین","قزوین","مرکزی",162,300,15,18,894,1227,9,1236
"قزوین","قزوین","مرکزی",163,392,22,12,432,858,12,870
"قزوین","قزوین","مرکزی",164,439,23,13,554,1029,15,1044
"قزوین","قزوین","مرکزی",165,186,15,17,806,1024,7,1031
"قزوین","قزوین","مرکزی",166,188,30,14,989,1221,11,1232
"قزوین","قزوین","مرکزی",167,212,25,21,1127,1385,17,1402
"قزوین","قزوین","مرکزی",168,556,29,6,521,1112,16,1128
"قزوین","قزوین","مرکزی",169,507,35,11,598,1151,23,1174
"قزوین","قزوین","مرکزی",170,377,28,19,591,1015,16,1031
"قزوین","قزوین","مرکزی",171,496,32,12,683,1223,14,1237
"قزوین","قزوین","مرکزی",172,289,38,13,763,1103,12,1115
"قزوین","قزوین","مرکزی",173,248,22,14,575,859,13,872
"قزوین","قزوین","مرکزی",174,522,40,23,1011,1596,18,1614
"قزوین","قزوین","مرکزی",175,335,18,8,512,873,16,889
"قزوین","قزوین","مرکزی",176,617,43,15,609,1284,16,1300
"قزوین","قزوین","مرکزی",177,575,54,16,754,1399,25,1424
"قزوین","قزوین","مرکزی",178,565,18,3,269,855,8,863
"قزوین","قزوین","مرکزی",179,151,11,5,262,429,8,437
"قزوین","قزوین","مرکزی",180,313,19,11,681,1024,15,1039
"قزوین","قزوین","مرکزی",181,273,26,23,666,988,12,1000
"قزوین","قزوین","مرکزی",182,401,42,15,744,1202,19,1221
"قزوین","قزوین","مرکزی",183,513,24,5,411,953,6,959
"قزوین","قزوین","مرکزی",184,411,18,5,475,909,9,918
"قزوین","قزوین","مرکزی",185,712,54,2,705,1473,23,1496
"قزوین","قزوین","مرکزی",186,421,28,7,719,1175,9,1184
"قزوین","قزوین","مرکزی",187,380,28,22,745,1175,15,1190
"قزوین","قزوین","مرکزی",188,186,15,5,267,473,7,480
"قزوین","قزوین","مرکزی",189,352,23,13,749,1137,14,1151
"قزوین","قزوین","مرکزی",190,289,18,7,536,850,14,864
"قزوین","قزوین","مرکزی",191,234,17,9,529,789,10,799
"قزوین","قزوین","مرکزی",192,184,26,10,391,611,4,615
"قزوین","قزوین","مرکزی",193,170,5,0,87,262,4,266
"قزوین","قزوین","مرکزی",194,259,1,1,105,366,4,370
"قزوین","قزوین","مرکزی",195,654,10,5,248,917,22,939
"قزوین","قزوین","مرکزی",196,427,33,19,1124,1603,3,1606
"قزوین","قزوین","مرکزی",197,125,15,2,309,451,6,457
"قزوین","قزوین","مرکزی",198,687,13,10,95,805,0,805
"قزوین","قزوین","مرکزی",199,423,10,3,134,570,6,576
"قزوین","قزوین","مرکزی",200,653,26,2,521,1202,16,1218
"قزوین","قزوین","مرکزی",201,633,30,6,718,1387,16,1403
"قزوین","قزوین","مرکزی",202,339,21,3,379,742,19,761
"قزوین","قزوین","مرکزی",203,189,10,7,198,404,3,407
"قزوین","قزوین","مرکزی",204,559,36,7,498,1100,15,1115
"قزوین","قزوین","مرکزی",235,558,10,7,219,794,13,807
"قزوین","قزوین","مرکزی",236,531,11,11,265,818,19,837
"قزوین","قزوین","مرکزی",237,805,24,7,369,1205,16,1221
"قزوین","قزوین","مرکزی",238,548,28,2,247,825,10,835
"قزوین","قزوین","مرکزی",239,866,39,4,399,1308,7,1315
"قزوین","قزوین","مرکزی",240,1023,35,6,605,1669,17,1686
"قزوین","قزوین","مرکزی",241,829,15,9,401,1254,9,1263
"قزوین","قزوین","مرکزی",242,772,33,8,382,1195,15,1210
"قزوین","قزوین","مرکزی",243,189,4,14,33,240,0,240
"قزوین","قزوین","مرکزی",244,247,9,0,84,340,0,340
"قزوین","قزوین","مرکزی",245,829,7,2,83,921,4,925
"قزوین","قزوین","مرکزی",246,800,9,2,118,929,3,932
"قزوین","قزوین","مرکزی",247,692,12,5,188,897,5,902
"قزوین","قزوین","مرکزی",248,916,6,0,130,1052,7,1059
"قزوین","قزوین","مرکزی",249,703,8,2,172,885,13,898
"قزوین","قزوین","مرکزی",250,896,3,0,99,998,6,1004
"قزوین","قزوین","مرکزی",251,660,4,1,135,800,25,825
"قزوین","قزوین","مرکزی",252,778,7,2,159,946,4,950
"قزوین","قزوین","مرکزی",253,849,7,1,98,955,12,967
"قزوین","قزوین","مرکزی",254,809,14,1,182,1006,3,1009
"قزوین","قزوین","مرکزی",255,1261,8,6,121,1396,15,1411
"قزوین","قزوین","مرکزی",256,825,5,0,63,893,6,899
"قزوین","قزوین","مرکزی",257,829,7,0,150,986,9,995
"قزوین","قزوین","مرکزی",258,551,4,0,70,625,3,628
"قزوین","قزوین","مرکزی",259,649,9,3,133,794,6,800
"قزوین","قزوین","مرکزی",260,1140,3,1,95,1239,6,1245
"قزوین","قزوین","مرکزی",261,933,4,2,51,990,0,990
"قزوین","قزوین","مرکزی",262,892,4,1,88,985,5,990
"قزوین","قزوین","مرکزی",263,678,0,0,31,709,3,712
"قزوین","قزوین","مرکزی",264,647,5,0,52,704,8,712
"قزوین","قزوین","مرکزی",205,682,18,7,198,905,5,910
"قزوین","قزوین","مرکزی",206,634,20,9,284,947,14,961
"قزوین","قزوین","مرکزی",207,205,8,1,148,362,1,363
"قزوین","قزوین","مرکزی",208,683,31,6,374,1094,12,1106
"قزوین","قزوین","مرکزی",209,766,22,16,262,1066,11,1077
"قزوین","قزوین","مرکزی",210,320,22,25,307,674,11,685
"قزوین","قزوین","مرکزی",211,808,16,7,304,1135,14,1149
"قزوین","قزوین","مرکزی",212,748,21,15,488,1272,18,1290
"قزوین","قزوین","مرکزی",213,207,6,3,67,283,2,285
"قزوین","قزوین","مرکزی",214,983,17,4,156,1160,13,1173
"قزوین","قزوین","مرکزی",215,580,8,5,147,740,10,750
"قزوین","قزوین","مرکزی",216,388,10,5,117,520,2,522
"قزوین","قزوین","مرکزی",217,529,13,0,211,753,6,759
"قزوین","قزوین","مرکزی",218,450,23,2,262,737,6,743
"قزوین","قزوین","مرکزی",219,899,21,3,346,1269,11,1280
"قزوین","قزوین","مرکزی",220,778,28,7,463,1276,24,1300
"قزوین","قزوین","مرکزی",221,814,25,7,439,1285,11,1296
"قزوین","قزوین","مرکزی",222,828,33,1,337,1199,9,1208
"قزوین","قزوین","مرکزی",223,622,35,5,347,1009,16,1025
"قزوین","قزوین","مرکزی",224,726,17,2,334,1079,16,1095
"قزوین","قزوین","مرکزی",225,661,27,8,379,1075,12,1087
"قزوین","قزوین","مرکزی",226,512,4,1,73,590,8,598
"قزوین","قزوین","مرکزی",227,412,3,2,126,543,4,547
"قزوین","قزوین","مرکزی",228,193,6,3,79,281,3,284
"قزوین","قزوین","مرکزی",229,570,13,4,227,814,7,821
"قزوین","قزوین","مرکزی",230,478,14,5,313,810,10,820
"قزوین","قزوین","مرکزی",231,1133,23,3,361,1520,22,1542
"قزوین","قزوین","مرکزی",232,957,21,7,493,1478,27,1505
"قزوین","قزوین","مرکزی",233,660,10,5,314,989,14,1003
"قزوین","قزوین","مرکزی",234,546,24,9,370,949,11,960
"قزوین","قزوین","مرکزی",265,840,7,0,66,913,4,917
"قزوین","قزوین","مرکزی",266,789,8,0,128,925,12,937
"قزوین","قزوین","مرکزی",267,1046,3,1,112,1162,5,1167
"قزوین","قزوین","مرکزی",268,752,3,0,70,825,0,825
"قزوین","قزوین","مرکزی",269,687,3,3,105,798,6,804
"قزوین","قزوین","مرکزی",270,1156,6,0,84,1246,3,1249
"قزوین","قزوین","مرکزی",271,1119,9,2,164,1294,10,1304
"قزوین","قزوین","مرکزی",272,799,3,1,103,906,7,913
"قزوین","قزوین","مرکزی",273,1485,8,6,306,1805,12,1817
"قزوین","قزوین","مرکزی",274,526,0,1,47,574,3,577
"قزوین","قزوین","مرکزی",275,674,3,2,161,840,10,850
"قزوین","قزوین","مرکزی",276,970,8,4,158,1140,5,1145
"قزوین","قزوین","مرکزی",277,685,6,1,73,765,0,765
"قزوین","قزوین","مرکزی",278,640,3,2,97,742,9,751
"قزوین","قزوین","مرکزی",279,1349,20,2,84,1455,8,1463
"قزوین","قزوین","مرکزی",280,455,3,1,121,580,6,586
"قزوین","قزوین","مرکزی",281,814,15,1,90,920,6,926
"قزوین","قزوین","مرکزی",282,682,6,0,95,783,7,790
"قزوین","قزوین","مرکزی",283,435,6,5,56,502,4,506
"قزوین","قزوین","مرکزی",284,545,3,0,226,774,16,790
"قزوین","قزوین","مرکزی",285,760,9,7,149,925,9,934
"قزوین","قزوین","مرکزی",286,778,2,2,74,856,5,861
"قزوین","قزوین","مرکزی",287,749,5,4,238,996,11,1007
"قزوین","قزوین","مرکزی",288,1421,3,1,144,1569,10,1579
"قزوین","قزوین","مرکزی",289,1025,1,1,105,1132,5,1137
"قزوین","قزوین","مرکزی",290,987,8,2,204,1201,14,1215
"قزوین","قزوین","مرکزی",291,731,1,2,100,834,0,834
"قزوین","قزوین","مرکزی",292,595,5,1,93,694,4,698
"قزوین","قزوین","مرکزی",293,625,7,3,181,816,12,828
"قزوین","قزوین","مرکزی",294,690,3,1,139,833,5,838
"قزوین","قزوین","مرکزی",295,970,9,1,81,1061,8,1069
"قزوین","قزوین","مرکزی",296,973,11,3,248,1235,11,1246
"قزوین","قزوین","مرکزی",297,719,4,1,146,870,0,870
"قزوین","قزوین","مرکزی",298,755,2,2,56,815,4,819
"قزوین","قزوین","مرکزی",299,651,3,2,118,774,8,782
"قزوین","قزوین","مرکزی",300,861,3,5,28,897,1,898
"قزوین","قزوین","مرکزی",301,472,4,1,136,613,3,616
"قزوین","قزوین","مرکزی",302,659,5,35,86,785,3,788
"قزوین","قزوین","مرکزی",303,930,3,1,52,986,2,988
"قزوین","قزوین","مرکزی",304,970,5,2,126,1103,11,1114
"قزوین","قزوین","مرکزی",305,630,1,3,41,675,4,679
"قزوین","قزوین","مرکزی",306,454,0,0,98,552,3,555
"قزوین","قزوین","مرکزی",307,780,1,2,43,826,5,831
"قزوین","قزوین","مرکزی",308,362,1,1,36,400,1,401
"قزوین","قزوین","مرکزی",309,334,6,4,136,480,1,481
"قزوین","قزوین","مرکزی",310,626,10,0,66,702,3,705
"قزوین","قزوین","مرکزی",311,735,0,0,50,785,0,785
"قزوین","قزوین","مرکزی",312,430,0,1,116,547,6,553
"قزوین","قزوین","مرکزی",313,217,4,1,73,295,4,299
"قزوین","قزوین","مرکزی",314,378,2,1,50,431,4,435
"قزوین","قزوین","مرکزی",315,311,5,2,57,375,3,378
"قزوین","قزوین","مرکزی",316,608,0,2,292,902,4,906
"قزوین","قزوین","مرکزی",317,99,2,3,61,165,2,167
"قزوین","قزوین","رودبار_الموت",1,721,12,4,357,1094,9,1103
"قزوین","قزوین","رودبار_الموت",2,391,1,9,85,486,1,487
"قزوین","قزوین","رودبار_الموت",3,93,1,0,5,99,0,99
"قزوین","قزوین","رودبار_الموت",4,318,2,1,78,399,1,400
"قزوین","قزوین","رودبار_الموت",5,180,1,0,57,238,4,242
"قزوین","قزوین","رودبار_الموت",6,181,2,0,66,249,1,250
"قزوین","قزوین","رودبار_الموت",7,92,2,0,28,122,0,122
"قزوین","قزوین","رودبار_الموت",8,179,3,1,55,238,3,241
"قزوین","قزوین","رودبار_الموت",9,112,1,1,24,138,0,138
"قزوین","قزوین","رودبار_الموت",10,397,4,1,41,443,0,443
"قزوین","قزوین","رودبار_الموت",11,310,1,0,8,319,0,319
"قزوین","قزوین","رودبار_الموت",12,575,3,1,88,667,0,667
"قزوین","قزوین","رودبار_الموت",13,687,9,0,121,817,4,821
"قزوین","قزوین","رودبار_الموت",14,362,2,1,50,415,6,421
"قزوین","قزوین","رودبار_الموت",15,312,3,0,98,413,3,416
"قزوین","قزوین","رودبار_الموت",16,231,5,0,87,323,0,323
"قزوین","قزوین","رودبار_الموت",17,242,1,0,163,406,1,407
"قزوین","قزوین","رودبار_الموت",18,138,1,0,29,168,2,170
"قزوین","قزوین","رودبار_الموت",19,268,0,0,56,324,0,324
"قزوین","قزوین","رودبار_الموت",20,106,0,1,16,123,0,123
"قزوین","قزوین","رودبار_الموت",21,93,1,0,21,115,0,115
"قزوین","قزوین","رودبار_الموت",22,333,0,4,81,418,3,421
"قزوین","قزوین","رودبار_الموت",23,419,1,0,106,526,3,529
"قزوین","قزوین","رودبار_الموت",24,432,4,1,190,627,1,628
"قزوین","قزوین","رودبار_الموت",25,284,1,0,82,367,0,367
"قزوین","قزوین","رودبار_شهرستان",1,162,3,8,81,254,1,255
"قزوین","قزوین","رودبار_شهرستان",2,178,0,9,102,289,1,290
"قزوین","قزوین","رودبار_شهرستان",3,75,1,0,46,122,2,124
"قزوین","قزوین","رودبار_شهرستان",4,379,5,7,75,466,9,475
"قزوین","قزوین","رودبار_شهرستان",5,431,3,0,61,495,2,497
"قزوین","قزوین","رودبار_شهرستان",6,998,6,1,161,1166,5,1171
"قزوین","قزوین","رودبار_شهرستان",7,216,1,0,76,293,1,294
"قزوین","قزوین","رودبار_شهرستان",8,478,1,0,81,560,0,560
"قزوین","قزوین","رودبار_شهرستان",9,478,2,0,116,596,5,601
"قزوین","قزوین","رودبار_شهرستان",10,392,3,0,102,497,3,500
"قزوین","قزوین","رودبار_شهرستان",11,607,6,0,35,648,2,650
"قزوین","قزوین","رودبار_شهرستان",12,242,0,0,23,265,2,267
"قزوین","قزوین","رودبار_شهرستان",13,357,2,0,23,382,0,382
"قزوین","قزوین","رودبار_شهرستان",14,429,1,1,42,473,5,478
"قزوین","قزوین","رودبار_شهرستان",15,217,1,1,46,265,3,268
"قزوین","قزوین","رودبار_شهرستان",16,231,1,0,66,298,2,300
"قزوین","قزوین","رودبار_شهرستان",17,225,1,3,55,284,6,290
"قزوین","قزوین","رودبار_شهرستان",18,110,0,0,86,196,4,200
"قزوین","قزوین","رودبار_شهرستان",19,449,2,26,57,534,3,537
"قزوین","قزوین","رودبار_شهرستان",20,342,2,0,45,389,1,390
"قزوین","قزوین","رودبار_شهرستان",21,251,0,0,14,265,1,266
"قزوین","قزوین","رودبار_شهرستان",22,327,1,0,38,366,0,366
"قزوین","قزوین","رودبار_شهرستان",23,271,0,0,48,319,7,326
"قزوین","قزوین","رودبار_شهرستان",24,383,0,10,70,463,4,467
"قزوین","قزوین","رودبار_شهرستان",25,256,2,1,37,296,2,298
"قزوین","قزوین","طارم_سفلی",1,230,7,0,166,403,2,405
"قزوین","قزوین","طارم_سفلی",2,325,0,0,31,356,5,361
"قزوین","قزوین","طارم_سفلی",3,495,1,0,20,516,1,517
"قزوین","قزوین","طارم_سفلی",4,466,1,1,17,485,2,487
"قزوین","قزوین","طارم_سفلی",5,248,0,0,12,260,0,260
"قزوین","قزوین","طارم_سفلی",6,247,0,0,53,300,0,300
"قزوین","قزوین","طارم_سفلی",7,673,0,2,17,692,3,695
"قزوین","قزوین","طارم_سفلی",8,573,4,0,79,656,12,668
"قزوین","قزوین","طارم_سفلی",9,380,0,1,16,397,2,399
"قزوین","قزوین","طارم_سفلی",10,528,4,2,171,705,6,711
"قزوین","قزوین","طارم_سفلی",11,351,0,0,56,407,0,407
"قزوین","قزوین","طارم_سفلی",12,249,1,0,43,293,0,293
"قزوین","قزوین","طارم_سفلی",13,279,0,0,76,355,4,359
"قزوین","قزوین","طارم_سفلی",14,519,2,2,102,625,0,625
"قزوین","قزوین","طارم_سفلی",15,163,1,2,31,197,0,197
"قزوین","قزوین","طارم_سفلی",16,148,0,0,41,189,1,190
"قزوین","قزوین","طارم_سفلی",17,387,1,0,5,393,0,393
"قزوین","قزوین","طارم_سفلی",18,627,3,1,120,751,3,754
"قزوین","قزوین","طارم_سفلی",19,285,1,1,54,341,0,341
"قزوین","قزوین","طارم_سفلی",20,394,2,3,72,471,6,477
"قزوین","قزوین","طارم_سفلی",21,598,0,1,60,659,6,665
"قزوین","قزوین","طارم_سفلی",22,204,2,0,32,238,2,240
"قزوین","قزوین","طارم_سفلی",23,133,1,0,13,147,0,147
"قزوین","قزوین","طارم_سفلی",24,307,1,2,136,446,12,458
"قزوین","قزوین","طارم_سفلی",25,176,0,0,6,182,0,182
"قزوین","قزوین","کوهین",1,709,7,4,135,855,11,866
"قزوین","قزوین","کوهین",2,814,4,1,138,957,8,965
"قزوین","قزوین","کوهین",3,935,3,2,122,1062,18,1080
"قزوین","قزوین","کوهین",4,598,2,0,73,673,4,677
"قزوین","قزوین","کوهین",5,261,1,0,35,297,1,298
"قزوین","قزوین","کوهین",6,580,6,0,29,615,2,617
"قزوین","قزوین","کوهین",7,240,0,0,17,257,1,258
"قزوین","قزوین","کوهین",8,172,0,0,24,196,1,197
"قزوین","قزوین","کوهین",9,351,2,0,36,389,2,391
"قزوین","قزوین","کوهین",10,369,1,0,56,426,1,427
"قزوین","قزوین","کوهین",11,575,2,0,12,589,4,593
"قزوین","قزوین","کوهین",12,507,8,1,135,651,3,654
"قزوین","قزوین","کوهین",13,368,2,0,88,458,4,462
"قزوین","قزوین","کوهین",14,637,6,0,108,751,3,754
"قزوین","قزوین","کوهین",15,640,2,0,56,698,4,702
"قزوین","قزوین","کوهین",16,740,1,0,88,829,6,835
"قزوین","قزوین","کوهین",17,657,1,1,22,681,1,682
"قزوین","قزوین","کوهین",18,223,1,1,17,242,2,244
"قزوین","قزوین","کوهین",19,299,0,1,23,323,3,326
"قزوین","قزوین","کوهین",20,175,1,0,18,194,0,194
"قم","قم","مرکزی",1,1303,68,7,385,1763,13,1776
"قم","قم","مرکزی",2,1677,45,6,281,2009,30,2039
"قم","قم","مرکزی",3,1198,47,12,253,1510,19,1529
"قم","قم","مرکزی",4,1045,66,3,155,1269,2,1271
"قم","قم","مرکزی",5,1596,76,9,395,2076,22,2098
"قم","قم","مرکزی",6,1276,88,23,403,1790,7,1797
"قم","قم","مرکزی",7,354,24,0,191,569,15,584
"قم","قم","مرکزی",8,478,41,7,289,815,13,828
"قم","قم","مرکزی",9,715,59,10,478,1262,36,1298
"قم","قم","مرکزی",10,851,51,4,339,1245,12,1257
"قم","قم","مرکزی",11,1150,64,4,454,1672,30,1702
"قم","قم","مرکزی",12,703,36,3,182,924,19,943
"قم","قم","مرکزی",13,574,67,5,378,1024,47,1071
"قم","قم","مرکزی",14,699,60,6,268,1033,64,1097
"قم","قم","مرکزی",15,932,51,5,349,1337,26,1363
"قم","قم","مرکزی",16,902,66,9,376,1353,35,1388
"قم","قم","مرکزی",17,1017,79,6,449,1551,23,1574
"قم","قم","مرکزی",18,233,41,0,65,339,6,345
"قم","قم","مرکزی",19,675,35,6,231,947,15,962
"قم","قم","مرکزی",20,468,22,0,145,635,12,647
"قم","قم","مرکزی",21,709,68,5,321,1103,41,1144
"قم","قم","مرکزی",22,824,52,4,410,1290,35,1325
"قم","قم","مرکزی",23,321,51,0,111,483,7,490
"قم","قم","مرکزی",24,279,9,0,116,404,7,411
"قم","قم","مرکزی",25,419,43,13,255,730,24,754
"قم","قم","مرکزی",26,727,50,11,343,1131,37,1168
"قم","قم","مرکزی",27,909,65,8,313,1295,4,1299
"قم","قم","مرکزی",28,1049,25,2,246,1322,35,1357
"قم","قم","مرکزی",29,504,16,1,105,626,6,632
"قم","قم","مرکزی",30,849,34,6,223,1112,20,1132
"قم","قم","مرکزی",31,908,30,5,281,1224,39,1263
"قم","قم","مرکزی",32,251,4,0,43,298,4,302
"قم","قم","مرکزی",33,707,25,4,280,1016,25,1041
"قم","قم","مرکزی",34,876,41,4,223,1144,30,1174
"قم","قم","مرکزی",35,690,24,10,210,934,22,956
"قم","قم","مرکزی",36,466,21,3,199,689,16,705
"قم","قم","مرکزی",37,641,25,3,206,875,20,895
"قم","قم","مرکزی",38,915,22,5,143,1085,13,1098
"قم","قم","مرکزی",39,1204,30,2,228,1464,24,1488
"قم","قم","مرکزی",40,1372,68,7,391,1838,3,1841
"قم","قم","مرکزی",41,1018,49,7,455,1529,25,1554
"قم","قم","مرکزی",42,668,32,7,275,982,27,1009
"قم","قم","مرکزی",43,888,36,6,436,1366,31,1397
"قم","قم","مرکزی",44,1126,26,1,272,1425,30,1455
"قم","قم","مرکزی",45,559,35,4,277,875,19,894
"قم","قم","مرکزی",46,763,27,0,209,999,22,1021
"قم","قم","مرکزی",47,1151,51,6,464,1672,28,1700
"قم","قم","مرکزی",48,1316,52,2,323,1693,27,1720
"قم","قم","مرکزی",49,1056,47,2,354,1459,38,1497
"قم","قم","مرکزی",50,967,34,7,186,1194,20,1214
"قم","قم","مرکزی",51,1339,90,4,428,1861,37,1898
"قم","قم","مرکزی",52,1105,48,3,310,1466,25,1491
"قم","قم","مرکزی",53,1037,32,9,218,1296,9,1305
"قم","قم","مرکزی",54,1316,33,3,266,1618,21,1639
"قم","قم","مرکزی",55,1178,31,1,412,1622,40,1662
"قم","قم","مرکزی",56,1372,18,4,242,1636,16,1652
"قم","قم","مرکزی",57,498,34,5,167,704,14,718
"قم","قم","مرکزی",58,636,23,1,106,766,10,776
"قم","قم","مرکزی",59,925,51,2,374,1352,32,1384
"قم","قم","مرکزی",60,1008,36,6,297,1347,26,1373
"قم","قم","مرکزی",61,928,25,0,273,1226,15,1241
"قم","قم","مرکزی",62,1501,43,4,284,1832,44,1876
"قم","قم","مرکزی",63,1129,52,3,310,1494,21,1515
"قم","قم","مرکزی",64,664,66,4,374,1108,18,1126
"قم","قم","مرکزی",65,864,66,3,426,1359,21,1380
"قم","قم","مرکزی",66,1509,59,7,422,1997,32,2029
"قم","قم","مرکزی",67,1708,44,3,263,2018,33,2051
"قم","قم","مرکزی",68,1133,14,2,156,1305,12,1317
"قم","قم","مرکزی",69,1280,44,2,326,1652,17,1669
"قم","قم","مرکزی",70,882,15,3,174,1074,20,1094
"قم","قم","مرکزی",71,1287,18,2,272,1579,21,1600
"قم","قم","مرکزی",72,1332,30,9,304,1675,37,1712
"قم","قم","مرکزی",73,615,56,13,588,1272,36,1308
"قم","قم","مرکزی",74,764,38,9,295,1106,15,1121
"قم","قم","مرکزی",75,964,85,53,715,1817,2,1819
"قم","قم","مرکزی",76,680,52,4,510,1246,31,1277
"قم","قم","مرکزی",77,1173,33,4,338,1548,34,1582
"قم","قم","مرکزی",78,780,51,11,502,1344,31,1375
"قم","قم","مرکزی",79,790,59,7,722,1578,77,1655
"قم","قم","مرکزی",80,840,65,2,544,1451,49,1500
"قم","قم","مرکزی",81,690,65,4,427,1186,40,1226
"قم","قم","مرکزی",82,593,59,12,495,1159,38,1197
"قم","قم","مرکزی",83,272,23,0,237,532,12,544
"قم","قم","مرکزی",84,868,60,10,790,1728,35,1763
"قم","قم","مرکزی",85,790,40,5,530,1365,24,1389
"قم","قم","مرکزی",86,500,54,11,568,1133,15,1148
"قم","قم","مرکزی",87,728,84,11,942,1765,34,1799
"قم","قم","مرکزی",88,994,79,6,767,1846,40,1886
"قم","قم","مرکزی",89,711,40,7,354,1112,17,1129
"قم","قم","مرکزی",90,596,52,6,665,1319,41,1360
"قم","قم","مرکزی",91,1063,78,16,702,1859,34,1893
"قم","قم","مرکزی",92,123,5,0,29,157,3,160
"قم","قم","مرکزی",93,114,8,0,37,159,1,160
"قم","قم","مرکزی",94,471,13,1,161,646,8,654
"قم","قم","مرکزی",95,211,9,2,93,315,3,318
"قم","قم","مرکزی",96,170,8,1,96,275,0,275
"قم","قم","مرکزی",97,230,12,0,150,392,5,397
"قم","قم","مرکزی",98,717,33,6,234,990,17,1007
"قم","قم","مرکزی",99,331,6,2,83,422,3,425
"قم","قم","مرکزی",100,524,61,4,243,832,10,842
"قم","قم","مرکزی",101,513,36,3,219,771,13,784
"قم","قم","مرکزی",102,652,34,6,289,981,27,1008
"قم","قم","مرکزی",103,671,65,8,357,1101,30,1131
"قم","قم","مرکزی",104,622,40,7,462,1131,24,1155
"قم","قم","مرکزی",105,340,6,4,173,523,6,529
"قم","قم","مرکزی",106,526,13,3,125,667,24,691
"قم","قم","مرکزی",107,1089,39,4,376,1508,29,1537
"قم","قم","مرکزی",108,1054,21,3,322,1400,20,1420
"قم","قم","مرکزی",109,963,40,2,380,1385,26,1411
"قم","قم","مرکزی",110,1405,19,6,332,1762,24,1786
"قم","قم","مرکزی",111,1198,33,5,400,1636,15,1651
"قم","قم","مرکزی",112,896,30,3,323,1252,18,1270
"قم","قم","مرکزی",113,713,14,4,217,948,15,963
"قم","قم","مرکزی",114,1415,25,5,441,1886,24,1910
"قم","قم","مرکزی",115,1351,15,7,204,1577,12,1589
"قم","قم","مرکزی",116,1222,35,3,351,1611,28,1639
"قم","قم","مرکزی",117,743,22,3,239,1007,13,1020
"قم","قم","مرکزی",118,1229,20,6,365,1620,46,1666
"قم","قم","مرکزی",119,1380,15,3,475,1873,29,1902
"قم","قم","مرکزی",120,1213,18,6,249,1486,18,1504
"قم","قم","مرکزی",121,1319,24,1,387,1731,17,1748
"قم","قم","مرکزی",122,1508,14,2,222,1746,9,1755
"قم","قم","مرکزی",123,1078,9,1,183,1271,16,1287
"قم","قم","مرکزی",124,1229,11,1,245,1486,13,1499
"قم","قم","مرکزی",125,1370,6,1,155,1532,14,1546
"قم","قم","مرکزی",126,786,60,10,260,1116,42,1158
"قم","قم","مرکزی",127,1235,76,10,550,1871,29,1900
"قم","قم","مرکزی",128,1077,67,12,296,1452,22,1474
"قم","قم","مرکزی",129,889,22,2,225,1138,12,1150
"قم","قم","مرکزی",130,802,16,1,131,950,8,958
"قم","قم","مرکزی",131,1457,57,5,385,1904,41,1945
"قم","قم","مرکزی",132,993,31,3,170,1197,10,1207
"قم","قم","مرکزی",133,801,12,3,281,1097,17,1114
"قم","قم","مرکزی",134,755,30,5,313,1103,26,1129
"قم","قم","مرکزی",135,537,20,10,216,783,13,796
"قم","قم","مرکزی",136,1224,66,12,461,1763,36,1799
"قم","قم","مرکزی",137,600,39,13,389,1041,15,1056
"قم","قم","مرکزی",138,606,67,14,369,1056,10,1066
"قم","قم","مرکزی",139,661,72,5,305,1043,14,1057
"قم","قم","مرکزی",140,785,58,4,292,1139,13,1152
"قم","قم","مرکزی",141,1182,49,8,414,1653,39,1692
"قم","قم","مرکزی",142,580,28,3,242,853,10,863
"قم","قم","مرکزی",143,553,92,11,211,867,23,890
"قم","قم","مرکزی",144,861,61,14,623,1559,43,1602
"قم","قم","مرکزی",145,1155,66,4,364,1589,18,1607
"قم","قم","مرکزی",146,883,57,10,391,1341,21,1362
"قم","قم","مرکزی",147,825,31,10,246,1112,16,1128
"قم","قم","مرکزی",148,1398,41,3,326,1768,34,1802
"قم","قم","مرکزی",149,842,32,4,172,1050,20,1070
"قم","قم","مرکزی",150,1122,23,9,422,1576,23,1599
"قم","قم","مرکزی",151,1023,41,9,470,1543,28,1571
"قم","قم","مرکزی",152,1308,41,2,353,1704,12,1716
"قم","قم","مرکزی",153,1166,39,4,396,1605,18,1623
"قم","قم","مرکزی",154,1509,31,9,373,1922,19,1941
"قم","قم","مرکزی",155,1156,30,1,253,1440,30,1470
"قم","قم","مرکزی",156,946,25,1,183,1155,11,1166
"قم","قم","مرکزی",157,1055,45,3,406,1509,34,1543
"قم","قم","مرکزی",158,899,23,0,304,1226,27,1253
"قم","قم","مرکزی",159,1257,26,5,337,1625,23,1648
"قم","قم","مرکزی",160,1567,13,5,236,1821,15,1836
"قم","قم","مرکزی",161,1379,28,6,352,1765,25,1790
"قم","قم","مرکزی",162,850,11,0,146,1007,9,1016
"قم","قم","مرکزی",163,809,22,2,310,1143,22,1165
"قم","قم","مرکزی",164,962,15,3,271,1251,15,1266
"قم","قم","مرکزی",165,1054,17,1,173,1245,13,1258
"قم","قم","مرکزی",166,1343,11,2,163,1519,8,1527
"قم","قم","مرکزی",167,1428,11,1,265,1705,11,1716
"قم","قم","مرکزی",168,656,14,2,161,833,13,846
"قم","قم","مرکزی",169,1016,17,3,163,1199,12,1211
"قم","قم","مرکزی",170,1061,15,6,137,1219,9,1228
"قم","قم","مرکزی",171,1356,20,8,247,1631,19,1650
"قم","قم","مرکزی",172,1458,9,1,154,1622,4,1626
"قم","قم","مرکزی",173,1521,21,11,216,1769,26,1795
"قم","قم","مرکزی",174,1472,8,1,119,1600,10,1610
"قم","قم","مرکزی",175,1378,18,2,182,1580,15,1595
"قم","قم","مرکزی",176,1926,9,3,161,2099,23,2122
"قم","قم","مرکزی",177,1253,5,1,229,1488,6,1494
"قم","قم","مرکزی",178,1359,14,0,103,1476,5,1481
"قم","قم","مرکزی",179,1216,16,15,440,1687,24,1711
"قم","قم","مرکزی",180,1146,22,7,415,1590,27,1617
"قم","قم","مرکزی",181,1172,21,13,284,1490,18,1508
"قم","قم","مرکزی",182,390,6,1,121,518,5,523
"قم","قم","مرکزی",183,732,8,2,247,989,12,1001
"قم","قم","مرکزی",184,717,17,4,383,1121,12,1133
"قم","قم","مرکزی",185,1664,51,11,839,2565,30,2595
"قم","قم","مرکزی",186,339,14,0,162,515,5,520
"قم","قم","مرکزی",187,1002,20,0,441,1463,24,1487
"قم","قم","مرکزی",188,1117,15,3,277,1412,11,1423
"قم","قم","مرکزی",189,744,8,1,280,1033,6,1039
"قم","قم","مرکزی",190,1126,24,3,368,1521,16,1537
"قم","قم","مرکزی",191,897,19,2,360,1278,19,1297
"قم","قم","مرکزی",192,1068,7,6,206,1287,12,1299
"قم","قم","مرکزی",193,1524,20,3,331,1878,29,1907
"قم","قم","مرکزی",194,726,18,3,236,983,12,995
"قم","قم","مرکزی",195,1320,13,0,368,1701,16,1717
"قم","قم","مرکزی",196,1486,14,2,267,1769,17,1786
"قم","قم","مرکزی",197,1189,7,3,217,1416,11,1427
"قم","قم","مرکزی",198,1212,9,7,290,1518,14,1532
"قم","قم","مرکزی",199,1495,16,0,261,1772,15,1787
"قم","قم","مرکزی",200,1486,27,5,575,2093,34,2127
"قم","قم","مرکزی",201,1468,13,1,278,1760,9,1769
"قم","قم","مرکزی",202,1140,12,2,273,1427,21,1448
"قم","قم","مرکزی",203,1353,4,4,182,1543,0,1543
"قم","قم","مرکزی",204,2014,15,11,305,2345,14,2359
"قم","قم","مرکزی",205,1130,12,0,268,1410,0,1410
"قم","قم","مرکزی",206,1118,7,1,187,1313,14,1327
"قم","قم","مرکزی",207,1516,10,14,283,1823,16,1839
"قم","قم","مرکزی",208,1097,12,5,270,1384,13,1397
"قم","قم","مرکزی",209,231,6,1,104,342,8,350
"قم","قم","مرکزی",210,253,13,1,101,368,9,377
"قم","قم","مرکزی",211,256,6,1,77,340,6,346
"قم","قم","مرکزی",212,727,37,2,260,1026,12,1038
"قم","قم","مرکزی",213,386,6,3,162,557,6,563
"قم","قم","مرکزی",214,613,12,2,102,729,9,738
"قم","قم","مرکزی",215,628,19,1,295,943,15,958
"قم","قم","مرکزی",216,966,45,4,596,1611,23,1634
"قم","قم","مرکزی",217,592,35,3,343,973,18,991
"قم","قم","مرکزی",218,742,33,1,361,1137,22,1159
"قم","قم","مرکزی",219,375,17,2,149,543,10,553
"قم","قم","مرکزی",220,682,14,3,198,897,18,915
"قم","قم","مرکزی",221,1140,27,3,250,1420,35,1455
"قم","قم","مرکزی",222,871,34,4,320,1229,15,1244
"قم","قم","مرکزی",223,1106,25,7,384,1522,20,1542
"قم","قم","مرکزی",224,994,25,5,272,1296,16,1312
"قم","قم","مرکزی",225,674,11,0,209,894,6,900
"قم","قم","مرکزی",226,867,20,1,215,1103,12,1115
"قم","قم","مرکزی",227,1525,39,4,447,2015,28,2043
"قم","قم","مرکزی",228,1497,54,9,679,2239,32,2271
"قم","قم","مرکزی",229,1401,46,8,631,2086,40,2126
"قم","قم","مرکزی",230,875,46,13,585,1519,45,1564
"قم","قم","مرکزی",231,849,32,7,548,1436,28,1464
"قم","قم","مرکزی",232,487,12,6,145,650,15,665
"قم","قم","مرکزی",233,597,8,1,117,723,13,736
"قم","قم","مرکزی",234,706,31,11,427,1175,24,1199
"قم","قم","مرکزی",235,687,26,9,307,1029,17,1046
"قم","قم","مرکزی",236,491,21,1,187,700,11,711
"قم","قم","مرکزی",237,884,12,3,173,1072,22,1094
"قم","قم","مرکزی",238,1109,38,10,378,1535,37,1572
"قم","قم","مرکزی",239,995,19,0,323,1337,26,1363
"قم","قم","مرکزی",240,1119,28,3,445,1595,24,1619
"قم","قم","مرکزی",241,817,16,2,269,1104,21,1125
"قم","قم","مرکزی",242,715,18,4,205,942,10,952
"قم","قم","مرکزی",243,786,31,2,359,1178,25,1203
"قم","قم","مرکزی",244,1460,39,6,576,2081,35,2116
"قم","قم","مرکزی",245,612,12,3,220,847,18,865
"قم","قم","مرکزی",246,833,14,1,142,990,8,998
"قم","قم","مرکزی",247,649,54,8,447,1158,34,1192
"قم","قم","مرکزی",248,953,38,16,741,1748,35,1783
"قم","قم","مرکزی",249,797,28,7,377,1209,34,1243
"قم","قم","مرکزی",250,884,35,6,346,1271,32,1303
"قم","قم","مرکزی",251,1295,40,2,355,1692,45,1737
"قم","قم","مرکزی",252,1536,23,5,350,1914,36,1950
"قم","قم","مرکزی",253,512,15,2,180,709,16,725
"قم","قم","مرکزی",254,1348,36,3,428,1815,39,1854
"قم","قم","مرکزی",255,1137,46,3,455,1641,35,1676
"قم","قم","مرکزی",256,1193,45,1,332,1571,25,1596
"قم","قم","مرکزی",257,949,72,3,637,1661,31,1692
"قم","قم","مرکزی",258,745,33,1,319,1098,27,1125
"قم","قم","مرکزی",259,843,55,10,777,1685,34,1719
"قم","قم","مرکزی",260,850,51,12,554,1467,32,1499
"قم","قم","مرکزی",261,770,37,1,439,1247,36,1283
"قم","قم","مرکزی",262,944,37,2,334,1317,28,1345
"قم","قم","مرکزی",263,846,31,6,464,1347,23,1370
"قم","قم","مرکزی",264,978,36,3,324,1341,18,1359
"قم","قم","مرکزی",265,1176,63,8,673,1920,40,1960
"قم","قم","مرکزی",266,1272,51,4,388,1715,26,1741
"قم","قم","مرکزی",267,898,20,10,375,1303,24,1327
"قم","قم","مرکزی",268,1182,19,7,283,1491,13,1504
"قم","قم","مرکزی",269,992,37,3,518,1550,29,1579
"قم","قم","مرکزی",270,978,20,1,223,1222,15,1237
"قم","قم","مرکزی",271,1027,38,8,492,1565,30,1595
"قم","قم","مرکزی",272,1247,54,6,461,1768,33,1801
"قم","قم","مرکزی",273,991,39,3,469,1502,16,1518
"قم","قم","مرکزی",274,1292,25,5,323,1645,37,1682
"قم","قم","مرکزی",275,1060,33,6,370,1469,25,1494
"قم","قم","مرکزی",276,527,14,5,213,759,27,786
"قم","قم","مرکزی",277,676,13,4,176,869,17,886
"قم","قم","مرکزی",278,1070,28,9,491,1598,43,1641
"قم","قم","مرکزی",279,1048,25,4,484,1561,18,1579
"قم","قم","مرکزی",280,1001,19,1,314,1335,19,1354
"قم","قم","مرکزی",281,353,27,3,226,609,11,620
"قم","قم","مرکزی",282,1237,28,3,411,1679,34,1713
"قم","قم","مرکزی",283,1441,31,6,429,1907,32,1939
"قم","قم","مرکزی",284,1401,20,1,255,1677,4,1681
"قم","قم","مرکزی",285,1262,19,0,309,1590,31,1621
"قم","قم","مرکزی",286,1155,13,0,272,1440,19,1459
"قم","قم","مرکزی",287,1036,21,2,419,1478,26,1504
"قم","قم","مرکزی",288,598,12,2,130,742,9,751
"قم","قم","مرکزی",289,1047,20,2,247,1316,14,1330
"قم","قم","مرکزی",290,1657,36,7,521,2221,22,2243
"قم","قم","مرکزی",291,976,28,5,387,1396,30,1426
"قم","قم","مرکزی",292,940,25,0,182,1147,23,1170
"قم","قم","مرکزی",293,877,20,2,193,1092,8,1100
"قم","قم","مرکزی",294,1185,37,5,414,1641,27,1668
"قم","قم","مرکزی",295,1272,17,1,210,1500,10,1510
"قم","قم","مرکزی",296,1174,16,0,260,1450,22,1472
"قم","قم","مرکزی",297,965,15,1,211,1192,12,1204
"قم","قم","مرکزی",298,1390,28,6,461,1885,31,1916
"قم","قم","مرکزی",299,1030,26,2,233,1291,32,1323
"قم","قم","مرکزی",300,1399,15,2,186,1602,13,1615
"قم","قم","مرکزی",301,1704,18,3,179,1904,20,1924
"قم","قم","مرکزی",302,1526,15,3,184,1728,32,1760
"قم","قم","مرکزی",303,1449,15,1,250,1715,0,1715
"قم","قم","مرکزی",304,1612,10,3,142,1767,6,1773
"قم","قم","مرکزی",305,1908,36,3,466,2413,24,2437
"قم","قم","مرکزی",306,1857,22,0,232,2111,17,2128
"قم","قم","مرکزی",307,1380,21,2,219,1622,19,1641
"قم","قم","مرکزی",308,1222,5,1,74,1302,20,1322
"قم","قم","مرکزی",309,1369,19,6,412,1806,22,1828
"قم","قم","مرکزی",310,244,10,3,104,361,8,369
"قم","قم","مرکزی",311,214,11,3,72,300,1,301
"قم","قم","مرکزی",312,158,12,1,52,223,3,226
"قم","قم","مرکزی",313,439,27,11,201,678,22,700
"قم","قم","مرکزی",314,90,3,0,30,123,3,126
"قم","قم","مرکزی",315,192,1,0,37,230,1,231
"قم","قم","مرکزی",316,246,11,1,103,361,1,362
"قم","قم","مرکزی",317,378,30,7,196,611,15,626
"قم","قم","مرکزی",318,634,47,8,412,1101,26,1127
"قم","قم","مرکزی",319,690,85,14,608,1397,42,1439
"قم","قم","مرکزی",320,930,90,15,723,1758,40,1798
"قم","قم","مرکزی",321,476,71,12,695,1254,31,1285
"قم","قم","مرکزی",322,661,58,10,652,1381,25,1406
"قم","قم","مرکزی",323,772,67,20,542,1401,32,1433
"قم","قم","مرکزی",324,485,49,3,344,881,15,896
"قم","قم","مرکزی",325,1008,98,14,867,1987,64,2051
"قم","قم","مرکزی",326,557,78,5,329,969,30,999
"قم","قم","مرکزی",327,315,23,7,332,677,16,693
"قم","قم","مرکزی",328,596,72,15,748,1431,33,1464
"قم","قم","مرکزی",329,805,91,10,656,1562,39,1601
"قم","قم","مرکزی",330,582,89,21,1207,1899,70,1969
"قم","قم","مرکزی",331,737,100,19,1017,1873,129,2002
"قم","قم","مرکزی",332,465,55,10,549,1079,21,1100
"قم","قم","مرکزی",333,668,108,15,1323,2114,86,2200
"قم","قم","مرکزی",334,1130,109,15,888,2142,50,2192
"قم","قم","مرکزی",335,494,39,6,665,1204,29,1233
"قم","قم","مرکزی",336,884,73,5,170,1132,17,1149
"قم","قم","مرکزی",337,805,52,4,99,960,1,961
"قم","قم","مرکزی",338,1244,73,2,206,1525,21,1546
"قم","قم","مرکزی",339,1550,86,14,600,2250,27,2277
"قم","قم","مرکزی",340,831,74,20,871,1796,28,1824
"قم","قم","مرکزی",341,865,62,6,655,1588,27,1615
"قم","قم","مرکزی",342,1122,86,8,468,1684,16,1700
"قم","قم","مرکزی",343,1297,99,16,649,2061,44,2105
"قم","قم","مرکزی",344,588,56,16,405,1065,25,1090
"قم","قم","مرکزی",345,904,61,11,552,1528,33,1561
"قم","قم","مرکزی",346,1085,79,9,498,1671,43,1714
"قم","قم","مرکزی",347,1288,85,12,535,1920,28,1948
"قم","قم","مرکزی",348,1392,81,6,252,1731,19,1750
"قم","قم","مرکزی",349,754,50,4,226,1034,20,1054
"قم","قم","مرکزی",350,984,65,6,321,1376,15,1391
"قم","قم","مرکزی",351,779,66,12,404,1261,20,1281
"قم","قم","مرکزی",352,661,73,14,414,1162,25,1187
"قم","قم","مرکزی",353,535,61,3,343,942,15,957
"قم","قم","مرکزی",354,1062,69,3,427,1561,28,1589
"قم","قم","مرکزی",355,1176,76,11,714,1977,26,2003
"قم","قم","مرکزی",356,1388,74,5,374,1841,30,1871
"قم","قم","مرکزی",357,1366,86,10,636,2098,33,2131
"قم","قم","مرکزی",358,580,67,8,423,1078,25,1103
"قم","قم","مرکزی",359,699,62,5,356,1122,28,1150
"قم","قم","مرکزی",360,893,84,16,665,1658,38,1696
"قم","قم","مرکزی",361,830,50,8,481,1369,34,1403
"قم","قم","مرکزی",362,719,66,17,968,1770,31,1801
"قم","قم","مرکزی",363,760,100,24,929,1813,27,1840
"قم","قم","مرکزی",364,353,45,10,435,843,19,862
"قم","قم","مرکزی",365,1460,60,4,430,1954,15,1969
"قم","قم","مرکزی",366,1291,60,8,422,1781,42,1823
"قم","قم","مرکزی",367,924,58,7,376,1365,20,1385
"قم","قم","مرکزی",368,682,78,4,371,1135,3,1138
"قم","قم","مرکزی",369,1484,61,8,352,1905,22,1927
"قم","قم","مرکزی",370,1268,65,8,484,1825,29,1854
"قم","قم","مرکزی",371,1144,69,4,483,1700,30,1730
"قم","قم","مرکزی",372,922,67,11,658,1658,5,1663
"قم","قم","مرکزی",373,126,12,0,125,263,9,272
"قم","قم","مرکزی",374,1081,43,8,313,1445,28,1473
"قم","قم","مرکزی",375,1168,109,11,763,2051,30,2081
"قم","قم","مرکزی",376,1112,79,6,521,1718,41,1759
"قم","قم","مرکزی",377,750,69,11,638,1468,36,1504
"قم","قم","مرکزی",378,534,76,13,624,1247,37,1284
"قم","قم","مرکزی",379,500,59,11,283,853,33,886
"قم","قم","مرکزی",380,705,52,7,256,1020,0,1020
"قم","قم","مرکزی",381,821,59,7,276,1163,38,1201
"قم","قم","مرکزی",382,570,49,9,307,935,25,960
"قم","قم","مرکزی",383,337,39,2,275,653,20,673
"قم","قم","مرکزی",384,318,43,6,290,657,27,684
"قم","قم","مرکزی",385,821,89,9,350,1269,29,1298
"قم","قم","مرکزی",386,927,66,3,478,1474,26,1500
"قم","قم","مرکزی",387,1666,22,2,232,1922,18,1940
"قم","قم","مرکزی",388,1313,19,5,212,1549,10,1559
"قم","قم","مرکزی",389,666,21,0,199,886,15,901
"قم","قم","مرکزی",390,1699,13,3,234,1949,14,1963
"قم","قم","مرکزی",391,1955,17,2,277,2251,7,2258
"قم","قم","مرکزی",392,559,17,4,97,677,8,685
"قم","قم","مرکزی",393,963,36,6,458,1463,29,1492
"قم","قم","مرکزی",394,858,37,6,245,1146,32,1178
"قم","قم","مرکزی",395,896,21,1,139,1057,15,1072
"قم","قم","مرکزی",396,269,32,4,83,388,13,401
"قم","قم","مرکزی",397,82,15,2,99,198,7,205
"قم","قم","مرکزی",398,883,39,12,179,1113,0,1113
"قم","قم","مرکزی",399,453,37,32,254,776,3,779
"قم","قم","مرکزی",400,529,47,7,366,949,19,968
"قم","قم","مرکزی",401,1115,73,9,221,1418,21,1439
"قم","قم","مرکزی",402,564,65,1,136,766,6,772
"قم","قم","مرکزی",403,714,16,1,170,901,11,912
"قم","قم","مرکزی",404,729,15,2,131,877,7,884
"قم","قم","مرکزی",405,795,9,1,92,897,8,905
"قم","قم","مرکزی",406,493,3,0,54,550,2,552
"قم","قم","مرکزی",407,514,5,1,39,559,5,564
"قم","قم","مرکزی",408,511,3,0,71,585,0,585
"قم","قم","مرکزی",409,877,4,0,95,976,5,981
"قم","قم","مرکزی",410,902,2,1,45,950,6,956
"قم","قم","مرکزی",411,499,6,1,117,623,8,631
"قم","قم","مرکزی",412,916,6,1,69,992,6,998
"قم","قم","مرکزی",413,636,7,1,73,717,6,723
"قم","قم","مرکزی",414,515,7,3,360,885,4,889
"قم","قم","مرکزی",415,392,1,1,32,426,3,429
"قم","قم","مرکزی",416,346,2,0,22,370,0,370
"قم","قم","مرکزی",417,521,6,1,8,536,0,536
"قم","قم","مرکزی",418,264,2,0,41,307,1,308
"قم","قم","مرکزی",419,187,1,0,60,248,2,250
"قم","قم","مرکزی",420,143,2,3,137,285,8,293
"قم","قم","سلفچگان",421,622,4,3,211,840,8,848
"قم","قم","سلفچگان",422,620,15,2,144,781,4,785
"قم","قم","سلفچگان",423,453,22,2,157,634,2,636
"قم","قم","سلفچگان",424,326,5,0,50,381,3,384
"قم","قم","سلفچگان",425,815,5,0,209,1029,8,1037
"قم","قم","سلفچگان",426,366,1,0,62,429,2,431
"قم","قم","سلفچگان",427,340,4,1,80,425,7,432
"قم","قم","سلفچگان",428,697,9,2,157,865,5,870
"قم","قم","سلفچگان",429,624,8,1,68,701,7,708
"قم","قم","سلفچگان",430,529,5,1,53,588,5,593
"قم","قم","سلفچگان",431,577,3,0,91,671,5,676
"قم","قم","سلفچگان",432,908,16,2,157,1083,9,1092
"قم","قم","سلفچگان",433,270,5,0,95,370,4,374
"قم","قم","سلفچگان",434,509,11,0,79,599,5,604
"قم","قم","سلفچگان",435,229,4,0,39,272,5,277
"قم","قم","کهک",436,654,10,2,219,885,20,905
"قم","قم","کهک",437,1049,55,1,563,1668,30,1698
"قم","قم","کهک",438,755,8,1,145,909,8,917
"قم","قم","کهک",439,880,7,2,141,1030,8,1038
"قم","قم","کهک",440,529,34,0,100,663,2,665
"قم","قم","کهک",441,585,19,0,63,667,3,670
"قم","قم","کهک",442,586,11,1,174,772,7,779
"قم","قم","کهک",443,669,5,0,90,764,6,770
"قم","قم","کهک",444,526,8,0,218,752,4,756
"قم","قم","کهک",445,545,9,0,203,757,2,759
"قم","قم","کهک",446,298,13,2,133,446,8,454
"قم","قم","کهک",447,755,19,3,263,1040,31,1071
"قم","قم","کهک",448,547,32,2,224,805,16,821
"قم","قم","کهک",449,472,24,1,304,801,18,819
"قم","قم","کهک",450,568,7,0,88,663,7,670
"قم","قم","کهک",451,583,6,0,51,640,6,646
"قم","قم","کهک",452,731,26,2,180,939,12,951
"قم","قم","کهک",453,748,19,0,112,879,10,889
"قم","قم","کهک",454,764,9,0,27,800,3,803
"قم","قم","کهک",455,313,2,0,58,373,6,379
"قم","قم","کهک",456,515,67,0,184,766,1,767
"قم","قم","کهک",457,269,17,0,171,457,7,464
"قم","قم","کهک",458,120,22,1,55,198,1,199
"قم","قم","خلجستان",459,442,19,2,223,686,7,693
"قم","قم","خلجستان",460,416,14,5,343,778,16,794
"قم","قم","خلجستان",461,543,10,3,113,669,5,674
"قم","قم","خلجستان",462,386,15,1,208,610,12,622
"قم","قم","خلجستان",463,318,5,0,96,419,3,422
"قم","قم","خلجستان",464,647,13,0,173,833,11,844
"قم","قم","خلجستان",465,522,9,2,93,626,2,628
"قم","قم","خلجستان",466,585,13,1,124,723,17,740
"قم","قم","خلجستان",467,262,4,1,86,353,1,354
"قم","قم","خلجستان",468,442,4,1,160,607,6,613
"قم","قم","خلجستان",469,445,4,0,66,515,1,516
"قم","قم","خلجستان",470,599,182,3,5,789,7,796
"قم","قم","خلجستان",471,336,13,0,60,409,2,411
"قم","قم","خلجستان",472,555,8,1,275,839,13,852
"قم","قم","خلجستان",473,612,11,0,157,780,5,785
"قم","قم","خلجستان",474,393,4,0,54,451,3,454
"قم","قم","جعفرآباد",475,601,17,5,145,768,15,783
"قم","قم","جعفرآباد",476,673,19,5,269,966,34,1000
"قم","قم","جعفرآباد",477,945,26,3,121,1095,15,1110
"قم","قم","جعفرآباد",478,483,7,1,77,568,4,572
"قم","قم","جعفرآباد",479,610,1,0,56,667,6,673
"قم","قم","جعفرآباد",480,563,2,0,169,734,4,738
"قم","قم","جعفرآباد",481,531,17,0,125,673,9,682
"قم","قم","جعفرآباد",482,530,7,2,162,701,6,707
"قم","قم","جعفرآباد",483,477,3,1,76,557,6,563
"قم","قم","جعفرآباد",484,333,0,0,79,412,5,417
"قم","قم","جعفرآباد",485,428,4,0,77,509,0,509
"قم","قم","جعفرآباد",486,320,3,0,54,377,7,384
"قم","قم","جعفرآباد",487,559,9,1,38,607,3,610
"قم","قم","جعفرآباد",488,200,0,0,21,221,1,222
"کردستان","بانه","مرکزی",1,304,14,25,524,867,23,890
"کردستان","بانه","مرکزی",2,639,16,38,576,1269,28,1297
"کردستان","بانه","مرکزی",3,205,10,6,385,606,9,615
"کردستان","بانه","مرکزی",4,362,10,26,684,1082,15,1097
"کردستان","بانه","مرکزی",5,486,18,76,822,1402,45,1447
"کردستان","بانه","مرکزی",6,702,17,52,878,1649,49,1698
"کردستان","بانه","مرکزی",7,367,12,22,529,930,20,950
"کردستان","بانه","مرکزی",8,562,4,49,703,1318,28,1346
"کردستان","بانه","مرکزی",9,268,18,52,605,943,19,962
"کردستان","بانه","مرکزی",10,155,10,31,346,542,15,557
"کردستان","بانه","مرکزی",11,459,8,48,570,1085,26,1111
"کردستان","بانه","مرکزی",12,181,8,19,398,606,18,624
"کردستان","بانه","مرکزی",13,583,20,48,749,1400,29,1429
"کردستان","بانه","مرکزی",14,193,7,26,458,684,17,701
"کردستان","بانه","مرکزی",15,417,15,43,811,1286,28,1314
"کردستان","بانه","مرکزی",16,236,13,48,600,897,22,919
"کردستان","بانه","مرکزی",17,373,21,28,762,1184,26,1210
"کردستان","بانه","مرکزی",18,239,7,28,672,946,24,970
"کردستان","بانه","مرکزی",19,229,5,28,385,647,5,652
"کردستان","بانه","مرکزی",20,440,9,40,671,1160,27,1187
"کردستان","بانه","مرکزی",21,398,23,48,794,1263,24,1287
"کردستان","بانه","مرکزی",22,258,9,31,354,652,10,662
"کردستان","بانه","مرکزی",23,333,9,29,470,841,21,862
"کردستان","بانه","مرکزی",24,273,8,36,607,924,21,945
"کردستان","بانه","مرکزی",25,584,11,42,984,1621,22,1643
"کردستان","بانه","مرکزی",26,171,5,10,248,434,5,439
"کردستان","بانه","مرکزی",27,267,7,9,162,445,10,455
"کردستان","بانه","مرکزی",28,251,2,12,270,535,7,542
"کردستان","بانه","مرکزی",29,146,3,16,162,327,5,332
"کردستان","بانه","مرکزی",30,124,1,12,125,262,6,268
"کردستان","بانه","مرکزی",31,191,3,14,301,509,12,521
"کردستان","بانه","مرکزی",32,134,2,10,76,222,3,225
"کردستان","بانه","مرکزی",33,121,1,8,81,211,8,219
"کردستان","بانه","مرکزی",34,108,4,10,107,229,1,230
"کردستان","بانه","مرکزی",35,94,4,6,183,287,7,294
"کردستان","بانه","مرکزی",36,76,0,8,70,154,8,162
"کردستان","بانه","آلوت",1,249,3,9,317,578,17,595
"کردستان","بانه","آلوت",2,115,0,0,130,245,3,248
"کردستان","بانه","آلوت",3,41,0,5,61,107,1,108
"کردستان","بانه","آلوت",4,50,0,1,39,90,2,92
"کردستان","بانه","آلوت",5,69,0,1,64,134,1,135
"کردستان","بانه","آلوت",6,129,1,1,234,365,2,367
"کردستان","بانه","آلوت",7,52,0,7,79,138,1,139
"کردستان","بانه","آلوت",8,82,1,3,114,200,9,209
"کردستان","بانه","آلوت",9,48,3,2,60,113,1,114
"کردستان","بانه","آلوت",10,154,1,2,84,241,4,245
"کردستان","بانه","آلوت",11,201,1,4,65,271,6,277
"کردستان","بانه","آلوت",12,40,0,3,44,87,0,87
"کردستان","بانه","آلوت",13,78,2,2,35,117,5,122
"کردستان","بانه","آلوت",14,39,2,0,35,76,3,79
"کردستان","بانه","آلوت",15,88,2,8,32,130,1,131
"کردستان","بانه","آلوت",16,77,1,0,90,168,0,168
"کردستان","بانه","آلوت",17,71,0,1,108,180,4,184
"کردستان","بانه","ننور",1,61,0,1,55,117,0,117
"کردستان","بانه","ننور",2,53,2,0,51,106,4,110
"کردستان","بانه","ننور",3,130,1,12,179,322,5,327
"کردستان","بانه","ننور",4,100,3,5,214,322,9,331
"کردستان","بانه","ننور",5,202,3,4,127,336,9,345
"کردستان","بانه","ننور",6,38,1,0,13,52,4,56
"کردستان","بانه","ننور",7,235,8,21,322,586,11,597
"کردستان","بانه","ننور",8,46,0,3,87,136,3,139
"کردستان","بانه","ننور",9,104,0,1,136,241,0,241
"کردستان","بانه","ننور",10,88,0,11,43,142,4,146
"کردستان","بانه","ننور",11,118,2,3,122,245,8,253
"کردستان","بانه","ننور",12,158,2,10,108,278,18,296
"کردستان","بانه","ننور",13,113,1,3,87,204,1,205
"کردستان","بانه","ننور",14,25,2,4,65,96,0,96
"کردستان","بانه","نمشیر",1,167,6,38,133,344,9,353
"کردستان","بانه","نمشیر",2,108,2,8,176,294,9,303
"کردستان","بانه","نمشیر",3,35,1,16,180,232,4,236
"کردستان","بانه","نمشیر",4,199,0,2,89,290,14,304
"کردستان","بانه","نمشیر",5,110,1,18,93,222,3,225
"کردستان","بانه","نمشیر",6,66,3,9,111,189,17,206
"کردستان","بانه","نمشیر",7,192,2,17,166,377,16,393
"کردستان","بانه","نمشیر",8,132,4,7,143,286,5,291
"کردستان","بانه","نمشیر",9,134,0,1,32,167,5,172
"کردستان","بانه","نمشیر",10,39,2,10,106,157,4,161
"کردستان","بانه","نمشیر",11,65,1,7,107,180,1,181
"کردستان","بانه","نمشیر",12,151,4,17,112,284,10,294
"کردستان","بانه","نمشیر",13,160,1,30,332,523,23,546
"کردستان","بانه","نمشیر",14,184,2,8,176,370,18,388
"کردستان","بانه","نمشیر",15,58,3,6,159,226,4,230
"کردستان","بانه","نمشیر",16,211,0,30,209,450,10,460
"کردستان","بانه","نمشیر",17,34,2,7,78,121,5,126
"کردستان","بانه","نمشیر",18,77,4,41,76,198,12,210
"کردستان","بانه","نمشیر",19,21,1,36,138,196,2,198
"کردستان","بانه","نمشیر",20,43,1,9,180,233,2,235
"کردستان","بانه","نمشیر",21,87,6,25,250,368,4,372
"کردستان","بانه","نمشیر",22,100,4,13,155,272,6,278
"کردستان","بانه","نمشیر",23,196,0,4,222,422,4,426
"کردستان","بیجار","مرکزی",1,696,29,5,492,1222,27,1249
"کردستان","بیجار","مرکزی",2,806,17,4,420,1247,36,1283
"کردستان","بیجار","مرکزی",3,559,9,6,420,994,13,1007
"کردستان","بیجار","مرکزی",4,981,21,10,427,1439,19,1458
"کردستان","بیجار","مرکزی",5,855,39,10,482,1386,17,1403
"کردستان","بیجار","مرکزی",6,895,35,9,588,1527,21,1548
"کردستان","بیجار","مرکزی",7,784,12,7,454,1257,10,1267
"کردستان","بیجار","مرکزی",8,1206,35,7,647,1895,21,1916
"کردستان","بیجار","مرکزی",9,595,25,3,377,1000,12,1012
"کردستان","بیجار","مرکزی",10,300,9,1,200,510,3,513
"کردستان","بیجار","مرکزی",11,481,13,2,261,757,15,772
"کردستان","بیجار","مرکزی",12,816,11,4,312,1143,24,1167
"کردستان","بیجار","مرکزی",13,838,22,6,482,1348,18,1366
"کردستان","بیجار","مرکزی",14,584,9,4,208,805,6,811
"کردستان","بیجار","مرکزی",15,370,7,9,225,611,11,622
"کردستان","بیجار","مرکزی",16,461,31,1,448,941,25,966
"کردستان","بیجار","مرکزی",17,536,20,5,362,923,15,938
"کردستان","بیجار","مرکزی",18,804,14,8,364,1190,30,1220
"کردستان","بیجار","مرکزی",19,881,6,0,197,1084,15,1099
"کردستان","بیجار","مرکزی",20,829,19,0,110,958,7,965
"کردستان","بیجار","مرکزی",21,666,11,5,152,834,16,850
"کردستان","بیجار","مرکزی",22,574,8,5,175,762,19,781
"کردستان","بیجار","مرکزی",23,1106,34,15,414,1569,18,1587
"کردستان","بیجار","مرکزی",24,867,14,5,294,1180,17,1197
"کردستان","بیجار","مرکزی",25,581,15,4,167,767,3,770
"کردستان","بیجار","مرکزی",26,460,8,2,67,537,7,544
"کردستان","بیجار","مرکزی",27,206,4,1,73,284,3,287
"کردستان","بیجار","مرکزی",28,247,0,0,42,289,1,290
"کردستان","بیجار","مرکزی",29,352,10,11,91,464,3,467
"کردستان","بیجار","مرکزی",30,157,1,0,70,228,1,229
"کردستان","بیجار","مرکزی",31,161,9,0,127,297,1,298
"کردستان","بیجار","مرکزی",32,139,2,3,21,165,2,167
"کردستان","بیجار","مرکزی",33,209,7,1,90,307,0,307
"کردستان","بیجار","مرکزی",34,219,2,0,45,266,0,266
"کردستان","بیجار","مرکزی",35,120,3,0,50,173,1,174
"کردستان","بیجار","مرکزی",36,547,4,2,246,799,8,807
"کردستان","بیجار","مرکزی",37,311,1,0,18,330,2,332
"کردستان","بیجار","مرکزی",38,730,8,0,73,811,3,814
"کردستان","بیجار","مرکزی",39,731,2,0,26,759,1,760
"کردستان","بیجار","مرکزی",40,241,0,0,9,250,0,250
"کردستان","بیجار","مرکزی",41,384,1,0,20,405,0,405
"کردستان","بیجار","مرکزی",42,554,1,0,21,576,1,577
"کردستان","بیجار","مرکزی",43,656,1,1,12,670,1,671
"کردستان","بیجار","مرکزی",44,166,1,2,12,181,2,183
"کردستان","بیجار","مرکزی",45,411,2,1,26,440,3,443
"کردستان","بیجار","مرکزی",46,583,4,1,40,628,1,629
"کردستان","بیجار","مرکزی",47,123,0,0,8,131,2,133
"کردستان","بیجار","مرکزی",48,247,0,2,39,288,0,288
"کردستان","بیجار","مرکزی",49,221,1,0,40,262,1,263
"کردستان","بیجار","مرکزی",50,174,0,1,14,189,2,191
"کردستان","بیجار","مرکزی",51,121,2,1,24,148,1,149
"کردستان","بیجار","مرکزی",52,266,0,2,30,298,2,300
"کردستان","بیجار","مرکزی",53,147,0,0,25,172,0,172
"کردستان","بیجار","مرکزی",54,587,0,9,117,713,0,713
"کردستان","بیجار","مرکزی",55,306,0,11,109,426,9,435
"کردستان","بیجار","مرکزی",56,297,7,0,38,342,1,343
"کردستان","بیجار","مرکزی",57,222,0,0,29,251,3,254
"کردستان","بیجار","مرکزی",58,288,5,0,84,377,6,383
"کردستان","بیجار","مرکزی",59,172,2,0,16,190,0,190
"کردستان","بیجار","مرکزی",60,195,1,0,7,203,0,203
"کردستان","بیجار","چنگ_الماس",1,497,2,0,50,549,7,556
"کردستان","بیجار","چنگ_الماس",2,221,1,0,20,242,4,246
"کردستان","بیجار","چنگ_الماس",3,247,1,1,46,295,2,297
"کردستان","بیجار","چنگ_الماس",4,234,1,0,14,249,4,253
"کردستان","بیجار","چنگ_الماس",5,368,3,3,56,430,4,434
"کردستان","بیجار","چنگ_الماس",6,275,3,0,50,328,2,330
"کردستان","بیجار","چنگ_الماس",7,315,3,3,21,342,1,343
"کردستان","بیجار","چنگ_الماس",8,325,3,2,23,353,2,355
"کردستان","بیجار","چنگ_الماس",9,261,4,3,14,282,4,286
"کردستان","بیجار","چنگ_الماس",10,301,1,1,10,313,0,313
"کردستان","بیجار","چنگ_الماس",11,193,1,0,17,211,3,214
"کردستان","بیجار","چنگ_الماس",12,155,1,0,16,172,2,174
"کردستان","بیجار","چنگ_الماس",13,363,1,0,30,394,8,402
"کردستان","بیجار","چنگ_الماس",14,257,3,0,28,288,0,288
"کردستان","بیجار","چنگ_الماس",15,346,2,0,36,384,1,385
"کردستان","بیجار","چنگ_الماس",16,499,8,0,15,522,0,522
"کردستان","بیجار","چنگ_الماس",17,295,3,2,12,312,1,313
"کردستان","بیجار","چنگ_الماس",18,481,1,1,12,495,2,497
"کردستان","بیجار","چنگ_الماس",19,708,3,0,37,748,2,750
"کردستان","بیجار","چنگ_الماس",20,754,2,1,77,834,13,847
"کردستان","بیجار","چنگ_الماس",21,499,4,0,59,562,1,563
"کردستان","بیجار","کرانی",1,405,8,2,139,554,11,565
"کردستان","بیجار","کرانی",2,378,10,1,232,621,6,627
"کردستان","بیجار","کرانی",3,351,7,0,144,502,8,510
"کردستان","بیجار","کرانی",4,284,4,2,215,505,10,515
"کردستان","بیجار","کرانی",5,303,2,0,26,331,1,332
"کردستان","بیجار","کرانی",6,242,1,0,21,264,1,265
"کردستان","بیجار","کرانی",7,258,4,0,43,305,2,307
"کردستان","بیجار","کرانی",8,193,5,0,48,246,2,248
"کردستان","بیجار","کرانی",9,305,2,1,23,331,0,331
"کردستان","بیجار","کرانی",10,125,0,0,24,149,0,149
"کردستان","بیجار","کرانی",11,518,1,2,39,560,3,563
"کردستان","بیجار","کرانی",12,180,1,0,9,190,2,192
"کردستان","بیجار","کرانی",13,348,2,0,40,390,0,390
"کردستان","بیجار","کرانی",14,369,1,1,38,409,5,414
"کردستان","بیجار","کرانی",15,327,5,1,55,388,2,390
"کردستان","بیجار","کرانی",16,176,2,0,16,194,1,195
"کردستان","بیجار","کرانی",17,237,3,0,14,254,2,256
"کردستان","بیجار","کرانی",18,162,4,1,14,181,0,181
"کردستان","بیجار","کرانی",19,437,0,1,40,478,0,478
"کردستان","بیجار","کرانی",20,235,1,0,26,262,0,262
"کردستان","بیجار","کرانی",21,453,0,0,40,493,3,496
"کردستان","بیجار","کرانی",22,280,1,0,12,293,1,294
"کردستان","بیجار","کرانی",23,513,1,2,47,563,1,564
"کردستان","قروه","مرکزی",1,773,22,21,629,1445,17,1462
"کردستان","قروه","مرکزی",2,769,23,12,656,1460,19,1479
"کردستان","قروه","مرکزی",3,745,16,18,643,1422,20,1442
"کردستان","قروه","مرکزی",4,789,8,23,586,1406,22,1428
"کردستان","قروه","مرکزی",5,908,16,7,516,1447,14,1461
"کردستان","قروه","مرکزی",6,749,19,12,678,1458,16,1474
"کردستان","قروه","مرکزی",7,932,31,27,562,1552,18,1570
"کردستان","قروه","مرکزی",8,645,15,15,542,1217,20,1237
"کردستان","قروه","مرکزی",9,875,8,3,357,1243,16,1259
"کردستان","قروه","مرکزی",10,1029,19,19,621,1688,17,1705
"کردستان","قروه","مرکزی",11,577,12,18,517,1124,26,1150
"کردستان","قروه","مرکزی",12,534,9,17,516,1076,11,1087
"کردستان","قروه","مرکزی",13,560,19,9,451,1039,21,1060
"کردستان","قروه","مرکزی",14,467,5,15,173,660,4,664
"کردستان","قروه","مرکزی",15,453,14,4,350,821,11,832
"کردستان","قروه","مرکزی",16,759,26,7,540,1332,16,1348
"کردستان","قروه","مرکزی",17,969,12,6,426,1413,16,1429
"کردستان","قروه","مرکزی",18,718,25,8,564,1315,18,1333
"کردستان","قروه","مرکزی",19,429,15,8,528,980,20,1000
"کردستان","قروه","مرکزی",20,788,8,11,452,1259,11,1270
"کردستان","قروه","مرکزی",21,1108,13,8,419,1548,6,1554
"کردستان","قروه","مرکزی",22,600,7,16,585,1208,30,1238
"کردستان","قروه","مرکزی",23,1041,21,14,394,1470,16,1486
"کردستان","قروه","مرکزی",24,736,10,7,566,1319,19,1338
"کردستان","قروه","مرکزی",25,570,21,13,477,1081,19,1100
"کردستان","قروه","مرکزی",26,570,15,5,464,1054,10,1064
"کردستان","قروه","مرکزی",27,592,13,6,570,1181,14,1195
"کردستان","قروه","مرکزی",28,685,19,14,463,1181,18,1199
"کردستان","قروه","مرکزی",29,463,7,10,170,650,5,655
"کردستان","قروه","مرکزی",30,488,9,8,369,874,14,888
"کردستان","قروه","مرکزی",31,644,7,1,142,794,4,798
"کردستان","قروه","مرکزی",32,1074,10,0,86,1170,6,1176
"کردستان","قروه","مرکزی",33,828,15,0,106,949,4,953
"کردستان","قروه","مرکزی",34,834,7,3,89,933,7,940
"کردستان","قروه","مرکزی",35,761,7,3,249,1020,12,1032
"کردستان","قروه","مرکزی",36,1030,8,3,167,1208,6,1214
"کردستان","قروه","مرکزی",37,598,6,3,217,824,16,840
"کردستان","قروه","مرکزی",38,318,2,2,38,360,5,365
"کردستان","قروه","مرکزی",39,589,1,6,89,685,0,685
"کردستان","قروه","مرکزی",40,441,3,1,30,475,2,477
"کردستان","قروه","مرکزی",41,551,4,1,20,576,2,578
"کردستان","قروه","مرکزی",42,810,0,0,45,855,11,866
"کردستان","قروه","مرکزی",43,662,1,0,20,683,3,686
"کردستان","قروه","مرکزی",44,904,4,0,68,976,4,980
"کردستان","قروه","مرکزی",45,600,2,4,66,672,2,674
"کردستان","قروه","مرکزی",46,864,9,11,172,1056,16,1072
"کردستان","قروه","مرکزی",47,544,3,8,153,708,7,715
"کردستان","قروه","مرکزی",48,488,2,0,21,511,3,514
"کردستان","قروه","مرکزی",49,233,0,1,74,308,2,310
"کردستان","قروه","مرکزی",50,434,3,1,190,628,6,634
"کردستان","قروه","مرکزی",51,579,0,0,107,686,2,688
"کردستان","قروه","مرکزی",52,513,1,6,100,620,5,625
"کردستان","قروه","مرکزی",53,601,4,2,141,748,1,749
"کردستان","قروه","مرکزی",54,441,2,2,123,568,3,571
"کردستان","قروه","سریش_آباد",1,565,16,0,253,834,7,841
"کردستان","قروه","سریش_آباد",2,688,16,0,183,887,9,896
"کردستان","قروه","سریش_آباد",3,991,23,1,400,1415,11,1426
"کردستان","قروه","سریش_آباد",4,835,20,0,313,1168,15,1183
"کردستان","قروه","سریش_آباد",5,358,5,0,156,519,4,523
"کردستان","قروه","سریش_آباد",6,254,5,0,28,287,2,289
"کردستان","قروه","سریش_آباد",7,399,3,1,63,466,2,468
"کردستان","قروه","سریش_آباد",8,572,1,4,53,630,2,632
"کردستان","قروه","سریش_آباد",9,486,5,0,72,563,3,566
"کردستان","قروه","سریش_آباد",10,306,7,1,76,390,1,391
"کردستان","قروه","سریش_آباد",11,309,2,0,25,336,4,340
"کردستان","قروه","سریش_آباد",12,263,1,1,89,354,0,354
"کردستان","قروه","سریش_آباد",13,308,0,0,84,392,2,394
"کردستان","قروه","سریش_آباد",14,166,2,2,52,222,3,225
"کردستان","قروه","سریش_آباد",15,499,5,0,129,633,10,643
"کردستان","قروه","سریش_آباد",16,482,1,3,100,586,11,597
"کردستان","قروه","سریش_آباد",17,340,2,1,75,418,5,423
"کردستان","قروه","سریش_آباد",18,293,5,1,70,369,3,372
"کردستان","قروه","سریش_آباد",19,177,2,0,66,245,1,246
"کردستان","قروه","سریش_آباد",20,434,6,2,126,568,4,572
"کردستان","قروه","سریش_آباد",21,151,1,0,51,203,2,205
"کردستان","قروه","سریش_آباد",22,466,11,2,182,661,9,670
"کردستان","قروه","سریش_آباد",1,377,14,1,100,492,6,498
"کردستان","قروه","چهاردولی",2,768,12,3,153,936,7,943
"کردستان","قروه","چهاردولی",3,812,4,0,91,907,8,915
"کردستان","قروه","چهاردولی",4,469,2,1,42,514,1,515
"کردستان","قروه","چهاردولی",5,634,3,0,41,678,6,684
"کردستان","قروه","چهاردولی",6,551,1,2,131,685,5,690
"کردستان","قروه","چهاردولی",7,422,0,2,97,521,5,526
"کردستان","قروه","چهاردولی",8,374,0,0,88,462,2,464
"کردستان","قروه","چهاردولی",9,478,1,0,56,535,4,539
"کردستان","قروه","چهاردولی",10,417,1,0,40,458,1,459
"کردستان","قروه","چهاردولی",11,857,0,0,63,920,0,920
"کردستان","قروه","چهاردولی",12,653,5,0,50,708,2,710
"کردستان","قروه","چهاردولی",13,402,0,1,27,430,0,430
"کردستان","قروه","چهاردولی",14,604,2,1,51,658,2,660
"کردستان","قروه","چهاردولی",15,634,1,0,77,712,2,714
"کردستان","قروه","چهاردولی",16,535,2,0,24,561,6,567
"کردستان","قروه","چهاردولی",17,461,0,0,44,505,2,507
"کردستان","قروه","چهاردولی",18,622,2,1,77,702,3,705
"کردستان","دهگلان","مرکزی",1,470,8,43,460,981,25,1006
"کردستان","دهگلان","مرکزی",2,518,12,37,484,1051,34,1085
"کردستان","دهگلان","مرکزی",3,589,12,28,495,1124,24,1148
"کردستان","دهگلان","مرکزی",4,339,7,35,375,756,21,777
"کردستان","دهگلان","مرکزی",5,360,5,54,290,709,26,735
"کردستان","دهگلان","مرکزی",6,591,10,32,391,1024,2,1026
"کردستان","دهگلان","مرکزی",7,579,22,46,827,1474,45,1519
"کردستان","دهگلان","مرکزی",8,338,11,39,478,866,0,866
"کردستان","دهگلان","مرکزی",9,253,6,33,402,694,16,710
"کردستان","دهگلان","مرکزی",10,250,9,22,288,569,18,587
"کردستان","دهگلان","مرکزی",11,209,5,0,56,270,6,276
"کردستان","دهگلان","مرکزی",12,294,5,17,208,524,8,532
"کردستان","دهگلان","مرکزی",13,299,1,3,52,355,4,359
"کردستان","دهگلان","مرکزی",14,278,2,3,64,347,5,352
"کردستان","دهگلان","مرکزی",15,265,6,5,114,390,10,400
"کردستان","دهگلان","مرکزی",16,262,0,4,67,333,16,349
"کردستان","دهگلان","مرکزی",17,390,1,3,248,642,5,647
"کردستان","دهگلان","مرکزی",18,458,2,7,382,849,2,851
"کردستان","دهگلان","مرکزی",19,134,7,4,114,259,10,269
"کردستان","دهگلان","مرکزی",20,107,0,5,17,129,3,132
"کردستان","دهگلان","مرکزی",21,340,2,3,49,394,9,403
"کردستان","دهگلان","مرکزی",22,150,3,2,37,192,0,192
"کردستان","دهگلان","مرکزی",23,229,0,4,64,297,3,300
"کردستان","دهگلان","مرکزی",24,354,2,4,90,450,6,456
"کردستان","دهگلان","مرکزی",25,195,3,7,127,332,5,337
"کردستان","دهگلان","مرکزی",26,181,3,14,45,243,2,245
"کردستان","دهگلان","مرکزی",27,99,0,4,52,155,2,157
"کردستان","دهگلان","مرکزی",28,433,1,5,121,560,13,573
"کردستان","دهگلان","مرکزی",29,83,2,4,40,129,2,131
"کردستان","دهگلان","مرکزی",30,153,0,8,97,258,0,258
"کردستان","دهگلان","مرکزی",31,170,1,23,46,240,2,242
"کردستان","دهگلان","مرکزی",32,303,0,24,101,428,9,437
"کردستان","دهگلان","مرکزی",33,110,2,6,34,152,4,156
"کردستان","دهگلان","مرکزی",34,607,8,6,158,779,13,792
"کردستان","دهگلان","مرکزی",35,219,1,5,56,281,2,283
"کردستان","دهگلان","مرکزی",36,349,0,10,155,514,3,517
"کردستان","دهگلان","مرکزی",37,353,4,7,226,590,9,599
"کردستان","دهگلان","مرکزی",38,80,0,6,46,132,7,139
"کردستان","دهگلان","بلبان_آباد",1,366,6,20,187,579,21,600
"کردستان","دهگلان","بلبان_آباد",2,498,6,20,284,808,24,832
"کردستان","دهگلان","بلبان_آباد",3,479,9,5,183,676,3,679
"کردستان","دهگلان","بلبان_آباد",4,388,5,11,200,604,5,609
"کردستان","دهگلان","بلبان_آباد",5,427,11,20,257,715,15,730
"کردستان","دهگلان","بلبان_آباد",6,415,8,14,311,748,18,766
"کردستان","دهگلان","بلبان_آباد",7,284,1,8,136,429,6,435
"کردستان","دهگلان","بلبان_آباد",8,311,6,15,128,460,11,471
"کردستان","دهگلان","بلبان_آباد",9,531,3,4,92,630,3,633
"کردستان","دهگلان","بلبان_آباد",10,444,1,4,76,525,1,526
"کردستان","دهگلان","بلبان_آباد",11,549,0,5,100,654,10,664
"کردستان","دهگلان","بلبان_آباد",12,206,2,3,25,236,4,240
"کردستان","دهگلان","بلبان_آباد",13,287,0,1,60,348,0,348
"کردستان","دهگلان","بلبان_آباد",14,240,2,9,122,373,2,375
"کردستان","دهگلان","بلبان_آباد",15,346,4,7,73,430,4,434
"کردستان","دهگلان","بلبان_آباد",16,231,0,2,84,317,1,318
"کردستان","دهگلان","بلبان_آباد",17,158,0,3,61,222,4,226
"کردستان","دهگلان","بلبان_آباد",18,297,5,6,64,372,2,374
"کردستان","دهگلان","بلبان_آباد",19,156,1,9,110,276,14,290
"کردستان","دیواندره","کرفتو",1,201,7,8,147,363,12,375
"کردستان","دیواندره","کرفتو",2,179,1,1,89,270,6,276
"کردستان","دیواندره","کرفتو",3,125,0,6,112,243,3,246
"کردستان","دیواندره","کرفتو",4,194,1,9,97,301,7,308
"کردستان","دیواندره","کرفتو",5,175,6,3,69,253,5,258
"کردستان","دیواندره","کرفتو",6,295,6,4,89,394,3,397
"کردستان","دیواندره","کرفتو",7,185,1,7,127,320,14,334
"کردستان","دیواندره","کرفتو",8,118,5,10,189,322,4,326
"کردستان","دیواندره","کرفتو",9,155,0,18,138,311,15,326
"کردستان","دیواندره","کرفتو",10,350,7,4,166,527,17,544
"کردستان","دیواندره","کرفتو",11,145,1,17,53,216,5,221
"کردستان","دیواندره","کرفتو",12,146,4,4,72,226,5,231
"کردستان","دیواندره","کرفتو",13,206,1,0,123,330,9,339
"کردستان","دیواندره","کرفتو",14,172,1,6,111,290,7,297
"کردستان","دیواندره","کرفتو",15,433,7,6,159,605,13,618
"کردستان","دیواندره","کرفتو",16,261,3,3,88,355,3,358
"کردستان","دیواندره","کرفتو",17,342,6,12,208,568,22,590
"کردستان","دیواندره","کرفتو",18,108,2,1,27,138,2,140
"کردستان","دیواندره","کرفتو",19,314,5,4,165,488,18,506
"کردستان","دیواندره","کرفتو",20,331,5,5,152,493,8,501
"کردستان","دیواندره","کرفتو",21,120,0,5,71,196,1,197
"کردستان","دیواندره","کرفتو",22,127,5,15,32,179,9,188
"کردستان","دیواندره","سارال",1,215,1,2,72,290,6,296
"کردستان","دیواندره","سارال",2,309,4,14,91,418,8,426
"کردستان","دیواندره","سارال",3,154,1,4,241,400,2,402
"کردستان","دیواندره","سارال",4,288,0,9,115,412,13,425
"کردستان","دیواندره","سارال",5,419,1,8,130,558,14,572
"کردستان","دیواندره","سارال",6,243,1,2,22,268,5,273
"کردستان","دیواندره","سارال",7,204,1,5,101,311,5,316
"کردستان","دیواندره","سارال",8,203,0,2,97,302,8,310
"کردستان","دیواندره","سارال",9,167,0,4,122,293,1,294
"کردستان","دیواندره","سارال",10,173,2,1,39,215,3,218
"کردستان","دیواندره","سارال",11,311,0,2,84,397,17,414
"کردستان","دیواندره","سارال",12,269,2,0,28,299,3,302
"کردستان","دیواندره","سارال",13,166,2,5,280,453,11,464
"کردستان","دیواندره","سارال",14,199,0,3,57,259,5,264
"کردستان","دیواندره","سارال",15,169,0,1,57,227,3,230
"کردستان","دیواندره","سارال",16,191,1,3,51,246,0,246
"کردستان","دیواندره","سارال",17,330,0,12,55,397,8,405
"کردستان","دیواندره","سارال",18,181,0,1,58,240,5,245
"کردستان","دیواندره","سارال",19,100,5,5,14,124,4,128
"کردستان","دیواندره","سارال",20,125,2,3,33,163,4,167
"کردستان","دیواندره","مرکزی",1,118,1,10,162,291,9,300
"کردستان","دیواندره","مرکزی",2,256,16,18,420,710,15,725
"کردستان","دیواندره","مرکزی",3,412,14,50,513,989,22,1011
"کردستان","دیواندره","مرکزی",4,341,19,25,619,1004,30,1034
"کردستان","دیواندره","مرکزی",5,390,11,23,298,722,14,736
"کردستان","دیواندره","مرکزی",6,374,15,15,408,812,20,832
"کردستان","دیواندره","مرکزی",7,435,8,23,451,917,27,944
"کردستان","دیواندره","مرکزی",8,503,9,22,428,962,22,984
"کردستان","دیواندره","مرکزی",9,747,25,51,788,1611,66,1677
"کردستان","دیواندره","مرکزی",10,244,21,25,288,578,22,600
"کردستان","دیواندره","مرکزی",11,576,6,14,290,886,17,903
"کردستان","دیواندره","مرکزی",12,208,11,24,276,519,25,544
"کردستان","دیواندره","مرکزی",13,302,4,14,79,399,10,409
"کردستان","دیواندره","مرکزی",14,384,0,6,52,442,0,442
"کردستان","دیواندره","مرکزی",15,144,1,7,125,277,5,282
"کردستان","دیواندره","مرکزی",16,304,4,7,164,479,14,493
"کردستان","دیواندره","مرکزی",17,134,1,3,113,251,8,259
"کردستان","دیواندره","مرکزی",18,237,6,3,159,405,10,415
"کردستان","دیواندره","مرکزی",19,174,3,5,100,282,4,286
"کردستان","دیواندره","مرکزی",20,144,0,15,67,226,2,228
"کردستان","دیواندره","مرکزی",21,155,1,8,92,256,3,259
"کردستان","دیواندره","مرکزی",22,55,1,6,35,97,1,98
"کردستان","دیواندره","مرکزی",23,161,3,14,102,280,3,283
"کردستان","دیواندره","مرکزی",24,343,0,21,101,465,17,482
"کردستان","دیواندره","مرکزی",25,252,6,3,89,350,10,360
"کردستان","دیواندره","مرکزی",26,369,0,3,109,481,6,487
"کردستان","دیواندره","مرکزی",27,297,2,6,113,418,6,424
"کردستان","دیواندره","مرکزی",28,171,1,8,66,246,2,248
"کردستان","دیواندره","مرکزی",29,276,1,13,107,397,8,405
"کردستان","دیواندره","مرکزی",30,127,1,2,95,225,4,229
"کردستان","دیواندره","مرکزی",31,267,1,9,50,327,6,333
"کردستان","دیواندره","مرکزی",32,191,2,0,28,221,4,225
"کردستان","دیواندره","مرکزی",33,266,2,4,81,353,10,363
"کردستان","دیواندره","مرکزی",34,95,1,7,87,190,2,192
"کردستان","دیواندره","مرکزی",35,199,0,4,68,271,4,275
"کردستان","دیواندره","مرکزی",36,332,9,11,212,564,9,573
"کردستان","دیواندره","مرکزی",37,176,1,12,123,312,3,315
"کردستان","دیواندره","مرکزی",38,312,2,14,124,452,11,463
"کردستان","دیواندره","مرکزی",39,40,1,2,36,79,1,80
"کردستان","دیواندره","مرکزی",40,102,6,0,54,162,9,171
"کردستان","دیواندره","مرکزی",41,390,6,8,192,596,6,602
"کردستان","سروآباد","مرکزی",1,106,10,16,124,256,14,270
"کردستان","سروآباد","مرکزی",2,160,1,20,225,406,12,418
"کردستان","سروآباد","مرکزی",3,148,5,5,163,321,17,338
"کردستان","سروآباد","مرکزی",4,49,9,3,114,175,13,188
"کردستان","سروآباد","مرکزی",5,124,1,6,157,288,10,298
"کردستان","سروآباد","مرکزی",6,96,2,3,98,199,5,204
"کردستان","سروآباد","مرکزی",7,297,13,3,109,422,17,439
"کردستان","سروآباد","مرکزی",8,194,2,0,59,255,6,261
"کردستان","سروآباد","مرکزی",9,79,2,18,73,172,16,188
"کردستان","سروآباد","مرکزی",10,351,1,15,183,550,5,555
"کردستان","سروآباد","مرکزی",11,170,2,15,75,262,7,269
"کردستان","سروآباد","مرکزی",12,268,10,10,163,451,8,459
"کردستان","سروآباد","مرکزی",13,209,1,5,115,330,7,337
"کردستان","سروآباد","مرکزی",14,188,1,1,99,289,3,292
"کردستان","سروآباد","مرکزی",15,224,1,7,47,279,1,280
"کردستان","سروآباد","مرکزی",16,314,2,4,151,471,11,482
"کردستان","سروآباد","مرکزی",17,263,5,6,200,474,11,485
"کردستان","سروآباد","مرکزی",18,40,2,1,20,63,3,66
"کردستان","سروآباد","مرکزی",19,129,6,14,283,432,5,437
"کردستان","سروآباد","مرکزی",20,108,6,15,192,321,3,324
"کردستان","سروآباد","مرکزی",21,57,0,6,52,115,4,119
"کردستان","سروآباد","مرکزی",22,168,10,7,106,291,6,297
"کردستان","سروآباد","مرکزی",23,87,0,2,38,127,1,128
"کردستان","سروآباد","مرکزی",24,79,1,4,68,152,1,153
"کردستان","سروآباد","مرکزی",25,106,4,6,113,229,4,233
"کردستان","سروآباد","مرکزی",26,20,1,3,21,45,5,50
"کردستان","سروآباد","مرکزی",27,69,3,4,84,160,8,168
"کردستان","سروآباد","مرکزی",28,118,2,2,49,171,2,173
"کردستان","سروآباد","مرکزی",29,38,1,0,45,84,2,86
"کردستان","سروآباد","مرکزی",30,69,1,2,109,181,0,181
"کردستان","سروآباد","مرکزی",31,121,8,5,226,360,13,373
"کردستان","سروآباد","مرکزی",32,100,5,5,141,251,0,251
"کردستان","سروآباد","مرکزی",33,160,27,2,158,347,21,368
"کردستان","سروآباد","مرکزی",34,105,2,0,104,211,1,212
"کردستان","سروآباد","مرکزی",35,120,2,2,151,275,6,281
"کردستان","سروآباد","مرکزی",36,178,19,15,173,385,6,391
"کردستان","سروآباد","مرکزی",37,127,3,0,98,228,9,237
"کردستان","سروآباد","مرکزی",38,89,2,17,151,259,1,260
"کردستان","سروآباد","مرکزی",39,125,8,23,79,235,9,244
"کردستان","سروآباد","مرکزی",40,128,6,12,125,271,7,278
"کردستان","سروآباد","مرکزی",41,109,1,1,66,177,2,179
"کردستان","سروآباد","مرکزی",42,253,2,2,232,489,5,494
"کردستان","سروآباد","مرکزی",43,257,4,9,221,491,10,501
"کردستان","سروآباد","مرکزی",44,245,9,8,141,403,27,430
"کردستان","سروآباد","مرکزی",45,348,7,49,304,708,31,739
"کردستان","سروآباد","مرکزی",46,39,0,8,96,143,5,148
"کردستان","سروآباد","مرکزی",47,95,4,15,178,292,10,302
"کردستان","سروآباد","مرکزی",48,103,1,7,102,213,4,217
"کردستان","سروآباد","مرکزی",49,120,2,21,191,334,8,342
"کردستان","سروآباد","مرکزی",50,40,1,3,34,78,2,80
"کردستان","سروآباد","مرکزی",51,210,1,8,131,350,6,356
"کردستان","سروآباد","مرکزی",52,363,3,18,199,583,49,632
"کردستان","سروآباد","مرکزی",53,141,0,11,184,336,14,350
"کردستان","سروآباد","مرکزی",54,254,7,24,185,470,17,487
"کردستان","سروآباد","مرکزی",55,132,5,7,46,190,7,197
"کردستان","سروآباد","اورامان",56,59,2,3,123,187,7,194
"کردستان","سروآباد","اورامان",57,177,5,7,237,426,17,443
"کردستان","سروآباد","اورامان",58,248,10,28,413,699,23,722
"کردستان","سروآباد","اورامان",59,122,2,9,311,444,24,468
"کردستان","سروآباد","اورامان",60,127,0,8,138,273,7,280
"کردستان","سروآباد","اورامان",61,266,2,1,201,470,11,481
"کردستان","سروآباد","اورامان",62,280,3,0,121,404,3,407
"کردستان","سروآباد","اورامان",63,293,2,5,227,527,29,556
"کردستان","سروآباد","اورامان",64,331,8,0,78,417,2,419
"کردستان","سروآباد","اورامان",65,120,0,3,107,230,0,230
"کردستان","سقز","مرکزی",1,450,12,39,1166,1667,27,1694
"کردستان","سقز","مرکزی",2,336,14,32,920,1302,38,1340
"کردستان","سقز","مرکزی",3,474,19,23,765,1281,13,1294
"کردستان","سقز","مرکزی",4,282,14,31,745,1072,18,1090
"کردستان","سقز","مرکزی",5,315,15,32,875,1237,16,1253
"کردستان","سقز","مرکزی",6,116,11,12,340,479,7,486
"کردستان","سقز","مرکزی",7,264,10,22,496,792,18,810
"کردستان","سقز","مرکزی",8,347,15,27,823,1212,23,1235
"کردستان","سقز","مرکزی",9,168,15,34,428,645,9,654
"کردستان","سقز","مرکزی",10,220,7,19,523,769,25,794
"کردستان","سقز","مرکزی",11,216,14,24,467,721,10,731
"کردستان","سقز","مرکزی",12,142,6,22,617,787,26,813
"کردستان","سقز","مرکزی",13,194,14,21,495,724,16,740
"کردستان","سقز","مرکزی",14,269,20,39,841,1169,22,1191
"کردستان","سقز","مرکزی",15,73,4,9,222,308,6,314
"کردستان","سقز","مرکزی",16,380,24,40,887,1331,19,1350
"کردستان","سقز","مرکزی",17,288,17,40,926,1271,17,1288
"کردستان","سقز","مرکزی",18,362,15,31,1050,1458,27,1485
"کردستان","سقز","مرکزی",19,313,7,31,871,1222,33,1255
"کردستان","سقز","مرکزی",20,191,15,19,563,788,13,801
"کردستان","سقز","مرکزی",21,208,19,40,675,942,25,967
"کردستان","سقز","مرکزی",22,319,19,44,966,1348,35,1383
"کردستان","سقز","مرکزی",23,516,13,23,777,1329,24,1353
"کردستان","سقز","مرکزی",24,158,4,22,486,670,0,670
"کردستان","سقز","مرکزی",25,389,18,31,832,1270,19,1289
"کردستان","سقز","مرکزی",26,94,2,11,369,476,9,485
"کردستان","سقز","مرکزی",27,260,14,37,635,946,37,983
"کردستان","سقز","مرکزی",28,128,5,19,342,494,19,513
"کردستان","سقز","مرکزی",29,241,9,31,693,974,24,998
"کردستان","سقز","مرکزی",30,185,16,46,600,847,22,869
"کردستان","سقز","مرکزی",31,205,10,17,437,669,18,687
"کردستان","سقز","مرکزی",32,309,28,30,630,997,20,1017
"کردستان","سقز","مرکزی",33,346,33,53,888,1320,25,1345
"کردستان","سقز","مرکزی",34,257,16,27,720,1020,25,1045
"کردستان","سقز","مرکزی",35,199,9,35,559,802,28,830
"کردستان","سقز","مرکزی",36,292,15,45,849,1201,30,1231
"کردستان","سقز","مرکزی",37,248,4,26,536,814,21,835
"کردستان","سقز","مرکزی",38,223,13,54,695,985,22,1007
"کردستان","سقز","مرکزی",39,105,8,19,422,554,13,567
"کردستان","سقز","مرکزی",40,152,3,26,351,532,10,542
"کردستان","سقز","مرکزی",41,168,11,17,430,626,17,643
"کردستان","سقز","مرکزی",42,297,12,17,622,948,0,948
"کردستان","سقز","مرکزی",43,257,10,26,712,1005,21,1026
"کردستان","سقز","مرکزی",44,262,17,40,920,1239,27,1266
"کردستان","سقز","مرکزی",45,270,14,13,393,690,13,703
"کردستان","سقز","مرکزی",46,136,8,35,609,788,21,809
"کردستان","سقز","مرکزی",47,178,14,19,500,711,17,728
"کردستان","سقز","مرکزی",48,180,14,49,678,921,15,936
"کردستان","سقز","مرکزی",49,200,9,27,544,780,22,802
"کردستان","سقز","مرکزی",50,275,11,21,505,812,10,822
"کردستان","سقز","مرکزی",51,154,12,29,394,589,16,605
"کردستان","سقز","مرکزی",52,194,8,29,396,627,20,647
"کردستان","سقز","مرکزی",53,255,17,62,893,1227,15,1242
"کردستان","سقز","مرکزی",54,360,21,30,864,1275,23,1298
"کردستان","سقز","مرکزی",55,178,13,43,617,851,20,871
"کردستان","سقز","مرکزی",56,155,13,32,510,710,10,720
"کردستان","سقز","مرکزی",57,154,6,14,368,542,9,551
"کردستان","سقز","مرکزی",58,282,12,3,245,542,14,556
"کردستان","سقز","مرکزی",59,330,5,18,230,583,17,600
"کردستان","سقز","مرکزی",60,231,5,12,247,495,13,508
"کردستان","سقز","مرکزی",61,228,9,15,218,470,7,477
"کردستان","سقز","مرکزی",62,177,8,20,511,716,17,733
"کردستان","سقز","مرکزی",63,108,2,8,88,206,2,208
"کردستان","سقز","مرکزی",64,142,1,39,378,560,16,576
"کردستان","سقز","مرکزی",65,253,3,6,212,474,10,484
"کردستان","سقز","مرکزی",66,104,14,11,114,243,3,246
"کردستان","سقز","مرکزی",67,163,8,18,169,358,2,360
"کردستان","سقز","مرکزی",68,171,4,14,153,342,5,347
"کردستان","سقز","مرکزی",69,82,3,7,215,307,9,316
"کردستان","سقز","مرکزی",70,52,1,10,178,241,1,242
"کردستان","سقز","مرکزی",71,79,2,22,250,353,10,363
"کردستان","سقز","مرکزی",72,73,3,16,137,229,10,239
"کردستان","سقز","مرکزی",73,113,1,9,101,224,3,227
"کردستان","سقز","مرکزی",74,75,3,18,177,273,5,278
"کردستان","سقز","مرکزی",75,55,5,11,164,235,7,242
"کردستان","سقز","مرکزی",76,206,2,9,198,415,3,418
"کردستان","سقز","مرکزی",77,122,3,18,214,357,7,364
"کردستان","سقز","مرکزی",78,29,2,8,58,97,8,105
"کردستان","سقز","مرکزی",79,209,6,12,297,524,9,533
"کردستان","سقز","مرکزی",80,31,3,13,94,141,3,144
"کردستان","سقز","مرکزی",81,12,1,10,46,69,1,70
"کردستان","سقز","مرکزی",82,70,7,56,80,213,13,226
"کردستان","سقز","مرکزی",83,245,6,22,215,488,7,495
"کردستان","سقز","مرکزی",84,24,0,11,128,163,2,165
"کردستان","سقز","مرکزی",85,65,2,12,171,250,1,251
"کردستان","سقز","زیویه",1,205,7,11,292,515,16,531
"کردستان","سقز","زیویه",2,76,3,4,147,230,1,231
"کردستان","سقز","زیویه",3,84,4,18,177,283,5,288
"کردستان","سقز","زیویه",4,119,2,12,84,217,4,221
"کردستان","سقز","زیویه",5,180,2,14,180,376,9,385
"کردستان","سقز","زیویه",6,73,1,4,172,250,5,255
"کردستان","سقز","زیویه",7,185,0,9,249,443,8,451
"کردستان","سقز","زیویه",8,104,2,7,52,165,3,168
"کردستان","سقز","زیویه",9,182,4,17,210,413,8,421
"کردستان","سقز","زیویه",10,174,0,8,126,308,4,312
"کردستان","سقز","زیویه",11,185,3,2,165,355,4,359
"کردستان","سقز","زیویه",12,145,1,14,87,247,1,248
"کردستان","سقز","زیویه",13,256,3,11,280,550,8,558
"کردستان","سقز","زیویه",14,148,0,40,87,275,2,277
"کردستان","سقز","زیویه",15,104,2,4,187,297,3,300
"کردستان","سقز","زیویه",16,91,1,21,150,263,10,273
"کردستان","سقز","زیویه",17,204,3,22,187,416,6,422
"کردستان","سقز","زیویه",18,202,2,6,157,367,10,377
"کردستان","سقز","زیویه",19,167,1,18,241,427,5,432
"کردستان","سقز","زیویه",20,91,1,5,111,208,5,213
"کردستان","سقز","زیویه",21,108,5,17,113,243,5,248
"کردستان","سقز","زیویه",22,111,3,7,99,220,6,226
"کردستان","سقز","زیویه",23,58,1,0,124,183,12,195
"کردستان","سقز","زیویه",24,187,2,5,56,250,5,255
"کردستان","سقز","زیویه",25,228,5,6,198,437,7,444
"کردستان","سقز","زیویه",26,73,2,20,146,241,2,243
"کردستان","سقز","زیویه",27,82,1,9,127,219,2,221
"کردستان","سقز","زیویه",28,227,1,37,289,554,6,560
"کردستان","سقز","زیویه",29,108,3,4,231,346,2,348
"کردستان","سقز","زیویه",30,86,4,6,152,248,7,255
"کردستان","سقز","زیویه",31,29,0,23,88,140,1,141
"کردستان","سقز","زیویه",32,130,2,16,119,267,6,273
"کردستان","سقز","زیویه",33,64,0,4,45,113,2,115
"کردستان","سقز","زیویه",34,288,3,3,274,568,10,578
"کردستان","سقز","زیویه",35,310,8,45,211,574,10,584
"کردستان","سقز","زیویه",36,169,0,4,67,240,3,243
"کردستان","سقز","زیویه",37,202,3,9,117,331,8,339
"کردستان","سقز","زیویه",38,162,0,6,64,232,3,235
"کردستان","سقز","زیویه",39,157,2,6,121,286,6,292
"کردستان","سقز","سرشیو",1,40,1,9,94,144,2,146
"کردستان","سقز","سرشیو",2,61,0,8,258,327,12,339
"کردستان","سقز","سرشیو",3,45,1,9,59,114,3,117
"کردستان","سقز","سرشیو",4,120,5,7,175,307,0,307
"کردستان","سقز","سرشیو",5,157,1,12,167,337,4,341
"کردستان","سقز","سرشیو",6,78,1,3,101,183,3,186
"کردستان","سقز","سرشیو",7,25,1,2,244,272,2,274
"کردستان","سقز","سرشیو",8,68,5,11,103,187,2,189
"کردستان","سقز","سرشیو",9,60,3,11,83,157,1,158
"کردستان","سقز","سرشیو",10,86,7,11,96,200,0,200
"کردستان","سقز","سرشیو",11,52,2,14,92,160,2,162
"کردستان","سقز","سرشیو",12,187,1,30,137,355,5,360
"کردستان","سقز","سرشیو",13,61,5,17,54,137,0,137
"کردستان","سقز","سرشیو",14,72,2,0,71,145,3,148
"کردستان","سقز","سرشیو",15,19,4,8,78,109,1,110
"کردستان","سنندج","مرکزی",1,292,11,16,299,618,27,645
"کردستان","سنندج","مرکزی",2,878,20,13,510,1421,44,1465
"کردستان","سنندج","مرکزی",3,520,21,31,473,1045,34,1079
"کردستان","سنندج","مرکزی",4,768,22,30,693,1513,45,1558
"کردستان","سنندج","مرکزی",5,223,10,8,403,644,19,663
"کردستان","سنندج","مرکزی",6,508,18,16,587,1129,40,1169
"کردستان","سنندج","مرکزی",7,486,28,75,1242,1831,53,1884
"کردستان","سنندج","مرکزی",8,474,14,32,923,1443,41,1484
"کردستان","سنندج","مرکزی",9,263,10,17,394,684,16,700
"کردستان","سنندج","مرکزی",10,310,36,39,606,991,20,1011
"کردستان","سنندج","مرکزی",11,518,56,31,542,1147,20,1167
"کردستان","سنندج","مرکزی",12,570,17,47,1060,1694,51,1745
"کردستان","سنندج","مرکزی",13,607,44,47,1314,2012,35,2047
"کردستان","سنندج","مرکزی",14,364,24,50,1077,1515,4,1519
"کردستان","سنندج","مرکزی",15,334,18,27,635,1014,36,1050
"کردستان","سنندج","مرکزی",16,414,26,33,728,1201,20,1221
"کردستان","سنندج","مرکزی",17,224,24,39,814,1101,29,1130
"کردستان","سنندج","مرکزی",18,420,7,62,676,1165,35,1200
"کردستان","سنندج","مرکزی",19,181,6,17,475,679,27,706
"کردستان","سنندج","مرکزی",20,335,16,15,302,668,10,678
"کردستان","سنندج","مرکزی",21,429,17,42,741,1229,30,1259
"کردستان","سنندج","مرکزی",22,439,31,29,728,1227,44,1271
"کردستان","سنندج","مرکزی",23,507,43,57,1038,1645,53,1698
"کردستان","سنندج","مرکزی",24,296,11,12,393,712,20,732
"کردستان","سنندج","مرکزی",25,714,29,43,705,1491,51,1542
"کردستان","سنندج","مرکزی",26,146,9,10,174,339,5,344
"کردستان","سنندج","مرکزی",27,780,34,37,668,1519,46,1565
"کردستان","سنندج","مرکزی",28,384,12,7,366,769,20,789
"کردستان","سنندج","مرکزی",29,796,34,34,794,1658,39,1697
"کردستان","سنندج","مرکزی",30,294,19,3,354,670,30,700
"کردستان","سنندج","مرکزی",31,734,20,9,245,1008,6,1014
"کردستان","سنندج","مرکزی",32,758,13,7,298,1076,8,1084
"کردستان","سنندج","مرکزی",33,393,7,3,197,600,15,615
"کردستان","سنندج","مرکزی",34,470,21,4,90,585,4,589
"کردستان","سنندج","مرکزی",35,442,15,11,227,695,8,703
"کردستان","سنندج","مرکزی",36,971,21,36,578,1606,33,1639
"کردستان","سنندج","مرکزی",37,410,7,14,309,740,21,761
"کردستان","سنندج","مرکزی",38,605,11,14,346,976,27,1003
"کردستان","سنندج","مرکزی",39,595,17,35,657,1304,52,1356
"کردستان","سنندج","مرکزی",40,429,11,24,483,947,34,981
"کردستان","سنندج","مرکزی",41,586,9,16,587,1198,26,1224
"کردستان","سنندج","مرکزی",42,38,2,9,118,167,7,174
"کردستان","سنندج","مرکزی",43,402,16,27,521,966,40,1006
"کردستان","سنندج","مرکزی",44,734,19,23,719,1495,53,1548
"کردستان","سنندج","مرکزی",45,874,9,31,448,1362,30,1392
"کردستان","سنندج","مرکزی",46,680,10,14,248,952,19,971
"کردستان","سنندج","مرکزی",47,467,6,19,202,694,14,708
"کردستان","سنندج","مرکزی",48,993,29,25,545,1592,49,1641
"کردستان","سنندج","مرکزی",49,540,10,24,618,1192,31,1223
"کردستان","سنندج","مرکزی",50,490,22,35,688,1235,33,1268
"کردستان","سنندج","مرکزی",51,172,3,11,203,389,20,409
"کردستان","سنندج","مرکزی",52,330,14,24,422,790,36,826
"کردستان","سنندج","مرکزی",53,363,19,22,553,957,45,1002
"کردستان","سنندج","مرکزی",54,595,30,28,633,1286,44,1330
"کردستان","سنندج","مرکزی",55,534,18,11,397,960,11,971
"کردستان","سنندج","مرکزی",56,205,6,15,253,479,8,487
"کردستان","سنندج","مرکزی",57,245,5,18,380,648,28,676
"کردستان","سنندج","مرکزی",58,99,5,3,172,279,9,288
"کردستان","سنندج","مرکزی",59,911,16,21,641,1589,54,1643
"کردستان","سنندج","مرکزی",60,820,18,24,629,1491,41,1532
"کردستان","سنندج","مرکزی",61,717,19,11,373,1120,42,1162
"کردستان","سنندج","مرکزی",62,539,10,4,291,844,17,861
"کردستان","سنندج","مرکزی",63,1053,6,18,511,1588,46,1634
"کردستان","سنندج","مرکزی",64,974,16,23,442,1455,34,1489
"کردستان","سنندج","مرکزی",65,578,8,9,191,786,22,808
"کردستان","سنندج","مرکزی",66,1077,10,31,550,1668,39,1707
"کردستان","سنندج","مرکزی",67,1483,25,17,437,1962,33,1995
"کردستان","سنندج","مرکزی",68,935,24,30,621,1610,43,1653
"کردستان","سنندج","مرکزی",69,826,17,18,395,1256,26,1282
"کردستان","سنندج","مرکزی",70,808,14,12,307,1141,32,1173
"کردستان","سنندج","مرکزی",71,694,24,27,555,1300,37,1337
"کردستان","سنندج","مرکزی",72,529,10,17,585,1141,35,1176
"کردستان","سنندج","مرکزی",73,726,24,20,627,1397,34,1431
"کردستان","سنندج","مرکزی",74,574,11,14,362,961,37,998
"کردستان","سنندج","مرکزی",75,735,16,32,588,1371,27,1398
"کردستان","سنندج","مرکزی",76,444,25,19,513,1001,33,1034
"کردستان","سنندج","مرکزی",77,494,10,9,414,927,18,945
"کردستان","سنندج","مرکزی",78,463,17,24,684,1188,26,1214
"کردستان","سنندج","مرکزی",79,217,12,31,307,567,26,593
"کردستان","سنندج","مرکزی",80,460,23,26,495,1004,25,1029
"کردستان","سنندج","مرکزی",81,399,14,7,237,657,10,667
"کردستان","سنندج","مرکزی",82,638,11,19,528,1196,38,1234
"کردستان","سنندج","مرکزی",83,296,11,17,408,732,18,750
"کردستان","سنندج","مرکزی",84,358,15,16,497,886,23,909
"کردستان","سنندج","مرکزی",85,190,18,13,565,786,30,816
"کردستان","سنندج","مرکزی",86,608,25,34,1034,1701,49,1750
"کردستان","سنندج","مرکزی",87,494,27,14,504,1039,33,1072
"کردستان","سنندج","مرکزی",88,440,33,33,1200,1706,31,1737
"کردستان","سنندج","مرکزی",89,518,36,61,1449,2064,36,2100
"کردستان","سنندج","مرکزی",90,281,24,26,798,1129,21,1150
"کردستان","سنندج","مرکزی",91,230,21,23,898,1172,21,1193
"کردستان","سنندج","مرکزی",92,367,27,50,1339,1783,43,1826
"کردستان","سنندج","مرکزی",93,194,11,32,677,914,22,936
"کردستان","سنندج","مرکزی",94,254,15,20,742,1031,22,1053
"کردستان","سنندج","مرکزی",95,178,15,19,464,676,25,701
"کردستان","سنندج","مرکزی",96,387,42,98,876,1403,46,1449
"کردستان","سنندج","مرکزی",97,383,8,35,430,856,27,883
"کردستان","سنندج","مرکزی",98,418,22,44,852,1336,58,1394
"کردستان","سنندج","مرکزی",99,282,10,46,676,1014,34,1048
"کردستان","سنندج","مرکزی",100,425,41,54,1038,1558,48,1606
"کردستان","سنندج","مرکزی",101,567,27,45,1096,1735,54,1789
"کردستان","سنندج","مرکزی",102,514,33,60,1093,1700,51,1751
"کردستان","سنندج","مرکزی",103,336,16,32,773,1157,42,1199
"کردستان","سنندج","مرکزی",104,600,37,75,1046,1758,43,1801
"کردستان","سنندج","مرکزی",105,433,24,27,836,1320,25,1345
"کردستان","سنندج","مرکزی",106,316,16,19,569,920,29,949
"کردستان","سنندج","مرکزی",107,344,17,35,607,1003,33,1036
"کردستان","سنندج","مرکزی",108,59,3,2,156,220,5,225
"کردستان","سنندج","مرکزی",109,54,2,2,85,143,0,143
"کردستان","سنندج","مرکزی",110,239,12,7,152,410,10,420
"کردستان","سنندج","مرکزی",111,195,11,9,185,400,16,416
"کردستان","سنندج","مرکزی",112,275,10,9,161,455,4,459
"کردستان","سنندج","مرکزی",113,379,14,3,144,540,5,545
"کردستان","سنندج","مرکزی",114,158,8,5,247,418,10,428
"کردستان","سنندج","مرکزی",115,845,9,7,264,1125,16,1141
"کردستان","سنندج","مرکزی",116,1060,10,10,295,1375,18,1393
"کردستان","سنندج","مرکزی",117,409,2,4,106,521,9,530
"کردستان","سنندج","مرکزی",118,667,6,11,241,925,20,945
"کردستان","سنندج","مرکزی",119,761,5,4,264,1034,24,1058
"کردستان","سنندج","مرکزی",120,356,15,15,435,821,24,845
"کردستان","سنندج","مرکزی",121,522,15,26,491,1054,19,1073
"کردستان","سنندج","مرکزی",122,346,20,8,267,641,17,658
"کردستان","سنندج","مرکزی",123,653,8,9,341,1011,20,1031
"کردستان","سنندج","مرکزی",124,297,2,5,140,444,8,452
"کردستان","سنندج","مرکزی",125,286,6,8,135,435,4,439
"کردستان","سنندج","مرکزی",126,233,4,6,136,379,5,384
"کردستان","سنندج","مرکزی",127,661,6,9,252,928,17,945
"کردستان","سنندج","مرکزی",128,352,5,12,158,527,6,533
"کردستان","سنندج","مرکزی",129,703,1,4,80,788,4,792
"کردستان","سنندج","مرکزی",130,612,20,17,531,1180,41,1221
"کردستان","سنندج","مرکزی",131,521,3,15,94,633,6,639
"کردستان","سنندج","مرکزی",132,291,0,8,224,523,8,531
"کردستان","سنندج","مرکزی",133,361,5,14,221,601,20,621
"کردستان","سنندج","مرکزی",134,637,13,22,366,1038,28,1066
"کردستان","سنندج","مرکزی",135,376,4,10,233,623,5,628
"کردستان","سنندج","مرکزی",136,128,1,5,45,179,2,181
"کردستان","سنندج","مرکزی",137,465,3,5,156,629,2,631
"کردستان","سنندج","مرکزی",138,550,14,12,288,864,21,885
"کردستان","سنندج","مرکزی",139,429,19,8,106,562,6,568
"کردستان","سنندج","مرکزی",140,348,2,3,100,453,2,455
"کردستان","سنندج","مرکزی",141,289,4,4,115,412,6,418
"کردستان","سنندج","مرکزی",142,387,5,4,195,591,14,605
"کردستان","سنندج","مرکزی",143,91,5,2,105,203,6,209
"کردستان","سنندج","مرکزی",144,182,0,1,69,252,0,252
"کردستان","سنندج","مرکزی",145,73,1,5,33,112,1,113
"کردستان","سنندج","مرکزی",146,116,0,2,91,209,0,209
"کردستان","سنندج","مرکزی",147,205,5,10,100,320,0,320
"کردستان","سنندج","مرکزی",148,112,1,13,71,197,3,200
"کردستان","سنندج","مرکزی",149,147,3,8,70,228,2,230
"کردستان","سنندج","مرکزی",150,212,2,7,88,309,5,314
"کردستان","سنندج","مرکزی",151,78,3,1,44,126,0,126
"کردستان","سنندج","مرکزی",152,526,2,31,89,648,13,661
"کردستان","سنندج","مرکزی",153,196,2,22,144,364,12,376
"کردستان","سنندج","مرکزی",154,177,2,2,45,226,0,226
"کردستان","سنندج","مرکزی",155,183,3,5,64,255,0,255
"کردستان","سنندج","مرکزی",156,157,2,4,38,201,1,202
"کردستان","سنندج","مرکزی",157,118,0,0,62,180,0,180
"کردستان","سنندج","مرکزی",158,92,0,0,42,134,0,134
"کردستان","سنندج","مرکزی",159,379,0,5,85,469,17,486
"کردستان","سنندج","مرکزی",160,177,2,2,45,226,9,235
"کردستان","سنندج","مرکزی",161,270,0,6,102,378,9,387
"کردستان","سنندج","مرکزی",162,116,2,2,90,210,5,215
"کردستان","سنندج","مرکزی",163,190,0,6,38,234,7,241
"کردستان","سنندج","مرکزی",164,253,0,10,87,350,6,356
"کردستان","سنندج","مرکزی",165,166,3,3,62,234,5,239
"کردستان","سنندج","مرکزی",166,247,1,9,49,306,9,315
"کردستان","سنندج","مرکزی",167,229,1,11,88,329,6,335
"کردستان","سنندج","مرکزی",168,156,2,0,118,276,5,281
"کردستان","سنندج","مرکزی",169,112,0,1,88,201,2,203
"کردستان","سنندج","مرکزی",170,104,1,12,73,190,2,192
"کردستان","سنندج","مرکزی",171,195,1,3,155,354,6,360
"کردستان","سنندج","مرکزی",172,211,1,0,19,231,1,232
"کردستان","سنندج","مرکزی",173,80,0,0,44,124,1,125
"کردستان","سنندج","مرکزی",174,125,0,0,50,175,0,175
"کردستان","سنندج","کلاترزان",1,181,18,8,171,378,7,385
"کردستان","سنندج","کلاترزان",2,179,2,0,85,266,14,280
"کردستان","سنندج","کلاترزان",3,115,1,3,167,286,12,298
"کردستان","سنندج","کلاترزان",4,81,0,3,160,244,3,247
"کردستان","سنندج","کلاترزان",5,390,0,0,71,461,16,477
"کردستان","سنندج","کلاترزان",6,280,0,0,31,311,9,320
"کردستان","سنندج","کلاترزان",7,271,6,12,249,538,17,555
"کردستان","سنندج","کلاترزان",8,194,2,1,107,304,4,308
"کردستان","سنندج","کلاترزان",9,276,0,17,45,338,2,340
"کردستان","سنندج","کلاترزان",10,388,3,4,66,461,7,468
"کردستان","سنندج","کلاترزان",11,479,3,1,98,581,0,581
"کردستان","سنندج","کلاترزان",12,183,1,6,45,235,2,237
"کردستان","سنندج","کلاترزان",13,200,1,0,23,224,4,228
"کردستان","سنندج","کلاترزان",14,329,0,0,81,410,7,417
"کردستان","سنندج","کلاترزان",15,124,0,1,31,156,1,157
"کردستان","سنندج","کلاترزان",16,207,0,5,27,239,2,241
"کردستان","سنندج","کلاترزان",17,382,2,1,70,455,2,457
"کردستان","سنندج","کلاترزان",18,220,0,5,42,267,1,268
"کردستان","سنندج","کلاترزان",19,455,1,2,80,538,12,550
"کردستان","سنندج","کلاترزان",20,55,0,5,78,138,0,138
"کردستان","سنندج","کلاترزان",21,89,1,2,53,145,1,146
"کردستان","سنندج","کلاترزان",22,114,1,2,48,165,1,166
"کردستان","سنندج","کلاترزان",23,78,1,2,36,117,7,124
"کردستان","سنندج","کلاترزان",24,118,0,3,29,150,2,152
"کردستان","سنندج","کلاترزان",25,161,1,8,89,259,7,266
"کردستان","سنندج","کلاترزان",26,161,1,12,79,253,7,260
"کردستان","سنندج","کلاترزان",27,87,3,4,101,195,5,200
"کردستان","سنندج","کلاترزان",28,186,1,5,89,281,4,285
"کردستان","سنندج","کلاترزان",29,54,0,1,96,151,0,151
"کردستان","سنندج","کلاترزان",30,71,1,8,23,103,0,103
"کردستان","سنندج","کلاترزان",31,83,0,5,224,312,8,320
"کردستان","سنندج","کلاترزان",32,31,1,0,35,67,1,68
"کردستان","کامیاران","مرکزی",1,665,6,21,443,1135,24,1159
"کردستان","کامیاران","مرکزی",2,699,4,7,347,1057,13,1070
"کردستان","کامیاران","مرکزی",3,569,10,23,341,943,14,957
"کردستان","کامیاران","مرکزی",4,596,10,14,291,911,16,927
"کردستان","کامیاران","مرکزی",5,639,16,11,320,986,21,1007
"کردستان","کامیاران","مرکزی",6,489,10,32,646,1177,19,1196
"کردستان","کامیاران","مرکزی",7,263,8,18,437,726,10,736
"کردستان","کامیاران","مرکزی",8,457,11,8,426,902,7,909
"کردستان","کامیاران","مرکزی",9,297,9,7,297,610,14,624
"کردستان","کامیاران","مرکزی",10,315,15,34,605,969,31,1000
"کردستان","کامیاران","مرکزی",11,516,14,39,612,1181,28,1209
"کردستان","کامیاران","مرکزی",12,439,16,45,707,1207,17,1224
"کردستان","کامیاران","مرکزی",13,454,18,47,840,1359,30,1389
"کردستان","کامیاران","مرکزی",14,277,17,16,520,830,24,854
"کردستان","کامیاران","مرکزی",15,297,12,27,627,963,22,985
"کردستان","کامیاران","مرکزی",16,173,9,16,406,604,17,621
"کردستان","کامیاران","مرکزی",17,518,12,21,648,1199,21,1220
"کردستان","کامیاران","مرکزی",18,158,8,27,370,563,6,569
"کردستان","کامیاران","مرکزی",19,390,12,29,720,1151,33,1184
"کردستان","کامیاران","مرکزی",20,374,8,30,359,771,18,789
"کردستان","کامیاران","مرکزی",21,457,5,8,260,730,16,746
"کردستان","کامیاران","مرکزی",22,560,14,12,489,1075,19,1094
"کردستان","کامیاران","مرکزی",23,363,9,9,161,542,3,545
"کردستان","کامیاران","مرکزی",24,262,5,10,198,475,5,480
"کردستان","کامیاران","مرکزی",25,372,1,1,163,537,7,544
"کردستان","کامیاران","مرکزی",26,366,3,16,157,542,5,547
"کردستان","کامیاران","مرکزی",27,270,4,24,95,393,3,396
"کردستان","کامیاران","مرکزی",28,340,1,6,96,443,6,449
"کردستان","کامیاران","مرکزی",29,323,4,55,234,616,9,625
"کردستان","کامیاران","مرکزی",30,201,4,6,145,356,7,363
"کردستان","کامیاران","مرکزی",31,174,7,18,205,404,4,408
"کردستان","کامیاران","مرکزی",32,660,8,10,290,968,25,993
"کردستان","کامیاران","مرکزی",33,337,2,10,206,555,4,559
"کردستان","کامیاران","مرکزی",34,135,0,1,69,205,2,207
"کردستان","کامیاران","مرکزی",35,218,6,8,162,394,2,396
"کردستان","کامیاران","مرکزی",36,553,17,24,494,1088,26,1114
"کردستان","کامیاران","مرکزی",37,67,5,28,136,236,0,236
"کردستان","کامیاران","مرکزی",38,268,1,7,425,701,14,715
"کردستان","کامیاران","مرکزی",39,339,6,6,198,549,10,559
"کردستان","کامیاران","مرکزی",40,381,5,11,225,622,10,632
"کردستان","کامیاران","مرکزی",41,380,4,1,146,531,1,532
"کردستان","کامیاران","مرکزی",42,340,2,4,261,607,5,612
"کردستان","کامیاران","مرکزی",43,412,2,0,53,467,1,468
"کردستان","کامیاران","مرکزی",44,312,2,0,66,380,5,385
"کردستان","کامیاران","مرکزی",45,107,0,1,51,159,2,161
"کردستان","کامیاران","مرکزی",46,368,0,1,42,411,0,411
"کردستان","کامیاران","مرکزی",47,129,1,2,111,243,7,250
"کردستان","کامیاران","مرکزی",48,246,6,1,80,333,2,335
"کردستان","کامیاران","مرکزی",1,409,5,14,363,791,16,807
"کردستان","کامیاران","موچش",2,145,9,35,211,400,9,409
"کردستان","کامیاران","موچش",3,325,1,7,127,460,1,461
"کردستان","کامیاران","موچش",4,153,3,8,78,242,0,242
"کردستان","کامیاران","موچش",5,231,1,3,173,408,3,411
"کردستان","کامیاران","موچش",6,302,2,0,89,393,7,400
"کردستان","کامیاران","موچش",7,168,1,7,61,237,9,246
"کردستان","کامیاران","موچش",8,349,1,3,77,430,2,432
"کردستان","کامیاران","موچش",9,456,3,2,91,552,19,571
"کردستان","کامیاران","موچش",10,187,2,4,73,266,2,268
"کردستان","کامیاران","موچش",11,205,1,0,38,244,8,252
"کردستان","کامیاران","موچش",12,144,2,8,50,204,3,207
"کردستان","کامیاران","موچش",13,439,0,2,77,518,8,526
"کردستان","کامیاران","موچش",14,185,4,2,73,264,8,272
"کردستان","کامیاران","موچش",15,141,1,2,71,215,14,229
"کردستان","کامیاران","موچش",16,139,3,2,78,222,5,227
"کردستان","کامیاران","موچش",17,189,6,20,162,377,7,384
"کردستان","کامیاران","موچش",18,231,1,9,341,582,5,587
"کردستان","کامیاران","موچش",19,174,3,12,564,753,10,763
"کردستان","کامیاران","موچش",20,341,3,10,257,611,11,622
"کردستان","کامیاران","موچش",21,440,4,23,238,705,16,721
"کردستان","کامیاران","موچش",22,193,0,4,100,297,10,307
"کردستان","کامیاران","موچش",23,96,4,1,58,159,6,165
"کردستان","کامیاران","موچش",24,248,3,0,103,354,2,356
"کردستان","کامیاران","موچش",25,94,1,2,13,110,5,115
"کردستان","کامیاران","موچش",26,134,2,1,66,203,1,204
"کردستان","کامیاران","موچش",27,428,5,5,205,643,20,663
"کردستان","کامیاران","موچش",28,160,1,2,19,182,1,183
"کردستان","کامیاران","موچش",29,345,0,2,34,381,2,383
"کردستان","کامیاران","موچش",30,103,1,2,22,128,3,131
"کردستان","کامیاران","موچش",31,171,0,0,15,186,3,189
"کردستان","کامیاران","موچش",32,238,0,3,21,262,2,264
"کردستان","مریوان","شهر_مریوان",1,289,18,33,518,858,45,903
"کردستان","مریوان","شهر_مریوان",2,143,6,35,503,687,20,707
"کردستان","مریوان","شهر_مریوان",3,514,12,59,768,1353,53,1406
"کردستان","مریوان","شهر_مریوان",4,425,15,50,568,1058,43,1101
"کردستان","مریوان","شهر_مریوان",5,284,9,55,498,846,29,875
"کردستان","مریوان","شهر_مریوان",6,280,9,36,292,617,15,632
"کردستان","مریوان","شهر_مریوان",7,170,4,33,290,497,23,520
"کردستان","مریوان","شهر_مریوان",8,127,12,15,308,462,19,481
"کردستان","مریوان","شهر_مریوان",9,279,18,60,527,884,33,917
"کردستان","مریوان","شهر_مریوان",10,235,13,27,406,681,19,700
"کردستان","مریوان","شهر_مریوان",11,174,10,17,322,523,18,541
"کردستان","مریوان","شهر_مریوان",12,139,5,16,219,379,9,388
"کردستان","مریوان","شهر_مریوان",13,211,14,32,470,727,27,754
"کردستان","مریوان","شهر_مریوان",14,303,11,20,288,622,10,632
"کردستان","مریوان","شهر_مریوان",15,232,6,20,192,450,6,456
"کردستان","مریوان","شهر_مریوان",16,300,7,34,259,600,23,623
"کردستان","مریوان","شهر_مریوان",17,172,7,23,240,442,13,455
"کردستان","مریوان","شهر_مریوان",18,265,6,37,329,637,15,652
"کردستان","مریوان","شهر_مریوان",19,238,9,31,436,714,31,745
"کردستان","مریوان","شهر_مریوان",20,277,22,42,553,894,24,918
"کردستان","مریوان","شهر_مریوان",21,109,3,29,332,473,20,493
"کردستان","مریوان","شهر_مریوان",22,346,12,30,599,987,44,1031
"کردستان","مریوان","شهر_مریوان",23,193,9,21,334,557,27,584
"کردستان","مریوان","شهر_مریوان",24,115,4,29,278,426,18,444
"کردستان","مریوان","شهر_مریوان",25,150,9,15,312,486,8,494
"کردستان","مریوان","شهر_مریوان",26,114,5,14,338,471,28,499
"کردستان","مریوان","شهر_مریوان",27,271,16,50,763,1100,41,1141
"کردستان","مریوان","شهر_مریوان",28,197,9,49,549,804,28,832
"کردستان","مریوان","شهر_مریوان",29,177,5,23,432,637,33,670
"کردستان","مریوان","شهر_مریوان",30,175,15,26,440,656,22,678
"کردستان","مریوان","شهر_مریوان",31,129,12,66,459,666,24,690
"کردستان","مریوان","شهر_مریوان",32,301,22,38,525,886,16,902
"کردستان","مریوان","شهر_مریوان",33,329,7,62,507,905,19,924
"کردستان","مریوان","شهر_مریوان",34,85,0,12,204,301,7,308
"کردستان","مریوان","شهر_مریوان",35,192,7,11,266,476,21,497
"کردستان","مریوان","شهر_مریوان",36,376,18,28,456,878,33,911
"کردستان","مریوان","شهر_مریوان",37,247,3,30,343,623,11,634
"کردستان","مریوان","شهر_مریوان",38,279,30,41,655,1005,34,1039
"کردستان","مریوان","شهر_مریوان",39,111,7,42,303,463,10,473
"کردستان","مریوان","شهر_مریوان",40,185,4,11,240,440,10,450
"کردستان","مریوان","شهر_مریوان",41,218,5,32,382,637,24,661
"کردستان","مریوان","شهر_مریوان",42,306,22,52,579,959,41,1000
"کردستان","مریوان","شهر_مریوان",43,213,3,27,329,572,28,600
"کردستان","مریوان","شهر_مریوان",44,383,16,46,592,1037,35,1072
"کردستان","مریوان","شهر_مریوان",45,74,7,10,140,231,7,238
"کردستان","مریوان","شهر_مریوان",46,194,19,24,483,720,27,747
"کردستان","مریوان","شهر_مریوان",47,186,5,29,359,579,24,603
"کردستان","مریوان","شهر_مریوان",48,163,13,25,495,696,32,728
"کردستان","مریوان","شهر_مریوان",49,160,5,18,214,397,14,411
"کردستان","مریوان","شهر_مریوان",50,80,11,27,286,404,13,417
"کردستان","مریوان","شهر_مریوان",51,108,8,22,146,284,13,297
"کردستان","مریوان","شهر_مریوان",52,348,9,9,209,575,14,589
"کردستان","مریوان","شهر_مریوان",53,263,14,6,127,410,15,425
"کردستان","مریوان","مرکزی",54,111,1,6,121,239,0,239
"کردستان","مریوان","مرکزی",55,221,6,16,99,342,8,350
"کردستان","مریوان","مرکزی",56,222,2,35,217,476,12,488
"کردستان","مریوان","مرکزی",57,197,2,6,65,270,4,274
"کردستان","مریوان","مرکزی",58,369,14,65,501,949,31,980
"کردستان","مریوان","مرکزی",59,317,12,38,435,802,20,822
"کردستان","مریوان","مرکزی",60,638,13,26,423,1100,29,1129
"کردستان","مریوان","مرکزی",61,192,3,3,123,321,5,326
"کردستان","مریوان","مرکزی",62,303,5,26,237,571,9,580
"کردستان","مریوان","مرکزی",63,240,0,40,166,446,9,455
"کردستان","مریوان","مرکزی",64,81,3,5,230,319,6,325
"کردستان","مریوان","مرکزی",65,140,0,35,151,326,10,336
"کردستان","مریوان","مرکزی",66,49,2,6,146,203,2,205
"کردستان","مریوان","مرکزی",67,70,3,9,56,138,4,142
"کردستان","مریوان","مرکزی",68,59,1,12,32,104,2,106
"کردستان","مریوان","مرکزی",69,104,1,6,87,198,11,209
"کردستان","مریوان","مرکزی",70,174,2,2,90,268,2,270
"کردستان","مریوان","مرکزی",71,61,4,9,156,230,13,243
"کردستان","مریوان","مرکزی",72,91,0,5,67,163,5,168
"کردستان","مریوان","مرکزی",73,126,0,11,95,232,9,241
"کردستان","مریوان","مرکزی",74,299,6,10,198,513,11,524
"کردستان","مریوان","مرکزی",75,122,3,2,175,302,13,315
"کردستان","مریوان","مرکزی",76,258,6,13,176,453,4,457
"کردستان","مریوان","مرکزی",77,103,2,9,68,182,12,194
"کردستان","مریوان","مرکزی",78,93,6,17,350,466,9,475
"کردستان","مریوان","مرکزی",79,144,7,25,235,411,11,422
"کردستان","مریوان","مرکزی",80,60,3,4,105,172,5,177
"کردستان","مریوان","مرکزی",81,111,3,10,163,287,3,290
"کردستان","مریوان","مرکزی",82,89,0,35,109,233,3,236
"کردستان","مریوان","مرکزی",83,155,7,20,57,239,11,250
"کردستان","مریوان","مرکزی",84,131,1,12,78,222,3,225
"کردستان","مریوان","مرکزی",85,102,4,1,40,147,0,147
"کردستان","مریوان","مرکزی",86,131,0,42,17,190,2,192
"کردستان","مریوان","مرکزی",87,219,0,1,43,263,1,264
"کردستان","مریوان","خاوومیرآباد",1,58,6,17,230,311,2,313
"کردستان","مریوان","خاوومیرآباد",2,22,1,19,170,212,7,219
"کردستان","مریوان","خاوومیرآباد",3,133,2,9,288,432,10,442
"کردستان","مریوان","خاوومیرآباد",4,87,6,10,149,252,8,260
"کردستان","مریوان","خاوومیرآباد",5,47,0,9,70,126,4,130
"کردستان","مریوان","خاوومیرآباد",6,41,0,8,186,235,5,240
"کردستان","مریوان","خاوومیرآباد",7,44,1,21,287,353,5,358
"کردستان","مریوان","خاوومیرآباد",8,106,1,24,328,459,13,472
"کردستان","مریوان","خاوومیرآباد",9,50,0,4,156,210,4,214
"کردستان","مریوان","خاوومیرآباد",10,74,0,10,131,215,5,220
"کردستان","مریوان","خاوومیرآباد",11,57,1,38,172,268,9,277
"کردستان","مریوان","خاوومیرآباد",12,72,1,4,124,201,7,208
"کردستان","مریوان","خاوومیرآباد",13,107,4,8,198,317,7,324
"کردستان","مریوان","خاوومیرآباد",14,43,1,15,146,205,7,212
"کردستان","مریوان","سرشیو",1,72,1,5,17,95,4,99
"کردستان","مریوان","سرشیو",2,106,1,6,50,163,3,166
"کردستان","مریوان","سرشیو",3,63,0,6,35,104,5,109
"کردستان","مریوان","سرشیو",4,29,3,4,72,108,5,113
"کردستان","مریوان","سرشیو",5,41,1,1,82,125,5,130
"کردستان","مریوان","سرشیو",6,138,3,1,155,297,10,307
"کردستان","مریوان","سرشیو",7,87,1,3,40,131,1,132
"کردستان","مریوان","سرشیو",8,54,0,2,64,120,5,125
"کردستان","مریوان","سرشیو",9,69,3,3,98,173,1,174
"کردستان","مریوان","سرشیو",10,77,0,17,144,238,3,241
"کردستان","مریوان","سرشیو",11,111,1,1,58,171,2,173
"کردستان","مریوان","سرشیو",12,89,2,6,37,134,4,138
"کردستان","مریوان","سرشیو",13,107,0,17,47,171,2,173
"کردستان","مریوان","سرشیو",14,98,0,10,49,157,4,161
"کردستان","مریوان","سرشیو",15,224,3,32,149,408,7,415
"کردستان","مریوان","سرشیو",16,81,2,6,17,106,2,108
"کردستان","مریوان","سرشیو",17,152,0,4,31,187,4,191
"کردستان","مریوان","سرشیو",18,46,0,11,43,100,1,101
"کردستان","مریوان","سرشیو",19,39,1,9,29,78,3,81
"کردستان","مریوان","سرشیو",20,97,1,2,35,135,4,139
"کردستان","مریوان","سرشیو",21,67,0,6,42,115,3,118
"کرمانشاه","باباجاني_ثلاث","مرکزی",1,241,14,16,350,621,27,648
"کرمانشاه","باباجاني_ثلاث","مرکزی",2,130,4,16,129,279,5,284
"کرمانشاه","باباجاني_ثلاث","مرکزی",3,195,5,6,135,341,19,360
"کرمانشاه","باباجاني_ثلاث","مرکزی",4,297,0,7,126,430,6,436
"کرمانشاه","باباجاني_ثلاث","مرکزی",5,199,11,20,210,440,28,468
"کرمانشاه","باباجاني_ثلاث","مرکزی",6,122,7,11,198,338,26,364
"کرمانشاه","باباجاني_ثلاث","مرکزی",7,157,7,11,164,339,20,359
"کرمانشاه","باباجاني_ثلاث","مرکزی",8,259,7,32,153,451,13,464
"کرمانشاه","باباجاني_ثلاث","مرکزی",9,144,6,12,176,338,16,354
"کرمانشاه","باباجاني_ثلاث","مرکزی",10,58,2,3,60,123,6,129
"کرمانشاه","باباجاني_ثلاث","مرکزی",11,147,1,1,62,211,5,216
"کرمانشاه","باباجاني_ثلاث","مرکزی",12,341,6,6,112,465,7,472
"کرمانشاه","باباجاني_ثلاث","مرکزی",13,123,0,7,89,219,4,223
"کرمانشاه","باباجاني_ثلاث","مرکزی",14,252,1,10,56,319,9,328
"کرمانشاه","باباجاني_ثلاث","مرکزی",15,246,0,8,125,379,21,400
"کرمانشاه","باباجاني_ثلاث","مرکزی",16,74,5,10,116,205,3,208
"کرمانشاه","باباجاني_ثلاث","مرکزی",17,133,0,35,59,227,9,236
"کرمانشاه","باباجاني_ثلاث","مرکزی",18,230,5,5,120,360,5,365
"کرمانشاه","باباجاني_ثلاث","مرکزی",19,218,0,3,60,281,2,283
"کرمانشاه","باباجاني_ثلاث","مرکزی",20,132,5,4,86,227,12,239
"کرمانشاه","باباجاني_ثلاث","مرکزی",21,94,5,7,37,143,1,144
"کرمانشاه","باباجاني_ثلاث","مرکزی",22,101,0,1,70,172,4,176
"کرمانشاه","باباجاني_ثلاث","مرکزی",23,88,1,9,28,126,5,131
"کرمانشاه","باباجاني_ثلاث","مرکزی",24,70,0,0,26,96,0,96
"کرمانشاه","باباجاني_ثلاث","مرکزی",25,148,4,12,73,237,0,237
"کرمانشاه","باباجاني_ثلاث","مرکزی",26,413,2,0,88,503,1,504
"کرمانشاه","باباجاني_ثلاث","مرکزی",27,254,5,6,175,440,6,446
"کرمانشاه","باباجاني_ثلاث","مرکزی",28,89,1,0,59,149,0,149
"کرمانشاه","باباجاني_ثلاث","مرکزی",29,230,0,1,197,428,1,429
"کرمانشاه","باباجاني_ثلاث","مرکزی",30,307,6,16,241,570,18,588
"کرمانشاه","باباجاني_ثلاث","مرکزی",31,322,1,2,115,440,6,446
"کرمانشاه","باباجاني_ثلاث","مرکزی",32,456,4,16,141,617,14,631
"کرمانشاه","باباجاني_ثلاث","مرکزی",33,301,4,8,198,511,12,523
"کرمانشاه","باباجاني_ثلاث","مرکزی",34,301,2,2,89,394,13,407
"کرمانشاه","باباجاني_ثلاث","مرکزی",35,59,0,3,151,213,3,216
"کرمانشاه","باباجاني_ثلاث","مرکزی",36,177,4,26,120,327,13,340
"کرمانشاه","باباجاني_ثلاث","ازگله",1,218,8,1,290,517,42,559
"کرمانشاه","باباجاني_ثلاث","ازگله",2,123,1,1,72,197,12,209
"کرمانشاه","باباجاني_ثلاث","ازگله",3,133,10,2,129,274,15,289
"کرمانشاه","باباجاني_ثلاث","ازگله",4,126,6,5,47,184,4,188
"کرمانشاه","باباجاني_ثلاث","ازگله",5,136,1,7,100,244,12,256
"کرمانشاه","باباجاني_ثلاث","ازگله",6,139,2,9,210,360,22,382
"کرمانشاه","باباجاني_ثلاث","ازگله",7,51,1,2,184,238,5,243
"کرمانشاه","باباجاني_ثلاث","ازگله",8,38,1,1,105,145,1,146
"کرمانشاه","باباجاني_ثلاث","ازگله",9,54,1,3,46,104,3,107
"کرمانشاه","باباجاني_ثلاث","ازگله",10,27,4,11,73,115,4,119
"کرمانشاه","باباجاني_ثلاث","ازگله",11,89,1,0,71,161,0,161
"کرمانشاه","باباجاني_ثلاث","ازگله",12,59,7,0,129,195,0,195
"کرمانشاه","جوانرود","مرکزی",1,145,12,10,179,346,14,360
"کرمانشاه","جوانرود","مرکزی",2,134,7,15,265,421,40,461
"کرمانشاه","جوانرود","مرکزی",3,28,0,2,77,107,12,119
"کرمانشاه","جوانرود","مرکزی",4,82,3,7,148,240,10,250
"کرمانشاه","جوانرود","مرکزی",5,164,6,17,249,436,24,460
"کرمانشاه","جوانرود","مرکزی",6,186,3,12,178,379,23,402
"کرمانشاه","جوانرود","مرکزی",7,77,2,3,64,146,6,152
"کرمانشاه","جوانرود","مرکزی",8,334,12,34,351,731,45,776
"کرمانشاه","جوانرود","مرکزی",9,131,8,25,322,486,44,530
"کرمانشاه","جوانرود","مرکزی",10,211,5,13,237,466,33,499
"کرمانشاه","جوانرود","مرکزی",11,157,13,17,228,415,34,449
"کرمانشاه","جوانرود","مرکزی",12,233,5,11,161,410,9,419
"کرمانشاه","جوانرود","مرکزی",13,348,12,14,187,561,25,586
"کرمانشاه","جوانرود","مرکزی",14,271,8,24,312,615,35,650
"کرمانشاه","جوانرود","مرکزی",15,255,1,18,231,505,20,525
"کرمانشاه","جوانرود","مرکزی",16,88,3,3,131,225,19,244
"کرمانشاه","جوانرود","مرکزی",17,36,0,2,87,125,12,137
"کرمانشاه","جوانرود","مرکزی",18,285,4,18,449,756,0,756
"کرمانشاه","جوانرود","مرکزی",19,121,9,10,308,448,23,471
"کرمانشاه","جوانرود","مرکزی",20,157,9,17,185,368,20,388
"کرمانشاه","جوانرود","مرکزی",21,35,2,7,111,155,6,161
"کرمانشاه","جوانرود","مرکزی",22,79,2,19,149,249,16,265
"کرمانشاه","جوانرود","مرکزی",23,84,1,11,175,271,24,295
"کرمانشاه","جوانرود","مرکزی",24,143,14,29,264,450,24,474
"کرمانشاه","جوانرود","مرکزی",25,133,14,18,295,460,43,503
"کرمانشاه","جوانرود","مرکزی",26,120,8,9,308,445,20,465
"کرمانشاه","جوانرود","مرکزی",27,80,6,26,280,392,19,411
"کرمانشاه","جوانرود","مرکزی",28,164,7,20,257,448,26,474
"کرمانشاه","جوانرود","مرکزی",29,16,3,12,53,84,5,89
"کرمانشاه","جوانرود","مرکزی",30,147,7,17,357,528,43,571
"کرمانشاه","جوانرود","مرکزی",31,132,2,13,182,329,24,353
"کرمانشاه","جوانرود","مرکزی",32,136,7,17,309,469,32,501
"کرمانشاه","جوانرود","مرکزی",33,90,1,14,164,269,14,283
"کرمانشاه","جوانرود","مرکزی",34,332,13,37,490,872,48,920
"کرمانشاه","جوانرود","مرکزی",35,202,10,28,387,627,62,689
"کرمانشاه","جوانرود","مرکزی",36,166,2,11,275,454,21,475
"کرمانشاه","جوانرود","مرکزی",37,176,3,19,286,484,31,515
"کرمانشاه","جوانرود","مرکزی",38,124,6,30,251,411,35,446
"کرمانشاه","جوانرود","مرکزی",39,35,0,2,60,97,11,108
"کرمانشاه","جوانرود","مرکزی",40,96,2,9,194,301,10,311
"کرمانشاه","جوانرود","مرکزی",41,63,0,13,166,242,12,254
"کرمانشاه","جوانرود","مرکزی",42,56,5,9,178,248,33,281
"کرمانشاه","جوانرود","مرکزی",43,177,14,4,82,277,14,291
"کرمانشاه","جوانرود","مرکزی",44,243,3,8,182,436,17,453
"کرمانشاه","جوانرود","مرکزی",45,226,2,14,154,396,9,405
"کرمانشاه","جوانرود","مرکزی",46,144,3,8,84,239,7,246
"کرمانشاه","جوانرود","مرکزی",47,142,8,20,67,237,11,248
"کرمانشاه","جوانرود","مرکزی",48,91,1,20,110,222,9,231
"کرمانشاه","جوانرود","مرکزی",49,141,2,12,78,233,3,236
"کرمانشاه","جوانرود","مرکزی",50,127,0,8,57,192,4,196
"کرمانشاه","جوانرود","مرکزی",51,88,0,4,74,166,4,170
"کرمانشاه","جوانرود","مرکزی",52,464,2,4,87,557,19,576
"کرمانشاه","جوانرود","مرکزی",53,276,1,12,35,324,12,336
"کرمانشاه","جوانرود","مرکزی",54,121,9,7,122,259,4,263
"کرمانشاه","جوانرود","مرکزی",55,204,6,2,105,317,3,320
"کرمانشاه","جوانرود","کلاشی",1,219,6,14,125,364,9,373
"کرمانشاه","جوانرود","کلاشی",2,155,2,9,86,252,7,259
"کرمانشاه","جوانرود","کلاشی",3,233,2,10,93,338,4,342
"کرمانشاه","جوانرود","کلاشی",4,150,0,4,34,188,3,191
"کرمانشاه","جوانرود","کلاشی",5,168,3,2,66,239,4,243
"کرمانشاه","جوانرود","کلاشی",6,355,5,9,101,470,11,481
"کرمانشاه","جوانرود","کلاشی",7,144,0,3,65,212,0,212
"کرمانشاه","جوانرود","کلاشی",8,154,3,6,53,216,1,217
"کرمانشاه","جوانرود","کلاشی",9,253,3,8,92,356,8,364
"کرمانشاه","جوانرود","کلاشی",10,102,0,3,71,176,0,176
"کرمانشاه","جوانرود","کلاشی",11,189,0,11,116,316,6,322
"کرمانشاه","جوانرود","کلاشی",12,151,2,7,198,358,9,367
"کرمانشاه","جوانرود","کلاشی",13,6,0,1,11,18,0,18
"کرمانشاه","پاوه","مرکزی",1,194,35,57,296,582,22,604
"کرمانشاه","پاوه","مرکزی",2,176,14,19,174,383,20,403
"کرمانشاه","پاوه","مرکزی",3,170,5,9,109,293,11,304
"کرمانشاه","پاوه","مرکزی",4,224,5,13,292,534,12,546
"کرمانشاه","پاوه","مرکزی",5,139,5,15,255,414,14,428
"کرمانشاه","پاوه","مرکزی",6,196,15,18,334,563,22,585
"کرمانشاه","پاوه","مرکزی",7,142,19,19,217,397,15,412
"کرمانشاه","پاوه","مرکزی",8,134,17,20,274,445,23,468
"کرمانشاه","پاوه","مرکزی",9,184,17,25,400,626,19,645
"کرمانشاه","پاوه","مرکزی",10,105,3,18,266,392,14,406
"کرمانشاه","پاوه","مرکزی",11,42,6,27,191,266,14,280
"کرمانشاه","پاوه","مرکزی",12,182,12,36,416,646,17,663
"کرمانشاه","پاوه","مرکزی",13,88,7,16,247,358,22,380
"کرمانشاه","پاوه","مرکزی",14,91,7,32,193,323,12,335
"کرمانشاه","پاوه","مرکزی",15,257,23,37,487,804,38,842
"کرمانشاه","پاوه","مرکزی",16,258,7,38,411,714,20,734
"کرمانشاه","پاوه","مرکزی",17,95,3,13,136,247,13,260
"کرمانشاه","پاوه","مرکزی",18,64,0,3,77,144,8,152
"کرمانشاه","پاوه","مرکزی",19,181,4,1,212,398,21,419
"کرمانشاه","پاوه","مرکزی",20,155,9,29,422,615,36,651
"کرمانشاه","پاوه","مرکزی",21,198,8,19,354,579,36,615
"کرمانشاه","پاوه","مرکزی",22,98,6,20,218,342,8,350
"کرمانشاه","پاوه","مرکزی",23,194,8,17,301,520,30,550
"کرمانشاه","پاوه","مرکزی",24,133,4,12,76,225,15,240
"کرمانشاه","پاوه","مرکزی",25,127,7,13,299,446,18,464
"کرمانشاه","پاوه","مرکزی",26,87,0,6,113,206,5,211
"کرمانشاه","پاوه","مرکزی",27,90,6,40,151,287,13,300
"کرمانشاه","پاوه","مرکزی",28,50,0,49,203,302,15,317
"کرمانشاه","پاوه","مرکزی",29,61,9,28,46,144,7,151
"کرمانشاه","پاوه","مرکزی",30,189,5,6,189,389,3,392
"کرمانشاه","پاوه","مرکزی",31,147,3,4,77,231,6,237
"کرمانشاه","پاوه","مرکزی",32,204,6,11,186,407,20,427
"کرمانشاه","پاوه","مرکزی",33,78,5,22,141,246,9,255
"کرمانشاه","پاوه","مرکزی",34,167,4,21,169,361,18,379
"کرمانشاه","پاوه","مرکزی",35,53,3,5,96,157,7,164
"کرمانشاه","پاوه","مرکزی",36,72,1,24,38,135,4,139
"کرمانشاه","پاوه","باینگان",1,235,11,15,180,441,10,451
"کرمانشاه","پاوه","باینگان",2,120,6,5,153,284,8,292
"کرمانشاه","پاوه","باینگان",3,58,3,0,60,121,1,122
"کرمانشاه","پاوه","باینگان",4,60,0,0,40,100,5,105
"کرمانشاه","پاوه","باینگان",5,184,2,6,187,379,15,394
"کرمانشاه","پاوه","باینگان",6,163,2,2,73,240,0,240
"کرمانشاه","پاوه","باینگان",7,89,2,3,49,143,9,152
"کرمانشاه","پاوه","باینگان",8,31,0,0,7,38,1,39
"کرمانشاه","پاوه","باینگان",9,127,0,6,68,201,4,205
"کرمانشاه","پاوه","باینگان",10,34,4,24,181,243,15,258
"کرمانشاه","پاوه","باینگان",11,165,8,10,223,406,28,434
"کرمانشاه","پاوه","باینگان",12,137,11,18,188,354,36,390
"کرمانشاه","پاوه","باینگان",13,101,4,1,59,165,19,184
"کرمانشاه","پاوه","باینگان",14,275,9,25,82,391,5,396
"کرمانشاه","پاوه","باینگان",15,168,0,4,116,288,14,302
"کرمانشاه","پاوه","باینگان",16,114,2,16,165,297,20,317
"کرمانشاه","پاوه","نوسود",1,148,4,3,265,420,24,444
"کرمانشاه","پاوه","نوسود",2,115,4,4,198,321,9,330
"کرمانشاه","پاوه","نوسود",3,233,2,2,149,386,16,402
"کرمانشاه","پاوه","نوسود",4,68,0,2,95,165,5,170
"کرمانشاه","پاوه","نوسود",5,95,0,2,140,237,14,251
"کرمانشاه","پاوه","نوسود",6,45,1,7,67,120,8,128
"کرمانشاه","پاوه","نوسود",7,140,1,9,141,291,13,304
"کرمانشاه","پاوه","نوسود",8,159,0,9,234,402,16,418
"کرمانشاه","پاوه","نوسود",9,107,6,5,149,267,3,270
"کرمانشاه","پاوه","نوسود",10,82,2,9,121,214,2,216
"کرمانشاه","پاوه","نوسود",11,52,0,1,179,232,5,237
"کرمانشاه","پاوه","نوسود",12,102,0,15,137,254,5,259
"کرمانشاه","پاوه","نوسود",13,51,1,2,50,104,7,111
"کرمانشاه","پاوه","نوسود",14,239,8,8,133,388,13,401
"کرمانشاه","پاوه","نوسود",15,119,1,1,159,280,7,287
"کرمانشاه","دالاهو","مرکزی",1,190,0,2,224,416,7,423
"کرمانشاه","دالاهو","مرکزی",2,243,14,8,464,729,13,742
"کرمانشاه","دالاهو","مرکزی",3,254,6,6,401,667,0,667
"کرمانشاه","دالاهو","مرکزی",4,314,4,6,263,587,7,594
"کرمانشاه","دالاهو","مرکزی",5,285,3,7,564,859,14,873
"کرمانشاه","دالاهو","مرکزی",6,198,3,0,91,292,5,297
"کرمانشاه","دالاهو","مرکزی",7,410,9,6,445,870,14,884
"کرمانشاه","دالاهو","مرکزی",8,204,7,2,245,458,6,464
"کرمانشاه","دالاهو","مرکزی",9,162,1,3,188,354,5,359
"کرمانشاه","دالاهو","مرکزی",10,353,4,3,275,635,10,645
"کرمانشاه","دالاهو","مرکزی",11,253,16,2,109,380,2,382
"کرمانشاه","دالاهو","مرکزی",12,510,4,0,176,690,5,695
"کرمانشاه","دالاهو","مرکزی",13,373,4,7,130,514,5,519
"کرمانشاه","دالاهو","مرکزی",14,327,2,0,134,463,7,470
"کرمانشاه","دالاهو","مرکزی",15,152,0,0,99,251,3,254
"کرمانشاه","دالاهو","مرکزی",16,223,5,20,429,677,18,695
"کرمانشاه","دالاهو","مرکزی",17,87,3,17,580,687,2,689
"کرمانشاه","دالاهو","مرکزی",18,214,12,25,319,570,2,572
"کرمانشاه","دالاهو","مرکزی",19,153,4,22,421,600,5,605
"کرمانشاه","دالاهو","مرکزی",20,350,2,6,378,736,4,740
"کرمانشاه","دالاهو","مرکزی",21,135,1,3,231,370,1,371
"کرمانشاه","دالاهو","مرکزی",22,105,1,1,109,216,0,216
"کرمانشاه","دالاهو","مرکزی",23,36,1,0,162,199,0,199
"کرمانشاه","دالاهو","مرکزی",24,116,11,3,97,227,3,230
"کرمانشاه","دالاهو","گهواره",1,170,3,0,426,599,11,610
"کرمانشاه","دالاهو","گهواره",2,199,6,2,500,707,9,716
"کرمانشاه","دالاهو","گهواره",3,191,5,3,561,760,9,769
"کرمانشاه","دالاهو","گهواره",4,92,3,1,434,530,4,534
"کرمانشاه","دالاهو","گهواره",5,164,2,1,300,467,3,470
"کرمانشاه","دالاهو","گهواره",6,81,1,0,392,474,1,475
"کرمانشاه","دالاهو","گهواره",7,72,1,0,426,499,0,499
"کرمانشاه","دالاهو","گهواره",8,59,6,0,184,249,2,251
"کرمانشاه","دالاهو","گهواره",9,218,1,3,174,396,2,398
"کرمانشاه","دالاهو","گهواره",10,145,3,6,195,349,5,354
"کرمانشاه","دالاهو","گهواره",11,99,0,2,417,518,2,520
"کرمانشاه","دالاهو","گهواره",12,163,0,1,288,452,3,455
"کرمانشاه","دالاهو","گهواره",13,169,4,2,241,416,0,416
"کرمانشاه","دالاهو","گهواره",14,81,2,5,299,387,2,389
"کرمانشاه","دالاهو","گهواره",15,85,5,0,314,404,5,409
"کرمانشاه","دالاهو","گهواره",16,91,5,8,367,471,1,472
"کرمانشاه","دالاهو","گهواره",17,58,1,0,243,302,0,302
"کرمانشاه","دالاهو","گهواره",18,83,1,1,494,579,1,580
"کرمانشاه","دالاهو","گهواره",19,76,0,0,372,448,0,448
"کرمانشاه","دالاهو","گهواره",20,67,0,1,316,384,2,386
"کرمانشاه","دالاهو","گهواره",21,101,1,1,347,450,1,451
"کرمانشاه","دالاهو","گهواره",22,30,0,0,395,425,0,425
"کرمانشاه","دالاهو","گهواره",23,132,0,1,319,452,1,453
"کرمانشاه","دالاهو","گهواره",24,52,2,1,396,451,1,452
"کرمانشاه","دالاهو","گهواره",25,59,1,1,170,231,0,231
"کرمانشاه","روانسر","روانسر",1,290,12,29,420,751,26,777
"کرمانشاه","روانسر","روانسر",2,252,16,45,396,709,23,732
"کرمانشاه","روانسر","روانسر",3,139,6,27,154,326,11,337
"کرمانشاه","روانسر","روانسر",4,158,12,14,217,401,14,415
"کرمانشاه","روانسر","روانسر",5,258,18,56,341,673,36,709
"کرمانشاه","روانسر","روانسر",6,106,7,17,225,355,14,369
"کرمانشاه","روانسر","روانسر",7,179,16,36,521,752,33,785
"کرمانشاه","روانسر","روانسر",8,101,17,17,338,473,25,498
"کرمانشاه","روانسر","روانسر",9,220,15,40,572,847,31,878
"کرمانشاه","روانسر","روانسر",10,216,22,51,554,843,42,885
"کرمانشاه","روانسر","روانسر",11,75,8,36,246,365,17,382
"کرمانشاه","روانسر","روانسر",12,143,14,16,293,466,12,478
"کرمانشاه","روانسر","روانسر",13,113,23,25,227,388,20,408
"کرمانشاه","روانسر","روانسر",14,94,2,5,141,242,6,248
"کرمانشاه","روانسر","روانسر",15,60,4,3,137,204,16,220
"کرمانشاه","روانسر","روانسر",16,268,17,12,122,419,11,430
"کرمانشاه","روانسر","روانسر",17,51,8,17,191,267,7,274
"کرمانشاه","روانسر","روانسر",18,85,2,21,148,256,9,265
"کرمانشاه","روانسر","روانسر",19,189,6,14,187,396,19,415
"کرمانشاه","روانسر","روانسر",20,150,3,22,153,328,14,342
"کرمانشاه","روانسر","روانسر",21,109,9,41,154,313,6,319
"کرمانشاه","روانسر","روانسر",22,234,5,28,148,415,9,424
"کرمانشاه","روانسر","روانسر",23,71,1,24,96,192,5,197
"کرمانشاه","روانسر","روانسر",24,116,6,27,190,339,21,360
"کرمانشاه","روانسر","روانسر",25,146,9,40,276,471,16,487
"کرمانشاه","روانسر","روانسر",26,109,4,27,208,348,15,363
"کرمانشاه","روانسر","روانسر",27,243,5,47,257,552,11,563
"کرمانشاه","روانسر","روانسر",28,161,5,19,318,503,11,514
"کرمانشاه","روانسر","روانسر",29,311,1,8,162,482,4,486
"کرمانشاه","روانسر","روانسر",30,180,6,10,189,385,6,391
"کرمانشاه","روانسر","روانسر",31,216,2,7,123,348,2,350
"کرمانشاه","روانسر","روانسر",32,162,11,7,165,345,2,347
"کرمانشاه","روانسر","روانسر",33,174,2,59,120,355,14,369
"کرمانشاه","روانسر","روانسر",34,131,0,14,168,313,14,327
"کرمانشاه","روانسر","روانسر",35,129,5,5,115,254,11,265
"کرمانشاه","روانسر","روانسر",36,108,2,16,56,182,5,187
"کرمانشاه","روانسر","روانسر",37,160,4,34,117,315,16,331
"کرمانشاه","روانسر","روانسر",38,93,1,1,61,156,2,158
"کرمانشاه","روانسر","روانسر",39,222,1,3,115,341,0,341
"کرمانشاه","روانسر","روانسر",40,74,5,0,61,140,3,143
"کرمانشاه","روانسر","روانسر",41,127,1,9,126,263,4,267
"کرمانشاه","روانسر","روانسر",42,125,6,8,154,293,2,295
"کرمانشاه","روانسر","روانسر",43,135,3,17,248,403,18,421
"کرمانشاه","روانسر","روانسر",44,262,2,12,172,448,11,459
"کرمانشاه","روانسر","شاهو",1,252,5,13,99,369,22,391
"کرمانشاه","روانسر","شاهو",2,205,1,11,200,417,17,434
"کرمانشاه","روانسر","شاهو",3,245,20,21,189,475,48,523
"کرمانشاه","روانسر","شاهو",4,275,8,22,199,504,45,549
"کرمانشاه","روانسر","شاهو",5,86,2,5,123,216,23,239
"کرمانشاه","روانسر","شاهو",6,77,0,3,101,181,14,195
"کرمانشاه","روانسر","شاهو",7,208,1,21,100,330,10,340
"کرمانشاه","روانسر","شاهو",8,67,0,29,71,167,3,170
"کرمانشاه","روانسر","شاهو",9,184,10,20,198,412,26,438
"کرمانشاه","ذهاب_سریل","مرکزی",1,164,12,7,176,359,3,362
"کرمانشاه","ذهاب_سریل","مرکزی",2,397,6,14,537,954,17,971
"کرمانشاه","ذهاب_سریل","مرکزی",3,265,13,9,266,553,15,568
"کرمانشاه","ذهاب_سریل","مرکزی",4,210,6,4,222,442,12,454
"کرمانشاه","ذهاب_سریل","مرکزی",5,233,10,1,262,506,10,516
"کرمانشاه","ذهاب_سریل","مرکزی",6,169,5,2,200,376,20,396
"کرمانشاه","ذهاب_سریل","مرکزی",7,263,3,9,420,695,27,722
"کرمانشاه","ذهاب_سریل","مرکزی",8,170,4,4,299,477,13,490
"کرمانشاه","ذهاب_سریل","مرکزی",9,192,0,24,459,675,48,723
"کرمانشاه","ذهاب_سریل","مرکزی",10,145,4,14,299,462,17,479
"کرمانشاه","ذهاب_سریل","مرکزی",11,223,6,10,460,699,28,727
"کرمانشاه","ذهاب_سریل","مرکزی",12,249,5,11,356,621,30,651
"کرمانشاه","ذهاب_سریل","مرکزی",13,442,7,18,487,954,26,980
"کرمانشاه","ذهاب_سریل","مرکزی",14,189,3,3,312,507,10,517
"کرمانشاه","ذهاب_سریل","مرکزی",15,192,6,8,220,426,10,436
"کرمانشاه","ذهاب_سریل","مرکزی",16,215,6,15,251,487,13,500
"کرمانشاه","ذهاب_سریل","مرکزی",17,240,5,14,295,554,13,567
"کرمانشاه","ذهاب_سریل","مرکزی",18,314,11,10,330,665,19,684
"کرمانشاه","ذهاب_سریل","مرکزی",19,467,16,22,538,1043,14,1057
"کرمانشاه","ذهاب_سریل","مرکزی",20,263,9,4,231,507,14,521
"کرمانشاه","ذهاب_سریل","مرکزی",21,441,16,15,435,907,16,923
"کرمانشاه","ذهاب_سریل","مرکزی",22,530,14,24,489,1057,23,1080
"کرمانشاه","ذهاب_سریل","مرکزی",23,137,7,5,120,269,4,273
"کرمانشاه","ذهاب_سریل","مرکزی",24,280,11,16,248,555,17,572
"کرمانشاه","ذهاب_سریل","مرکزی",25,609,10,20,296,935,33,968
"کرمانشاه","ذهاب_سریل","مرکزی",26,680,10,16,417,1123,12,1135
"کرمانشاه","ذهاب_سریل","مرکزی",27,260,1,8,182,451,7,458
"کرمانشاه","ذهاب_سریل","مرکزی",28,420,10,9,278,717,14,731
"کرمانشاه","ذهاب_سریل","مرکزی",29,400,14,8,218,640,12,652
"کرمانشاه","ذهاب_سریل","مرکزی",30,109,4,5,87,205,3,208
"کرمانشاه","ذهاب_سریل","مرکزی",31,365,8,9,130,512,3,515
"کرمانشاه","ذهاب_سریل","مرکزی",32,421,3,3,173,600,4,604
"کرمانشاه","ذهاب_سریل","مرکزی",33,473,10,5,230,718,4,722
"کرمانشاه","ذهاب_سریل","مرکزی",34,479,23,0,155,657,15,672
"کرمانشاه","ذهاب_سریل","مرکزی",35,463,15,5,234,717,13,730
"کرمانشاه","ذهاب_سریل","مرکزی",36,686,5,0,46,737,4,741
"کرمانشاه","ذهاب_سریل","مرکزی",37,716,3,0,138,857,3,860
"کرمانشاه","ذهاب_سریل","مرکزی",38,749,4,0,140,893,17,910
"کرمانشاه","ذهاب_سریل","مرکزی",39,653,9,2,189,853,7,860
"کرمانشاه","ذهاب_سریل","مرکزی",40,321,7,4,97,429,6,435
"کرمانشاه","ذهاب_سریل","مرکزی",41,431,5,1,184,621,1,622
"کرمانشاه","ذهاب_سریل","مرکزی",42,342,5,2,133,482,6,488
"کرمانشاه","ذهاب_سریل","مرکزی",43,150,5,3,78,236,2,238
"کرمانشاه","ذهاب_سریل","مرکزی",44,581,4,19,275,879,48,927
"کرمانشاه","ذهاب_سریل","مرکزی",45,285,5,3,120,413,7,420
"کرمانشاه","ذهاب_سریل","مرکزی",46,494,5,26,277,802,25,827
"کرمانشاه","ذهاب_سریل","مرکزی",47,192,2,2,337,533,9,542
"کرمانشاه","ذهاب_سریل","مرکزی",48,193,10,0,199,402,8,410
"کرمانشاه","ذهاب_سریل","مرکزی",49,181,11,9,196,397,7,404
"کرمانشاه","ذهاب_سریل","مرکزی",50,355,10,8,308,681,5,686
"کرمانشاه","ذهاب_سریل","مرکزی",51,145,2,1,158,306,3,309
"کرمانشاه","ذهاب_سریل","مرکزی",52,245,5,12,246,508,11,519
"کرمانشاه","ذهاب_سریل","مرکزی",53,149,3,3,217,372,5,377
"کرمانشاه","ذهاب_سریل","مرکزی",54,133,6,13,384,536,19,555
"کرمانشاه","ذهاب_سریل","مرکزی",55,123,1,15,248,387,10,397
"کرمانشاه","ذهاب_سریل","مرکزی",56,129,7,70,291,497,20,517
"کرمانشاه","ذهاب_سریل","مرکزی",57,203,5,23,279,510,15,525
"کرمانشاه","ذهاب_سریل","مرکزی",58,133,4,10,182,329,9,338
"کرمانشاه","ذهاب_سریل","مرکزی",59,183,3,10,127,323,11,334
"کرمانشاه","ذهاب_سریل","مرکزی",60,200,5,3,100,308,25,333
"کرمانشاه","ذهاب_سریل","مرکزی",61,244,3,8,63,318,4,322
"کرمانشاه","ذهاب_سریل","مرکزی",62,204,4,2,205,415,8,423
"کرمانشاه","ذهاب_سریل","مرکزی",63,34,0,0,114,148,9,157
"کرمانشاه","ذهاب_سریل","مرکزی",64,440,3,4,265,712,4,716
"کرمانشاه","ذهاب_سریل","مرکزی",65,36,0,0,62,98,0,98
"کرمانشاه","ذهاب_سریل","مرکزی",66,54,1,0,66,121,3,124
"کرمانشاه","ذهاب_سریل","مرکزی",67,371,1,3,106,481,5,486
"کرمانشاه","ذهاب_سریل","مرکزی",68,559,8,6,164,737,3,740
"کرمانشاه","ذهاب_سریل","مرکزی",69,303,14,4,131,452,5,457
"کرمانشاه","ذهاب_سریل","مرکزی",70,407,2,4,246,659,6,665
"کرمانشاه","ذهاب_سریل","مرکزی",71,513,13,0,146,672,6,678
"کرمانشاه","ذهاب_سریل","مرکزی",72,174,3,3,191,371,5,376
"کرمانشاه","ذهاب_سریل","مرکزی",73,127,4,7,182,320,5,325
"کرمانشاه","سنقر","مرکزی",1,471,8,7,348,834,17,851
"کرمانشاه","سنقر","مرکزی",2,669,5,4,361,1039,21,1060
"کرمانشاه","سنقر","مرکزی",3,662,17,6,298,983,16,999
"کرمانشاه","سنقر","مرکزی",4,631,2,0,112,745,9,754
"کرمانشاه","سنقر","مرکزی",5,1125,11,1,227,1364,12,1376
"کرمانشاه","سنقر","مرکزی",6,717,15,2,441,1175,25,1200
"کرمانشاه","سنقر","مرکزی",7,337,7,1,244,589,0,589
"کرمانشاه","سنقر","مرکزی",8,164,1,2,139,306,9,315
"کرمانشاه","سنقر","مرکزی",9,572,13,5,231,821,17,838
"کرمانشاه","سنقر","مرکزی",10,498,8,5,258,769,18,787
"کرمانشاه","سنقر","مرکزی",11,249,4,1,168,422,11,433
"کرمانشاه","سنقر","مرکزی",12,536,11,4,369,920,23,943
"کرمانشاه","سنقر","مرکزی",13,840,14,4,355,1213,11,1224
"کرمانشاه","سنقر","مرکزی",14,272,4,1,304,581,20,601
"کرمانشاه","سنقر","مرکزی",15,385,8,2,309,704,17,721
"کرمانشاه","سنقر","مرکزی",16,436,6,3,236,681,19,700
"کرمانشاه","سنقر","مرکزی",17,484,17,7,247,755,25,780
"کرمانشاه","سنقر","مرکزی",18,747,13,4,479,1243,36,1279
"کرمانشاه","سنقر","مرکزی",19,545,11,0,292,848,16,864
"کرمانشاه","سنقر","مرکزی",20,379,9,2,196,586,10,596
"کرمانشاه","سنقر","مرکزی",21,600,11,8,447,1066,34,1100
"کرمانشاه","سنقر","مرکزی",22,311,7,8,315,641,16,657
"کرمانشاه","سنقر","مرکزی",23,376,15,6,618,1015,30,1045
"کرمانشاه","سنقر","مرکزی",24,425,21,4,548,998,27,1025
"کرمانشاه","سنقر","مرکزی",25,377,9,8,436,830,18,848
"کرمانشاه","سنقر","مرکزی",26,531,8,1,197,737,10,747
"کرمانشاه","سنقر","مرکزی",27,582,22,5,364,973,22,995
"کرمانشاه","سنقر","مرکزی",28,687,13,3,463,1166,34,1200
"کرمانشاه","سنقر","مرکزی",29,689,19,5,436,1149,22,1171
"کرمانشاه","سنقر","مرکزی",30,369,13,1,534,917,18,935
"کرمانشاه","سنقر","مرکزی",31,563,8,1,229,801,18,819
"کرمانشاه","سنقر","مرکزی",32,397,11,2,129,539,16,555
"کرمانشاه","سنقر","مرکزی",33,330,1,0,40,371,8,379
"کرمانشاه","سنقر","مرکزی",34,118,3,1,57,179,8,187
"کرمانشاه","سنقر","مرکزی",35,563,0,0,45,608,38,646
"کرمانشاه","سنقر","مرکزی",36,413,1,1,35,450,5,455
"کرمانشاه","سنقر","مرکزی",37,431,2,2,58,493,8,501
"کرمانشاه","سنقر","مرکزی",38,310,5,0,96,411,8,419
"کرمانشاه","سنقر","مرکزی",39,653,12,0,112,777,14,791
"کرمانشاه","سنقر","مرکزی",40,724,6,0,106,836,12,848
"کرمانشاه","سنقر","مرکزی",41,587,0,3,55,645,23,668
"کرمانشاه","سنقر","مرکزی",42,461,0,0,47,508,9,517
"کرمانشاه","سنقر","مرکزی",43,793,5,5,61,864,14,878
"کرمانشاه","سنقر","مرکزی",44,446,2,0,57,505,10,515
"کرمانشاه","سنقر","مرکزی",45,793,1,1,117,912,30,942
"کرمانشاه","سنقر","مرکزی",46,132,1,0,11,144,2,146
"کرمانشاه","سنقر","مرکزی",47,358,2,0,46,406,11,417
"کرمانشاه","سنقر","مرکزی",48,556,0,1,40,597,3,600
"کرمانشاه","سنقر","مرکزی",49,678,11,2,139,830,2,832
"کرمانشاه","سنقر","مرکزی",50,420,2,1,35,458,2,460
"کرمانشاه","سنقر","مرکزی",51,428,1,0,42,471,4,475
"کرمانشاه","سنقر","مرکزی",52,810,2,0,85,897,9,906
"کرمانشاه","سنقر","مرکزی",53,572,5,2,69,648,5,653
"کرمانشاه","سنقر","مرکزی",54,224,0,0,17,241,2,243
"کرمانشاه","سنقر","مرکزی",55,385,2,0,23,410,8,418
"کرمانشاه","سنقر","مرکزی",56,579,1,1,36,617,12,629
"کرمانشاه","سنقر","مرکزی",57,333,0,0,28,361,3,364
"کرمانشاه","سنقر","مرکزی",58,562,3,0,58,623,10,633
"کرمانشاه","سنقر","مرکزی",59,273,5,2,58,338,4,342
"کرمانشاه","سنقر","مرکزی",60,509,4,0,90,603,14,617
"کرمانشاه","سنقر","مرکزی",61,430,5,0,28,463,9,472
"کرمانشاه","سنقر","مرکزی",62,425,10,0,115,550,11,561
"کرمانشاه","سنقر","مرکزی",63,275,1,0,68,344,16,360
"کرمانشاه","سنقر","مرکزی",64,545,12,1,85,643,13,656
"کرمانشاه","سنقر","مرکزی",65,314,1,0,26,341,23,364
"کرمانشاه","سنقر","مرکزی",66,842,3,0,51,896,10,906
"کرمانشاه","سنقر","مرکزی",67,365,1,3,12,381,6,387
"کرمانشاه","سنقر","مرکزی",68,855,5,2,109,971,22,993
"کرمانشاه","سنقر","مرکزی",69,482,5,0,77,564,9,573
"کرمانشاه","سنقر","مرکزی",70,424,7,2,51,484,0,484
"کرمانشاه","سنقر","مرکزی",71,879,4,1,74,958,16,974
"کرمانشاه","سنقر","کلیایی",1,219,2,0,82,303,5,308
"کرمانشاه","سنقر","کلیایی",2,410,3,4,188,605,20,625
"کرمانشاه","سنقر","کلیایی",3,616,7,1,124,748,5,753
"کرمانشاه","سنقر","کلیایی",4,501,3,1,25,530,3,533
"کرمانشاه","سنقر","کلیایی",5,358,2,0,37,397,1,398
"کرمانشاه","سنقر","کلیایی",6,316,3,0,54,373,2,375
"کرمانشاه","سنقر","کلیایی",7,381,1,2,68,452,4,456
"کرمانشاه","سنقر","کلیایی",8,254,2,0,68,324,6,330
"کرمانشاه","سنقر","کلیایی",9,188,1,0,32,221,6,227
"کرمانشاه","سنقر","کلیایی",10,266,0,1,64,331,1,332
"کرمانشاه","سنقر","کلیایی",11,294,4,1,34,333,10,343
"کرمانشاه","سنقر","کلیایی",12,370,4,0,50,424,7,431
"کرمانشاه","سنقر","کلیایی",13,272,4,1,84,361,2,363
"کرمانشاه","سنقر","کلیایی",14,438,3,0,37,478,6,484
"کرمانشاه","سنقر","کلیایی",15,682,8,0,65,755,4,759
"کرمانشاه","سنقر","کلیایی",16,377,1,0,41,419,10,429
"کرمانشاه","سنقر","کلیایی",17,389,0,1,81,471,6,477
"کرمانشاه","سنقر","کلیایی",18,256,3,1,56,316,3,319
"کرمانشاه","سنقر","کلیایی",19,390,1,0,17,408,2,410
"کرمانشاه","سنقر","کلیایی",20,295,1,2,58,356,7,363
"کرمانشاه","سنقر","کلیایی",21,319,1,0,16,336,9,345
"کرمانشاه","سنقر","کلیایی",22,359,2,0,26,387,5,392
"کرمانشاه","سنقر","کلیایی",23,156,3,1,36,196,4,200
"کرمانشاه","صحنه","مرکزی",1,507,2,6,288,803,12,815
"کرمانشاه","صحنه","مرکزی",2,652,8,7,272,939,10,949
"کرمانشاه","صحنه","مرکزی",3,532,4,3,183,722,6,728
"کرمانشاه","صحنه","مرکزی",4,387,8,10,409,814,5,819
"کرمانشاه","صحنه","مرکزی",5,322,6,2,328,658,6,664
"کرمانشاه","صحنه","مرکزی",6,180,3,3,359,545,5,550
"کرمانشاه","صحنه","مرکزی",7,227,10,5,431,673,8,681
"کرمانشاه","صحنه","مرکزی",8,265,3,5,128,401,2,403
"کرمانشاه","صحنه","مرکزی",9,475,0,3,123,601,6,607
"کرمانشاه","صحنه","مرکزی",10,358,2,12,378,750,8,758
"کرمانشاه","صحنه","مرکزی",11,296,2,3,163,464,3,467
"کرمانشاه","صحنه","مرکزی",12,68,2,9,133,212,3,215
"کرمانشاه","صحنه","مرکزی",13,360,9,8,406,783,8,791
"کرمانشاه","صحنه","مرکزی",14,176,7,6,684,873,6,879
"کرمانشاه","صحنه","مرکزی",15,171,9,5,270,455,0,455
"کرمانشاه","صحنه","مرکزی",16,210,4,2,172,388,4,392
"کرمانشاه","صحنه","مرکزی",17,160,2,1,98,261,1,262
"کرمانشاه","صحنه","مرکزی",18,400,2,2,123,527,2,529
"کرمانشاه","صحنه","مرکزی",19,371,0,4,167,542,7,549
"کرمانشاه","صحنه","مرکزی",20,117,3,9,141,270,6,276
"کرمانشاه","صحنه","مرکزی",21,342,5,18,527,892,7,899
"کرمانشاه","صحنه","مرکزی",22,347,13,13,303,676,6,682
"کرمانشاه","صحنه","مرکزی",23,329,3,6,286,624,12,636
"کرمانشاه","صحنه","مرکزی",24,366,8,2,355,731,3,734
"کرمانشاه","صحنه","مرکزی",25,523,7,8,380,918,10,928
"کرمانشاه","صحنه","مرکزی",26,375,5,13,310,703,3,706
"کرمانشاه","صحنه","مرکزی",27,471,15,16,321,823,2,825
"کرمانشاه","صحنه","مرکزی",28,150,6,3,105,264,0,264
"کرمانشاه","صحنه","مرکزی",29,228,2,8,169,407,2,409
"کرمانشاه","صحنه","مرکزی",30,203,0,1,88,292,2,294
"کرمانشاه","صحنه","مرکزی",31,243,1,3,96,343,6,349
"کرمانشاه","صحنه","مرکزی",32,444,4,4,258,710,1,711
"کرمانشاه","صحنه","مرکزی",33,223,7,9,127,366,1,367
"کرمانشاه","صحنه","مرکزی",34,279,1,0,75,355,0,355
"کرمانشاه","صحنه","مرکزی",35,266,4,65,235,570,4,574
"کرمانشاه","صحنه","مرکزی",36,590,2,0,94,686,2,688
"کرمانشاه","صحنه","مرکزی",37,455,9,1,63,528,3,531
"کرمانشاه","صحنه","مرکزی",38,255,0,1,33,289,1,290
"کرمانشاه","صحنه","مرکزی",39,200,3,1,64,268,1,269
"کرمانشاه","صحنه","مرکزی",40,667,1,3,92,763,0,763
"کرمانشاه","صحنه","مرکزی",41,369,2,1,101,473,2,475
"کرمانشاه","صحنه","مرکزی",42,632,2,1,98,733,2,735
"کرمانشاه","صحنه","مرکزی",42,613,1,10,109,733,5,738
"کرمانشاه","صحنه","مرکزی",44,719,2,1,41,763,3,766
"کرمانشاه","صحنه","مرکزی",45,270,2,0,32,304,0,304
"کرمانشاه","صحنه","مرکزی",46,138,2,1,44,185,1,186
"کرمانشاه","صحنه","مرکزی",47,264,1,4,134,403,7,410
"کرمانشاه","صحنه","مرکزی",48,562,3,1,99,665,1,666
"کرمانشاه","صحنه","مرکزی",49,474,1,1,67,543,0,543
"کرمانشاه","صحنه","مرکزی",50,634,1,1,110,746,3,749
"کرمانشاه","صحنه","مرکزی",51,278,2,1,36,317,1,318
"کرمانشاه","صحنه","مرکزی",52,243,1,6,73,323,6,329
"کرمانشاه","صحنه","مرکزی",53,214,0,1,88,303,0,303
"کرمانشاه","صحنه","مرکزی",54,115,1,2,90,208,2,210
"کرمانشاه","صحنه","مرکزی",55,332,0,1,48,381,3,384
"کرمانشاه","صحنه","مرکزی",56,619,6,0,43,668,5,673
"کرمانشاه","صحنه","مرکزی",57,102,0,1,97,200,0,200
"کرمانشاه","صحنه","دینور",1,665,2,5,191,863,2,865
"کرمانشاه","صحنه","دینور",2,360,2,0,130,492,5,497
"کرمانشاه","صحنه","دینور",3,510,8,13,156,687,4,691
"کرمانشاه","صحنه","دینور",4,391,12,3,79,485,1,486
"کرمانشاه","صحنه","دینور",5,392,5,2,67,466,6,472
"کرمانشاه","صحنه","دینور",6,230,9,0,53,292,0,292
"کرمانشاه","صحنه","دینور",7,135,2,1,74,212,2,214
"کرمانشاه","صحنه","دینور",8,206,4,1,118,329,3,332
"کرمانشاه","صحنه","دینور",9,367,1,1,61,430,0,430
"کرمانشاه","صحنه","دینور",10,478,1,8,96,583,2,585
"کرمانشاه","صحنه","دینور",11,405,2,0,121,528,5,533
"کرمانشاه","صحنه","دینور",12,236,0,3,59,298,2,300
"کرمانشاه","صحنه","دینور",13,214,0,0,60,274,1,275
"کرمانشاه","صحنه","دینور",14,217,0,0,53,270,0,270
"کرمانشاه","صحنه","دینور",15,308,5,1,107,421,6,427
"کرمانشاه","صحنه","دینور",16,308,5,0,53,366,1,367
"کرمانشاه","صحنه","دینور",17,404,3,0,143,550,3,553
"کرمانشاه","صحنه","دینور",18,252,1,1,40,294,2,296
"کرمانشاه","صحنه","دینور",19,354,4,0,118,476,0,476
"کرمانشاه","صحنه","دینور",20,674,3,0,60,737,0,737
"کرمانشاه","صحنه","دینور",21,462,5,2,97,566,0,566
"کرمانشاه","صحنه","دینور",22,113,2,0,8,123,0,123
"کرمانشاه","صحنه","دینور",23,153,1,0,15,169,3,172
"کرمانشاه","صحنه","دینور",24,97,1,10,42,150,1,151
"کرمانشاه","صحنه","دینور",25,305,10,8,181,504,4,508
"کرمانشاه","قصر_شیرین","شهری",1,210,6,7,286,509,5,514
"کرمانشاه","قصر_شیرین","شهری",2,187,2,4,164,357,9,366
"کرمانشاه","قصر_شیرین","شهری",3,207,6,3,193,409,7,416
"کرمانشاه","قصر_شیرین","شهری",4,321,10,4,407,742,14,756
"کرمانشاه","قصر_شیرین","شهری",5,466,15,8,356,845,6,851
"کرمانشاه","قصر_شیرین","شهری",6,217,4,6,384,611,7,618
"کرمانشاه","قصر_شیرین","شهری",7,374,8,10,317,709,14,723
"کرمانشاه","قصر_شیرین","شهری",8,166,4,6,144,320,4,324
"کرمانشاه","قصر_شیرین","شهری",9,373,9,5,403,790,8,798
"کرمانشاه","قصر_شیرین","شهری",10,142,7,7,263,419,4,423
"کرمانشاه","قصر_شیرین","شهری",11,447,12,7,514,980,13,993
"کرمانشاه","قصر_شیرین","شهری",12,377,8,6,352,743,9,752
"کرمانشاه","قصر_شیرین","شهری",13,428,4,3,302,737,9,746
"کرمانشاه","قصر_شیرین","شهری",14,216,4,1,151,372,10,382
"کرمانشاه","قصر_شیرین","مرکزی",15,121,5,3,119,248,6,254
"کرمانشاه","قصر_شیرین","مرکزی",16,105,0,0,84,189,1,190
"کرمانشاه","قصر_شیرین","مرکزی",17,163,3,1,273,440,2,442
"کرمانشاه","قصر_شیرین","مرکزی",18,63,0,1,35,99,1,100
"کرمانشاه","قصر_شیرین","مرکزی",19,39,0,1,17,57,1,58
"کرمانشاه","قصر_شیرین","مرکزی",20,221,4,5,143,373,12,385
"کرمانشاه","قصر_شیرین","مرکزی",21,287,3,6,149,445,3,448
"کرمانشاه","قصر_شیرین","مرکزی",22,206,3,0,80,289,9,298
"کرمانشاه","قصر_شیرین","مرکزی",23,163,2,1,113,279,4,283
"کرمانشاه","قصر_شیرین","مرکزی",24,29,0,0,27,56,0,56
"کرمانشاه","قصر_شیرین","مرکزی",25,21,1,0,16,38,2,40
"کرمانشاه","قصر_شیرین","مرکزی",26,18,0,0,18,36,2,38
"کرمانشاه","قصر_شیرین","مرکزی",27,119,2,0,52,173,3,176
"کرمانشاه","قصر_شیرین","مرکزی",28,32,0,1,36,69,3,72
"کرمانشاه","قصر_شیرین","مرکزی",29,264,3,0,73,340,7,347
"کرمانشاه","قصر_شیرین","سومار",1,94,2,4,36,136,2,138
"کرمانشاه","قصر_شیرین","سومار",2,89,1,0,20,110,0,110
"کرمانشاه","قصر_شیرین","سومار",3,50,0,0,24,74,0,74
"کرمانشاه","قصر_شیرین","سومار",4,147,6,3,119,275,2,277
"کرمانشاه","قصر_شیرین","سومار",5,75,1,2,36,114,2,116
"کرمانشاه","قصر_شیرین","سومار",6,78,0,0,43,121,5,126
"کرمانشاه","کرمانشاه","مرکزی",1,684,18,3,412,1117,4,1121
"کرمانشاه","کرمانشاه","مرکزی",2,697,17,8,571,1293,4,1297
"کرمانشاه","کرمانشاه","مرکزی",3,889,21,4,555,1469,13,1482
"کرمانشاه","کرمانشاه","مرکزی",4,445,21,5,476,947,20,967
"کرمانشاه","کرمانشاه","مرکزی",5,313,9,3,559,884,10,894
"کرمانشاه","کرمانشاه","مرکزی",6,359,12,16,687,1074,10,1084
"کرمانشاه","کرمانشاه","مرکزی",7,323,16,10,559,908,20,928
"کرمانشاه","کرمانشاه","مرکزی",8,193,17,4,459,673,20,693
"کرمانشاه","کرمانشاه","مرکزی",9,242,14,12,551,819,5,824
"کرمانشاه","کرمانشاه","مرکزی",10,322,18,6,525,871,15,886
"کرمانشاه","کرمانشاه","مرکزی",11,267,11,14,459,751,12,763
"کرمانشاه","کرمانشاه","مرکزی",12,515,14,4,349,882,16,898
"کرمانشاه","کرمانشاه","مرکزی",13,399,15,9,994,1417,11,1428
"کرمانشاه","کرمانشاه","مرکزی",14,433,22,16,866,1337,18,1355
"کرمانشاه","کرمانشاه","مرکزی",15,302,31,21,694,1048,10,1058
"کرمانشاه","کرمانشاه","مرکزی",16,339,27,16,821,1203,6,1209
"کرمانشاه","کرمانشاه","مرکزی",17,618,25,13,871,1527,11,1538
"کرمانشاه","کرمانشاه","مرکزی",18,265,18,13,637,933,5,938
"کرمانشاه","کرمانشاه","مرکزی",19,763,14,1,136,914,19,933
"کرمانشاه","کرمانشاه","مرکزی",20,786,14,1,145,946,9,955
"کرمانشاه","کرمانشاه","مرکزی",21,454,30,23,725,1232,2,1234
"کرمانشاه","کرمانشاه","مرکزی",22,242,7,9,384,642,18,660
"کرمانشاه","کرمانشاه","مرکزی",23,414,13,9,483,919,10,929
"کرمانشاه","کرمانشاه","مرکزی",24,392,9,8,519,928,14,942
"کرمانشاه","کرمانشاه","مرکزی",25,539,11,4,754,1308,11,1319
"کرمانشاه","کرمانشاه","مرکزی",26,439,17,3,541,1000,24,1024
"کرمانشاه","کرمانشاه","مرکزی",27,634,23,11,722,1390,17,1407
"کرمانشاه","کرمانشاه","مرکزی",28,420,14,6,355,795,18,813
"کرمانشاه","کرمانشاه","مرکزی",29,449,19,8,364,840,4,844
"کرمانشاه","کرمانشاه","مرکزی",30,638,15,5,210,868,28,896
"کرمانشاه","کرمانشاه","مرکزی",31,672,7,1,178,858,3,861
"کرمانشاه","کرمانشاه","مرکزی",32,697,13,17,397,1124,9,1133
"کرمانشاه","کرمانشاه","مرکزی",33,623,17,9,322,971,15,986
"کرمانشاه","کرمانشاه","مرکزی",34,606,11,11,239,867,14,881
"کرمانشاه","کرمانشاه","مرکزی",35,464,18,9,342,833,7,840
"کرمانشاه","کرمانشاه","مرکزی",36,792,9,22,264,1087,5,1092
"کرمانشاه","کرمانشاه","مرکزی",37,830,2,2,168,1002,0,1002
"کرمانشاه","کرمانشاه","مرکزی",38,972,9,15,201,1197,13,1210
"کرمانشاه","کرمانشاه","مرکزی",39,532,32,7,899,1470,13,1483
"کرمانشاه","کرمانشاه","مرکزی",40,320,16,10,537,883,17,900
"کرمانشاه","کرمانشاه","مرکزی",41,245,10,4,486,745,15,760
"کرمانشاه","کرمانشاه","مرکزی",42,394,30,9,815,1248,8,1256
"کرمانشاه","کرمانشاه","مرکزی",43,337,20,15,927,1299,9,1308
"کرمانشاه","کرمانشاه","مرکزی",44,390,9,10,759,1168,14,1182
"کرمانشاه","کرمانشاه","مرکزی",45,400,19,7,570,996,10,1006
"کرمانشاه","کرمانشاه","مرکزی",46,252,13,12,484,761,12,773
"کرمانشاه","کرمانشاه","مرکزی",47,443,15,3,539,1000,9,1009
"کرمانشاه","کرمانشاه","مرکزی",48,593,19,2,359,973,19,992
"کرمانشاه","کرمانشاه","مرکزی",49,259,7,4,159,429,15,444
"کرمانشاه","کرمانشاه","مرکزی",50,426,11,8,296,741,9,750
"کرمانشاه","کرمانشاه","مرکزی",51,445,22,19,578,1064,13,1077
"کرمانشاه","کرمانشاه","مرکزی",52,414,13,4,512,943,7,950
"کرمانشاه","کرمانشاه","مرکزی",53,503,13,9,602,1127,22,1149
"کرمانشاه","کرمانشاه","مرکزی",54,460,15,3,414,892,0,892
"کرمانشاه","کرمانشاه","مرکزی",55,538,15,8,394,955,7,962
"کرمانشاه","کرمانشاه","مرکزی",56,333,10,16,554,913,4,917
"کرمانشاه","کرمانشاه","مرکزی",57,474,11,5,295,785,18,803
"کرمانشاه","کرمانشاه","مرکزی",58,524,14,9,534,1081,15,1096
"کرمانشاه","کرمانشاه","مرکزی",59,512,22,9,551,1094,18,1112
"کرمانشاه","کرمانشاه","مرکزی",60,608,26,4,549,1187,20,1207
"کرمانشاه","کرمانشاه","مرکزی",61,522,23,4,461,1010,12,1022
"کرمانشاه","کرمانشاه","مرکزی",62,561,15,9,244,829,12,841
"کرمانشاه","کرمانشاه","مرکزی",63,323,23,10,428,784,9,793
"کرمانشاه","کرمانشاه","مرکزی",64,786,14,6,248,1054,9,1063
"کرمانشاه","کرمانشاه","مرکزی",65,697,9,9,433,1148,15,1163
"کرمانشاه","کرمانشاه","مرکزی",66,679,9,4,298,990,16,1006
"کرمانشاه","کرمانشاه","مرکزی",67,867,5,1,170,1043,5,1048
"کرمانشاه","کرمانشاه","مرکزی",68,650,12,7,396,1065,10,1075
"کرمانشاه","کرمانشاه","مرکزی",69,1065,9,11,287,1372,25,1397
"کرمانشاه","کرمانشاه","مرکزی",70,613,5,2,84,704,18,722
"کرمانشاه","کرمانشاه","مرکزی",71,712,4,0,116,832,11,843
"کرمانشاه","کرمانشاه","مرکزی",72,825,3,2,196,1026,1,1027
"کرمانشاه","کرمانشاه","مرکزی",73,774,9,2,123,908,18,926
"کرمانشاه","کرمانشاه","مرکزی",74,415,3,0,219,637,10,647
"کرمانشاه","کرمانشاه","مرکزی",75,462,6,0,195,663,11,674
"کرمانشاه","کرمانشاه","مرکزی",76,592,3,9,271,875,4,879
"کرمانشاه","کرمانشاه","مرکزی",77,800,18,4,535,1357,11,1368
"کرمانشاه","کرمانشاه","مرکزی",78,561,8,5,463,1037,16,1053
"کرمانشاه","کرمانشاه","مرکزی",79,495,9,4,386,894,14,908
"کرمانشاه","کرمانشاه","مرکزی",80,567,18,4,453,1042,10,1052
"کرمانشاه","کرمانشاه","مرکزی",81,483,12,4,484,983,10,993
"کرمانشاه","کرمانشاه","مرکزی",82,513,11,2,430,956,0,956
"کرمانشاه","کرمانشاه","مرکزی",83,449,17,8,323,797,15,812
"کرمانشاه","کرمانشاه","مرکزی",84,500,5,4,294,803,5,808
"کرمانشاه","کرمانشاه","مرکزی",85,705,22,5,396,1128,15,1143
"کرمانشاه","کرمانشاه","مرکزی",86,288,3,1,164,456,0,456
"کرمانشاه","کرمانشاه","مرکزی",87,319,13,14,352,698,2,700
"کرمانشاه","کرمانشاه","مرکزی",88,442,3,18,264,727,11,738
"کرمانشاه","کرمانشاه","مرکزی",89,769,14,5,378,1166,12,1178
"کرمانشاه","کرمانشاه","مرکزی",90,493,10,9,277,789,12,801
"کرمانشاه","کرمانشاه","مرکزی",91,396,12,4,264,676,7,683
"کرمانشاه","کرمانشاه","مرکزی",92,484,3,14,209,710,6,716
"کرمانشاه","کرمانشاه","مرکزی",93,715,21,11,328,1075,10,1085
"کرمانشاه","کرمانشاه","مرکزی",94,579,26,20,363,988,10,998
"کرمانشاه","کرمانشاه","مرکزی",95,421,8,10,465,904,7,911
"کرمانشاه","کرمانشاه","مرکزی",96,396,30,7,455,888,16,904
"کرمانشاه","کرمانشاه","مرکزی",97,320,10,4,193,527,10,537
"کرمانشاه","کرمانشاه","مرکزی",98,603,9,4,331,947,7,954
"کرمانشاه","کرمانشاه","مرکزی",99,416,6,7,568,997,15,1012
"کرمانشاه","کرمانشاه","مرکزی",100,269,22,3,384,678,25,703
"کرمانشاه","کرمانشاه","مرکزی",101,361,14,8,702,1085,11,1096
"کرمانشاه","کرمانشاه","مرکزی",102,483,21,12,872,1388,15,1403
"کرمانشاه","کرمانشاه","مرکزی",103,633,9,6,205,853,21,874
"کرمانشاه","کرمانشاه","مرکزی",104,480,3,0,232,715,0,715
"کرمانشاه","کرمانشاه","مرکزی",105,770,6,14,218,1008,5,1013
"کرمانشاه","کرمانشاه","مرکزی",106,724,15,12,173,924,13,937
"کرمانشاه","کرمانشاه","مرکزی",107,596,6,5,187,794,9,803
"کرمانشاه","کرمانشاه","مرکزی",108,719,7,1,194,921,6,927
"کرمانشاه","کرمانشاه","مرکزی",109,431,14,2,293,740,17,757
"کرمانشاه","کرمانشاه","مرکزی",110,747,5,9,156,917,8,925
"کرمانشاه","کرمانشاه","مرکزی",111,636,6,1,163,806,11,817
"کرمانشاه","کرمانشاه","مرکزی",112,797,12,1,166,976,8,984
"کرمانشاه","کرمانشاه","مرکزی",113,493,8,6,130,637,8,645
"کرمانشاه","کرمانشاه","مرکزی",114,1089,7,6,83,1185,5,1190
"کرمانشاه","کرمانشاه","مرکزی",115,824,5,17,112,958,6,964
"کرمانشاه","کرمانشاه","مرکزی",116,864,6,7,172,1049,5,1054
"کرمانشاه","کرمانشاه","مرکزی",117,1024,4,1,52,1081,11,1092
"کرمانشاه","کرمانشاه","مرکزی",118,737,4,5,105,851,6,857
"کرمانشاه","کرمانشاه","مرکزی",119,931,7,3,113,1054,4,1058
"کرمانشاه","کرمانشاه","مرکزی",120,627,4,7,129,767,15,782
"کرمانشاه","کرمانشاه","مرکزی",121,636,11,4,150,801,6,807
"کرمانشاه","کرمانشاه","مرکزی",122,776,3,1,108,888,6,894
"کرمانشاه","کرمانشاه","مرکزی",123,971,12,3,140,1126,8,1134
"کرمانشاه","کرمانشاه","مرکزی",124,605,2,1,99,707,8,715
"کرمانشاه","کرمانشاه","مرکزی",125,688,5,11,147,851,8,859
"کرمانشاه","کرمانشاه","مرکزی",126,896,0,1,55,952,7,959
"کرمانشاه","کرمانشاه","مرکزی",127,718,7,5,114,844,7,851
"کرمانشاه","کرمانشاه","مرکزی",128,536,14,3,363,916,2,918
"کرمانشاه","کرمانشاه","مرکزی",129,532,23,3,367,925,10,935
"کرمانشاه","کرمانشاه","مرکزی",130,612,20,12,451,1095,18,1113
"کرمانشاه","کرمانشاه","مرکزی",131,534,15,9,571,1129,16,1145
"کرمانشاه","کرمانشاه","مرکزی",132,386,16,7,508,917,19,936
"کرمانشاه","کرمانشاه","مرکزی",133,394,14,11,473,892,12,904
"کرمانشاه","کرمانشاه","مرکزی",134,297,11,9,450,767,16,783
"کرمانشاه","کرمانشاه","مرکزی",135,269,14,9,290,582,13,595
"کرمانشاه","کرمانشاه","مرکزی",136,492,7,5,351,855,10,865
"کرمانشاه","کرمانشاه","مرکزی",137,477,14,1,515,1007,17,1024
"کرمانشاه","کرمانشاه","مرکزی",138,488,15,1,331,835,15,850
"کرمانشاه","کرمانشاه","مرکزی",139,388,16,7,571,982,14,996
"کرمانشاه","کرمانشاه","مرکزی",140,304,13,4,336,657,14,671
"کرمانشاه","کرمانشاه","مرکزی",141,838,17,8,539,1402,14,1416
"کرمانشاه","کرمانشاه","مرکزی",142,518,14,7,332,871,16,887
"کرمانشاه","کرمانشاه","مرکزی",143,494,10,6,427,937,18,955
"کرمانشاه","کرمانشاه","مرکزی",144,657,8,6,511,1182,17,1199
"کرمانشاه","کرمانشاه","مرکزی",145,506,12,1,472,991,11,1002
"کرمانشاه","کرمانشاه","مرکزی",146,297,3,0,298,598,9,607
"کرمانشاه","کرمانشاه","مرکزی",147,329,8,6,701,1044,2,1046
"کرمانشاه","کرمانشاه","مرکزی",148,429,10,11,657,1107,11,1118
"کرمانشاه","کرمانشاه","مرکزی",149,416,5,4,478,903,12,915
"کرمانشاه","کرمانشاه","مرکزی",150,264,10,1,395,670,12,682
"کرمانشاه","کرمانشاه","مرکزی",151,304,7,10,440,761,8,769
"کرمانشاه","کرمانشاه","مرکزی",152,440,11,10,511,972,13,985
"کرمانشاه","کرمانشاه","مرکزی",153,486,10,7,462,965,0,965
"کرمانشاه","کرمانشاه","مرکزی",154,385,8,4,336,733,14,747
"کرمانشاه","کرمانشاه","مرکزی",155,407,7,4,384,802,0,802
"کرمانشاه","کرمانشاه","مرکزی",156,312,7,3,406,728,15,743
"کرمانشاه","کرمانشاه","مرکزی",157,454,11,8,515,988,26,1014
"کرمانشاه","کرمانشاه","مرکزی",158,338,7,5,326,676,39,715
"کرمانشاه","کرمانشاه","مرکزی",159,523,12,4,472,1011,16,1027
"کرمانشاه","کرمانشاه","مرکزی",160,379,6,8,394,787,12,799
"کرمانشاه","کرمانشاه","مرکزی",161,465,5,9,601,1080,38,1118
"کرمانشاه","کرمانشاه","مرکزی",162,321,12,9,466,808,25,833
"کرمانشاه","کرمانشاه","مرکزی",163,468,13,5,565,1051,16,1067
"کرمانشاه","کرمانشاه","مرکزی",164,614,14,11,677,1316,19,1335
"کرمانشاه","کرمانشاه","مرکزی",165,386,10,5,564,965,32,997
"کرمانشاه","کرمانشاه","مرکزی",166,344,13,4,551,912,4,916
"کرمانشاه","کرمانشاه","مرکزی",167,630,34,17,925,1606,8,1614
"کرمانشاه","کرمانشاه","مرکزی",168,599,23,8,855,1485,27,1512
"کرمانشاه","کرمانشاه","مرکزی",169,803,32,15,824,1674,26,1700
"کرمانشاه","کرمانشاه","مرکزی",170,590,22,21,775,1408,25,1433
"کرمانشاه","کرمانشاه","مرکزی",171,434,17,12,738,1201,18,1219
"کرمانشاه","کرمانشاه","مرکزی",172,523,19,5,694,1241,14,1255
"کرمانشاه","کرمانشاه","مرکزی",173,834,17,5,517,1373,7,1380
"کرمانشاه","کرمانشاه","مرکزی",174,655,15,8,536,1214,11,1225
"کرمانشاه","کرمانشاه","مرکزی",175,819,27,8,667,1521,13,1534
"کرمانشاه","کرمانشاه","مرکزی",176,807,20,11,596,1434,16,1450
"کرمانشاه","کرمانشاه","مرکزی",177,651,18,15,686,1370,13,1383
"کرمانشاه","کرمانشاه","مرکزی",178,653,19,8,757,1437,22,1459
"کرمانشاه","کرمانشاه","مرکزی",179,688,24,15,647,1374,12,1386
"کرمانشاه","کرمانشاه","مرکزی",180,497,27,20,859,1403,19,1422
"کرمانشاه","کرمانشاه","مرکزی",181,458,17,12,618,1105,18,1123
"کرمانشاه","کرمانشاه","مرکزی",182,458,18,8,600,1084,17,1101
"کرمانشاه","کرمانشاه","مرکزی",183,682,24,8,768,1482,15,1497
"کرمانشاه","کرمانشاه","مرکزی",184,610,14,4,558,1186,15,1201
"کرمانشاه","کرمانشاه","مرکزی",185,655,22,11,695,1383,13,1396
"کرمانشاه","کرمانشاه","مرکزی",186,770,11,1,305,1087,17,1104
"کرمانشاه","کرمانشاه","مرکزی",187,880,13,6,260,1159,5,1164
"کرمانشاه","کرمانشاه","مرکزی",188,694,6,3,175,878,16,894
"کرمانشاه","کرمانشاه","مرکزی",189,802,6,2,252,1062,9,1071
"کرمانشاه","کرمانشاه","مرکزی",190,919,7,4,175,1105,16,1121
"کرمانشاه","کرمانشاه","مرکزی",191,858,9,11,291,1169,14,1183
"کرمانشاه","کرمانشاه","مرکزی",192,605,10,5,181,801,17,818
"کرمانشاه","کرمانشاه","مرکزی",193,747,9,15,218,989,5,994
"کرمانشاه","کرمانشاه","مرکزی",194,605,15,3,371,994,14,1008
"کرمانشاه","کرمانشاه","مرکزی",195,447,20,10,198,675,20,695
"کرمانشاه","کرمانشاه","مرکزی",196,729,13,10,342,1094,10,1104
"کرمانشاه","کرمانشاه","مرکزی",197,734,2,5,280,1021,8,1029
"کرمانشاه","کرمانشاه","مرکزی",198,922,13,19,380,1334,9,1343
"کرمانشاه","کرمانشاه","مرکزی",199,922,9,7,294,1232,15,1247
"کرمانشاه","کرمانشاه","مرکزی",200,883,23,10,371,1287,11,1298
"کرمانشاه","کرمانشاه","مرکزی",201,782,8,5,227,1022,17,1039
"کرمانشاه","کرمانشاه","مرکزی",202,633,14,1,176,824,0,824
"کرمانشاه","کرمانشاه","مرکزی",203,566,7,3,181,757,8,765
"کرمانشاه","کرمانشاه","مرکزی",204,974,14,6,416,1410,4,1414
"کرمانشاه","کرمانشاه","مرکزی",205,649,12,7,323,991,9,1000
"کرمانشاه","کرمانشاه","مرکزی",206,630,5,4,203,842,7,849
"کرمانشاه","کرمانشاه","مرکزی",207,903,5,0,182,1090,0,1090
"کرمانشاه","کرمانشاه","مرکزی",208,816,4,1,140,961,10,971
"کرمانشاه","کرمانشاه","مرکزی",209,906,8,2,230,1146,8,1154
"کرمانشاه","کرمانشاه","مرکزی",210,771,6,2,83,862,15,877
"کرمانشاه","کرمانشاه","مرکزی",211,832,4,3,233,1072,6,1078
"کرمانشاه","کرمانشاه","مرکزی",212,568,9,0,176,753,23,776
"کرمانشاه","کرمانشاه","مرکزی",213,900,9,8,166,1083,21,1104
"کرمانشاه","کرمانشاه","مرکزی",214,1078,1,2,147,1228,25,1253
"کرمانشاه","کرمانشاه","مرکزی",215,727,5,1,147,880,6,886
"کرمانشاه","کرمانشاه","مرکزی",216,877,12,2,252,1143,18,1161
"کرمانشاه","کرمانشاه","مرکزی",217,715,15,8,294,1032,13,1045
"کرمانشاه","کرمانشاه","مرکزی",218,993,8,2,288,1291,13,1304
"کرمانشاه","کرمانشاه","مرکزی",219,876,6,4,283,1169,15,1184
"کرمانشاه","کرمانشاه","مرکزی",220,746,14,4,260,1024,9,1033
"کرمانشاه","کرمانشاه","مرکزی",221,1099,12,3,265,1379,9,1388
"کرمانشاه","کرمانشاه","مرکزی",222,1000,10,6,284,1300,13,1313
"کرمانشاه","کرمانشاه","مرکزی",223,627,22,4,527,1180,18,1198
"کرمانشاه","کرمانشاه","مرکزی",224,372,29,16,750,1167,34,1201
"کرمانشاه","کرمانشاه","مرکزی",225,593,30,6,691,1320,9,1329
"کرمانشاه","کرمانشاه","مرکزی",226,510,35,8,821,1374,18,1392
"کرمانشاه","کرمانشاه","مرکزی",227,432,28,12,843,1315,26,1341
"کرمانشاه","کرمانشاه","مرکزی",228,274,26,19,702,1021,16,1037
"کرمانشاه","کرمانشاه","مرکزی",229,310,23,13,911,1257,13,1270
"کرمانشاه","کرمانشاه","مرکزی",230,446,20,8,664,1138,11,1149
"کرمانشاه","کرمانشاه","مرکزی",231,358,6,8,621,993,13,1006
"کرمانشاه","کرمانشاه","مرکزی",232,393,32,21,929,1375,7,1382
"کرمانشاه","کرمانشاه","مرکزی",233,348,14,20,651,1033,22,1055
"کرمانشاه","کرمانشاه","مرکزی",234,339,18,5,610,972,11,983
"کرمانشاه","کرمانشاه","مرکزی",235,385,16,9,570,980,7,987
"کرمانشاه","کرمانشاه","مرکزی",236,554,28,10,829,1421,20,1441
"کرمانشاه","کرمانشاه","مرکزی",237,492,10,15,605,1122,26,1148
"کرمانشاه","کرمانشاه","مرکزی",238,444,24,26,1082,1576,18,1594
"کرمانشاه","کرمانشاه","مرکزی",239,323,13,5,598,939,10,949
"کرمانشاه","کرمانشاه","مرکزی",240,312,37,14,898,1261,16,1277
"کرمانشاه","کرمانشاه","مرکزی",241,333,16,11,976,1336,19,1355
"کرمانشاه","کرمانشاه","مرکزی",242,287,9,21,1042,1359,8,1367
"کرمانشاه","کرمانشاه","مرکزی",243,397,23,10,798,1228,22,1250
"کرمانشاه","کرمانشاه","مرکزی",244,267,18,9,711,1005,10,1015
"کرمانشاه","کرمانشاه","مرکزی",245,355,23,7,516,901,17,918
"کرمانشاه","کرمانشاه","مرکزی",246,351,14,8,644,1017,13,1030
"کرمانشاه","کرمانشاه","مرکزی",247,502,25,6,943,1476,11,1487
"کرمانشاه","کرمانشاه","مرکزی",248,369,12,16,991,1388,19,1407
"کرمانشاه","کرمانشاه","مرکزی",249,407,19,4,707,1137,25,1162
"کرمانشاه","کرمانشاه","مرکزی",250,220,16,5,409,650,17,667
"کرمانشاه","کرمانشاه","مرکزی",251,347,21,21,1003,1392,7,1399
"کرمانشاه","کرمانشاه","مرکزی",252,278,12,12,1085,1387,14,1401
"کرمانشاه","کرمانشاه","مرکزی",253,243,15,19,950,1227,18,1245
"کرمانشاه","کرمانشاه","مرکزی",254,545,27,29,818,1419,7,1426
"کرمانشاه","کرمانشاه","مرکزی",255,254,19,13,587,873,21,894
"کرمانشاه","کرمانشاه","مرکزی",256,506,19,23,864,1412,2,1414
"کرمانشاه","کرمانشاه","مرکزی",257,259,19,33,732,1043,10,1053
"کرمانشاه","کرمانشاه","مرکزی",258,301,21,8,537,867,10,877
"کرمانشاه","کرمانشاه","مرکزی",259,281,16,16,753,1066,5,1071
"کرمانشاه","کرمانشاه","مرکزی",260,351,15,11,659,1036,9,1045
"کرمانشاه","کرمانشاه","مرکزی",261,430,31,28,932,1421,15,1436
"کرمانشاه","کرمانشاه","مرکزی",262,507,31,27,794,1359,18,1377
"کرمانشاه","کرمانشاه","مرکزی",263,637,10,3,473,1123,17,1140
"کرمانشاه","کرمانشاه","مرکزی",264,507,20,6,597,1130,14,1144
"کرمانشاه","کرمانشاه","مرکزی",265,355,20,19,663,1057,15,1072
"کرمانشاه","کرمانشاه","مرکزی",266,293,16,20,674,1003,21,1024
"کرمانشاه","کرمانشاه","مرکزی",267,471,38,50,598,1157,9,1166
"کرمانشاه","کرمانشاه","مرکزی",268,728,19,3,463,1213,17,1230
"کرمانشاه","کرمانشاه","مرکزی",269,661,32,8,421,1122,28,1150
"کرمانشاه","کرمانشاه","مرکزی",270,708,19,9,326,1062,18,1080
"کرمانشاه","کرمانشاه","مرکزی",271,663,20,2,363,1048,14,1062
"کرمانشاه","کرمانشاه","مرکزی",272,506,27,7,627,1167,14,1181
"کرمانشاه","کرمانشاه","مرکزی",273,735,14,15,353,1117,13,1130
"کرمانشاه","کرمانشاه","مرکزی",274,560,16,5,353,934,15,949
"کرمانشاه","کرمانشاه","مرکزی",275,656,8,5,307,976,7,983
"کرمانشاه","کرمانشاه","مرکزی",276,671,8,4,307,990,10,1000
"کرمانشاه","کرمانشاه","مرکزی",277,590,10,1,251,852,11,863
"کرمانشاه","کرمانشاه","مرکزی",278,354,6,4,186,550,15,565
"کرمانشاه","کرمانشاه","مرکزی",279,643,19,6,501,1169,7,1176
"کرمانشاه","کرمانشاه","مرکزی",280,750,11,0,354,1115,17,1132
"کرمانشاه","کرمانشاه","مرکزی",281,531,9,6,320,866,13,879
"کرمانشاه","کرمانشاه","مرکزی",282,827,10,1,417,1255,8,1263
"کرمانشاه","کرمانشاه","مرکزی",283,748,22,15,469,1254,8,1262
"کرمانشاه","کرمانشاه","مرکزی",284,696,10,3,531,1240,20,1260
"کرمانشاه","کرمانشاه","مرکزی",285,666,16,3,471,1156,16,1172
"کرمانشاه","کرمانشاه","مرکزی",286,722,18,10,454,1204,18,1222
"کرمانشاه","کرمانشاه","مرکزی",287,552,16,8,351,927,12,939
"کرمانشاه","کرمانشاه","مرکزی",288,905,19,13,243,1180,15,1195
"کرمانشاه","کرمانشاه","مرکزی",289,933,22,6,185,1146,13,1159
"کرمانشاه","کرمانشاه","مرکزی",290,1040,20,4,218,1282,9,1291
"کرمانشاه","کرمانشاه","مرکزی",291,950,11,2,273,1236,9,1245
"کرمانشاه","کرمانشاه","مرکزی",292,909,25,2,274,1210,9,1219
"کرمانشاه","کرمانشاه","مرکزی",293,735,11,4,231,981,12,993
"کرمانشاه","کرمانشاه","مرکزی",294,1027,21,1,306,1355,11,1366
"کرمانشاه","کرمانشاه","مرکزی",295,592,13,2,252,859,11,870
"کرمانشاه","کرمانشاه","مرکزی",296,820,15,8,375,1218,16,1234
"کرمانشاه","کرمانشاه","مرکزی",297,966,10,8,475,1459,17,1476
"کرمانشاه","کرمانشاه","مرکزی",298,755,4,1,250,1010,19,1029
"کرمانشاه","کرمانشاه","مرکزی",299,626,19,2,305,952,15,967
"کرمانشاه","کرمانشاه","مرکزی",300,620,13,2,254,889,11,900
"کرمانشاه","کرمانشاه","مرکزی",301,605,13,4,511,1133,11,1144
"کرمانشاه","کرمانشاه","مرکزی",302,569,14,9,456,1048,19,1067
"کرمانشاه","کرمانشاه","مرکزی",303,752,14,4,438,1208,9,1217
"کرمانشاه","کرمانشاه","مرکزی",304,583,17,9,310,919,24,943
"کرمانشاه","کرمانشاه","مرکزی",305,520,5,8,373,906,10,916
"کرمانشاه","کرمانشاه","مرکزی",306,514,12,2,361,889,10,899
"کرمانشاه","کرمانشاه","مرکزی",307,625,24,8,544,1201,13,1214
"کرمانشاه","کرمانشاه","مرکزی",308,586,21,5,379,991,8,999
"کرمانشاه","کرمانشاه","مرکزی",309,610,8,2,340,960,9,969
"کرمانشاه","کرمانشاه","مرکزی",310,511,15,3,481,1010,3,1013
"کرمانشاه","کرمانشاه","مرکزی",311,648,21,13,626,1308,9,1317
"کرمانشاه","کرمانشاه","مرکزی",312,495,15,6,496,1012,17,1029
"کرمانشاه","کرمانشاه","مرکزی",313,769,14,8,599,1390,6,1396
"کرمانشاه","کرمانشاه","مرکزی",314,602,15,5,604,1226,18,1244
"کرمانشاه","کرمانشاه","مرکزی",315,613,17,10,443,1083,11,1094
"کرمانشاه","کرمانشاه","مرکزی",316,566,18,12,446,1042,7,1049
"کرمانشاه","کرمانشاه","مرکزی",317,720,24,9,528,1281,13,1294
"کرمانشاه","کرمانشاه","مرکزی",318,703,12,2,384,1101,8,1109
"کرمانشاه","کرمانشاه","مرکزی",319,823,7,3,446,1279,19,1298
"کرمانشاه","کرمانشاه","مرکزی",320,869,4,0,214,1087,20,1107
"کرمانشاه","کرمانشاه","مرکزی",321,896,6,5,399,1306,12,1318
"کرمانشاه","کرمانشاه","مرکزی",322,719,13,6,564,1302,9,1311
"کرمانشاه","کرمانشاه","مرکزی",323,617,15,13,403,1048,21,1069
"کرمانشاه","کرمانشاه","مرکزی",324,830,22,4,432,1288,21,1309
"کرمانشاه","کرمانشاه","مرکزی",325,598,14,9,421,1042,12,1054
"کرمانشاه","کرمانشاه","مرکزی",326,736,17,5,527,1285,10,1295
"کرمانشاه","کرمانشاه","مرکزی",327,905,13,4,353,1275,16,1291
"کرمانشاه","کرمانشاه","مرکزی",328,788,17,11,406,1222,12,1234
"کرمانشاه","کرمانشاه","مرکزی",329,661,11,2,296,970,20,990
"کرمانشاه","کرمانشاه","مرکزی",330,950,6,4,267,1227,10,1237
"کرمانشاه","کرمانشاه","مرکزی",331,605,13,1,339,958,7,965
"کرمانشاه","کرمانشاه","مرکزی",332,370,20,5,461,856,8,864
"کرمانشاه","کرمانشاه","مرکزی",333,435,24,15,711,1185,5,1190
"کرمانشاه","کرمانشاه","مرکزی",334,753,36,15,601,1405,11,1416
"کرمانشاه","کرمانشاه","مرکزی",335,344,20,9,536,909,27,936
"کرمانشاه","کرمانشاه","مرکزی",336,626,31,18,889,1564,14,1578
"کرمانشاه","کرمانشاه","مرکزی",337,581,23,21,467,1092,22,1114
"کرمانشاه","کرمانشاه","مرکزی",338,636,18,13,791,1458,13,1471
"کرمانشاه","کرمانشاه","مرکزی",339,368,12,6,509,895,19,914
"کرمانشاه","کرمانشاه","مرکزی",340,644,21,10,559,1234,12,1246
"کرمانشاه","کرمانشاه","مرکزی",341,367,17,6,510,900,13,913
"کرمانشاه","کرمانشاه","مرکزی",342,443,33,6,573,1055,9,1064
"کرمانشاه","کرمانشاه","مرکزی",343,497,5,3,454,959,14,973
"کرمانشاه","کرمانشاه","مرکزی",344,658,13,16,622,1309,13,1322
"کرمانشاه","کرمانشاه","مرکزی",345,661,19,10,603,1293,21,1314
"کرمانشاه","کرمانشاه","مرکزی",346,338,14,9,369,730,14,744
"کرمانشاه","کرمانشاه","مرکزی",347,532,24,26,895,1477,10,1487
"کرمانشاه","کرمانشاه","مرکزی",348,956,5,1,265,1227,15,1242
"کرمانشاه","کرمانشاه","مرکزی",349,709,9,3,274,995,5,1000
"کرمانشاه","کرمانشاه","مرکزی",350,550,20,5,682,1257,13,1270
"کرمانشاه","کرمانشاه","مرکزی",351,593,18,8,444,1063,20,1083
"کرمانشاه","کرمانشاه","مرکزی",352,757,22,7,636,1422,12,1434
"کرمانشاه","کرمانشاه","مرکزی",353,579,16,10,478,1083,16,1099
"کرمانشاه","کرمانشاه","مرکزی",354,429,13,4,463,909,13,922
"کرمانشاه","کرمانشاه","مرکزی",355,696,12,6,490,1204,14,1218
"کرمانشاه","کرمانشاه","مرکزی",356,504,10,2,443,959,14,973
"کرمانشاه","کرمانشاه","مرکزی",357,689,9,5,346,1049,13,1062
"کرمانشاه","کرمانشاه","مرکزی",358,731,9,13,463,1216,9,1225
"کرمانشاه","کرمانشاه","مرکزی",359,713,10,4,608,1335,15,1350
"کرمانشاه","کرمانشاه","مرکزی",360,517,16,7,506,1046,11,1057
"کرمانشاه","کرمانشاه","مرکزی",361,676,20,15,658,1369,23,1392
"کرمانشاه","کرمانشاه","مرکزی",362,655,18,8,523,1204,18,1222
"کرمانشاه","کرمانشاه","مرکزی",363,496,15,3,444,958,22,980
"کرمانشاه","کرمانشاه","مرکزی",364,746,12,11,447,1216,17,1233
"کرمانشاه","کرمانشاه","مرکزی",365,875,17,6,761,1659,20,1679
"کرمانشاه","کرمانشاه","مرکزی",366,562,15,10,640,1227,40,1267
"کرمانشاه","کرمانشاه","مرکزی",367,608,20,4,660,1292,15,1307
"کرمانشاه","کرمانشاه","مرکزی",368,851,18,7,768,1644,14,1658
"کرمانشاه","کرمانشاه","مرکزی",369,868,16,5,301,1190,19,1209
"کرمانشاه","کرمانشاه","مرکزی",370,450,16,0,452,918,17,935
"کرمانشاه","کرمانشاه","مرکزی",371,594,16,10,549,1169,9,1178
"کرمانشاه","کرمانشاه","مرکزی",372,816,11,3,489,1319,11,1330
"کرمانشاه","کرمانشاه","مرکزی",373,471,12,6,418,907,17,924
"کرمانشاه","کرمانشاه","مرکزی",374,755,16,3,621,1395,10,1405
"کرمانشاه","کرمانشاه","مرکزی",375,388,11,3,216,618,19,637
"کرمانشاه","کرمانشاه","مرکزی",376,526,22,9,521,1078,12,1090
"کرمانشاه","کرمانشاه","مرکزی",377,739,7,1,241,988,17,1005
"کرمانشاه","کرمانشاه","مرکزی",378,548,17,16,490,1071,10,1081
"کرمانشاه","کرمانشاه","مرکزی",379,530,10,8,242,790,17,807
"کرمانشاه","کرمانشاه","مرکزی",380,562,5,3,313,883,17,900
"کرمانشاه","کرمانشاه","مرکزی",381,883,21,8,544,1456,11,1467
"کرمانشاه","کرمانشاه","مرکزی",382,430,8,6,316,760,12,772
"کرمانشاه","کرمانشاه","مرکزی",383,576,6,2,403,987,21,1008
"کرمانشاه","کرمانشاه","مرکزی",384,691,7,4,282,984,12,996
"کرمانشاه","کرمانشاه","مرکزی",385,640,11,4,241,896,13,909
"کرمانشاه","کرمانشاه","مرکزی",386,546,5,2,337,890,8,898
"کرمانشاه","کرمانشاه","مرکزی",387,741,5,1,409,1156,13,1169
"کرمانشاه","کرمانشاه","مرکزی",388,584,6,3,329,922,17,939
"کرمانشاه","کرمانشاه","مرکزی",389,647,4,4,276,931,11,942
"کرمانشاه","کرمانشاه","مرکزی",390,591,11,9,488,1099,16,1115
"کرمانشاه","کرمانشاه","مرکزی",391,642,15,4,505,1166,11,1177
"کرمانشاه","کرمانشاه","مرکزی",392,319,15,1,164,499,13,512
"کرمانشاه","کرمانشاه","مرکزی",393,399,12,7,318,736,13,749
"کرمانشاه","کرمانشاه","مرکزی",394,214,4,3,214,435,15,450
"کرمانشاه","کرمانشاه","مرکزی",395,361,10,9,310,690,9,699
"کرمانشاه","کرمانشاه","مرکزی",396,137,3,8,125,273,7,280
"کرمانشاه","کرمانشاه","مرکزی",397,308,10,7,274,599,4,603
"کرمانشاه","کرمانشاه","مرکزی",398,153,1,1,46,201,10,211
"کرمانشاه","کرمانشاه","مرکزی",399,263,16,0,96,375,8,383
"کرمانشاه","کرمانشاه","مرکزی",400,376,4,0,142,522,8,530
"کرمانشاه","کرمانشاه","مرکزی",401,189,8,2,126,325,2,327
"کرمانشاه","کرمانشاه","مرکزی",402,218,3,2,174,397,5,402
"کرمانشاه","کرمانشاه","مرکزی",403,216,9,2,167,394,15,409
"کرمانشاه","کرمانشاه","مرکزی",404,298,1,0,102,401,6,407
"کرمانشاه","کرمانشاه","مرکزی",405,111,3,3,159,276,6,282
"کرمانشاه","کرمانشاه","مرکزی",406,367,6,5,153,531,3,534
"کرمانشاه","کرمانشاه","مرکزی",407,116,2,0,35,153,7,160
"کرمانشاه","کرمانشاه","مرکزی",408,292,3,0,33,328,1,329
"کرمانشاه","کرمانشاه","مرکزی",409,501,0,6,60,567,0,567
"کرمانشاه","کرمانشاه","مرکزی",410,666,2,1,163,832,1,833
"کرمانشاه","کرمانشاه","مرکزی",411,877,2,1,211,1091,1,1092
"کرمانشاه","کرمانشاه","مرکزی",412,705,3,3,242,953,9,962
"کرمانشاه","کرمانشاه","مرکزی",413,551,4,1,95,651,6,657
"کرمانشاه","کرمانشاه","مرکزی",414,1016,9,2,151,1178,0,1178
"کرمانشاه","کرمانشاه","مرکزی",415,481,4,1,49,535,0,535
"کرمانشاه","کرمانشاه","مرکزی",416,737,4,0,62,803,1,804
"کرمانشاه","کرمانشاه","مرکزی",417,1404,7,2,217,1630,3,1633
"کرمانشاه","کرمانشاه","مرکزی",418,1140,9,3,188,1340,9,1349
"کرمانشاه","کرمانشاه","مرکزی",419,341,4,0,35,380,12,392
"کرمانشاه","کرمانشاه","مرکزی",420,251,1,0,21,273,5,278
"کرمانشاه","کرمانشاه","مرکزی",421,48,0,0,3,51,0,51
"کرمانشاه","کرمانشاه","مرکزی",422,251,0,0,15,266,0,266
"کرمانشاه","کرمانشاه","مرکزی",423,154,0,1,11,166,0,166
"کرمانشاه","کرمانشاه","مرکزی",424,520,0,1,48,569,0,569
"کرمانشاه","کرمانشاه","مرکزی",425,141,0,0,13,154,2,156
"کرمانشاه","کرمانشاه","مرکزی",426,434,0,0,49,483,0,483
"کرمانشاه","کرمانشاه","مرکزی",427,403,3,0,35,441,1,442
"کرمانشاه","کرمانشاه","مرکزی",428,299,2,0,44,345,0,345
"کرمانشاه","کرمانشاه","مرکزی",429,797,15,3,76,891,4,895
"کرمانشاه","کرمانشاه","مرکزی",430,1049,5,1,85,1140,0,1140
"کرمانشاه","کرمانشاه","مرکزی",431,253,0,0,57,310,9,319
"کرمانشاه","کرمانشاه","مرکزی",432,269,5,0,91,365,1,366
"کرمانشاه","کرمانشاه","مرکزی",433,274,4,1,103,382,2,384
"کرمانشاه","کرمانشاه","مرکزی",434,312,1,1,121,435,2,437
"کرمانشاه","کرمانشاه","مرکزی",435,610,8,5,321,944,4,948
"کرمانشاه","کرمانشاه","مرکزی",436,547,10,0,126,683,15,698
"کرمانشاه","کرمانشاه","مرکزی",437,610,4,1,71,686,11,697
"کرمانشاه","کرمانشاه","مرکزی",438,234,6,0,120,360,5,365
"کرمانشاه","کرمانشاه","مرکزی",439,466,2,2,86,556,2,558
"کرمانشاه","کرمانشاه","مرکزی",440,176,8,2,713,899,3,902
"کرمانشاه","کرمانشاه","مرکزی",441,335,5,4,1017,1361,6,1367
"کرمانشاه","کرمانشاه","مرکزی",442,487,7,0,94,588,6,594
"کرمانشاه","کرمانشاه","مرکزی",443,228,4,3,66,301,3,304
"کرمانشاه","کرمانشاه","مرکزی",444,309,6,0,63,378,1,379
"کرمانشاه","کرمانشاه","مرکزی",445,298,3,0,203,504,2,506
"کرمانشاه","کرمانشاه","مرکزی",446,110,0,0,71,181,5,186
"کرمانشاه","کرمانشاه","مرکزی",447,768,5,0,139,912,3,915
"کرمانشاه","کرمانشاه","مرکزی",448,151,2,1,117,271,2,273
"کرمانشاه","کرمانشاه","مرکزی",449,738,28,8,590,1364,1,1365
"کرمانشاه","کرمانشاه","مرکزی",450,389,4,1,120,514,36,550
"کرمانشاه","کرمانشاه","مرکزی",451,242,0,2,32,276,3,279
"کرمانشاه","کرمانشاه","مرکزی",452,585,0,0,58,643,2,645
"کرمانشاه","کرمانشاه","مرکزی",453,178,1,9,100,288,3,291
"کرمانشاه","کرمانشاه","مرکزی",454,433,4,0,97,534,2,536
"کرمانشاه","کرمانشاه","مرکزی",455,279,5,0,81,365,2,367
"کرمانشاه","کرمانشاه","مرکزی",456,806,2,6,233,1047,0,1047
"کرمانشاه","کرمانشاه","مرکزی",457,929,2,6,216,1153,16,1169
"کرمانشاه","کرمانشاه","مرکزی",458,705,6,0,52,763,13,776
"کرمانشاه","کرمانشاه","مرکزی",459,671,9,2,230,912,5,917
"کرمانشاه","کرمانشاه","مرکزی",460,426,0,0,63,489,6,495
"کرمانشاه","کرمانشاه","مرکزی",461,813,10,2,198,1023,3,1026
"کرمانشاه","کرمانشاه","مرکزی",462,230,2,3,94,329,4,333
"کرمانشاه","کرمانشاه","مرکزی",463,215,1,1,40,257,6,263
"کرمانشاه","کرمانشاه","مرکزی",464,256,0,0,49,305,1,306
"کرمانشاه","کرمانشاه","مرکزی",465,542,14,6,185,747,2,749
"کرمانشاه","کرمانشاه","مرکزی",466,866,22,2,173,1063,33,1096
"کرمانشاه","کرمانشاه","مرکزی",467,645,4,4,183,836,20,856
"کرمانشاه","کرمانشاه","مرکزی",468,657,2,0,212,871,5,876
"کرمانشاه","کرمانشاه","مرکزی",469,832,1,2,65,900,4,904
"کرمانشاه","کرمانشاه","مرکزی",470,615,2,0,89,706,10,716
"کرمانشاه","کرمانشاه","مرکزی",471,698,1,1,76,776,4,780
"کرمانشاه","کرمانشاه","مرکزی",472,440,1,1,18,460,4,464
"کرمانشاه","کرمانشاه","مرکزی",473,258,5,2,147,412,0,412
"کرمانشاه","کرمانشاه","مرکزی",474,438,1,0,94,533,1,534
"کرمانشاه","کرمانشاه","مرکزی",475,421,1,3,56,481,5,486
"کرمانشاه","کرمانشاه","مرکزی",476,491,1,0,26,518,4,522
"کرمانشاه","کرمانشاه","مرکزی",477,466,3,1,84,554,3,557
"کرمانشاه","کرمانشاه","ماهیدشت",1,541,5,4,337,887,13,900
"کرمانشاه","کرمانشاه","ماهیدشت",2,297,3,0,93,393,7,400
"کرمانشاه","کرمانشاه","ماهیدشت",3,477,2,1,63,543,3,546
"کرمانشاه","کرمانشاه","ماهیدشت",4,346,2,8,105,461,1,462
"کرمانشاه","کرمانشاه","ماهیدشت",5,391,3,0,84,478,0,478
"کرمانشاه","کرمانشاه","ماهیدشت",6,156,1,0,74,231,1,232
"کرمانشاه","کرمانشاه","ماهیدشت",7,222,0,0,19,241,1,242
"کرمانشاه","کرمانشاه","ماهیدشت",8,480,7,0,110,597,7,604
"کرمانشاه","کرمانشاه","ماهیدشت",9,532,1,0,100,633,3,636
"کرمانشاه","کرمانشاه","ماهیدشت",10,343,0,0,64,407,2,409
"کرمانشاه","کرمانشاه","ماهیدشت",11,301,1,0,86,388,2,390
"کرمانشاه","کرمانشاه","ماهیدشت",12,531,8,10,146,695,5,700
"کرمانشاه","کرمانشاه","ماهیدشت",13,454,5,5,79,543,0,543
"کرمانشاه","کرمانشاه","ماهیدشت",14,255,0,1,59,315,4,319
"کرمانشاه","کرمانشاه","ماهیدشت",15,136,0,0,25,161,1,162
"کرمانشاه","کرمانشاه","ماهیدشت",16,511,1,1,125,638,2,640
"کرمانشاه","کرمانشاه","ماهیدشت",17,278,0,4,37,319,2,321
"کرمانشاه","کرمانشاه","ماهیدشت",18,556,4,0,94,654,3,657
"کرمانشاه","کرمانشاه","ماهیدشت",19,386,5,4,121,516,4,520
"کرمانشاه","کرمانشاه","ماهیدشت",20,328,1,0,134,463,0,463
"کرمانشاه","کرمانشاه","ماهیدشت",21,398,1,1,78,478,2,480
"کرمانشاه","کرمانشاه","ماهیدشت",22,400,3,4,77,484,4,488
"کرمانشاه","کرمانشاه","ماهیدشت",23,346,6,2,67,421,2,423
"کرمانشاه","کرمانشاه","ماهیدشت",24,378,2,0,65,445,1,446
"کرمانشاه","کرمانشاه","ماهیدشت",25,528,13,0,81,622,4,626
"کرمانشاه","کرمانشاه","کورزان",1,115,0,7,268,390,2,392
"کرمانشاه","کرمانشاه","کورزان",2,223,3,8,324,558,2,560
"کرمانشاه","کرمانشاه","کورزان",3,185,4,0,190,379,6,385
"کرمانشاه","کرمانشاه","کورزان",4,340,5,4,411,760,9,769
"کرمانشاه","کرمانشاه","کورزان",5,119,4,0,366,489,1,490
"کرمانشاه","کرمانشاه","کورزان",6,193,1,2,137,333,2,335
"کرمانشاه","کرمانشاه","کورزان",7,219,2,2,163,386,3,389
"کرمانشاه","کرمانشاه","کورزان",8,296,6,0,183,485,4,489
"کرمانشاه","کرمانشاه","کورزان",9,174,0,0,71,245,5,250
"کرمانشاه","کرمانشاه","کورزان",10,89,2,1,236,328,5,333
"کرمانشاه","کرمانشاه","کورزان",11,86,1,0,221,308,4,312
"کرمانشاه","کرمانشاه","کورزان",12,37,0,0,178,215,1,216
"کرمانشاه","کرمانشاه","کورزان",13,105,2,2,321,430,5,435
"کرمانشاه","کرمانشاه","کورزان",14,70,3,0,118,191,0,191
"کرمانشاه","کرمانشاه","کورزان",15,159,2,1,207,369,0,369
"کرمانشاه","کرمانشاه","کورزان",16,212,4,1,169,386,1,387
"کرمانشاه","کرمانشاه","کورزان",17,148,1,0,181,330,8,338
"کرمانشاه","کرمانشاه","کورزان",18,415,5,5,176,601,4,605
"کرمانشاه","کرمانشاه","کورزان",19,347,4,0,380,731,14,745
"کرمانشاه","کرمانشاه","کورزان",20,384,2,3,183,572,2,574
"کرمانشاه","کرمانشاه","فیروزآباد",1,589,8,0,171,768,11,779
"کرمانشاه","کرمانشاه","فیروزآباد",2,292,0,1,87,380,5,385
"کرمانشاه","کرمانشاه","فیروزآباد",3,333,1,1,70,405,5,410
"کرمانشاه","کرمانشاه","فیروزآباد",4,311,1,0,22,334,0,334
"کرمانشاه","کرمانشاه","فیروزآباد",5,573,1,43,114,731,3,734
"کرمانشاه","کرمانشاه","فیروزآباد",6,595,2,0,40,637,0,637
"کرمانشاه","کرمانشاه","فیروزآباد",7,429,1,0,70,500,2,502
"کرمانشاه","کرمانشاه","فیروزآباد",8,223,2,0,51,276,2,278
"کرمانشاه","کرمانشاه","فیروزآباد",9,667,11,9,296,983,0,983
"کرمانشاه","کرمانشاه","فیروزآباد",10,387,1,0,53,441,1,442
"کرمانشاه","کرمانشاه","فیروزآباد",11,453,0,3,31,487,0,487
"کرمانشاه","کرمانشاه","فیروزآباد",12,434,2,4,31,471,0,471
"کرمانشاه","کرمانشاه","فیروزآباد",13,137,0,0,15,152,0,152
"کرمانشاه","کرمانشاه","فیروزآباد",14,234,0,0,20,254,0,254
"کرمانشاه","کرمانشاه","فیروزآباد",15,512,1,1,27,541,2,543
"کرمانشاه","کرمانشاه","فیروزآباد",16,256,3,2,13,274,6,280
"کرمانشاه","کرمانشاه","فیروزآباد",17,178,0,0,8,186,0,186
"کرمانشاه","کرمانشاه","فیروزآباد",18,241,0,0,7,248,0,248
"کرمانشاه","کرمانشاه","فیروزآباد",19,199,0,0,10,209,1,210
"کرمانشاه","کرمانشاه","فیروزآباد",20,222,0,0,9,231,1,232
"کرمانشاه","کرمانشاه","فیروزآباد",21,426,1,0,10,437,0,437
"کرمانشاه","کرمانشاه","فیروزآباد",22,357,1,0,49,407,0,407
"کرمانشاه","کرمانشاه","فیروزآباد",23,398,2,2,43,445,0,445
"کرمانشاه","کرمانشاه","فیروزآباد",24,434,0,0,60,494,2,496
"کرمانشاه","کرمانشاه","فیروزآباد",25,195,0,0,27,222,0,222
"کرمانشاه","کرمانشاه","فیروزآباد",26,160,2,0,41,203,1,204
"کرمانشاه","کرمانشاه","فیروزآباد",27,257,0,5,18,280,1,281
"کرمانشاه","کرمانشاه","فیروزآباد",28,185,0,1,36,222,3,225
"کرمانشاه","کرمانشاه","فیروزآباد",29,406,0,2,67,475,46,521
"کرمانشاه","کرمانشاه","فیروزآباد",30,394,3,1,101,499,0,499
"کرمانشاه","کرمانشاه","فیروزآباد",31,128,1,2,81,212,3,215
"کرمانشاه","کنگاور","مرکزی",1,145,3,1,103,252,4,256
"کرمانشاه","کنگاور","مرکزی",2,408,9,7,199,623,6,629
"کرمانشاه","کنگاور","مرکزی",3,258,5,6,181,450,10,460
"کرمانشاه","کنگاور","مرکزی",4,569,15,9,398,991,11,1002
"کرمانشاه","کنگاور","مرکزی",5,226,5,7,105,343,3,346
"کرمانشاه","کنگاور","مرکزی",6,757,16,19,307,1099,8,1107
"کرمانشاه","کنگاور","مرکزی",7,712,11,29,305,1057,11,1068
"کرمانشاه","کنگاور","مرکزی",8,272,6,5,253,536,8,544
"کرمانشاه","کنگاور","مرکزی",9,452,10,11,231,704,4,708
"کرمانشاه","کنگاور","مرکزی",10,494,13,8,200,715,8,723
"کرمانشاه","کنگاور","مرکزی",11,590,33,31,432,1086,10,1096
"کرمانشاه","کنگاور","مرکزی",12,454,16,37,384,891,9,900
"کرمانشاه","کنگاور","مرکزی",13,419,15,25,496,955,10,965
"کرمانشاه","کنگاور","مرکزی",14,566,20,16,316,918,9,927
"کرمانشاه","کنگاور","مرکزی",15,835,11,23,255,1124,13,1137
"کرمانشاه","کنگاور","مرکزی",16,410,5,12,157,584,4,588
"کرمانشاه","کنگاور","مرکزی",17,594,11,29,218,852,11,863
"کرمانشاه","کنگاور","مرکزی",18,843,13,38,266,1160,18,1178
"کرمانشاه","کنگاور","مرکزی",19,234,4,9,89,336,4,340
"کرمانشاه","کنگاور","مرکزی",20,620,5,22,254,901,9,910
"کرمانشاه","کنگاور","مرکزی",21,765,11,26,183,985,14,999
"کرمانشاه","کنگاور","مرکزی",22,627,7,18,141,793,7,800
"کرمانشاه","کنگاور","مرکزی",23,760,2,67,260,1089,7,1096
"کرمانشاه","کنگاور","مرکزی",24,760,1,5,172,938,7,945
"کرمانشاه","کنگاور","مرکزی",25,648,14,7,210,879,3,882
"کرمانشاه","کنگاور","مرکزی",26,281,8,2,149,440,5,445
"کرمانشاه","کنگاور","مرکزی",27,647,8,50,219,924,10,934
"کرمانشاه","کنگاور","مرکزی",28,446,17,36,305,804,11,815
"کرمانشاه","کنگاور","مرکزی",29,430,11,31,515,987,11,998
"کرمانشاه","کنگاور","مرکزی",30,675,15,23,441,1154,15,1169
"کرمانشاه","کنگاور","مرکزی",31,589,12,26,318,945,10,955
"کرمانشاه","کنگاور","مرکزی",32,288,11,1,189,489,0,489
"کرمانشاه","کنگاور","مرکزی",33,631,3,7,177,818,6,824
"کرمانشاه","کنگاور","مرکزی",34,206,6,6,179,397,8,405
"کرمانشاه","کنگاور","مرکزی",35,280,4,0,86,370,6,376
"کرمانشاه","کنگاور","مرکزی",36,539,5,15,223,782,4,786
"کرمانشاه","کنگاور","مرکزی",37,265,4,2,118,389,5,394
"کرمانشاه","کنگاور","مرکزی",38,371,12,17,371,771,11,782
"کرمانشاه","کنگاور","مرکزی",39,954,11,3,122,1090,10,1100
"کرمانشاه","کنگاور","مرکزی",40,850,9,4,188,1051,11,1062
"کرمانشاه","کنگاور","مرکزی",41,462,5,6,124,597,3,600
"کرمانشاه","کنگاور","مرکزی",42,535,6,2,127,670,2,672
"کرمانشاه","کنگاور","مرکزی",43,438,1,2,57,498,2,500
"کرمانشاه","کنگاور","مرکزی",44,499,5,8,35,547,3,550
"کرمانشاه","کنگاور","مرکزی",45,684,16,10,164,874,10,884
"کرمانشاه","کنگاور","مرکزی",46,354,1,5,59,419,8,427
"کرمانشاه","کنگاور","مرکزی",47,472,6,4,90,572,3,575
"کرمانشاه","کنگاور","مرکزی",48,346,4,0,60,410,1,411
"کرمانشاه","کنگاور","مرکزی",49,167,3,323,102,595,7,602
"کرمانشاه","کنگاور","مرکزی",50,248,1,20,49,318,0,318
"کرمانشاه","کنگاور","مرکزی",51,352,2,1,103,458,7,465
"کرمانشاه","کنگاور","مرکزی",52,411,1,4,98,514,1,515
"کرمانشاه","کنگاور","مرکزی",53,326,5,4,96,431,7,438
"کرمانشاه","کنگاور","مرکزی",54,469,4,6,116,595,3,598
"کرمانشاه","کنگاور","مرکزی",55,281,2,2,34,319,0,319
"کرمانشاه","کنگاور","مرکزی",56,152,1,2,61,216,0,216
"کرمانشاه","کنگاور","مرکزی",57,309,1,3,66,379,2,381
"کرمانشاه","کنگاور","مرکزی",58,55,0,8,36,99,1,100
"کرمانشاه","کنگاور","مرکزی",59,209,6,0,68,283,4,287
"کرمانشاه","کنگاور","مرکزی",60,67,2,3,126,198,1,199
"کرمانشاه","کنگاور","مرکزی",61,139,1,0,30,170,6,176
"کرمانشاه","کنگاور","مرکزی",62,316,4,7,52,379,2,381
"کرمانشاه","کنگاور","مرکزی",63,359,3,3,49,414,3,417
"کرمانشاه","کنگاور","مرکزی",64,304,6,9,84,403,4,407
"کرمانشاه","کنگاور","مرکزی",65,653,19,5,187,864,7,871
"کرمانشاه","کنگاور","مرکزی",66,268,8,4,38,318,0,318
"کرمانشاه","کنگاور","مرکزی",67,388,4,6,52,450,2,452
"کرمانشاه","کنگاور","مرکزی",68,531,6,9,93,639,2,641
"کرمانشاه","کنگاور","مرکزی",69,446,3,1,81,531,2,533
"کرمانشاه","کنگاور","مرکزی",70,550,4,2,67,623,0,623
"کرمانشاه","کنگاور","مرکزی",71,199,3,22,54,278,3,281
"کرمانشاه","کنگاور","مرکزی",72,226,5,1,22,254,3,257
"کرمانشاه","کنگاور","مرکزی",73,120,3,0,56,179,1,180
"کرمانشاه","کنگاور","مرکزی",74,346,5,0,19,370,0,370
"کرمانشاه","کنگاور","مرکزی",75,50,2,0,21,73,2,75
"کرمانشاه","هریسن","مرکزی",1,473,8,1,144,626,7,633
"کرمانشاه","هریسن","مرکزی",2,305,7,6,181,499,4,503
"کرمانشاه","هریسن","مرکزی",3,348,7,0,107,462,4,466
"کرمانشاه","هریسن","مرکزی",4,405,3,1,189,598,5,603
"کرمانشاه","هریسن","مرکزی",5,485,12,0,161,658,3,661
"کرمانشاه","هریسن","مرکزی",6,326,1,3,47,377,4,381
"کرمانشاه","هریسن","مرکزی",7,191,0,0,47,238,3,241
"کرمانشاه","هریسن","مرکزی",8,132,4,0,58,194,5,199
"کرمانشاه","هریسن","مرکزی",9,234,9,1,259,503,10,513
"کرمانشاه","هریسن","مرکزی",10,181,2,2,197,382,10,392
"کرمانشاه","هریسن","مرکزی",11,275,7,0,210,492,8,500
"کرمانشاه","هریسن","مرکزی",12,154,6,1,237,398,8,406
"کرمانشاه","هریسن","مرکزی",13,456,16,0,321,793,7,800
"کرمانشاه","هریسن","مرکزی",14,238,2,2,55,297,0,297
"کرمانشاه","هریسن","مرکزی",15,215,5,0,220,440,0,440
"کرمانشاه","هریسن","مرکزی",16,418,13,0,304,735,10,745
"کرمانشاه","هریسن","مرکزی",17,354,8,3,235,600,3,603
"کرمانشاه","هریسن","مرکزی",18,213,5,3,203,424,9,433
"کرمانشاه","هریسن","مرکزی",19,360,12,2,118,492,5,497
"کرمانشاه","هریسن","مرکزی",20,373,2,0,133,508,8,516
"کرمانشاه","هریسن","مرکزی",21,99,2,0,75,176,6,182
"کرمانشاه","هریسن","مرکزی",22,535,4,2,166,707,4,711
"کرمانشاه","هریسن","مرکزی",23,335,14,2,254,605,8,613
"کرمانشاه","هریسن","مرکزی",24,324,7,0,129,460,0,460
"کرمانشاه","هریسن","مرکزی",25,500,5,3,195,703,10,713
"کرمانشاه","هریسن","مرکزی",26,421,6,7,163,597,8,605
"کرمانشاه","هریسن","مرکزی",27,217,8,0,130,355,5,360
"کرمانشاه","هریسن","مرکزی",28,127,1,9,71,208,2,210
"کرمانشاه","هریسن","مرکزی",29,549,3,16,126,694,8,702
"کرمانشاه","هریسن","مرکزی",30,357,1,1,89,448,3,451
"کرمانشاه","هریسن","مرکزی",31,530,3,11,95,639,3,642
"کرمانشاه","هریسن","مرکزی",32,468,5,5,138,616,3,619
"کرمانشاه","هریسن","مرکزی",33,583,6,3,127,719,5,724
"کرمانشاه","هریسن","مرکزی",34,480,3,7,240,730,3,733
"کرمانشاه","هریسن","مرکزی",35,429,18,3,233,683,2,685
"کرمانشاه","هریسن","مرکزی",36,582,12,5,262,861,4,865
"کرمانشاه","هریسن","مرکزی",37,214,9,5,140,368,6,374
"کرمانشاه","هریسن","مرکزی",38,278,4,6,99,387,2,389
"کرمانشاه","هریسن","مرکزی",39,543,12,16,298,869,12,881
"کرمانشاه","هریسن","مرکزی",40,368,3,1,111,483,3,486
"کرمانشاه","هریسن","مرکزی",41,509,13,5,343,870,8,878
"کرمانشاه","هریسن","مرکزی",42,270,8,2,131,411,0,411
"کرمانشاه","هریسن","مرکزی",43,590,8,0,279,877,9,886
"کرمانشاه","هریسن","مرکزی",44,532,7,9,239,787,8,795
"کرمانشاه","هریسن","مرکزی",45,419,4,2,93,518,2,520
"کرمانشاه","هریسن","مرکزی",46,328,7,0,141,476,1,477
"کرمانشاه","هریسن","مرکزی",47,517,10,13,216,756,7,763
"کرمانشاه","هریسن","مرکزی",48,126,2,2,64,194,1,195
"کرمانشاه","هریسن","مرکزی",49,339,4,1,25,369,2,371
"کرمانشاه","هریسن","مرکزی",50,627,6,10,111,754,7,761
"کرمانشاه","هریسن","مرکزی",51,367,0,3,20,390,0,390
"کرمانشاه","هریسن","مرکزی",52,223,2,0,10,235,4,239
"کرمانشاه","هریسن","مرکزی",53,521,1,0,34,556,1,557
"کرمانشاه","هریسن","مرکزی",54,370,0,2,41,413,0,413
"کرمانشاه","هریسن","مرکزی",55,628,9,1,53,691,0,691
"کرمانشاه","هریسن","مرکزی",56,304,2,8,20,334,5,339
"کرمانشاه","هریسن","مرکزی",57,195,0,198,47,440,1,441
"کرمانشاه","هریسن","مرکزی",58,431,0,1,76,508,2,510
"کرمانشاه","هریسن","مرکزی",59,306,1,4,40,351,2,353
"کرمانشاه","هریسن","مرکزی",60,154,0,1,64,219,3,222
"کرمانشاه","هریسن","مرکزی",61,255,0,0,41,296,3,299
"کرمانشاه","هریسن","مرکزی",62,147,0,0,29,176,0,176
"کرمانشاه","هریسن","مرکزی",63,155,0,0,31,186,0,186
"کرمانشاه","هریسن","بیستون",1,492,8,13,291,804,10,814
"کرمانشاه","هریسن","بیستون",2,414,8,5,255,682,7,689
"کرمانشاه","هریسن","بیستون",3,97,12,8,201,318,3,321
"کرمانشاه","هریسن","بیستون",4,359,5,0,214,578,11,589
"کرمانشاه","هریسن","بیستون",5,122,1,0,74,197,1,198
"کرمانشاه","هریسن","بیستون",6,555,7,9,260,831,13,844
"کرمانشاه","هریسن","بیستون",7,165,5,0,125,295,4,299
"کرمانشاه","هریسن","بیستون",8,345,6,4,140,495,2,497
"کرمانشاه","هریسن","بیستون",9,693,1,6,149,849,7,856
"کرمانشاه","هریسن","بیستون",10,215,1,11,86,313,5,318
"کرمانشاه","هریسن","بیستون",11,618,1,10,123,752,6,758
"کرمانشاه","هریسن","بیستون",12,536,3,0,254,793,9,802
"کرمانشاه","هریسن","بیستون",13,365,4,3,58,430,3,433
"کرمانشاه","هریسن","بیستون",14,371,3,1,123,498,4,502
"کرمانشاه","هریسن","بیستون",15,378,6,2,80,466,3,469
"کرمانشاه","هریسن","بیستون",16,323,3,7,139,472,2,474
"کرمانشاه","هریسن","بیستون",17,114,0,0,17,131,1,132
"کرمانشاه","هریسن","بیستون",18,51,0,0,12,63,0,63
"کرمانشاه","هریسن","بیستون",19,92,3,0,61,156,0,156
"کرمانشاه","هریسن","بیستون",20,175,0,0,78,253,3,256
"کرمانشاه","هریسن","بیستون",21,219,0,0,17,236,0,236
"کرمانشاه","هریسن","بیستون",22,41,1,0,39,81,0,81
"کرمانشاه","هریسن","بیستون",23,249,7,0,136,392,5,397
"کرمانشاه","هریسن","بیستون",24,309,5,2,47,363,1,364
"کرمانشاه","هریسن","بیستون",25,275,5,0,84,364,3,367
"کرمانشاه","هریسن","بیستون",26,346,3,1,60,410,2,412
"کرمانشاه","هریسن","بیستون",27,438,0,3,93,534,1,535
"کرمانشاه","هریسن","بیستون",28,420,8,0,87,515,0,515
"کرمانشاه","هریسن","بیستون",29,224,2,3,51,280,0,280
"کرمانشاه","هریسن","بیستون",30,387,3,15,205,610,0,610
"کرمانشاه","هریسن","بیستون",31,330,1,3,106,440,0,440
"کرمانشاه","هریسن","بیستون",32,481,2,2,81,566,6,572
"کرمانشاه","گیلانغرب","مرکزی",1,380,11,18,388,797,3,800
"کرمانشاه","گیلانغرب","مرکزی",2,117,3,7,165,292,2,294
"کرمانشاه","گیلانغرب","مرکزی",3,197,3,9,372,581,13,594
"کرمانشاه","گیلانغرب","مرکزی",4,143,7,4,272,426,5,431
"کرمانشاه","گیلانغرب","مرکزی",5,202,3,4,387,596,6,602
"کرمانشاه","گیلانغرب","مرکزی",6,327,9,8,460,804,13,817
"کرمانشاه","گیلانغرب","مرکزی",7,235,9,5,273,522,6,528
"کرمانشاه","گیلانغرب","مرکزی",8,440,4,5,339,788,5,793
"کرمانشاه","گیلانغرب","مرکزی",9,473,11,5,332,821,11,832
"کرمانشاه","گیلانغرب","مرکزی",10,464,3,3,322,792,8,800
"کرمانشاه","گیلانغرب","مرکزی",11,203,10,5,247,465,3,468
"کرمانشاه","گیلانغرب","مرکزی",12,375,11,25,479,890,10,900
"کرمانشاه","گیلانغرب","مرکزی",13,292,11,3,270,576,10,586
"کرمانشاه","گیلانغرب","مرکزی",14,249,5,11,359,624,9,633
"کرمانشاه","گیلانغرب","مرکزی",15,122,4,8,252,386,5,391
"کرمانشاه","گیلانغرب","مرکزی",16,130,4,2,241,377,3,380
"کرمانشاه","گیلانغرب","مرکزی",17,352,11,16,442,821,11,832
"کرمانشاه","گیلانغرب","مرکزی",18,186,8,7,288,489,7,496
"کرمانشاه","گیلانغرب","مرکزی",19,410,10,5,301,726,15,741
"کرمانشاه","گیلانغرب","مرکزی",20,138,3,2,63,206,0,206
"کرمانشاه","گیلانغرب","مرکزی",21,428,1,1,168,598,2,600
"کرمانشاه","گیلانغرب","مرکزی",22,172,1,4,45,222,1,223
"کرمانشاه","گیلانغرب","مرکزی",23,110,0,0,38,148,2,150
"کرمانشاه","گیلانغرب","مرکزی",24,315,3,1,184,503,7,510
"کرمانشاه","گیلانغرب","مرکزی",25,94,2,3,79,178,1,179
"کرمانشاه","گیلانغرب","مرکزی",26,201,6,2,252,461,6,467
"کرمانشاه","گیلانغرب","مرکزی",27,144,3,0,304,451,12,463
"کرمانشاه","گیلانغرب","مرکزی",28,346,6,14,285,651,6,657
"کرمانشاه","گیلانغرب","مرکزی",29,231,4,2,205,442,7,449
"کرمانشاه","گیلانغرب","مرکزی",30,178,2,30,145,355,3,358
"کرمانشاه","گیلانغرب","مرکزی",31,346,3,4,86,439,4,443
"کرمانشاه","گیلانغرب","مرکزی",32,161,2,2,92,257,2,259
"کرمانشاه","گیلانغرب","مرکزی",33,277,3,3,189,472,8,480
"کرمانشاه","گیلانغرب","مرکزی",34,191,0,3,63,257,2,259
"کرمانشاه","گیلانغرب","مرکزی",35,424,5,12,76,517,1,518
"کرمانشاه","گیلانغرب","مرکزی",36,446,6,3,101,556,3,559
"کرمانشاه","گیلانغرب","مرکزی",37,26,0,2,6,34,0,34
"کرمانشاه","گیلانغرب","مرکزی",38,7,0,0,6,13,0,13
"کرمانشاه","گیلانغرب","مرکزی",39,215,7,2,162,386,6,392
"کرمانشاه","گیلانغرب","مرکزی",40,191,5,2,193,391,8,399
"کرمانشاه","گیلانغرب","مرکزی",41,331,1,1,163,496,10,506
"کرمانشاه","گیلانغرب","مرکزی",42,219,5,2,223,449,5,454
"کرمانشاه","گیلانغرب","مرکزی",43,502,2,3,153,660,9,669
"کرمانشاه","گیلانغرب","مرکزی",44,40,0,0,34,74,0,74
"کرمانشاه","گیلانغرب","مرکزی",45,88,2,8,33,131,1,132
"کرمانشاه","گیلانغرب","مرکزی",46,547,8,2,152,709,6,715
"کرمانشاه","گیلانغرب","مرکزی",47,130,1,2,75,208,6,214
"کرمانشاه","گیلانغرب","مرکزی",48,210,2,1,120,333,7,340
"کرمانشاه","گیلانغرب","مرکزی",49,173,1,8,95,277,8,285
"کرمانشاه","گیلانغرب","مرکزی",50,272,7,0,36,315,3,318
"کرمانشاه","گیلانغرب","مرکزی",51,208,3,0,60,271,5,276
"کرمانشاه","گیلانغرب","مرکزی",52,364,4,5,141,514,5,519
"کرمانشاه","گیلانغرب","مرکزی",53,252,2,2,144,400,5,405
"کرمانشاه","گیلانغرب","مرکزی",54,254,1,2,111,368,0,368
"کرمانشاه","گیلانغرب","مرکزی",55,396,13,9,160,578,7,585
"کرمانشاه","گیلانغرب","مرکزی",56,76,0,0,81,157,0,157
"کرمانشاه","گیلانغرب","گواور",1,118,4,2,130,254,7,261
"کرمانشاه","گیلانغرب","گواور",2,239,8,13,216,476,6,482
"کرمانشاه","گیلانغرب","گواور",3,524,7,14,395,940,5,945
"کرمانشاه","گیلانغرب","گواور",4,417,5,11,296,729,9,738
"کرمانشاه","گیلانغرب","گواور",5,238,5,11,245,499,1,500
"کرمانشاه","گیلانغرب","گواور",6,350,5,1,258,614,2,616
"کرمانشاه","گیلانغرب","گواور",7,527,2,4,112,645,3,648
"کرمانشاه","گیلانغرب","گواور",8,145,4,3,48,200,2,202
"کرمانشاه","گیلانغرب","گواور",9,140,0,6,26,172,0,172
"کرمانشاه","گیلانغرب","گواور",10,226,2,5,186,419,3,422
"کرمانشاه","گیلانغرب","گواور",11,539,3,2,221,765,3,768
"کرمانشاه","گیلانغرب","گواور",12,215,2,10,147,374,0,374
"کرمانشاه","گیلانغرب","گواور",13,220,12,7,123,362,2,364
"کرمانشاه","گیلانغرب","گواور",14,408,1,0,186,595,5,600
"کرمانشاه","گیلانغرب","گواور",15,262,3,1,110,376,3,379
"کرمانشاه","گیلانغرب","گواور",16,196,0,3,184,383,1,384
"کرمانشاه","گیلانغرب","گواور",17,265,0,8,102,375,7,382
"کرمانشاه","گیلانغرب","گواور",18,238,4,2,105,349,3,352
"کرمانشاه","گیلانغرب","گواور",19,461,3,1,135,600,0,600
"کرمانشاه","گیلانغرب","گواور",20,424,2,0,94,520,3,523
"کرمانشاه","گیلانغرب","گواور",21,404,13,2,146,565,5,570
"کرمانشاه","گیلانغرب","گواور",22,111,3,1,101,216,0,216
"کرمانشاه","آباد_غرب_اسلام","مرکزی",1,624,16,8,423,1071,8,1079
"کرمانشاه","آباد_غرب_اسلام","مرکزی",2,272,5,3,213,493,9,502
"کرمانشاه","آباد_غرب_اسلام","مرکزی",3,653,8,10,605,1276,15,1291
"کرمانشاه","آباد_غرب_اسلام","مرکزی",4,670,13,11,437,1131,7,1138
"کرمانشاه","آباد_غرب_اسلام","مرکزی",5,614,8,3,426,1051,13,1064
"کرمانشاه","آباد_غرب_اسلام","مرکزی",6,689,19,3,471,1182,18,1200
"کرمانشاه","آباد_غرب_اسلام","مرکزی",7,664,11,13,582,1270,12,1282
"کرمانشاه","آباد_غرب_اسلام","مرکزی",8,558,13,8,487,1066,10,1076
"کرمانشاه","آباد_غرب_اسلام","مرکزی",9,723,15,6,434,1178,13,1191
"کرمانشاه","آباد_غرب_اسلام","مرکزی",10,662,7,5,407,1081,9,1090
"کرمانشاه","آباد_غرب_اسلام","مرکزی",11,311,10,4,219,544,8,552
"کرمانشاه","آباد_غرب_اسلام","مرکزی",12,502,2,12,470,986,10,996
"کرمانشاه","آباد_غرب_اسلام","مرکزی",13,695,10,11,394,1110,11,1121
"کرمانشاه","آباد_غرب_اسلام","مرکزی",14,858,6,8,464,1336,14,1350
"کرمانشاه","آباد_غرب_اسلام","مرکزی",15,926,12,8,456,1402,17,1419
"کرمانشاه","آباد_غرب_اسلام","مرکزی",16,911,6,10,363,1290,10,1300
"کرمانشاه","آباد_غرب_اسلام","مرکزی",17,821,18,15,438,1292,8,1300
"کرمانشاه","آباد_غرب_اسلام","مرکزی",18,687,4,6,242,939,10,949
"کرمانشاه","آباد_غرب_اسلام","مرکزی",19,771,5,9,302,1087,13,1100
"کرمانشاه","آباد_غرب_اسلام","مرکزی",20,840,14,7,419,1280,13,1293
"کرمانشاه","آباد_غرب_اسلام","مرکزی",21,328,17,1,346,692,8,700
"کرمانشاه","آباد_غرب_اسلام","مرکزی",22,381,14,6,536,937,12,949
"کرمانشاه","آباد_غرب_اسلام","مرکزی",23,280,7,7,352,646,6,652
"کرمانشاه","آباد_غرب_اسلام","مرکزی",24,408,5,3,293,709,6,715
"کرمانشاه","آباد_غرب_اسلام","مرکزی",25,764,25,17,401,1207,18,1225
"کرمانشاه","آباد_غرب_اسلام","مرکزی",26,356,21,10,380,767,12,779
"کرمانشاه","آباد_غرب_اسلام","مرکزی",27,511,14,11,445,981,19,1000
"کرمانشاه","آباد_غرب_اسلام","مرکزی",28,316,15,11,332,674,14,688
"کرمانشاه","آباد_غرب_اسلام","مرکزی",29,386,10,11,391,798,10,808
"کرمانشاه","آباد_غرب_اسلام","مرکزی",30,656,20,12,493,1181,25,1206
"کرمانشاه","آباد_غرب_اسلام","مرکزی",31,307,13,2,370,692,13,705
"کرمانشاه","آباد_غرب_اسلام","مرکزی",32,333,8,5,296,642,6,648
"کرمانشاه","آباد_غرب_اسلام","مرکزی",33,485,14,14,517,1030,18,1048
"کرمانشاه","آباد_غرب_اسلام","مرکزی",34,704,15,9,521,1249,13,1262
"کرمانشاه","آباد_غرب_اسلام","مرکزی",35,696,31,10,780,1517,18,1535
"کرمانشاه","آباد_غرب_اسلام","مرکزی",36,475,14,8,406,903,18,921
"کرمانشاه","آباد_غرب_اسلام","مرکزی",37,704,13,7,549,1273,12,1285
"کرمانشاه","آباد_غرب_اسلام","مرکزی",38,611,25,11,715,1362,19,1381
"کرمانشاه","آباد_غرب_اسلام","مرکزی",39,593,16,10,644,1263,14,1277
"کرمانشاه","آباد_غرب_اسلام","مرکزی",40,166,12,7,252,437,4,441
"کرمانشاه","آباد_غرب_اسلام","مرکزی",41,436,15,6,491,948,11,959
"کرمانشاه","آباد_غرب_اسلام","مرکزی",42,502,13,8,542,1065,5,1070
"کرمانشاه","آباد_غرب_اسلام","مرکزی",43,439,11,6,502,958,7,965
"کرمانشاه","آباد_غرب_اسلام","مرکزی",44,326,13,13,241,593,17,610
"کرمانشاه","آباد_غرب_اسلام","مرکزی",45,629,23,11,650,1313,21,1334
"کرمانشاه","آباد_غرب_اسلام","مرکزی",46,338,3,4,377,722,5,727
"کرمانشاه","آباد_غرب_اسلام","مرکزی",47,629,7,0,339,975,8,983
"کرمانشاه","آباد_غرب_اسلام","مرکزی",48,235,5,2,104,346,2,348
"کرمانشاه","آباد_غرب_اسلام","مرکزی",49,386,6,3,225,620,7,627
"کرمانشاه","آباد_غرب_اسلام","مرکزی",50,329,8,5,274,616,8,624
"کرمانشاه","آباد_غرب_اسلام","مرکزی",51,168,12,1,224,405,7,412
"کرمانشاه","آباد_غرب_اسلام","مرکزی",52,415,13,4,365,797,7,804
"کرمانشاه","آباد_غرب_اسلام","مرکزی",53,164,13,4,266,447,3,450
"کرمانشاه","آباد_غرب_اسلام","مرکزی",54,437,10,11,468,926,9,935
"کرمانشاه","آباد_غرب_اسلام","مرکزی",55,539,9,7,451,1006,8,1014
"کرمانشاه","آباد_غرب_اسلام","مرکزی",56,186,9,3,140,338,2,340
"کرمانشاه","آباد_غرب_اسلام","مرکزی",57,691,16,5,277,989,11,1000
"کرمانشاه","آباد_غرب_اسلام","مرکزی",58,693,5,2,222,922,13,935
"کرمانشاه","آباد_غرب_اسلام","مرکزی",59,738,7,5,205,955,10,965
"کرمانشاه","آباد_غرب_اسلام","مرکزی",60,572,10,6,285,873,4,877
"کرمانشاه","آباد_غرب_اسلام","مرکزی",61,753,4,4,134,895,5,900
"کرمانشاه","آباد_غرب_اسلام","مرکزی",62,214,0,0,102,316,4,320
"کرمانشاه","آباد_غرب_اسلام","مرکزی",63,360,2,2,220,584,5,589
"کرمانشاه","آباد_غرب_اسلام","مرکزی",64,265,9,5,172,451,2,453
"کرمانشاه","آباد_غرب_اسلام","مرکزی",65,253,6,5,180,444,2,446
"کرمانشاه","آباد_غرب_اسلام","مرکزی",66,597,13,3,346,959,6,965
"کرمانشاه","آباد_غرب_اسلام","مرکزی",67,147,0,1,915,1063,3,1066
"کرمانشاه","آباد_غرب_اسلام","مرکزی",68,489,3,2,190,684,3,687
"کرمانشاه","آباد_غرب_اسلام","مرکزی",69,36,0,0,561,597,1,598
"کرمانشاه","آباد_غرب_اسلام","مرکزی",70,70,0,2,630,702,2,704
"کرمانشاه","آباد_غرب_اسلام","مرکزی",71,122,1,4,261,388,0,388
"کرمانشاه","آباد_غرب_اسلام","مرکزی",72,654,6,2,109,771,7,778
"کرمانشاه","آباد_غرب_اسلام","مرکزی",73,837,5,8,81,931,8,939
"کرمانشاه","آباد_غرب_اسلام","مرکزی",74,817,4,5,159,985,4,989
"کرمانشاه","آباد_غرب_اسلام","مرکزی",75,723,4,6,174,907,5,912
"کرمانشاه","آباد_غرب_اسلام","مرکزی",76,629,6,9,188,832,7,839
"کرمانشاه","آباد_غرب_اسلام","مرکزی",77,490,5,2,519,1016,7,1023
"کرمانشاه","آباد_غرب_اسلام","مرکزی",78,892,10,2,357,1261,13,1274
"کرمانشاه","آباد_غرب_اسلام","مرکزی",79,520,6,2,117,645,8,653
"کرمانشاه","آباد_غرب_اسلام","مرکزی",80,414,4,7,144,569,6,575
"کرمانشاه","آباد_غرب_اسلام","مرکزی",81,633,12,3,190,838,9,847
"کرمانشاه","آباد_غرب_اسلام","مرکزی",82,401,3,8,103,515,5,520
"کرمانشاه","آباد_غرب_اسلام","حمیل",1,323,3,2,117,445,0,445
"کرمانشاه","آباد_غرب_اسلام","حمیل",2,408,6,4,156,574,7,581
"کرمانشاه","آباد_غرب_اسلام","حمیل",3,144,2,7,43,196,1,197
"کرمانشاه","آباد_غرب_اسلام","حمیل",4,339,4,6,103,452,7,459
"کرمانشاه","آباد_غرب_اسلام","حمیل",5,147,1,10,93,251,1,252
"کرمانشاه","آباد_غرب_اسلام","حمیل",6,302,0,2,94,398,2,400
"کرمانشاه","آباد_غرب_اسلام","حمیل",7,271,1,9,90,371,1,372
"کرمانشاه","آباد_غرب_اسلام","حمیل",8,575,5,13,163,756,7,763
"کرمانشاه","آباد_غرب_اسلام","حمیل",9,510,3,11,213,737,7,744
"کرمانشاه","آباد_غرب_اسلام","حمیل",10,549,1,2,89,641,1,642
"کرمانشاه","آباد_غرب_اسلام","حمیل",11,281,1,0,40,322,2,324
"کرمانشاه","آباد_غرب_اسلام","حمیل",12,223,0,5,145,373,1,374
"کرمانشاه","آباد_غرب_اسلام","حمیل",13,290,2,1,129,422,9,431
"کرمانشاه","آباد_غرب_اسلام","حمیل",14,218,2,6,67,293,2,295
"کرمانشاه","آباد_غرب_اسلام","حمیل",15,229,3,0,40,272,0,272
"کرمانشاه","آباد_غرب_اسلام","حمیل",16,102,0,0,43,145,0,145
"کرمانشاه","آباد_غرب_اسلام","حمیل",17,148,0,0,35,183,0,183
"کرمانشاه","آباد_غرب_اسلام","حمیل",18,586,5,10,106,707,5,712
"کرمانشاه","آباد_غرب_اسلام","حمیل",19,515,12,2,178,707,10,717
"کرمانشاه","آباد_غرب_اسلام","حمیل",20,305,2,6,53,366,5,371
"کرمانشاه","آباد_غرب_اسلام","حمیل",21,534,6,32,153,725,11,736
"کرمانشاه","آباد_غرب_اسلام","حمیل",22,539,11,6,174,730,6,736
"کرمانشاه","آباد_غرب_اسلام","حمیل",23,376,1,1,62,440,2,442
"کرمانشاه","آباد_غرب_اسلام","حمیل",24,312,0,4,199,515,1,516
"کرمانشاه","آباد_غرب_اسلام","حمیل",25,167,1,2,66,236,1,237
"کرمانشاه","آباد_غرب_اسلام","حمیل",26,406,3,4,103,516,5,521
"لرستان","ازنا","مرکزی",1,845,25,77,155,1102,9,1111
"لرستان","ازنا","مرکزی",2,174,3,18,66,261,7,268
"لرستان","ازنا","مرکزی",3,600,41,76,141,858,2,860
"لرستان","ازنا","مرکزی",4,725,10,33,128,896,6,902
"لرستان","ازنا","مرکزی",5,664,7,66,152,889,9,898
"لرستان","ازنا","مرکزی",6,688,15,34,93,830,5,835
"لرستان","ازنا","مرکزی",7,340,10,21,160,531,5,536
"لرستان","ازنا","مرکزی",8,604,11,38,239,892,5,897
"لرستان","ازنا","مرکزی",9,428,31,61,165,685,3,688
"لرستان","ازنا","مرکزی",10,501,24,86,354,965,6,971
"لرستان","ازنا","مرکزی",11,593,35,93,376,1097,19,1116
"لرستان","ازنا","مرکزی",12,210,8,20,171,409,9,418
"لرستان","ازنا","مرکزی",13,428,10,34,232,704,6,710
"لرستان","ازنا","مرکزی",14,703,8,37,213,961,9,970
"لرستان","ازنا","مرکزی",15,850,23,82,284,1239,16,1255
"لرستان","ازنا","مرکزی",16,169,2,26,109,306,5,311
"لرستان","ازنا","مرکزی",17,767,19,31,222,1039,5,1044
"لرستان","ازنا","مرکزی",18,567,32,30,362,991,5,996
"لرستان","ازنا","مرکزی",19,670,22,48,227,967,6,973
"لرستان","ازنا","مرکزی",20,830,30,39,317,1216,5,1221
"لرستان","ازنا","مرکزی",21,431,8,35,204,678,9,687
"لرستان","ازنا","مرکزی",22,529,15,47,277,868,10,878
"لرستان","ازنا","مرکزی",23,791,13,36,360,1200,10,1210
"لرستان","ازنا","مرکزی",24,681,15,28,196,920,7,927
"لرستان","ازنا","مرکزی",25,804,27,45,288,1164,7,1171
"لرستان","ازنا","مرکزی",26,658,18,28,297,1001,10,1011
"لرستان","ازنا","مرکزی",27,118,8,8,28,162,0,162
"لرستان","ازنا","مرکزی",28,339,23,29,35,426,0,426
"لرستان","ازنا","مرکزی",29,962,55,67,219,1303,6,1309
"لرستان","ازنا","مرکزی",30,758,37,88,135,1018,7,1025
"لرستان","ازنا","مرکزی",31,560,5,38,100,703,2,705
"لرستان","ازنا","مرکزی",32,418,0,11,78,507,4,511
"لرستان","ازنا","مرکزی",33,1062,35,32,102,1231,3,1234
"لرستان","ازنا","مرکزی",34,528,2,1,19,550,0,550
"لرستان","ازنا","مرکزی",35,429,5,14,71,519,3,522
"لرستان","ازنا","مرکزی",36,744,22,35,35,836,0,836
"لرستان","ازنا","مرکزی",37,929,0,23,46,998,2,1000
"لرستان","ازنا","مرکزی",38,382,77,19,35,513,1,514
"لرستان","ازنا","مرکزی",39,463,40,43,40,586,1,587
"لرستان","ازنا","مرکزی",40,286,27,72,12,397,5,402
"لرستان","ازنا","مرکزی",41,423,35,75,41,574,1,575
"لرستان","ازنا","مرکزی",42,280,20,32,38,370,2,372
"لرستان","ازنا","مرکزی",43,458,33,34,52,577,4,581
"لرستان","ازنا","مرکزی",44,438,54,33,24,549,1,550
"لرستان","ازنا","مرکزی",45,120,11,32,5,168,1,169
"لرستان","ازنا","چاپلق",1,389,9,5,67,470,2,472
"لرستان","ازنا","چاپلق",2,311,5,7,62,385,1,386
"لرستان","ازنا","چاپلق",3,359,3,4,129,495,5,500
"لرستان","ازنا","چاپلق",4,531,2,2,47,582,4,586
"لرستان","ازنا","چاپلق",5,210,2,1,34,247,1,248
"لرستان","ازنا","چاپلق",6,570,16,12,76,674,3,677
"لرستان","ازنا","چاپلق",7,633,17,13,37,700,0,700
"لرستان","ازنا","چاپلق",8,183,0,2,39,224,1,225
"لرستان","ازنا","چاپلق",9,632,2,3,40,677,1,678
"لرستان","ازنا","چاپلق",10,475,1,1,69,546,1,547
"لرستان","ازنا","چاپلق",11,253,0,2,22,277,0,277
"لرستان","ازنا","چاپلق",12,193,1,9,36,239,0,239
"لرستان","ازنا","چاپلق",13,315,1,0,20,336,1,337
"لرستان","ازنا","چاپلق",14,356,0,0,26,382,0,382
"لرستان","ازنا","چاپلق",15,296,0,1,18,315,0,315
"لرستان","ازنا","چاپلق",16,486,0,2,34,522,1,523
"لرستان","ازنا","چاپلق",17,353,2,1,30,386,3,389
"لرستان","ازنا","چاپلق",18,298,0,1,9,308,0,308
"لرستان","ازنا","چاپلق",19,209,0,2,8,219,0,219
"لرستان","الیگودرز","مرکزی",1,165,13,132,71,381,1,382
"لرستان","الیگودرز","مرکزی",2,498,25,283,286,1092,12,1104
"لرستان","الیگودرز","مرکزی",3,277,21,177,146,621,10,631
"لرستان","الیگودرز","مرکزی",4,558,31,148,120,857,7,864
"لرستان","الیگودرز","مرکزی",5,450,27,232,83,792,8,800
"لرستان","الیگودرز","مرکزی",6,412,38,200,80,730,2,732
"لرستان","الیگودرز","مرکزی",7,179,13,91,104,387,3,390
"لرستان","الیگودرز","مرکزی",8,105,5,52,65,227,1,228
"لرستان","الیگودرز","مرکزی",9,306,36,168,197,707,8,715
"لرستان","الیگودرز","مرکزی",10,215,19,104,117,455,7,462
"لرستان","الیگودرز","مرکزی",11,243,7,114,82,446,1,447
"لرستان","الیگودرز","مرکزی",12,340,33,200,196,769,5,774
"لرستان","الیگودرز","مرکزی",13,193,13,82,99,387,3,390
"لرستان","الیگودرز","مرکزی",14,207,11,154,138,510,5,515
"لرستان","الیگودرز","مرکزی",15,316,17,139,129,601,6,607
"لرستان","الیگودرز","مرکزی",16,456,21,263,219,959,13,972
"لرستان","الیگودرز","مرکزی",17,181,4,99,41,325,5,330
"لرستان","الیگودرز","مرکزی",18,169,15,71,66,321,1,322
"لرستان","الیگودرز","مرکزی",19,312,34,208,250,804,12,816
"لرستان","الیگودرز","مرکزی",20,80,4,26,31,141,2,143
"لرستان","الیگودرز","مرکزی",21,81,7,38,55,181,3,184
"لرستان","الیگودرز","مرکزی",22,407,24,220,254,905,12,917
"لرستان","الیگودرز","مرکزی",23,392,18,219,228,857,8,865
"لرستان","الیگودرز","مرکزی",24,125,8,94,84,311,3,314
"لرستان","الیگودرز","مرکزی",25,476,38,330,253,1097,10,1107
"لرستان","الیگودرز","مرکزی",26,129,13,48,64,254,5,259
"لرستان","الیگودرز","مرکزی",27,298,34,138,204,674,13,687
"لرستان","الیگودرز","مرکزی",28,120,23,51,63,257,2,259
"لرستان","الیگودرز","مرکزی",29,279,9,121,185,594,8,602
"لرستان","الیگودرز","مرکزی",30,384,9,238,158,789,11,800
"لرستان","الیگودرز","مرکزی",31,87,6,20,28,141,2,143
"لرستان","الیگودرز","مرکزی",32,382,16,193,93,684,5,689
"لرستان","الیگودرز","مرکزی",33,291,18,107,43,459,8,467
"لرستان","الیگودرز","مرکزی",34,405,27,172,62,666,5,671
"لرستان","الیگودرز","مرکزی",35,256,19,135,37,447,1,448
"لرستان","الیگودرز","مرکزی",36,586,28,213,66,893,4,897
"لرستان","الیگودرز","مرکزی",37,361,17,137,32,547,6,553
"لرستان","الیگودرز","مرکزی",38,197,22,96,21,336,4,340
"لرستان","الیگودرز","مرکزی",39,552,25,272,204,1053,6,1059
"لرستان","الیگودرز","مرکزی",40,475,28,236,89,828,6,834
"لرستان","الیگودرز","مرکزی",41,327,25,176,76,604,7,611
"لرستان","الیگودرز","مرکزی",42,394,17,167,170,748,8,756
"لرستان","الیگودرز","مرکزی",43,143,2,46,53,244,5,249
"لرستان","الیگودرز","مرکزی",44,218,11,104,184,517,8,525
"لرستان","الیگودرز","مرکزی",45,333,17,193,230,773,8,781
"لرستان","الیگودرز","مرکزی",46,362,14,157,178,711,5,716
"لرستان","الیگودرز","مرکزی",47,233,11,171,175,590,7,597
"لرستان","الیگودرز","مرکزی",48,519,32,182,110,843,9,852
"لرستان","الیگودرز","مرکزی",49,508,21,179,195,903,18,921
"لرستان","الیگودرز","مرکزی",50,502,27,227,227,983,16,999
"لرستان","الیگودرز","مرکزی",51,75,9,54,35,173,3,176
"لرستان","الیگودرز","مرکزی",52,186,10,107,82,385,2,387
"لرستان","الیگودرز","مرکزی",53,330,11,183,184,708,13,721
"لرستان","الیگودرز","مرکزی",54,284,15,122,89,510,5,515
"لرستان","الیگودرز","مرکزی",55,386,36,203,89,714,4,718
"لرستان","الیگودرز","مرکزی",56,452,49,215,97,813,3,816
"لرستان","الیگودرز","مرکزی",57,271,14,176,69,530,6,536
"لرستان","الیگودرز","مرکزی",58,264,14,143,75,496,7,503
"لرستان","الیگودرز","مرکزی",59,527,36,260,233,1056,11,1067
"لرستان","الیگودرز","مرکزی",60,368,26,271,177,842,12,854
"لرستان","الیگودرز","مرکزی",61,123,4,78,80,285,7,292
"لرستان","الیگودرز","مرکزی",62,679,17,332,220,1248,10,1258
"لرستان","الیگودرز","مرکزی",63,314,24,227,100,665,2,667
"لرستان","الیگودرز","مرکزی",64,162,5,55,45,267,5,272
"لرستان","الیگودرز","مرکزی",65,257,9,79,6,351,0,351
"لرستان","الیگودرز","مرکزی",66,473,21,227,77,798,2,800
"لرستان","الیگودرز","مرکزی",67,344,44,40,40,468,2,470
"لرستان","الیگودرز","مرکزی",68,426,12,22,67,527,4,531
"لرستان","الیگودرز","مرکزی",69,171,1,50,19,241,0,241
"لرستان","الیگودرز","مرکزی",70,187,5,98,7,297,2,299
"لرستان","الیگودرز","مرکزی",71,270,28,39,21,358,4,362
"لرستان","الیگودرز","مرکزی",72,617,17,65,40,739,1,740
"لرستان","الیگودرز","مرکزی",73,429,3,42,19,493,1,494
"لرستان","الیگودرز","مرکزی",74,221,7,30,17,275,0,275
"لرستان","الیگودرز","مرکزی",75,293,2,18,11,324,2,326
"لرستان","الیگودرز","مرکزی",76,271,2,76,10,359,1,360
"لرستان","الیگودرز","مرکزی",77,282,4,54,26,366,0,366
"لرستان","الیگودرز","مرکزی",78,568,5,36,56,665,2,667
"لرستان","الیگودرز","مرکزی",79,443,2,66,61,572,1,573
"لرستان","الیگودرز","مرکزی",80,242,4,70,8,324,0,324
"لرستان","الیگودرز","مرکزی",81,646,3,15,31,695,3,698
"لرستان","الیگودرز","مرکزی",82,800,15,22,90,927,3,930
"لرستان","الیگودرز","مرکزی",83,366,1,10,76,453,2,455
"لرستان","الیگودرز","مرکزی",84,448,79,135,18,680,15,695
"لرستان","الیگودرز","مرکزی",85,242,15,70,14,341,1,342
"لرستان","الیگودرز","مرکزی",86,402,8,91,27,528,2,530
"لرستان","الیگودرز","مرکزی",87,379,17,121,13,530,1,531
"لرستان","الیگودرز","مرکزی",88,223,26,155,24,428,0,428
"لرستان","الیگودرز","مرکزی",89,231,51,153,19,454,12,466
"لرستان","الیگودرز","مرکزی",90,169,22,123,15,329,4,333
"لرستان","الیگودرز","مرکزی",91,296,32,74,14,416,2,418
"لرستان","الیگودرز","مرکزی",92,202,50,202,11,465,5,470
"لرستان","الیگودرز","مرکزی",93,521,20,91,34,666,5,671
"لرستان","الیگودرز","مرکزی",94,479,35,133,103,750,12,762
"لرستان","الیگودرز","مرکزی",95,150,8,50,20,228,1,229
"لرستان","الیگودرز","مرکزی",96,166,13,59,2,240,0,240
"لرستان","الیگودرز","مرکزی",97,104,6,99,7,216,0,216
"لرستان","الیگودرز","مرکزی",98,133,10,149,12,304,3,307
"لرستان","الیگودرز","مرکزی",99,127,8,86,9,230,0,230
"لرستان","الیگودرز","مرکزی",100,265,2,65,9,341,1,342
"لرستان","الیگودرز","مرکزی",101,142,31,155,8,336,0,336
"لرستان","الیگودرز","مرکزی",102,150,1,326,28,505,2,507
"لرستان","الیگودرز","بشارت",1,203,6,35,34,278,0,278
"لرستان","الیگودرز","بشارت",2,133,2,75,8,218,0,218
"لرستان","الیگودرز","بشارت",3,409,8,68,2,487,2,489
"لرستان","الیگودرز","بشارت",4,242,23,100,6,371,1,372
"لرستان","الیگودرز","بشارت",5,135,7,33,8,183,0,183
"لرستان","الیگودرز","بشارت",6,87,4,81,3,175,0,175
"لرستان","الیگودرز","بشارت",7,133,26,45,15,219,4,223
"لرستان","الیگودرز","بشارت",8,79,10,51,2,142,0,142
"لرستان","الیگودرز","بشارت",9,76,6,115,2,199,0,199
"لرستان","الیگودرز","بشارت",10,69,7,115,1,192,0,192
"لرستان","الیگودرز","بشارت",11,23,2,97,2,124,0,124
"لرستان","الیگودرز","بشارت",12,124,9,29,5,167,0,167
"لرستان","الیگودرز","بشارت",13,291,4,9,2,306,1,307
"لرستان","الیگودرز","بشارت",14,56,5,30,2,93,0,93
"لرستان","الیگودرز","بشارت",15,139,37,46,54,276,0,276
"لرستان","الیگودرز","بشارت",16,129,6,13,24,172,0,172
"لرستان","الیگودرز","ززوماهرو",1,491,91,13,20,615,2,617
"لرستان","الیگودرز","ززوماهرو",2,303,9,9,18,339,0,339
"لرستان","الیگودرز","ززوماهرو",3,178,80,12,2,272,3,275
"لرستان","الیگودرز","ززوماهرو",4,121,10,4,3,138,0,138
"لرستان","الیگودرز","ززوماهرو",5,430,6,0,11,447,2,449
"لرستان","الیگودرز","ززوماهرو",6,392,6,23,3,424,1,425
"لرستان","الیگودرز","ززوماهرو",7,408,31,6,12,457,0,457
"لرستان","الیگودرز","ززوماهرو",8,205,34,10,5,254,0,254
"لرستان","الیگودرز","ززوماهرو",9,109,12,3,2,126,0,126
"لرستان","الیگودرز","ززوماهرو",10,436,5,10,28,479,2,481
"لرستان","الیگودرز","ززوماهرو",11,320,1,1,7,329,1,330
"لرستان","الیگودرز","ززوماهرو",12,302,15,4,14,335,1,336
"لرستان","الیگودرز","ززوماهرو",13,389,8,3,8,408,0,408
"لرستان","الیگودرز","ززوماهرو",14,292,1,0,2,295,4,299
"لرستان","الیگودرز","ززوماهرو",15,153,10,0,16,179,0,179
"لرستان","الیگودرز","ززوماهرو",16,73,9,1,2,85,0,85
"لرستان","الیگودرز","ززوماهرو",17,118,4,3,1,126,0,126
"لرستان","الیگودرز","ززوماهرو",18,207,9,13,4,233,0,233
"لرستان","الیگودرز","ززوماهرو",19,395,21,10,17,443,1,444
"لرستان","بروجرد","اشترینان",1,546,2,10,216,774,7,781
"لرستان","بروجرد","اشترینان",2,386,8,12,102,508,3,511
"لرستان","بروجرد","اشترینان",3,431,2,8,114,555,1,556
"لرستان","بروجرد","اشترینان",4,348,4,0,125,477,2,479
"لرستان","بروجرد","اشترینان",5,606,11,12,196,825,4,829
"لرستان","بروجرد","اشترینان",6,171,2,2,59,234,1,235
"لرستان","بروجرد","اشترینان",7,1140,2,4,75,1221,4,1225
"لرستان","بروجرد","اشترینان",8,453,4,0,49,506,3,509
"لرستان","بروجرد","اشترینان",9,980,10,0,47,1037,0,1037
"لرستان","بروجرد","اشترینان",10,844,2,7,39,892,4,896
"لرستان","بروجرد","اشترینان",11,959,2,6,49,1016,2,1018
"لرستان","بروجرد","اشترینان",12,1071,4,2,64,1141,10,1151
"لرستان","بروجرد","اشترینان",13,894,11,1,190,1096,4,1100
"لرستان","بروجرد","اشترینان",14,595,2,1,65,663,2,665
"لرستان","بروجرد","اشترینان",15,173,3,0,35,211,4,215
"لرستان","بروجرد","اشترینان",16,1007,3,2,131,1143,5,1148
"لرستان","بروجرد","اشترینان",17,643,1,6,60,710,5,715
"لرستان","بروجرد","اشترینان",18,906,1,5,36,948,2,950
"لرستان","بروجرد","اشترینان",19,577,0,2,10,589,0,589
"لرستان","بروجرد","اشترینان",20,635,0,2,31,668,1,669
"لرستان","بروجرد","اشترینان",21,788,3,0,31,822,2,824
"لرستان","بروجرد","اشترینان",22,610,0,9,14,633,0,633
"لرستان","بروجرد","اشترینان",23,294,2,1,66,363,3,366
"لرستان","بروجرد","اشترینان",24,801,7,9,126,943,6,949
"لرستان","بروجرد","اشترینان",25,493,2,1,35,531,1,532
"لرستان","بروجرد","اشترینان",26,555,0,0,33,588,0,588
"لرستان","بروجرد","اشترینان",27,337,0,3,19,359,1,360
"لرستان","بروجرد","اشترینان",28,349,0,4,63,416,2,418
"لرستان","بروجرد","اشترینان",29,582,1,0,57,640,0,640
"لرستان","بروجرد","اشترینان",30,707,2,4,22,735,1,736
"لرستان","بروجرد","اشترینان",31,286,2,0,29,317,0,317
"لرستان","بروجرد","مرکزی",1,858,36,20,533,1447,28,1475
"لرستان","بروجرد","مرکزی",2,548,23,27,937,1535,20,1555
"لرستان","بروجرد","مرکزی",3,1059,42,38,729,1868,24,1892
"لرستان","بروجرد","مرکزی",4,919,15,18,448,1400,8,1408
"لرستان","بروجرد","مرکزی",5,478,23,43,1050,1594,17,1611
"لرستان","بروجرد","مرکزی",6,268,13,30,1188,1499,23,1522
"لرستان","بروجرد","مرکزی",7,205,12,19,619,855,5,860
"لرستان","بروجرد","مرکزی",8,361,15,21,629,1026,23,1049
"لرستان","بروجرد","مرکزی",9,416,21,25,575,1037,14,1051
"لرستان","بروجرد","مرکزی",10,576,26,42,942,1586,12,1598
"لرستان","بروجرد","مرکزی",11,383,18,23,798,1222,21,1243
"لرستان","بروجرد","مرکزی",12,650,23,35,824,1532,12,1544
"لرستان","بروجرد","مرکزی",13,455,15,15,902,1387,15,1402
"لرستان","بروجرد","مرکزی",14,324,11,36,426,797,9,806
"لرستان","بروجرد","مرکزی",15,242,8,35,472,757,5,762
"لرستان","بروجرد","مرکزی",16,627,22,35,709,1393,21,1414
"لرستان","بروجرد","مرکزی",17,1162,21,17,275,1475,13,1488
"لرستان","بروجرد","مرکزی",18,925,16,21,313,1275,13,1288
"لرستان","بروجرد","مرکزی",19,579,12,4,181,776,9,785
"لرستان","بروجرد","مرکزی",20,888,21,33,536,1478,20,1498
"لرستان","بروجرد","مرکزی",21,930,16,34,636,1616,33,1649
"لرستان","بروجرد","مرکزی",22,613,15,16,368,1012,13,1025
"لرستان","بروجرد","مرکزی",23,299,10,8,307,624,10,634
"لرستان","بروجرد","مرکزی",24,688,17,12,270,987,16,1003
"لرستان","بروجرد","مرکزی",25,685,6,8,171,870,9,879
"لرستان","بروجرد","مرکزی",26,627,26,42,812,1507,11,1518
"لرستان","بروجرد","مرکزی",27,342,15,24,480,861,8,869
"لرستان","بروجرد","مرکزی",28,226,10,12,172,420,10,430
"لرستان","بروجرد","مرکزی",29,696,29,66,504,1295,16,1311
"لرستان","بروجرد","مرکزی",30,788,18,17,383,1206,10,1216
"لرستان","بروجرد","مرکزی",31,987,14,16,397,1414,13,1427
"لرستان","بروجرد","مرکزی",32,512,15,31,247,805,21,826
"لرستان","بروجرد","مرکزی",33,1223,12,19,317,1571,22,1593
"لرستان","بروجرد","مرکزی",34,1435,12,12,278,1737,10,1747
"لرستان","بروجرد","مرکزی",35,1033,9,7,159,1208,10,1218
"لرستان","بروجرد","مرکزی",36,1394,14,25,295,1728,13,1741
"لرستان","بروجرد","مرکزی",37,1146,14,7,240,1407,18,1425
"لرستان","بروجرد","مرکزی",38,1624,16,11,338,1989,11,2000
"لرستان","بروجرد","مرکزی",39,723,8,12,253,996,9,1005
"لرستان","بروجرد","مرکزی",40,957,22,32,496,1507,26,1533
"لرستان","بروجرد","مرکزی",41,722,10,21,246,999,13,1012
"لرستان","بروجرد","مرکزی",42,1364,12,12,339,1727,12,1739
"لرستان","بروجرد","مرکزی",43,1136,18,42,395,1591,15,1606
"لرستان","بروجرد","مرکزی",44,715,18,69,343,1145,26,1171
"لرستان","بروجرد","مرکزی",45,905,6,24,196,1131,14,1145
"لرستان","بروجرد","مرکزی",46,755,7,26,298,1086,13,1099
"لرستان","بروجرد","مرکزی",47,1190,13,21,317,1541,23,1564
"لرستان","بروجرد","مرکزی",48,1195,4,9,142,1350,6,1356
"لرستان","بروجرد","مرکزی",49,1126,6,12,242,1386,4,1390
"لرستان","بروجرد","مرکزی",50,1475,10,19,223,1727,15,1742
"لرستان","بروجرد","مرکزی",51,878,13,76,361,1328,15,1343
"لرستان","بروجرد","مرکزی",52,1143,13,15,190,1361,15,1376
"لرستان","بروجرد","مرکزی",53,1172,12,25,353,1562,15,1577
"لرستان","بروجرد","مرکزی",54,537,8,20,166,731,9,740
"لرستان","بروجرد","مرکزی",55,710,16,41,402,1169,14,1183
"لرستان","بروجرد","مرکزی",56,786,13,36,289,1124,13,1137
"لرستان","بروجرد","مرکزی",57,815,12,7,263,1097,5,1102
"لرستان","بروجرد","مرکزی",58,819,8,15,251,1093,13,1106
"لرستان","بروجرد","مرکزی",59,400,6,22,162,590,7,597
"لرستان","بروجرد","مرکزی",60,994,9,1,85,1089,4,1093
"لرستان","بروجرد","مرکزی",61,1258,3,4,137,1402,13,1415
"لرستان","بروجرد","مرکزی",62,1101,5,9,126,1241,8,1249
"لرستان","بروجرد","مرکزی",63,1302,17,15,320,1654,13,1667
"لرستان","بروجرد","مرکزی",64,1310,12,13,424,1759,14,1773
"لرستان","بروجرد","مرکزی",65,549,3,3,53,608,9,617
"لرستان","بروجرد","مرکزی",66,364,5,10,109,488,8,496
"لرستان","بروجرد","مرکزی",67,680,9,9,277,975,12,987
"لرستان","بروجرد","مرکزی",68,871,9,14,194,1088,12,1100
"لرستان","بروجرد","مرکزی",69,1079,2,8,138,1227,11,1238
"لرستان","بروجرد","مرکزی",70,1032,5,16,160,1213,12,1225
"لرستان","بروجرد","مرکزی",71,812,6,12,217,1047,14,1061
"لرستان","بروجرد","مرکزی",72,651,9,6,173,839,13,852
"لرستان","بروجرد","مرکزی",73,443,4,8,100,555,10,565
"لرستان","بروجرد","مرکزی",74,440,12,1,118,571,12,583
"لرستان","بروجرد","مرکزی",75,509,8,10,247,774,12,786
"لرستان","بروجرد","مرکزی",76,778,8,12,237,1035,11,1046
"لرستان","بروجرد","مرکزی",77,851,10,25,419,1305,16,1321
"لرستان","بروجرد","مرکزی",78,595,9,48,438,1090,12,1102
"لرستان","بروجرد","مرکزی",79,384,10,20,311,725,13,738
"لرستان","بروجرد","مرکزی",80,334,5,10,106,455,3,458
"لرستان","بروجرد","مرکزی",81,219,8,8,120,355,6,361
"لرستان","بروجرد","مرکزی",82,371,10,27,188,596,4,600
"لرستان","بروجرد","مرکزی",83,724,7,20,222,973,8,981
"لرستان","بروجرد","مرکزی",84,539,24,26,686,1275,24,1299
"لرستان","بروجرد","مرکزی",85,886,26,31,694,1637,38,1675
"لرستان","بروجرد","مرکزی",86,743,40,25,925,1733,26,1759
"لرستان","بروجرد","مرکزی",87,373,10,16,321,720,10,730
"لرستان","بروجرد","مرکزی",88,706,34,32,1194,1966,33,1999
"لرستان","بروجرد","مرکزی",89,270,11,35,419,735,12,747
"لرستان","بروجرد","مرکزی",90,359,21,32,717,1129,17,1146
"لرستان","بروجرد","مرکزی",91,288,17,19,681,1005,11,1016
"لرستان","بروجرد","مرکزی",92,180,10,9,332,531,6,537
"لرستان","بروجرد","مرکزی",93,612,24,28,619,1283,25,1308
"لرستان","بروجرد","مرکزی",94,535,14,12,510,1071,24,1095
"لرستان","بروجرد","مرکزی",95,319,10,22,370,721,11,732
"لرستان","بروجرد","مرکزی",96,384,17,46,553,1000,8,1008
"لرستان","بروجرد","مرکزی",97,508,30,24,881,1443,14,1457
"لرستان","بروجرد","مرکزی",98,396,10,10,291,707,11,718
"لرستان","بروجرد","مرکزی",99,363,17,18,346,744,7,751
"لرستان","بروجرد","مرکزی",100,489,15,8,538,1050,10,1060
"لرستان","بروجرد","مرکزی",101,664,22,20,484,1190,7,1197
"لرستان","بروجرد","مرکزی",102,573,18,31,616,1238,12,1250
"لرستان","بروجرد","مرکزی",103,781,17,6,242,1046,12,1058
"لرستان","بروجرد","مرکزی",104,483,10,14,278,785,15,800
"لرستان","بروجرد","مرکزی",105,1049,26,11,418,1504,12,1516
"لرستان","بروجرد","مرکزی",106,362,5,7,285,659,17,676
"لرستان","بروجرد","مرکزی",107,300,13,7,146,466,5,471
"لرستان","بروجرد","مرکزی",108,400,42,53,962,1457,22,1479
"لرستان","بروجرد","مرکزی",109,371,9,3,141,524,2,526
"لرستان","بروجرد","مرکزی",110,211,5,1,108,325,6,331
"لرستان","بروجرد","مرکزی",111,518,11,5,216,750,9,759
"لرستان","بروجرد","مرکزی",112,956,9,9,217,1191,9,1200
"لرستان","بروجرد","مرکزی",113,511,0,2,40,553,6,559
"لرستان","بروجرد","مرکزی",114,1097,8,6,81,1192,7,1199
"لرستان","بروجرد","مرکزی",115,488,5,19,83,595,7,602
"لرستان","بروجرد","مرکزی",116,728,5,30,76,839,5,844
"لرستان","بروجرد","مرکزی",117,366,6,8,90,470,8,478
"لرستان","بروجرد","مرکزی",118,545,4,12,187,748,6,754
"لرستان","بروجرد","مرکزی",119,746,6,16,123,891,6,897
"لرستان","بروجرد","مرکزی",120,753,0,0,37,790,2,792
"لرستان","بروجرد","مرکزی",121,466,0,1,46,513,2,515
"لرستان","بروجرد","مرکزی",122,739,2,8,103,852,6,858
"لرستان","بروجرد","مرکزی",123,988,12,7,82,1089,3,1092
"لرستان","بروجرد","مرکزی",124,752,2,18,77,849,6,855
"لرستان","بروجرد","مرکزی",125,622,2,8,83,715,4,719
"لرستان","بروجرد","مرکزی",126,516,0,12,32,560,0,560
"لرستان","بروجرد","مرکزی",127,742,2,5,79,828,3,831
"لرستان","بروجرد","مرکزی",128,788,7,7,76,878,4,882
"لرستان","بروجرد","مرکزی",129,336,5,2,86,429,2,431
"لرستان","بروجرد","مرکزی",130,765,9,7,212,993,20,1013
"لرستان","بروجرد","مرکزی",131,402,0,3,73,478,2,480
"لرستان","بروجرد","مرکزی",132,832,6,5,80,923,8,931
"لرستان","بروجرد","مرکزی",133,906,2,1,59,968,3,971
"لرستان","بروجرد","مرکزی",134,681,1,7,34,723,1,724
"لرستان","بروجرد","مرکزی",135,378,7,1,42,428,10,438
"لرستان","بروجرد","مرکزی",136,436,6,0,45,487,1,488
"لرستان","بروجرد","مرکزی",137,1011,3,3,76,1093,6,1099
"لرستان","بروجرد","مرکزی",138,784,5,0,29,818,5,823
"لرستان","بروجرد","مرکزی",139,929,5,3,75,1012,3,1015
"لرستان","بروجرد","مرکزی",140,854,3,5,79,941,4,945
"لرستان","بروجرد","مرکزی",141,507,3,4,26,540,1,541
"لرستان","بروجرد","مرکزی",142,663,0,1,74,738,3,741
"لرستان","بروجرد","مرکزی",143,980,7,9,81,1077,7,1084
"لرستان","بروجرد","مرکزی",144,317,2,1,44,364,0,364
"لرستان","بروجرد","مرکزی",145,1112,0,1,92,1205,4,1209
"لرستان","بروجرد","مرکزی",146,334,3,1,15,353,3,356
"لرستان","بروجرد","مرکزی",147,688,3,0,50,741,0,741
"لرستان","بروجرد","مرکزی",148,778,2,2,23,805,4,809
"لرستان","بروجرد","مرکزی",149,296,2,4,21,323,4,327
"لرستان","بروجرد","مرکزی",150,383,6,2,41,432,4,436
"لرستان","بروجرد","مرکزی",151,390,0,0,28,418,3,421
"لرستان","بروجرد","مرکزی",152,577,4,2,28,611,2,613
"لرستان","بروجرد","مرکزی",153,384,3,2,14,403,2,405
"لرستان","بروجرد","مرکزی",154,852,3,0,33,888,5,893
"لرستان","بروجرد","مرکزی",155,345,2,1,37,385,2,387
"لرستان","بروجرد","مرکزی",156,538,0,1,18,557,1,558
"لرستان","بروجرد","مرکزی",157,138,0,0,16,154,1,155
"لرستان","بروجرد","مرکزی",158,512,2,19,84,617,6,623
"لرستان","بروجرد","مرکزی",159,116,5,2,41,164,0,164
"لرستان","بروجرد","مرکزی",160,99,0,0,16,115,0,115
"لرستان","پلدختر","شهر",1,626,20,29,188,863,18,881
"لرستان","پلدختر","شهر",2,450,18,33,189,690,4,694
"لرستان","پلدختر","شهر",3,453,27,14,173,667,7,674
"لرستان","پلدختر","شهر",4,361,12,28,210,611,8,619
"لرستان","پلدختر","شهر",5,226,18,15,153,412,7,419
"لرستان","پلدختر","شهر",6,326,31,12,141,510,7,517
"لرستان","پلدختر","شهر",7,232,13,2,100,347,4,351
"لرستان","پلدختر","شهر",8,461,13,23,267,764,13,777
"لرستان","پلدختر","شهر",9,353,10,24,337,724,18,742
"لرستان","پلدختر","شهر",10,404,12,35,288,739,11,750
"لرستان","پلدختر","شهر",11,470,34,31,238,773,8,781
"لرستان","پلدختر","شهر",12,504,29,37,267,837,7,844
"لرستان","پلدختر","شهر",13,693,20,46,323,1082,9,1091
"لرستان","پلدختر","شهر",14,554,25,43,219,841,8,849
"لرستان","پلدختر","شهر",15,470,15,35,187,707,3,710
"لرستان","پلدختر","شهر",16,405,19,32,213,669,14,683
"لرستان","پلدختر","شهر",17,490,5,39,120,654,4,658
"لرستان","پلدختر","شهر",18,529,14,19,183,745,10,755
"لرستان","پلدختر","شهر",19,325,13,29,175,542,9,551
"لرستان","پلدختر","مرکزی",20,267,9,4,109,389,4,393
"لرستان","پلدختر","مرکزی",21,336,2,3,26,367,-6,361
"لرستان","پلدختر","مرکزی",22,842,20,25,187,1074,7,1081
"لرستان","پلدختر","مرکزی",23,561,11,11,175,758,5,763
"لرستان","پلدختر","مرکزی",24,191,0,4,56,251,0,251
"لرستان","پلدختر","مرکزی",25,233,6,22,137,398,2,400
"لرستان","پلدختر","مرکزی",26,506,5,58,124,693,7,700
"لرستان","پلدختر","مرکزی",27,362,6,14,137,519,6,525
"لرستان","پلدختر","مرکزی",28,455,7,13,76,551,5,556
"لرستان","پلدختر","مرکزی",29,506,21,4,133,664,6,670
"لرستان","پلدختر","مرکزی",30,256,8,6,35,305,1,306
"لرستان","پلدختر","مرکزی",31,443,9,7,115,574,5,579
"لرستان","پلدختر","مرکزی",32,543,16,7,81,647,20,667
"لرستان","پلدختر","مرکزی",33,372,8,7,31,418,3,421
"لرستان","پلدختر","مرکزی",34,468,6,5,165,644,17,661
"لرستان","پلدختر","مرکزی",35,95,6,0,37,138,2,140
"لرستان","پلدختر","مرکزی",36,96,2,0,57,155,2,157
"لرستان","پلدختر","مرکزی",37,212,4,1,11,228,0,228
"لرستان","پلدختر","مرکزی",38,575,10,7,100,692,7,699
"لرستان","پلدختر","مرکزی",39,274,2,18,67,361,2,363
"لرستان","پلدختر","مرکزی",40,158,0,4,15,177,3,180
"لرستان","پلدختر","مرکزی",41,212,5,0,26,243,0,243
"لرستان","پلدختر","مرکزی",42,184,0,0,12,196,1,197
"لرستان","پلدختر","مرکزی",43,139,1,1,28,169,1,170
"لرستان","پلدختر","مرکزی",44,201,2,9,35,247,2,249
"لرستان","پلدختر","مرکزی",45,542,19,33,222,816,9,825
"لرستان","پلدختر","مرکزی",46,923,7,28,210,1168,7,1175
"لرستان","پلدختر","مرکزی",47,550,8,27,243,828,4,832
"لرستان","پلدختر","مرکزی",48,809,13,15,255,1092,8,1100
"لرستان","پلدختر","مرکزی",49,127,4,7,69,207,3,210
"لرستان","پلدختر","مرکزی",50,592,1,1,138,732,4,736
"لرستان","پلدختر","معمولان",1,543,5,19,237,804,3,807
"لرستان","پلدختر","معمولان",2,278,3,10,200,491,9,500
"لرستان","پلدختر","معمولان",3,568,10,28,187,793,8,801
"لرستان","پلدختر","معمولان",4,393,0,5,23,421,2,423
"لرستان","پلدختر","معمولان",5,372,4,6,73,455,1,456
"لرستان","پلدختر","معمولان",6,379,4,11,140,534,6,540
"لرستان","پلدختر","معمولان",7,356,1,5,65,427,4,431
"لرستان","پلدختر","معمولان",8,144,3,10,57,214,2,216
"لرستان","پلدختر","معمولان",9,388,2,29,80,499,0,499
"لرستان","پلدختر","معمولان",10,303,5,2,72,382,0,382
"لرستان","پلدختر","معمولان",11,296,5,29,116,446,8,454
"لرستان","پلدختر","معمولان",12,429,1,15,50,495,4,499
"لرستان","پلدختر","معمولان",13,414,1,11,98,524,6,530
"لرستان","پلدختر","معمولان",14,372,10,13,149,544,3,547
"لرستان","پلدختر","معمولان",15,455,2,4,39,500,0,500
"لرستان","پلدختر","معمولان",16,227,6,34,80,347,0,347
"لرستان","پلدختر","معمولان",17,303,1,7,66,377,1,378
"لرستان","پلدختر","معمولان",18,119,3,2,25,149,2,151
"لرستان","پلدختر","معمولان",19,177,0,3,64,244,4,248
"لرستان","پلدختر","معمولان",20,278,0,6,66,350,0,350
"لرستان","پلدختر","معمولان",21,351,0,27,155,533,1,534
"لرستان","پلدختر","معمولان",22,300,11,27,122,460,7,467
"لرستان","پلدختر","معمولان",23,140,8,0,3,151,0,151
"لرستان","پلدختر","معمولان",24,214,5,3,26,248,0,248
"لرستان","پلدختر","معمولان",25,264,6,2,20,292,0,292
"لرستان","پلدختر","معمولان",26,173,1,7,79,260,4,264
"لرستان","پلدختر","معمولان",27,335,3,4,44,386,3,389
"لرستان","پلدختر","معمولان",28,235,1,4,37,277,0,277
"لرستان","پلدختر","معمولان",29,278,1,0,48,327,0,327
"لرستان","پلدختر","معمولان",30,404,1,2,47,454,8,462
"لرستان","پلدختر","معمولان",31,119,0,0,6,125,2,127
"لرستان","پلدختر","معمولان",32,293,2,8,42,345,0,345
"لرستان","خرم_آباد","مرکزی",1,1044,10,32,207,1293,9,1302
"لرستان","خرم_آباد","مرکزی",2,1292,10,47,183,1532,13,1545
"لرستان","خرم_آباد","مرکزی",3,1106,17,18,227,1368,13,1381
"لرستان","خرم_آباد","مرکزی",4,1150,11,40,217,1418,22,1440
"لرستان","خرم_آباد","مرکزی",5,1153,12,23,166,1354,13,1367
"لرستان","خرم_آباد","مرکزی",6,802,15,34,273,1124,10,1134
"لرستان","خرم_آباد","مرکزی",7,474,12,21,249,756,6,762
"لرستان","خرم_آباد","مرکزی",8,1179,24,21,242,1466,3,1469
"لرستان","خرم_آباد","مرکزی",9,1160,12,17,288,1477,0,1477
"لرستان","خرم_آباد","مرکزی",10,1344,5,10,101,1460,7,1467
"لرستان","خرم_آباد","مرکزی",11,1663,7,6,113,1789,11,1800
"لرستان","خرم_آباد","مرکزی",12,852,18,62,370,1302,18,1320
"لرستان","خرم_آباد","مرکزی",13,481,27,94,888,1490,10,1500
"لرستان","خرم_آباد","مرکزی",14,781,35,68,601,1485,15,1500
"لرستان","خرم_آباد","مرکزی",15,978,34,34,631,1677,20,1697
"لرستان","خرم_آباد","مرکزی",16,343,27,75,682,1127,8,1135
"لرستان","خرم_آباد","مرکزی",17,630,28,24,500,1182,12,1194
"لرستان","خرم_آباد","مرکزی",18,531,29,64,671,1295,13,1308
"لرستان","خرم_آباد","مرکزی",19,920,33,45,398,1396,19,1415
"لرستان","خرم_آباد","مرکزی",20,383,19,47,456,905,12,917
"لرستان","خرم_آباد","مرکزی",21,350,28,62,765,1205,0,1205
"لرستان","خرم_آباد","مرکزی",22,439,23,48,649,1159,22,1181
"لرستان","خرم_آباد","مرکزی",23,560,35,63,688,1346,14,1360
"لرستان","خرم_آباد","مرکزی",24,262,18,61,439,780,13,793
"لرستان","خرم_آباد","مرکزی",25,773,30,84,637,1524,17,1541
"لرستان","خرم_آباد","مرکزی",26,365,29,75,870,1339,23,1362
"لرستان","خرم_آباد","مرکزی",27,765,24,46,587,1422,23,1445
"لرستان","خرم_آباد","مرکزی",28,587,23,68,582,1260,0,1260
"لرستان","خرم_آباد","مرکزی",29,837,26,17,379,1259,15,1274
"لرستان","خرم_آباد","مرکزی",30,822,24,37,357,1240,16,1256
"لرستان","خرم_آباد","مرکزی",31,723,29,50,671,1473,17,1490
"لرستان","خرم_آباد","مرکزی",32,985,42,68,665,1760,26,1786
"لرستان","خرم_آباد","مرکزی",33,847,35,62,657,1601,30,1631
"لرستان","خرم_آباد","مرکزی",34,1050,21,33,415,1519,18,1537
"لرستان","خرم_آباد","مرکزی",35,690,37,42,568,1337,26,1363
"لرستان","خرم_آباد","مرکزی",36,1106,32,58,462,1658,28,1686
"لرستان","خرم_آباد","مرکزی",37,880,38,71,688,1677,21,1698
"لرستان","خرم_آباد","مرکزی",38,814,36,77,543,1470,20,1490
"لرستان","خرم_آباد","مرکزی",39,729,41,71,606,1447,21,1468
"لرستان","خرم_آباد","مرکزی",40,578,32,50,794,1454,11,1465
"لرستان","خرم_آباد","مرکزی",41,1144,35,31,458,1668,34,1702
"لرستان","خرم_آباد","مرکزی",42,780,37,51,745,1613,19,1632
"لرستان","خرم_آباد","مرکزی",43,740,46,90,887,1763,22,1785
"لرستان","خرم_آباد","مرکزی",44,326,16,100,895,1337,12,1349
"لرستان","خرم_آباد","مرکزی",45,661,27,39,541,1268,22,1290
"لرستان","خرم_آباد","مرکزی",46,1094,32,60,627,1813,22,1835
"لرستان","خرم_آباد","مرکزی",47,696,39,68,664,1467,21,1488
"لرستان","خرم_آباد","مرکزی",48,1114,22,54,388,1578,12,1590
"لرستان","خرم_آباد","مرکزی",49,885,30,64,628,1607,22,1629
"لرستان","خرم_آباد","مرکزی",50,765,41,47,644,1497,13,1510
"لرستان","خرم_آباد","مرکزی",51,1262,20,26,373,1681,18,1699
"لرستان","خرم_آباد","مرکزی",52,1193,16,52,378,1639,0,1639
"لرستان","خرم_آباد","مرکزی",53,1558,29,49,342,1978,20,1998
"لرستان","خرم_آباد","مرکزی",54,1174,13,7,229,1423,17,1440
"لرستان","خرم_آباد","مرکزی",55,1398,7,13,165,1583,0,1583
"لرستان","خرم_آباد","مرکزی",56,916,38,31,372,1357,15,1372
"لرستان","خرم_آباد","مرکزی",57,601,37,69,872,1579,8,1587
"لرستان","خرم_آباد","مرکزی",58,1032,26,34,457,1549,17,1566
"لرستان","خرم_آباد","مرکزی",59,1055,17,22,164,1258,5,1263
"لرستان","خرم_آباد","مرکزی",60,1762,22,18,248,2050,16,2066
"لرستان","خرم_آباد","مرکزی",61,1235,14,37,294,1580,17,1597
"لرستان","خرم_آباد","مرکزی",62,736,39,46,663,1484,12,1496
"لرستان","خرم_آباد","مرکزی",63,949,39,25,384,1397,15,1412
"لرستان","خرم_آباد","مرکزی",64,722,33,44,484,1283,19,1302
"لرستان","خرم_آباد","مرکزی",65,1086,43,53,601,1783,13,1796
"لرستان","خرم_آباد","مرکزی",66,1230,24,45,406,1705,23,1728
"لرستان","خرم_آباد","مرکزی",67,819,11,25,362,1217,23,1240
"لرستان","خرم_آباد","مرکزی",68,860,24,42,358,1284,18,1302
"لرستان","خرم_آباد","مرکزی",69,1057,12,27,226,1322,11,1333
"لرستان","خرم_آباد","مرکزی",70,1055,13,16,205,1289,13,1302
"لرستان","خرم_آباد","مرکزی",71,1340,15,25,239,1619,16,1635
"لرستان","خرم_آباد","مرکزی",72,1140,7,14,194,1355,11,1366
"لرستان","خرم_آباد","مرکزی",73,1240,9,13,105,1367,12,1379
"لرستان","خرم_آباد","مرکزی",74,1213,15,10,214,1452,0,1452
"لرستان","خرم_آباد","مرکزی",75,753,35,41,326,1155,18,1173
"لرستان","خرم_آباد","مرکزی",76,1152,44,55,694,1945,23,1968
"لرستان","خرم_آباد","مرکزی",77,906,25,46,511,1488,10,1498
"لرستان","خرم_آباد","مرکزی",78,691,19,43,409,1162,13,1175
"لرستان","خرم_آباد","مرکزی",79,742,46,47,640,1475,16,1491
"لرستان","خرم_آباد","مرکزی",80,772,12,55,146,985,12,997
"لرستان","خرم_آباد","مرکزی",81,758,10,18,239,1025,8,1033
"لرستان","خرم_آباد","مرکزی",82,1002,18,14,146,1180,8,1188
"لرستان","خرم_آباد","مرکزی",83,518,3,22,160,703,8,711
"لرستان","خرم_آباد","مرکزی",84,1171,17,33,338,1559,10,1569
"لرستان","خرم_آباد","مرکزی",85,969,28,34,456,1487,13,1500
"لرستان","خرم_آباد","مرکزی",86,924,24,33,394,1375,0,1375
"لرستان","خرم_آباد","مرکزی",87,538,8,12,184,742,0,742
"لرستان","خرم_آباد","مرکزی",88,462,19,25,455,961,10,971
"لرستان","خرم_آباد","مرکزی",89,694,13,43,575,1325,17,1342
"لرستان","خرم_آباد","مرکزی",90,576,30,31,523,1160,9,1169
"لرستان","خرم_آباد","مرکزی",91,540,29,73,726,1368,20,1388
"لرستان","خرم_آباد","مرکزی",92,567,43,83,1044,1737,13,1750
"لرستان","خرم_آباد","مرکزی",93,573,32,79,782,1466,9,1475
"لرستان","خرم_آباد","مرکزی",94,756,35,69,566,1426,23,1449
"لرستان","خرم_آباد","مرکزی",95,1164,28,43,246,1481,16,1497
"لرستان","خرم_آباد","مرکزی",96,993,19,62,272,1346,15,1361
"لرستان","خرم_آباد","مرکزی",97,830,18,34,330,1212,23,1235
"لرستان","خرم_آباد","مرکزی",98,795,24,21,230,1070,30,1100
"لرستان","خرم_آباد","مرکزی",99,1143,30,28,281,1482,18,1500
"لرستان","خرم_آباد","مرکزی",100,710,17,15,154,896,5,901
"لرستان","خرم_آباد","مرکزی",101,1385,10,28,237,1660,37,1697
"لرستان","خرم_آباد","مرکزی",102,1051,17,14,193,1275,14,1289
"لرستان","خرم_آباد","مرکزی",103,859,9,17,197,1082,14,1096
"لرستان","خرم_آباد","مرکزی",104,1040,30,36,519,1625,23,1648
"لرستان","خرم_آباد","مرکزی",105,1004,40,58,564,1666,9,1675
"لرستان","خرم_آباد","مرکزی",106,1225,31,69,738,2063,34,2097
"لرستان","خرم_آباد","مرکزی",107,967,25,25,470,1487,11,1498
"لرستان","خرم_آباد","مرکزی",108,1229,15,28,271,1543,22,1565
"لرستان","خرم_آباد","مرکزی",109,1121,27,37,299,1484,16,1500
"لرستان","خرم_آباد","مرکزی",110,568,18,21,181,788,12,800
"لرستان","خرم_آباد","مرکزی",111,945,32,31,441,1449,20,1469
"لرستان","خرم_آباد","مرکزی",112,841,19,28,229,1117,13,1130
"لرستان","خرم_آباد","مرکزی",113,660,20,22,259,961,6,967
"لرستان","خرم_آباد","مرکزی",114,712,16,11,238,977,6,983
"لرستان","خرم_آباد","مرکزی",115,1027,25,55,465,1572,17,1589
"لرستان","خرم_آباد","مرکزی",116,1165,32,45,532,1774,16,1790
"لرستان","خرم_آباد","مرکزی",117,1076,24,64,329,1493,7,1500
"لرستان","خرم_آباد","مرکزی",118,636,7,23,242,908,11,919
"لرستان","خرم_آباد","مرکزی",119,949,29,77,525,1580,20,1600
"لرستان","خرم_آباد","مرکزی",120,668,37,86,611,1402,10,1412
"لرستان","خرم_آباد","مرکزی",121,408,28,31,388,855,10,865
"لرستان","خرم_آباد","مرکزی",122,1476,50,39,408,1973,30,2003
"لرستان","خرم_آباد","مرکزی",123,232,18,35,377,662,6,668
"لرستان","خرم_آباد","مرکزی",124,199,17,34,287,537,8,545
"لرستان","خرم_آباد","مرکزی",125,536,27,77,561,1201,8,1209
"لرستان","خرم_آباد","مرکزی",126,251,20,60,422,753,12,765
"لرستان","خرم_آباد","مرکزی",127,294,11,47,488,840,10,850
"لرستان","خرم_آباد","مرکزی",128,586,30,85,685,1386,13,1399
"لرستان","خرم_آباد","مرکزی",129,624,38,80,1010,1752,23,1775
"لرستان","خرم_آباد","مرکزی",130,461,21,17,210,709,12,721
"لرستان","خرم_آباد","مرکزی",131,893,25,17,154,1089,12,1101
"لرستان","خرم_آباد","مرکزی",132,1415,13,22,223,1673,15,1688
"لرستان","خرم_آباد","مرکزی",133,1157,8,19,164,1348,10,1358
"لرستان","خرم_آباد","مرکزی",134,1329,20,15,327,1691,17,1708
"لرستان","خرم_آباد","مرکزی",135,865,11,16,198,1090,12,1102
"لرستان","خرم_آباد","مرکزی",136,860,14,15,282,1171,10,1181
"لرستان","خرم_آباد","مرکزی",137,1046,15,13,153,1227,7,1234
"لرستان","خرم_آباد","مرکزی",138,1204,19,13,260,1496,23,1519
"لرستان","خرم_آباد","مرکزی",139,1064,19,13,163,1259,14,1273
"لرستان","خرم_آباد","مرکزی",140,421,4,5,83,513,3,516
"لرستان","خرم_آباد","مرکزی",141,731,7,12,149,899,6,905
"لرستان","خرم_آباد","مرکزی",142,1285,13,9,174,1481,17,1498
"لرستان","خرم_آباد","مرکزی",143,807,5,5,76,893,4,897
"لرستان","خرم_آباد","مرکزی",144,267,2,2,69,340,4,344
"لرستان","خرم_آباد","مرکزی",145,956,2,3,59,1020,0,1020
"لرستان","خرم_آباد","مرکزی",146,980,8,32,163,1183,14,1197
"لرستان","خرم_آباد","مرکزی",147,1032,14,19,316,1381,11,1392
"لرستان","خرم_آباد","مرکزی",148,1109,37,44,541,1731,30,1761
"لرستان","خرم_آباد","مرکزی",149,1444,21,30,224,1719,9,1728
"لرستان","خرم_آباد","مرکزی",150,848,6,6,128,988,10,998
"لرستان","خرم_آباد","مرکزی",151,295,2,11,53,361,6,367
"لرستان","خرم_آباد","مرکزی",152,477,1,1,46,525,1,526
"لرستان","خرم_آباد","مرکزی",153,853,1,2,80,936,6,942
"لرستان","خرم_آباد","مرکزی",154,1017,3,24,152,1196,10,1206
"لرستان","خرم_آباد","مرکزی",155,321,9,7,29,366,5,371
"لرستان","خرم_آباد","مرکزی",156,418,4,4,96,522,9,531
"لرستان","خرم_آباد","مرکزی",157,468,4,7,84,563,4,567
"لرستان","خرم_آباد","مرکزی",158,223,6,1,56,286,1,287
"لرستان","خرم_آباد","مرکزی",159,1158,9,20,289,1476,15,1491
"لرستان","خرم_آباد","مرکزی",160,80,4,2,44,130,7,137
"لرستان","خرم_آباد","مرکزی",161,336,4,2,116,458,3,461
"لرستان","خرم_آباد","مرکزی",162,984,6,3,43,1036,2,1038
"لرستان","خرم_آباد","مرکزی",163,417,9,11,41,478,5,483
"لرستان","خرم_آباد","مرکزی",164,150,5,3,32,190,0,190
"لرستان","خرم_آباد","مرکزی",165,806,6,4,45,861,4,865
"لرستان","خرم_آباد","مرکزی",166,798,13,23,208,1042,9,1051
"لرستان","خرم_آباد","مرکزی",167,1033,5,12,114,1164,8,1172
"لرستان","خرم_آباد","مرکزی",168,1375,12,7,242,1636,13,1649
"لرستان","خرم_آباد","مرکزی",169,796,7,14,176,993,6,999
"لرستان","خرم_آباد","مرکزی",170,863,11,3,42,919,5,924
"لرستان","خرم_آباد","مرکزی",171,331,0,5,12,348,4,352
"لرستان","خرم_آباد","مرکزی",172,1330,3,5,144,1482,18,1500
"لرستان","خرم_آباد","مرکزی",173,627,2,17,137,783,5,788
"لرستان","خرم_آباد","مرکزی",174,921,4,13,49,987,8,995
"لرستان","خرم_آباد","مرکزی",175,603,3,9,175,790,10,800
"لرستان","خرم_آباد","مرکزی",176,668,3,6,104,781,6,787
"لرستان","خرم_آباد","مرکزی",177,664,5,15,104,788,2,790
"لرستان","خرم_آباد","مرکزی",178,1234,5,13,138,1390,20,1410
"لرستان","خرم_آباد","مرکزی",179,602,8,12,197,819,2,821
"لرستان","خرم_آباد","مرکزی",180,745,3,7,142,897,7,904
"لرستان","خرم_آباد","مرکزی",181,539,2,1,42,584,0,584
"لرستان","خرم_آباد","مرکزی",182,421,1,4,125,551,2,553
"لرستان","خرم_آباد","چغلوندی",1,529,5,15,113,662,1,663
"لرستان","خرم_آباد","چغلوندی",2,368,15,10,89,482,4,486
"لرستان","خرم_آباد","چغلوندی",3,327,21,27,85,460,3,463
"لرستان","خرم_آباد","چغلوندی",4,450,3,7,84,544,2,546
"لرستان","خرم_آباد","چغلوندی",5,487,2,6,45,540,2,542
"لرستان","خرم_آباد","چغلوندی",6,426,16,4,49,495,4,499
"لرستان","خرم_آباد","چغلوندی",7,169,1,3,36,209,10,219
"لرستان","خرم_آباد","چغلوندی",8,324,2,11,26,363,3,366
"لرستان","خرم_آباد","چغلوندی",9,538,1,4,89,632,2,634
"لرستان","خرم_آباد","چغلوندی",10,334,18,5,37,394,3,397
"لرستان","خرم_آباد","چغلوندی",11,175,4,1,56,236,5,241
"لرستان","خرم_آباد","چغلوندی",12,574,9,15,90,688,9,697
"لرستان","خرم_آباد","چغلوندی",13,463,2,8,82,555,5,560
"لرستان","خرم_آباد","چغلوندی",14,528,1,3,46,578,3,581
"لرستان","خرم_آباد","چغلوندی",15,201,9,5,53,268,5,273
"لرستان","خرم_آباد","چغلوندی",16,231,2,12,75,320,5,325
"لرستان","خرم_آباد","چغلوندی",17,275,3,3,12,293,0,293
"لرستان","خرم_آباد","چگنی",1,664,10,23,221,918,9,927
"لرستان","خرم_آباد","چگنی",2,538,6,10,150,704,11,715
"لرستان","خرم_آباد","چگنی",3,658,0,4,72,734,1,735
"لرستان","خرم_آباد","چگنی",4,272,8,5,99,384,3,387
"لرستان","خرم_آباد","چگنی",5,333,4,10,91,438,0,438
"لرستان","خرم_آباد","چگنی",6,615,1,4,74,694,6,700
"لرستان","خرم_آباد","چگنی",7,424,4,4,48,480,3,483
"لرستان","خرم_آباد","چگنی",8,327,3,5,134,469,10,479
"لرستان","خرم_آباد","چگنی",9,283,2,4,110,399,3,402
"لرستان","خرم_آباد","چگنی",10,642,1,1,131,775,0,775
"لرستان","خرم_آباد","چگنی",11,822,5,6,105,938,3,941
"لرستان","خرم_آباد","چگنی",12,904,2,6,27,939,5,944
"لرستان","خرم_آباد","چگنی",13,949,7,2,50,1008,1,1009
"لرستان","خرم_آباد","چگنی",14,545,7,3,32,587,0,587
"لرستان","خرم_آباد","چگنی",15,403,7,41,48,499,0,499
"لرستان","خرم_آباد","چگنی",16,454,1,0,37,492,0,492
"لرستان","خرم_آباد","چگنی",17,378,3,2,5,388,0,388
"لرستان","خرم_آباد","چگنی",18,374,1,10,84,469,0,469
"لرستان","خرم_آباد","چگنی",19,480,2,1,132,615,0,615
"لرستان","خرم_آباد","چگنی",20,294,0,215,5,514,2,516
"لرستان","خرم_آباد","چگنی",21,1086,2,1,74,1163,1,1164
"لرستان","خرم_آباد","چگنی",22,980,7,2,33,1022,0,1022
"لرستان","خرم_آباد","چگنی",23,295,3,1,9,308,0,308
"لرستان","خرم_آباد","چگنی",24,451,1,3,11,466,0,466
"لرستان","خرم_آباد","چگنی",25,526,1,2,45,574,4,578
"لرستان","خرم_آباد","چگنی",26,372,0,0,22,394,0,394
"لرستان","خرم_آباد","چگنی",27,199,1,7,20,227,0,227
"لرستان","خرم_آباد","چگنی",28,276,0,0,10,286,0,286
"لرستان","خرم_آباد","چگنی",29,412,6,103,80,601,2,603
"لرستان","خرم_آباد","چگنی",30,261,1,22,155,439,1,440
"لرستان","خرم_آباد","زاغه",1,587,7,35,223,852,7,859
"لرستان","خرم_آباد","زاغه",2,794,5,26,146,971,2,973
"لرستان","خرم_آباد","زاغه",3,465,1,10,76,552,0,552
"لرستان","خرم_آباد","زاغه",4,421,4,2,68,495,5,500
"لرستان","خرم_آباد","زاغه",5,561,7,14,93,675,16,691
"لرستان","خرم_آباد","زاغه",6,362,4,31,96,493,8,501
"لرستان","خرم_آباد","زاغه",7,554,3,12,75,644,1,645
"لرستان","خرم_آباد","زاغه",8,175,11,7,52,245,3,248
"لرستان","خرم_آباد","زاغه",9,575,9,5,130,719,2,721
"لرستان","خرم_آباد","زاغه",10,320,0,0,134,454,1,455
"لرستان","خرم_آباد","زاغه",11,490,1,18,125,634,3,637
"لرستان","خرم_آباد","زاغه",12,301,3,0,28,332,1,333
"لرستان","خرم_آباد","زاغه",13,399,0,22,31,452,2,454
"لرستان","خرم_آباد","زاغه",14,533,3,38,178,752,0,752
"لرستان","خرم_آباد","زاغه",15,347,7,8,69,431,3,434
"لرستان","خرم_آباد","زاغه",16,217,2,4,67,290,0,290
"لرستان","خرم_آباد","زاغه",17,230,2,0,51,283,0,283
"لرستان","خرم_آباد","زاغه",18,462,5,1,24,492,0,492
"لرستان","خرم_آباد","زاغه",19,235,2,9,59,305,0,305
"لرستان","خرم_آباد","زاغه",20,830,3,5,45,883,5,888
"لرستان","خرم_آباد","زاغه",21,521,2,12,53,588,4,592
"لرستان","خرم_آباد","زاغه",22,318,0,2,42,362,4,366
"لرستان","خرم_آباد","ویسیان",1,645,12,14,197,868,9,877
"لرستان","خرم_آباد","ویسیان",2,271,7,12,90,380,0,380
"لرستان","خرم_آباد","ویسیان",3,473,1,9,81,564,4,568
"لرستان","خرم_آباد","ویسیان",4,292,2,8,55,357,2,359
"لرستان","خرم_آباد","ویسیان",5,494,10,6,106,616,0,616
"لرستان","خرم_آباد","ویسیان",6,205,2,3,37,247,1,248
"لرستان","خرم_آباد","ویسیان",7,367,1,7,55,430,2,432
"لرستان","خرم_آباد","ویسیان",8,306,3,7,100,416,2,418
"لرستان","خرم_آباد","ویسیان",9,581,1,5,47,634,3,637
"لرستان","خرم_آباد","ویسیان",10,430,5,2,102,539,4,543
"لرستان","خرم_آباد","ویسیان",11,315,4,8,54,381,5,386
"لرستان","خرم_آباد","ویسیان",12,349,1,7,28,385,2,387
"لرستان","خرم_آباد","ویسیان",13,235,2,1,52,290,2,292
"لرستان","خرم_آباد","ویسیان",14,565,1,7,72,645,3,648
"لرستان","خرم_آباد","ویسیان",15,290,2,0,26,318,4,322
"لرستان","خرم_آباد","ویسیان",16,230,1,7,40,278,2,280
"لرستان","خرم_آباد","ویسیان",17,406,1,2,25,434,16,450
"لرستان","خرم_آباد","ویسیان",18,435,0,6,17,458,1,459
"لرستان","خرم_آباد","پاپی",1,539,15,7,147,708,3,711
"لرستان","خرم_آباد","پاپی",2,375,4,1,85,465,3,468
"لرستان","خرم_آباد","پاپی",3,545,27,27,116,715,5,720
"لرستان","خرم_آباد","پاپی",4,549,6,18,123,696,1,697
"لرستان","خرم_آباد","پاپی",5,238,0,1,30,269,0,269
"لرستان","خرم_آباد","پاپی",6,415,5,2,2,424,2,426
"لرستان","خرم_آباد","پاپی",7,164,7,1,9,181,0,181
"لرستان","خرم_آباد","پاپی",8,197,1,6,5,209,31,240
"لرستان","خرم_آباد","پاپی",9,216,57,3,19,295,1,296
"لرستان","خرم_آباد","پاپی",10,702,20,6,41,769,2,771
"لرستان","خرم_آباد","پاپی",11,172,4,0,6,182,0,182
"لرستان","خرم_آباد","پاپی",12,251,0,0,33,284,2,286
"لرستان","خرم_آباد","پاپی",13,116,1,0,20,137,1,138
"لرستان","خرم_آباد","پاپی",14,259,2,12,64,337,1,338
"لرستان","خرم_آباد","پاپی",15,314,0,2,3,319,0,319
"لرستان","خرم_آباد","پاپی",16,191,17,3,19,230,0,230
"لرستان","خرم_آباد","پاپی",17,219,5,6,3,233,0,233
"لرستان","خرم_آباد","پاپی",18,378,0,0,25,403,0,403
"لرستان","خرم_آباد","پاپی",19,347,43,0,26,416,0,416
"لرستان","خرم_آباد","پاپی",20,476,0,4,56,536,0,536
"لرستان","خرم_آباد","پاپی",21,1213,5,6,107,1331,2,1333
"لرستان","خرم_آباد","پاپی",22,339,6,0,27,372,0,372
"لرستان","خرم_آباد","پاپی",23,519,2,1,8,530,9,539
"لرستان","خرم_آباد","پاپی",24,429,0,0,30,459,41,500
"لرستان","خرم_آباد","پاپی",25,565,7,2,3,577,0,577
"لرستان","خرم_آباد","پاپی",26,412,0,3,8,423,0,423
"لرستان","خرم_آباد","پاپی",27,177,5,1,37,220,4,224
"لرستان","خرم_آباد","پاپی",28,121,11,1,15,148,0,148
"لرستان","خرم_آباد","پاپی",29,304,12,5,29,350,0,350
"لرستان","خرم_آباد","پاپی",30,280,5,7,8,300,0,300
"لرستان","خرم_آباد","پاپی",31,376,2,5,16,399,1,400
"لرستان","دلفان","مرکزی",1,1218,7,30,268,1523,4,1527
"لرستان","دلفان","مرکزی",2,741,17,139,189,1086,14,1100
"لرستان","دلفان","مرکزی",3,536,15,90,255,896,4,900
"لرستان","دلفان","مرکزی",4,644,15,44,384,1087,13,1100
"لرستان","دلفان","مرکزی",5,661,21,86,253,1021,15,1036
"لرستان","دلفان","مرکزی",6,320,8,97,417,842,3,845
"لرستان","دلفان","مرکزی",7,435,10,119,248,812,5,817
"لرستان","دلفان","مرکزی",8,808,26,240,271,1345,5,1350
"لرستان","دلفان","مرکزی",9,633,7,78,200,918,5,923
"لرستان","دلفان","مرکزی",10,961,22,49,388,1420,0,1420
"لرستان","دلفان","مرکزی",11,729,11,107,222,1069,7,1076
"لرستان","دلفان","مرکزی",12,467,12,36,193,708,1,709
"لرستان","دلفان","مرکزی",13,622,13,52,207,894,6,900
"لرستان","دلفان","مرکزی",14,584,10,152,220,966,13,979
"لرستان","دلفان","مرکزی",15,507,25,53,273,858,4,862
"لرستان","دلفان","مرکزی",16,1024,11,25,381,1441,7,1448
"لرستان","دلفان","مرکزی",17,1016,9,173,243,1441,0,1441
"لرستان","دلفان","مرکزی",18,825,14,11,195,1045,7,1052
"لرستان","دلفان","مرکزی",19,705,16,112,358,1191,6,1197
"لرستان","دلفان","مرکزی",20,716,6,140,230,1092,5,1097
"لرستان","دلفان","مرکزی",21,487,14,48,175,724,1,725
"لرستان","دلفان","مرکزی",22,600,12,62,335,1009,8,1017
"لرستان","دلفان","مرکزی",23,560,13,111,295,979,0,979
"لرستان","دلفان","مرکزی",24,930,13,82,211,1236,7,1243
"لرستان","دلفان","مرکزی",25,297,5,139,102,543,3,546
"لرستان","دلفان","مرکزی",26,435,10,57,192,694,6,700
"لرستان","دلفان","مرکزی",27,570,13,23,267,873,8,881
"لرستان","دلفان","مرکزی",28,414,16,77,242,749,5,754
"لرستان","دلفان","مرکزی",29,493,17,121,279,910,13,923
"لرستان","دلفان","مرکزی",30,650,25,41,324,1040,9,1049
"لرستان","دلفان","مرکزی",31,672,10,18,361,1061,11,1072
"لرستان","دلفان","مرکزی",32,423,7,50,231,711,2,713
"لرستان","دلفان","مرکزی",33,550,9,74,259,892,1,893
"لرستان","دلفان","مرکزی",34,594,15,143,242,994,6,1000
"لرستان","دلفان","مرکزی",35,334,18,70,343,765,7,772
"لرستان","دلفان","مرکزی",36,576,8,186,117,887,6,893
"لرستان","دلفان","مرکزی",37,876,1,31,89,997,0,997
"لرستان","دلفان","مرکزی",38,373,3,364,58,798,2,800
"لرستان","دلفان","مرکزی",39,374,0,367,59,800,0,800
"لرستان","دلفان","مرکزی",40,775,7,38,176,996,3,999
"لرستان","دلفان","مرکزی",41,494,4,106,91,695,5,700
"لرستان","دلفان","مرکزی",42,298,1,3,8,310,0,310
"لرستان","دلفان","مرکزی",43,243,4,600,36,883,2,885
"لرستان","دلفان","مرکزی",44,893,5,14,101,1013,13,1026
"لرستان","دلفان","مرکزی",45,919,3,3,59,984,4,988
"لرستان","دلفان","مرکزی",46,715,6,5,106,832,2,834
"لرستان","دلفان","مرکزی",47,661,1,215,86,963,5,968
"لرستان","دلفان","مرکزی",48,655,15,10,101,781,5,786
"لرستان","دلفان","مرکزی",49,1105,9,11,75,1200,0,1200
"لرستان","دلفان","مرکزی",50,670,2,3,58,733,0,733
"لرستان","دلفان","مرکزی",51,1138,5,88,138,1369,6,1375
"لرستان","دلفان","مرکزی",52,478,2,0,119,599,1,600
"لرستان","دلفان","مرکزی",53,722,7,32,170,931,0,931
"لرستان","دلفان","مرکزی",54,619,4,6,130,759,2,761
"لرستان","دلفان","مرکزی",55,477,3,58,50,588,0,588
"لرستان","دلفان","مرکزی",56,412,1,8,54,475,4,479
"لرستان","دلفان","مرکزی",57,837,10,6,79,932,5,937
"لرستان","دلفان","مرکزی",58,945,6,9,82,1042,4,1046
"لرستان","دلفان","مرکزی",59,1031,2,195,53,1281,4,1285
"لرستان","دلفان","مرکزی",60,724,0,3,21,748,0,748
"لرستان","دلفان","مرکزی",61,209,2,637,81,929,2,931
"لرستان","دلفان","مرکزی",62,85,0,219,19,323,0,323
"لرستان","دلفان","مرکزی",63,1862,1,5,5,1873,11,1884
"لرستان","دلفان","مرکزی",64,492,3,0,27,522,2,524
"لرستان","دلفان","مرکزی",65,900,0,124,26,1050,0,1050
"لرستان","دلفان","مرکزی",66,388,0,7,129,524,0,524
"لرستان","دلفان","مرکزی",67,1319,3,25,32,1379,2,1381
"لرستان","دلفان","مرکزی",68,394,3,5,43,445,0,445
"لرستان","دلفان","مرکزی",69,399,1,47,73,520,3,523
"لرستان","دلفان","مرکزی",70,485,0,3,12,500,0,500
"لرستان","دلفان","مرکزی",71,951,2,3,43,999,1,1000
"لرستان","دلفان","مرکزی",72,367,0,0,26,393,0,393
"لرستان","دلفان","مرکزی",73,297,0,1,1,299,0,299
"لرستان","دلفان","مرکزی",74,749,4,18,28,799,1,800
"لرستان","دلفان","مرکزی",75,395,1,2,52,450,0,450
"لرستان","دلفان","کاکاوند",1,507,10,24,227,768,0,768
"لرستان","دلفان","کاکاوند",2,368,2,1,108,479,0,479
"لرستان","دلفان","کاکاوند",3,645,0,1,74,720,2,722
"لرستان","دلفان","کاکاوند",4,614,2,1,80,697,3,700
"لرستان","دلفان","کاکاوند",5,718,26,14,134,892,3,895
"لرستان","دلفان","کاکاوند",6,224,4,0,12,240,0,240
"لرستان","دلفان","کاکاوند",7,437,1,2,10,450,0,450
"لرستان","دلفان","کاکاوند",8,466,1,5,64,536,3,539
"لرستان","دلفان","کاکاوند",9,813,3,4,57,877,0,877
"لرستان","دلفان","کاکاوند",10,256,4,19,21,300,0,300
"لرستان","دلفان","کاکاوند",11,441,3,4,52,500,0,500
"لرستان","دلفان","کاکاوند",12,471,0,3,74,548,2,550
"لرستان","دلفان","کاکاوند",13,470,0,0,0,470,0,470
"لرستان","دلفان","کاکاوند",14,342,2,0,56,400,0,400
"لرستان","دلفان","کاکاوند",15,343,0,0,6,349,1,350
"لرستان","دلفان","کاکاوند",16,148,0,1,72,221,5,226
"لرستان","دلفان","کاکاوند",17,324,0,3,56,383,0,383
"لرستان","دلفان","کاکاوند",18,628,0,0,13,641,0,641
"لرستان","دلفان","کاکاوند",19,396,1,0,3,400,0,400
"لرستان","دلفان","کاکاوند",20,391,1,4,4,400,0,400
"لرستان","دلفان","کاکاوند",21,1226,0,3,21,1250,0,1250
"لرستان","دلفان","کاکاوند",22,446,3,1,30,480,1,481
"لرستان","دلفان","کاکاوند",23,853,0,4,43,900,0,900
"لرستان","دلفان","کاکاوند",24,786,1,11,51,849,1,850
"لرستان","دلفان","کاکاوند",25,278,0,2,46,326,2,328
"لرستان","دلفان","کاکاوند",26,227,1,1,21,250,0,250
"لرستان","دلفان","کاکاوند",27,199,0,2,18,219,0,219
"لرستان","دلفان","کاکاوند",28,366,0,0,14,380,0,380
"لرستان","دلفان","کاکاوند",29,328,3,1,82,414,1,415
"لرستان","دلفان","کاکاوند",30,647,0,1,40,688,0,688
"لرستان","دورود","مرکزی",1,728,30,18,359,1135,8,1143
"لرستان","دورود","مرکزی",2,600,11,19,186,816,7,823
"لرستان","دورود","مرکزی",3,721,15,31,304,1071,10,1081
"لرستان","دورود","مرکزی",4,799,27,47,426,1299,23,1322
"لرستان","دورود","مرکزی",5,327,23,41,317,708,5,713
"لرستان","دورود","مرکزی",6,407,18,81,439,945,15,960
"لرستان","دورود","مرکزی",7,428,12,16,135,591,5,596
"لرستان","دورود","مرکزی",8,475,4,23,88,590,7,597
"لرستان","دورود","مرکزی",9,664,3,10,62,739,3,742
"لرستان","دورود","مرکزی",10,918,14,40,184,1156,8,1164
"لرستان","دورود","مرکزی",11,485,16,51,243,795,10,805
"لرستان","دورود","مرکزی",12,325,5,27,175,532,6,538
"لرستان","دورود","مرکزی",13,419,18,13,152,602,10,612
"لرستان","دورود","مرکزی",14,209,6,6,72,293,1,294
"لرستان","دورود","مرکزی",15,647,8,87,465,1207,14,1221
"لرستان","دورود","مرکزی",16,386,25,24,183,618,9,627
"لرستان","دورود","مرکزی",17,184,7,17,124,332,7,339
"لرستان","دورود","مرکزی",18,771,19,44,267,1101,7,1108
"لرستان","دورود","مرکزی",19,690,22,24,355,1091,11,1102
"لرستان","دورود","مرکزی",20,361,11,27,259,658,9,667
"لرستان","دورود","مرکزی",21,438,13,22,267,740,4,744
"لرستان","دورود","مرکزی",22,733,2,14,235,984,4,988
"لرستان","دورود","مرکزی",23,601,17,36,304,958,9,967
"لرستان","دورود","مرکزی",24,642,15,16,70,743,0,743
"لرستان","دورود","مرکزی",25,1061,38,32,150,1281,20,1301
"لرستان","دورود","مرکزی",26,337,11,9,52,409,1,410
"لرستان","دورود","مرکزی",27,559,12,13,44,628,3,631
"لرستان","دورود","مرکزی",28,241,12,7,55,315,5,320
"لرستان","دورود","مرکزی",29,1048,40,16,62,1166,2,1168
"لرستان","دورود","مرکزی",30,435,8,18,150,611,6,617
"لرستان","دورود","مرکزی",31,541,25,46,440,1052,12,1064
"لرستان","دورود","مرکزی",32,590,24,43,409,1066,10,1076
"لرستان","دورود","مرکزی",33,639,33,66,625,1363,19,1382
"لرستان","دورود","مرکزی",34,625,21,62,374,1082,18,1100
"لرستان","دورود","مرکزی",35,791,27,39,357,1214,12,1226
"لرستان","دورود","مرکزی",36,815,36,35,199,1085,9,1094
"لرستان","دورود","مرکزی",37,805,25,31,518,1379,18,1397
"لرستان","دورود","مرکزی",38,779,46,41,425,1291,6,1297
"لرستان","دورود","مرکزی",39,789,47,35,449,1320,18,1338
"لرستان","دورود","مرکزی",40,691,29,37,438,1195,12,1207
"لرستان","دورود","مرکزی",41,391,15,23,306,735,4,739
"لرستان","دورود","مرکزی",42,646,25,21,261,953,4,957
"لرستان","دورود","مرکزی",43,798,46,30,583,1457,14,1471
"لرستان","دورود","مرکزی",44,1006,34,46,574,1660,22,1682
"لرستان","دورود","مرکزی",45,487,29,24,388,928,10,938
"لرستان","دورود","مرکزی",46,435,43,31,385,894,6,900
"لرستان","دورود","مرکزی",47,803,35,15,282,1135,11,1146
"لرستان","دورود","مرکزی",48,998,33,16,202,1249,13,1262
"لرستان","دورود","مرکزی",49,862,28,5,75,970,4,974
"لرستان","دورود","مرکزی",50,722,57,7,169,955,9,964
"لرستان","دورود","مرکزی",51,616,62,12,102,792,8,800
"لرستان","دورود","مرکزی",52,505,8,31,183,727,3,730
"لرستان","دورود","مرکزی",53,731,19,9,248,1007,8,1015
"لرستان","دورود","مرکزی",54,645,4,28,135,812,6,818
"لرستان","دورود","مرکزی",55,733,13,30,138,914,5,919
"لرستان","دورود","مرکزی",56,670,3,27,120,820,5,825
"لرستان","دورود","مرکزی",57,550,11,25,190,776,8,784
"لرستان","دورود","مرکزی",58,661,16,55,446,1178,15,1193
"لرستان","دورود","مرکزی",59,250,6,15,191,462,4,466
"لرستان","دورود","مرکزی",60,450,7,10,207,674,7,681
"لرستان","دورود","مرکزی",61,698,7,20,228,953,7,960
"لرستان","دورود","مرکزی",62,503,19,18,337,877,11,888
"لرستان","دورود","مرکزی",63,43,2,3,40,88,0,88
"لرستان","دورود","مرکزی",64,364,34,19,267,684,3,687
"لرستان","دورود","مرکزی",65,607,21,35,390,1053,7,1060
"لرستان","دورود","مرکزی",66,1166,31,17,147,1361,22,1383
"لرستان","دورود","مرکزی",67,1055,13,8,68,1144,1,1145
"لرستان","دورود","مرکزی",68,581,5,16,115,717,8,725
"لرستان","دورود","مرکزی",69,815,11,7,71,904,11,915
"لرستان","دورود","مرکزی",70,893,12,3,85,993,7,1000
"لرستان","دورود","مرکزی",71,408,2,5,27,442,1,443
"لرستان","دورود","مرکزی",72,491,12,12,78,593,2,595
"لرستان","دورود","مرکزی",73,558,11,3,58,630,0,630
"لرستان","دورود","مرکزی",74,836,7,13,89,945,6,951
"لرستان","دورود","مرکزی",75,823,6,7,73,909,4,913
"لرستان","دورود","مرکزی",76,410,1,3,72,486,2,488
"لرستان","دورود","مرکزی",77,981,4,16,98,1099,5,1104
"لرستان","دورود","مرکزی",78,511,7,14,115,647,2,649
"لرستان","دورود","مرکزی",79,752,4,7,116,879,5,884
"لرستان","دورود","مرکزی",80,685,20,28,36,769,5,774
"لرستان","دورود","مرکزی",81,438,22,2,24,486,0,486
"لرستان","دورود","مرکزی",82,803,6,17,60,886,3,889
"لرستان","دورود","مرکزی",83,440,2,3,23,468,2,470
"لرستان","دورود","مرکزی",84,117,0,11,8,136,0,136
"لرستان","دورود","مرکزی",85,658,7,2,30,697,2,699
"لرستان","دورود","مرکزی",86,180,1,0,5,186,3,189
"لرستان","دورود","مرکزی",87,878,23,9,58,968,3,971
"لرستان","دورود","مرکزی",88,807,15,21,99,942,9,951
"لرستان","دورود","مرکزی",89,692,19,36,107,854,7,861
"لرستان","دورود","مرکزی",90,688,6,23,54,771,2,773
"لرستان","دورود","مرکزی",91,387,2,2,27,418,3,421
"لرستان","دورود","مرکزی",92,1003,10,13,138,1164,11,1175
"لرستان","دورود","مرکزی",93,661,6,9,53,729,4,733
"لرستان","دورود","مرکزی",94,593,22,6,75,696,4,700
"لرستان","دورود","مرکزی",95,298,1,1,14,314,1,315
"لرستان","دورود","مرکزی",96,118,2,2,17,139,2,141
"لرستان","دورود","مرکزی",97,472,1,5,28,506,2,508
"لرستان","دورود","سیلاخور",1,334,1,7,84,426,8,434
"لرستان","دورود","سیلاخور",2,368,5,7,144,524,7,531
"لرستان","دورود","سیلاخور",3,652,7,10,99,768,0,768
"لرستان","دورود","سیلاخور",4,226,1,7,23,257,1,258
"لرستان","دورود","سیلاخور",5,574,3,2,48,627,0,627
"لرستان","دورود","سیلاخور",6,493,3,0,20,516,1,517
"لرستان","دورود","سیلاخور",7,693,3,10,133,839,1,840
"لرستان","دورود","سیلاخور",8,410,2,5,61,478,4,482
"لرستان","دورود","سیلاخور",9,781,4,9,38,832,0,832
"لرستان","دورود","سیلاخور",10,445,2,3,38,488,0,488
"لرستان","دورود","سیلاخور",11,314,1,2,135,452,2,454
"لرستان","دورود","سیلاخور",12,734,2,0,29,765,6,771
"لرستان","دورود","سیلاخور",13,538,4,4,29,575,4,579
"لرستان","دورود","سیلاخور",14,868,2,7,62,939,2,941
"لرستان","سلسله","سلسله",1,619,9,10,307,945,2,947
"لرستان","سلسله","سلسله",2,453,12,3,128,596,2,598
"لرستان","سلسله","سلسله",3,617,15,7,176,815,6,821
"لرستان","سلسله","سلسله",4,392,8,5,241,646,2,648
"لرستان","سلسله","سلسله",5,352,6,1,171,530,6,536
"لرستان","سلسله","سلسله",6,452,8,3,222,685,14,699
"لرستان","سلسله","سلسله",7,608,10,8,263,889,9,898
"لرستان","سلسله","سلسله",8,676,9,5,151,841,9,850
"لرستان","سلسله","سلسله",9,475,6,4,111,596,4,600
"لرستان","سلسله","سلسله",10,536,12,7,136,691,9,700
"لرستان","سلسله","سلسله",11,889,1,15,85,990,0,990
"لرستان","سلسله","سلسله",12,626,6,1,159,792,8,800
"لرستان","سلسله","سلسله",13,593,5,3,139,740,10,750
"لرستان","سلسله","سلسله",14,511,14,1,166,692,8,700
"لرستان","سلسله","سلسله",15,625,16,4,150,795,4,799
"لرستان","سلسله","سلسله",16,416,9,11,248,684,15,699
"لرستان","سلسله","سلسله",17,348,8,18,224,598,2,600
"لرستان","سلسله","سلسله",18,469,14,11,290,784,12,796
"لرستان","سلسله","سلسله",19,184,1,1,56,242,0,242
"لرستان","سلسله","سلسله",20,565,11,5,116,697,3,700
"لرستان","سلسله","سلسله",21,516,12,5,164,697,3,700
"لرستان","سلسله","سلسله",22,701,18,14,259,992,0,992
"لرستان","سلسله","سلسله",23,531,10,12,240,793,7,800
"لرستان","سلسله","سلسله",24,837,15,12,208,1072,10,1082
"لرستان","سلسله","سلسله",25,649,8,5,187,849,1,850
"لرستان","سلسله","سلسله",26,481,4,11,150,646,4,650
"لرستان","سلسله","سلسله",27,504,0,13,125,642,0,642
"لرستان","سلسله","سلسله",28,832,0,0,15,847,3,850
"لرستان","سلسله","سلسله",29,424,2,4,17,447,2,449
"لرستان","سلسله","سلسله",30,498,0,0,0,498,2,500
"لرستان","سلسله","سلسله",31,428,0,0,18,446,3,449
"لرستان","سلسله","سلسله",32,353,3,2,34,392,3,395
"لرستان","سلسله","سلسله",33,237,2,1,10,250,0,250
"لرستان","سلسله","سلسله",34,457,5,1,61,524,3,527
"لرستان","سلسله","سلسله",35,418,10,2,64,494,4,498
"لرستان","سلسله","سلسله",36,513,1,3,76,593,5,598
"لرستان","سلسله","سلسله",37,385,7,2,153,547,3,550
"لرستان","سلسله","سلسله",38,467,4,2,79,552,2,554
"لرستان","سلسله","سلسله",39,377,3,3,47,430,5,435
"لرستان","سلسله","سلسله",40,680,2,0,67,749,1,750
"لرستان","سلسله","سلسله",41,668,5,3,74,750,0,750
"لرستان","سلسله","سلسله",42,424,3,0,99,526,3,529
"لرستان","سلسله","سلسله",43,1076,0,0,24,1100,0,1100
"لرستان","سلسله","سلسله",44,559,3,0,134,696,4,700
"لرستان","سلسله","سلسله",45,387,1,2,66,456,0,456
"لرستان","سلسله","سلسله",46,728,16,6,100,850,0,850
"لرستان","سلسله","سلسله",47,750,1,6,43,800,0,800
"لرستان","سلسله","سلسله",48,685,7,0,108,800,0,800
"لرستان","سلسله","سلسله",49,310,2,3,99,414,2,416
"لرستان","سلسله","سلسله",50,578,3,9,108,698,2,700
"لرستان","سلسله","سلسله",51,980,5,3,111,1099,1,1100
"لرستان","سلسله","سلسله",52,577,5,2,164,748,0,748
"لرستان","سلسله","سلسله",53,732,0,5,86,823,0,823
"لرستان","سلسله","سلسله",54,676,0,1,72,749,1,750
"لرستان","سلسله","سلسله",55,489,4,1,69,563,9,572
"لرستان","سلسله","سلسله",56,713,6,0,81,800,0,800
"لرستان","سلسله","سلسله",57,349,0,6,29,384,5,389
"لرستان","سلسله","فیروزآباد",1,620,8,4,67,699,0,699
"لرستان","سلسله","فیروزآباد",2,464,11,1,77,553,3,556
"لرستان","سلسله","فیروزآباد",3,655,7,2,124,788,10,798
"لرستان","سلسله","فیروزآباد",4,342,0,0,7,349,0,349
"لرستان","سلسله","فیروزآباد",5,399,0,0,1,400,0,400
"لرستان","سلسله","فیروزآباد",6,345,1,2,51,399,1,400
"لرستان","سلسله","فیروزآباد",7,533,0,2,15,550,0,550
"لرستان","سلسله","فیروزآباد",8,478,1,2,68,549,0,549
"لرستان","سلسله","فیروزآباد",9,533,0,0,21,554,0,554
"لرستان","سلسله","فیروزآباد",10,863,0,8,22,893,3,896
"لرستان","سلسله","فیروزآباد",11,558,1,4,21,584,0,584
"لرستان","سلسله","فیروزآباد",12,582,2,0,13,597,0,597
"لرستان","سلسله","فیروزآباد",13,596,4,0,106,706,1,707
"لرستان","سلسله","فیروزآباد",14,392,4,9,115,520,2,522
"لرستان","سلسله","فیروزآباد",15,619,1,16,61,697,2,699
"لرستان","سلسله","فیروزآباد",16,385,3,2,56,446,1,447
"لرستان","سلسله","فیروزآباد",17,453,0,2,55,510,2,512
"لرستان","سلسله","فیروزآباد",18,432,2,5,74,513,0,513
"لرستان","سلسله","فیروزآباد",19,375,1,4,31,411,0,411
"لرستان","سلسله","فیروزآباد",20,497,8,2,51,558,1,559
"لرستان","کوهدشت","مرکزی",1,510,15,49,414,988,10,998
"لرستان","کوهدشت","مرکزی",2,532,26,74,357,989,11,1000
"لرستان","کوهدشت","مرکزی",3,521,17,68,286,892,6,898
"لرستان","کوهدشت","مرکزی",4,221,8,29,176,434,36,470
"لرستان","کوهدشت","مرکزی",5,431,25,41,269,766,25,791
"لرستان","کوهدشت","مرکزی",6,840,23,25,209,1097,3,1100
"لرستان","کوهدشت","مرکزی",7,437,8,39,206,690,0,690
"لرستان","کوهدشت","مرکزی",8,734,20,53,186,993,6,999
"لرستان","کوهدشت","مرکزی",9,716,12,32,284,1044,6,1050
"لرستان","کوهدشت","مرکزی",10,348,19,43,365,775,14,789
"لرستان","کوهدشت","مرکزی",11,317,15,107,450,889,51,940
"لرستان","کوهدشت","مرکزی",12,308,15,95,270,688,12,700
"لرستان","کوهدشت","مرکزی",13,354,12,73,348,787,11,798
"لرستان","کوهدشت","مرکزی",14,554,16,25,381,976,9,985
"لرستان","کوهدشت","مرکزی",15,640,14,70,272,996,4,1000
"لرستان","کوهدشت","مرکزی",16,544,8,162,144,858,9,867
"لرستان","کوهدشت","مرکزی",17,268,11,60,193,532,2,534
"لرستان","کوهدشت","مرکزی",18,573,16,42,355,986,11,997
"لرستان","کوهدشت","مرکزی",19,332,17,73,306,728,10,738
"لرستان","کوهدشت","مرکزی",20,425,19,118,329,891,9,900
"لرستان","کوهدشت","مرکزی",21,591,11,56,137,795,5,800
"لرستان","کوهدشت","مرکزی",22,508,8,73,307,896,4,900
"لرستان","کوهدشت","مرکزی",23,746,8,59,182,995,0,995
"لرستان","کوهدشت","مرکزی",24,536,15,194,309,1054,46,1100
"لرستان","کوهدشت","مرکزی",25,387,15,82,391,875,19,894
"لرستان","کوهدشت","مرکزی",26,291,11,123,272,697,3,700
"لرستان","کوهدشت","مرکزی",27,404,26,63,477,970,28,998
"لرستان","کوهدشت","مرکزی",28,508,17,55,307,887,11,898
"لرستان","کوهدشت","مرکزی",29,842,9,45,204,1100,0,1100
"لرستان","کوهدشت","مرکزی",30,491,18,56,328,893,7,900
"لرستان","کوهدشت","مرکزی",31,172,24,13,237,446,4,450
"لرستان","کوهدشت","مرکزی",32,344,14,50,337,745,5,750
"لرستان","کوهدشت","مرکزی",33,557,4,27,301,889,0,889
"لرستان","کوهدشت","مرکزی",34,325,12,106,292,735,0,735
"لرستان","کوهدشت","مرکزی",35,307,5,76,404,792,0,792
"لرستان","کوهدشت","مرکزی",36,321,23,77,363,784,16,800
"لرستان","کوهدشت","مرکزی",37,352,16,147,310,825,0,825
"لرستان","کوهدشت","مرکزی",38,316,16,29,201,562,4,566
"لرستان","کوهدشت","مرکزی",39,435,5,69,327,836,7,843
"لرستان","کوهدشت","مرکزی",40,408,11,46,426,891,6,897
"لرستان","کوهدشت","مرکزی",41,299,7,112,271,689,11,700
"لرستان","کوهدشت","مرکزی",42,534,15,32,315,896,4,900
"لرستان","کوهدشت","مرکزی",43,711,14,38,237,1000,0,1000
"لرستان","کوهدشت","مرکزی",44,739,12,40,209,1000,0,1000
"لرستان","کوهدشت","مرکزی",45,531,12,51,393,987,3,990
"لرستان","کوهدشت","مرکزی",46,477,6,139,176,798,2,800
"لرستان","کوهدشت","مرکزی",47,219,18,54,206,497,5,502
"لرستان","کوهدشت","مرکزی",48,264,7,45,302,618,11,629
"لرستان","کوهدشت","مرکزی",49,386,19,75,302,782,15,797
"لرستان","کوهدشت","مرکزی",50,232,13,59,341,645,7,652
"لرستان","کوهدشت","مرکزی",51,630,13,46,300,989,11,1000
"لرستان","کوهدشت","مرکزی",52,318,9,30,267,624,6,630
"لرستان","کوهدشت","مرکزی",53,506,20,71,302,899,1,900
"لرستان","کوهدشت","مرکزی",54,290,16,119,467,892,8,900
"لرستان","کوهدشت","مرکزی",55,313,6,47,132,498,2,500
"لرستان","کوهدشت","مرکزی",56,608,25,50,190,873,0,873
"لرستان","کوهدشت","مرکزی",57,569,0,1,30,600,0,600
"لرستان","کوهدشت","مرکزی",58,579,1,0,70,650,0,650
"لرستان","کوهدشت","مرکزی",59,396,1,4,61,462,0,462
"لرستان","کوهدشت","مرکزی",60,251,6,20,78,355,7,362
"لرستان","کوهدشت","مرکزی",61,1038,4,3,51,1096,0,1096
"لرستان","کوهدشت","مرکزی",62,161,0,1,26,188,0,188
"لرستان","کوهدشت","مرکزی",63,187,2,35,90,314,8,322
"لرستان","کوهدشت","مرکزی",64,389,8,39,175,611,0,611
"لرستان","کوهدشت","مرکزی",65,496,10,77,310,893,7,900
"لرستان","کوهدشت","مرکزی",66,268,3,143,73,487,2,489
"لرستان","کوهدشت","مرکزی",67,403,7,223,27,660,0,660
"لرستان","کوهدشت","مرکزی",68,601,17,33,249,900,0,900
"لرستان","کوهدشت","مرکزی",69,454,20,26,130,630,0,630
"لرستان","کوهدشت","مرکزی",70,553,13,136,210,912,3,915
"لرستان","کوهدشت","مرکزی",71,437,2,5,57,501,1,502
"لرستان","کوهدشت","مرکزی",72,818,2,4,76,900,0,900
"لرستان","کوهدشت","مرکزی",73,305,3,100,70,478,0,478
"لرستان","کوهدشت","مرکزی",74,281,5,41,191,518,2,520
"لرستان","کوهدشت","مرکزی",75,187,4,18,211,420,5,425
"لرستان","کوهدشت","مرکزی",76,576,4,57,126,763,0,763
"لرستان","کوهدشت","مرکزی",77,350,15,77,178,620,11,631
"لرستان","کوهدشت","مرکزی",78,480,11,100,260,851,3,854
"لرستان","کوهدشت","مرکزی",79,414,10,15,155,594,1,595
"لرستان","کوهدشت","مرکزی",80,596,14,16,290,916,13,929
"لرستان","کوهدشت","مرکزی",81,453,5,76,245,779,9,788
"لرستان","کوهدشت","مرکزی",82,165,0,13,83,261,0,261
"لرستان","کوهدشت","مرکزی",83,429,8,24,213,674,0,674
"لرستان","کوهدشت","مرکزی",84,135,3,13,84,235,0,235
"لرستان","کوهدشت","مرکزی",85,570,6,75,128,779,0,779
"لرستان","کوهدشت","مرکزی",86,223,4,15,91,333,0,333
"لرستان","کوهدشت","کونانی",1,465,11,69,98,643,4,647
"لرستان","کوهدشت","کونانی",2,245,6,11,151,413,3,416
"لرستان","کوهدشت","کونانی",3,218,2,19,79,318,0,318
"لرستان","کوهدشت","کونانی",4,297,4,15,68,384,2,386
"لرستان","کوهدشت","کونانی",5,171,1,14,55,241,5,246
"لرستان","کوهدشت","کونانی",6,206,3,21,89,319,4,323
"لرستان","کوهدشت","کونانی",7,385,0,11,31,427,5,432
"لرستان","کوهدشت","کونانی",8,443,4,18,153,618,5,623
"لرستان","کوهدشت","کونانی",9,317,1,7,261,586,0,586
"لرستان","کوهدشت","کونانی",10,376,4,22,180,582,2,584
"لرستان","کوهدشت","کونانی",11,646,11,1,37,695,4,699
"لرستان","کوهدشت","کونانی",12,479,3,5,111,598,2,600
"لرستان","کوهدشت","کونانی",13,335,3,17,42,397,2,399
"لرستان","کوهدشت","کونانی",14,458,15,135,316,924,7,931
"لرستان","کوهدشت","کونانی",15,332,12,53,272,669,5,674
"لرستان","کوهدشت","کونانی",16,226,8,26,160,420,2,422
"لرستان","کوهدشت","کونانی",17,400,10,64,172,646,4,650
"لرستان","کوهدشت","کونانی",18,185,2,40,73,300,0,300
"لرستان","کوهدشت","کونانی",19,360,2,39,99,500,0,500
"لرستان","کوهدشت","کونانی",20,218,1,79,49,347,0,347
"لرستان","کوهدشت","طرهان",1,403,7,22,95,527,0,527
"لرستان","کوهدشت","طرهان",2,279,1,77,140,497,3,500
"لرستان","کوهدشت","طرهان",3,251,6,70,223,550,0,550
"لرستان","کوهدشت","طرهان",4,323,0,19,48,390,18,408
"لرستان","کوهدشت","طرهان",5,434,5,123,160,722,5,727
"لرستان","کوهدشت","طرهان",6,283,1,5,110,399,0,399
"لرستان","کوهدشت","طرهان",7,304,4,13,168,489,3,492
"لرستان","کوهدشت","طرهان",8,425,3,5,158,591,5,596
"لرستان","کوهدشت","طرهان",9,544,11,28,78,661,9,670
"لرستان","کوهدشت","طرهان",10,525,4,22,49,600,0,600
"لرستان","کوهدشت","طرهان",11,216,12,42,142,412,3,415
"لرستان","کوهدشت","طرهان",12,304,5,45,188,542,4,546
"لرستان","کوهدشت","طرهان",13,482,2,14,48,546,5,551
"لرستان","کوهدشت","طرهان",14,353,7,28,165,553,0,553
"لرستان","کوهدشت","طرهان",15,237,2,10,133,382,0,382
"لرستان","کوهدشت","طرهان",16,377,6,42,163,588,0,588
"لرستان","کوهدشت","طرهان",17,597,0,15,38,650,0,650
"لرستان","کوهدشت","طرهان",18,796,1,24,65,886,0,886
"لرستان","کوهدشت","طرهان",19,241,1,21,37,300,0,300
"لرستان","کوهدشت","رومشگان",1,365,12,21,149,547,2,549
"لرستان","کوهدشت","رومشگان",2,351,11,18,216,596,4,600
"لرستان","کوهدشت","رومشگان",3,392,18,9,78,497,3,500
"لرستان","کوهدشت","رومشگان",4,246,11,27,209,493,7,500
"لرستان","کوهدشت","رومشگان",5,343,8,11,138,500,0,500
"لرستان","کوهدشت","رومشگان",6,588,4,3,57,652,0,652
"لرستان","کوهدشت","رومشگان",7,398,2,0,100,500,0,500
"لرستان","کوهدشت","رومشگان",8,621,0,3,76,700,0,700
"لرستان","کوهدشت","رومشگان",9,654,3,7,136,800,0,800
"لرستان","کوهدشت","رومشگان",10,706,1,0,93,800,0,800
"لرستان","کوهدشت","رومشگان",11,765,2,1,131,899,1,900
"لرستان","کوهدشت","رومشگان",12,492,3,1,146,642,8,650
"لرستان","کوهدشت","رومشگان",13,331,6,6,147,490,4,494
"لرستان","کوهدشت","رومشگان",14,500,1,14,141,656,1,657
"لرستان","کوهدشت","رومشگان",15,337,2,65,96,500,0,500
"لرستان","کوهدشت","رومشگان",16,410,1,2,36,449,1,450
"لرستان","کوهدشت","رومشگان",17,358,3,1,37,399,1,400
"لرستان","کوهدشت","رومشگان",18,365,2,10,68,445,10,455
"لرستان","کوهدشت","رومشگان",19,457,1,0,9,467,0,467
"لرستان","کوهدشت","رومشگان",20,669,1,9,40,719,0,719
"لرستان","کوهدشت","رومشگان",21,295,4,19,96,414,0,414
"لرستان","کوهدشت","رومشگان",22,553,2,2,143,700,0,700
"لرستان","کوهدشت","رومشگان",23,436,11,15,133,595,3,598
"لرستان","کوهدشت","رومشگان",24,545,3,24,126,698,2,700
"لرستان","کوهدشت","رومشگان",25,492,0,16,92,600,0,600
"لرستان","کوهدشت","رومشگان",26,456,1,28,106,591,6,597
"لرستان","کوهدشت","رومشگان",27,317,11,43,116,487,2,489
"لرستان","کوهدشت","رومشگان",28,479,10,41,162,692,8,700
"لرستان","کوهدشت","رومشگان",29,632,6,35,123,796,2,798
"لرستان","کوهدشت","رومشگان",30,486,9,8,286,789,2,791
"لرستان","کوهدشت","رومشگان",31,326,2,14,52,394,6,400
"لرستان","کوهدشت","رومشگان",32,591,4,29,106,730,0,730
"لرستان","کوهدشت","رومشگان",33,620,2,22,106,750,0,750
"لرستان","کوهدشت","رومشگان",34,231,6,17,46,300,0,300
"لرستان","کوهدشت","رومشگان",35,175,4,45,113,337,1,338
"لرستان","کوهدشت","درب_گنبد",1,616,5,5,147,773,7,780
"لرستان","کوهدشت","درب_گنبد",2,626,1,4,66,697,3,700
"لرستان","کوهدشت","درب_گنبد",3,189,2,0,9,200,0,200
"لرستان","کوهدشت","درب_گنبد",4,558,12,4,268,842,0,842
"لرستان","کوهدشت","درب_گنبد",5,443,2,22,127,594,5,599
"لرستان","کوهدشت","درب_گنبد",6,245,1,4,95,345,1,346
"لرستان","کوهدشت","درب_گنبد",7,270,2,0,31,303,147,450
"لرستان","کوهدشت","درب_گنبد",8,360,1,4,33,398,202,600
"لرستان","کوهدشت","درب_گنبد",9,293,0,3,35,331,0,331
"لرستان","کوهدشت","درب_گنبد",10,201,2,2,104,309,2,311
"لرستان","کوهدشت","درب_گنبد",11,249,1,101,70,421,48,469
"لرستان","کوهدشت","درب_گنبد",12,104,0,188,28,320,5,325
"لرستان","کوهدشت","درب_گنبد",13,226,2,18,52,298,25,323
"لرستان","کوهدشت","درب_گنبد",14,560,2,4,28,594,0,594
"لرستان","کوهدشت","درب_گنبد",15,415,4,19,18,456,0,456
"لرستان","کوهدشت","درب_گنبد",16,729,2,28,87,846,4,850
"مازندران","آمل","مرکزی",1,417,21,17,841,1296,16,1312
"مازندران","آمل","مرکزی",2,416,9,2,306,733,7,740
"مازندران","آمل","مرکزی",3,308,16,1,464,789,8,797
"مازندران","آمل","مرکزی",4,622,22,11,525,1180,15,1195
"مازندران","آمل","مرکزی",5,223,4,1,93,321,4,325
"مازندران","آمل","مرکزی",6,286,10,1,151,448,3,451
"مازندران","آمل","مرکزی",7,430,24,30,1181,1665,12,1677
"مازندران","آمل","مرکزی",8,303,19,8,972,1302,16,1318
"مازندران","آمل","مرکزی",9,329,9,5,207,550,11,561
"مازندران","آمل","مرکزی",10,384,6,3,460,853,3,856
"مازندران","آمل","مرکزی",11,534,27,4,684,1249,10,1259
"مازندران","آمل","مرکزی",12,590,9,1,224,824,3,827
"مازندران","آمل","مرکزی",13,608,8,4,313,933,12,945
"مازندران","آمل","مرکزی",14,654,12,9,515,1190,5,1195
"مازندران","آمل","مرکزی",15,438,21,17,832,1308,7,1315
"مازندران","آمل","مرکزی",16,192,16,11,777,996,6,1002
"مازندران","آمل","مرکزی",17,453,20,7,674,1154,17,1171
"مازندران","آمل","مرکزی",18,180,10,6,504,700,9,709
"مازندران","آمل","مرکزی",19,468,26,19,1001,1514,17,1531
"مازندران","آمل","مرکزی",20,377,19,12,784,1192,12,1204
"مازندران","آمل","مرکزی",21,716,22,2,548,1288,17,1305
"مازندران","آمل","مرکزی",22,236,9,5,350,600,4,604
"مازندران","آمل","مرکزی",23,219,6,3,266,494,8,502
"مازندران","آمل","مرکزی",24,368,15,8,620,1011,9,1020
"مازندران","آمل","مرکزی",25,268,12,5,501,786,21,807
"مازندران","آمل","مرکزی",26,402,10,5,392,809,15,824
"مازندران","آمل","مرکزی",27,359,8,11,499,877,16,893
"مازندران","آمل","مرکزی",28,531,14,9,339,893,10,903
"مازندران","آمل","مرکزی",29,893,24,19,1257,2193,32,2225
"مازندران","آمل","مرکزی",30,141,4,6,207,358,3,361
"مازندران","آمل","مرکزی",31,519,17,21,1128,1685,13,1698
"مازندران","آمل","مرکزی",32,414,13,5,281,713,17,730
"مازندران","آمل","مرکزی",33,513,26,8,815,1362,12,1374
"مازندران","آمل","مرکزی",34,491,17,3,745,1256,5,1261
"مازندران","آمل","مرکزی",35,533,15,4,478,1030,14,1044
"مازندران","آمل","مرکزی",36,828,15,6,467,1316,16,1332
"مازندران","آمل","مرکزی",37,1033,23,3,580,1639,16,1655
"مازندران","آمل","مرکزی",38,978,17,7,442,1444,14,1458
"مازندران","آمل","مرکزی",39,974,8,3,629,1614,13,1627
"مازندران","آمل","مرکزی",40,652,15,3,257,927,13,940
"مازندران","آمل","مرکزی",41,730,19,6,411,1166,8,1174
"مازندران","آمل","مرکزی",42,814,5,5,334,1158,11,1169
"مازندران","آمل","مرکزی",43,555,7,1,83,646,4,650
"مازندران","آمل","مرکزی",44,1329,12,0,199,1540,10,1550
"مازندران","آمل","مرکزی",45,727,5,5,238,975,12,987
"مازندران","آمل","مرکزی",46,576,4,4,142,726,4,730
"مازندران","آمل","مرکزی",47,609,2,3,134,748,4,752
"مازندران","آمل","مرکزی",48,533,6,2,272,813,7,820
"مازندران","آمل","مرکزی",49,1158,9,3,235,1405,11,1416
"مازندران","آمل","مرکزی",50,549,7,4,208,768,2,770
"مازندران","آمل","مرکزی",51,721,7,2,160,890,5,895
"مازندران","آمل","مرکزی",52,234,4,1,106,345,4,349
"مازندران","آمل","مرکزی",53,378,7,0,180,565,7,572
"مازندران","آمل","مرکزی",54,514,17,13,697,1241,10,1251
"مازندران","آمل","مرکزی",55,493,10,4,451,958,6,964
"مازندران","آمل","مرکزی",56,682,13,6,430,1131,14,1145
"مازندران","آمل","مرکزی",57,1073,13,10,584,1680,18,1698
"مازندران","آمل","مرکزی",58,336,9,0,208,553,7,560
"مازندران","آمل","مرکزی",59,861,5,1,223,1090,1,1091
"مازندران","آمل","مرکزی",60,476,1,0,225,702,5,707
"مازندران","آمل","مرکزی",61,540,6,1,161,708,6,714
"مازندران","آمل","مرکزی",62,277,6,1,114,398,3,401
"مازندران","آمل","مرکزی",63,761,22,3,432,1218,2,1220
"مازندران","آمل","مرکزی",64,768,31,4,647,1450,12,1462
"مازندران","آمل","مرکزی",65,364,5,2,276,647,5,652
"مازندران","آمل","مرکزی",66,417,11,3,382,813,11,824
"مازندران","آمل","مرکزی",67,827,20,10,543,1400,16,1416
"مازندران","آمل","مرکزی",68,807,26,6,576,1415,11,1426
"مازندران","آمل","مرکزی",69,781,10,14,299,1104,9,1113
"مازندران","آمل","مرکزی",70,807,4,9,242,1062,14,1076
"مازندران","آمل","مرکزی",71,934,7,0,175,1116,6,1122
"مازندران","آمل","مرکزی",72,828,6,3,192,1029,5,1034
"مازندران","آمل","مرکزی",73,511,10,9,559,1089,18,1107
"مازندران","آمل","مرکزی",74,145,8,7,248,408,4,412
"مازندران","آمل","مرکزی",75,804,18,5,399,1226,15,1241
"مازندران","آمل","مرکزی",76,322,13,0,233,568,8,576
"مازندران","آمل","مرکزی",77,667,8,3,278,956,10,966
"مازندران","آمل","مرکزی",78,297,109,1,5,412,9,421
"مازندران","آمل","مرکزی",79,405,8,1,162,576,8,584
"مازندران","آمل","مرکزی",80,314,6,2,112,434,1,435
"مازندران","آمل","مرکزی",81,941,17,3,287,1248,5,1253
"مازندران","آمل","مرکزی",82,480,13,2,192,687,5,692
"مازندران","آمل","مرکزی",83,779,12,1,280,1072,11,1083
"مازندران","آمل","مرکزی",84,842,6,1,223,1072,6,1078
"مازندران","آمل","مرکزی",85,240,4,4,196,444,5,449
"مازندران","آمل","مرکزی",86,512,9,3,316,840,6,846
"مازندران","آمل","مرکزی",87,740,15,1,555,1311,15,1326
"مازندران","آمل","مرکزی",88,202,3,1,69,275,0,275
"مازندران","آمل","مرکزی",89,850,8,0,291,1149,8,1157
"مازندران","آمل","مرکزی",90,508,6,1,180,695,5,700
"مازندران","آمل","مرکزی",91,472,17,6,441,936,12,948
"مازندران","آمل","مرکزی",92,277,3,0,240,520,9,529
"مازندران","آمل","مرکزی",93,333,6,4,397,740,6,746
"مازندران","آمل","مرکزی",94,710,18,10,562,1300,13,1313
"مازندران","آمل","مرکزی",95,541,17,2,376,936,5,941
"مازندران","آمل","مرکزی",96,200,8,4,241,453,4,457
"مازندران","آمل","مرکزی",97,259,5,7,256,527,6,533
"مازندران","آمل","مرکزی",98,761,18,5,575,1359,13,1372
"مازندران","آمل","مرکزی",99,518,3,3,225,749,12,761
"مازندران","آمل","مرکزی",100,444,14,1,181,640,5,645
"مازندران","آمل","مرکزی",101,1121,20,4,479,1624,18,1642
"مازندران","آمل","مرکزی",102,687,11,1,147,846,9,855
"مازندران","آمل","مرکزی",103,797,30,2,332,1161,9,1170
"مازندران","آمل","مرکزی",104,387,5,4,135,531,3,534
"مازندران","آمل","مرکزی",105,914,9,4,234,1161,13,1174
"مازندران","آمل","مرکزی",106,408,10,4,189,611,7,618
"مازندران","آمل","مرکزی",107,600,8,0,148,756,3,759
"مازندران","آمل","مرکزی",108,764,18,3,306,1091,9,1100
"مازندران","آمل","مرکزی",109,739,11,3,116,869,15,884
"مازندران","آمل","مرکزی",110,1059,15,1,331,1406,9,1415
"مازندران","آمل","مرکزی",111,365,4,0,65,434,1,435
"مازندران","آمل","مرکزی",112,888,7,6,289,1190,8,1198
"مازندران","آمل","مرکزی",113,1206,11,3,509,1729,15,1744
"مازندران","آمل","مرکزی",114,576,14,7,466,1063,13,1076
"مازندران","آمل","مرکزی",115,643,17,3,352,1015,12,1027
"مازندران","آمل","مرکزی",116,768,6,9,405,1188,17,1205
"مازندران","آمل","مرکزی",117,1168,12,6,378,1564,16,1580
"مازندران","آمل","مرکزی",118,318,2,2,113,435,1,436
"مازندران","آمل","مرکزی",119,403,11,0,190,604,11,615
"مازندران","آمل","مرکزی",120,117,4,6,103,230,3,233
"مازندران","آمل","مرکزی",121,394,1,0,105,500,1,501
"مازندران","آمل","مرکزی",122,596,2,0,154,752,2,754
"مازندران","آمل","مرکزی",123,571,5,0,135,711,7,718
"مازندران","آمل","مرکزی",124,289,2,2,74,367,0,367
"مازندران","آمل","مرکزی",125,486,4,1,113,604,10,614
"مازندران","آمل","مرکزی",126,316,1,1,105,423,4,427
"مازندران","آمل","مرکزی",127,225,3,1,71,300,1,301
"مازندران","آمل","مرکزی",128,503,3,0,96,602,6,608
"مازندران","آمل","مرکزی",129,355,2,1,214,572,2,574
"مازندران","آمل","مرکزی",130,904,5,0,183,1092,1,1093
"مازندران","آمل","مرکزی",131,425,2,0,156,583,2,585
"مازندران","آمل","مرکزی",132,287,7,1,132,427,0,427
"مازندران","آمل","مرکزی",133,955,10,2,309,1276,7,1283
"مازندران","آمل","مرکزی",134,263,0,1,24,288,2,290
"مازندران","آمل","مرکزی",135,510,2,0,55,567,0,567
"مازندران","آمل","مرکزی",136,260,1,5,39,305,2,307
"مازندران","آمل","مرکزی",137,257,0,0,26,283,0,283
"مازندران","آمل","مرکزی",138,280,2,0,131,413,5,418
"مازندران","آمل","مرکزی",139,215,2,0,79,296,2,298
"مازندران","آمل","مرکزی",140,345,4,0,329,678,4,682
"مازندران","آمل","مرکزی",141,358,3,1,120,482,5,487
"مازندران","آمل","مرکزی",142,625,3,2,192,822,7,829
"مازندران","آمل","مرکزی",143,356,7,1,89,453,5,458
"مازندران","آمل","مرکزی",144,353,12,0,77,442,3,445
"مازندران","آمل","مرکزی",145,432,17,2,47,498,1,499
"مازندران","آمل","مرکزی",146,377,4,2,129,512,2,514
"مازندران","آمل","مرکزی",147,207,4,1,45,257,5,262
"مازندران","آمل","مرکزی",148,379,5,1,88,473,3,476
"مازندران","آمل","مرکزی",149,170,1,3,39,213,4,217
"مازندران","آمل","مرکزی",150,89,0,0,23,112,1,113
"مازندران","آمل","مرکزی",151,297,2,2,119,420,3,423
"مازندران","آمل","مرکزی",152,598,2,3,104,707,2,709
"مازندران","آمل","مرکزی",153,453,0,0,43,496,0,496
"مازندران","آمل","مرکزی",154,569,12,4,172,757,6,763
"مازندران","آمل","مرکزی",155,168,3,0,43,214,2,216
"مازندران","آمل","مرکزی",156,371,2,0,99,472,7,479
"مازندران","آمل","مرکزی",157,270,2,0,77,349,7,356
"مازندران","آمل","مرکزی",158,188,1,0,39,228,3,231
"مازندران","آمل","مرکزی",159,186,0,1,53,240,1,241
"مازندران","آمل","مرکزی",160,498,2,0,58,558,1,559
"مازندران","آمل","مرکزی",161,167,2,0,28,197,1,198
"مازندران","آمل","مرکزی",162,379,3,0,51,433,5,438
"مازندران","آمل","مرکزی",163,301,6,0,46,353,0,353
"مازندران","آمل","مرکزی",164,523,3,0,61,587,0,587
"مازندران","آمل","مرکزی",165,352,2,0,57,411,0,411
"مازندران","آمل","مرکزی",166,576,1,0,37,614,3,617
"مازندران","آمل","مرکزی",167,370,1,0,68,439,1,440
"مازندران","آمل","مرکزی",168,123,0,0,28,151,0,151
"مازندران","آمل","مرکزی",169,239,1,0,63,303,2,305
"مازندران","آمل","مرکزی",170,309,3,4,71,387,3,390
"مازندران","آمل","مرکزی",171,221,0,0,41,262,3,265
"مازندران","آمل","مرکزی",172,321,1,1,57,380,0,380
"مازندران","آمل","مرکزی",173,322,2,4,41,369,0,369
"مازندران","آمل","مرکزی",174,479,3,0,119,601,4,605
"مازندران","آمل","مرکزی",175,214,0,0,85,299,0,299
"مازندران","آمل","مرکزی",176,1225,19,5,485,1734,22,1756
"مازندران","آمل","مرکزی",177,463,9,0,254,726,2,728
"مازندران","آمل","مرکزی",178,376,2,1,146,525,6,531
"مازندران","آمل","مرکزی",179,872,8,1,104,985,9,994
"مازندران","آمل","مرکزی",180,392,1,0,70,463,6,469
"مازندران","آمل","مرکزی",181,320,2,0,69,391,0,391
"مازندران","آمل","مرکزی",182,271,4,1,88,364,0,364
"مازندران","آمل","مرکزی",183,307,0,0,90,397,1,398
"مازندران","آمل","مرکزی",184,392,5,0,105,502,6,508
"مازندران","آمل","مرکزی",185,153,0,0,44,197,0,197
"مازندران","آمل","مرکزی",186,289,0,0,65,354,2,356
"مازندران","آمل","مرکزی",187,189,0,0,29,218,2,220
"مازندران","آمل","مرکزی",188,148,0,0,65,213,1,214
"مازندران","آمل","مرکزی",189,293,2,1,56,352,4,356
"مازندران","آمل","مرکزی",190,249,3,1,73,326,2,328
"مازندران","آمل","مرکزی",191,431,2,0,61,494,3,497
"مازندران","آمل","مرکزی",192,332,0,1,119,452,3,455
"مازندران","آمل","مرکزی",193,324,3,2,133,462,3,465
"مازندران","آمل","مرکزی",194,620,8,1,166,795,5,800
"مازندران","آمل","مرکزی",195,538,0,1,136,675,9,684
"مازندران","آمل","مرکزی",196,419,4,1,295,719,5,724
"مازندران","آمل","مرکزی",197,187,5,0,57,249,0,249
"مازندران","آمل","مرکزی",198,406,2,0,60,468,2,470
"مازندران","آمل","مرکزی",199,345,3,4,106,458,6,464
"مازندران","آمل","مرکزی",200,257,2,0,108,367,2,369
"مازندران","آمل","مرکزی",201,488,3,0,152,643,4,647
"مازندران","آمل","مرکزی",202,713,2,2,207,924,17,941
"مازندران","آمل","مرکزی",203,153,1,1,71,226,0,226
"مازندران","آمل","مرکزی",204,129,3,1,154,287,0,287
"مازندران","آمل","مرکزی",205,144,3,0,81,228,1,229
"مازندران","آمل","مرکزی",206,27,0,0,26,53,0,53
"مازندران","آمل","مرکزی",207,349,8,1,214,572,1,573
"مازندران","آمل","مرکزی",208,203,0,1,59,263,0,263
"مازندران","آمل","مرکزی",209,146,0,0,35,181,1,182
"مازندران","آمل","مرکزی",210,103,2,0,65,170,0,170
"مازندران","آمل","مرکزی",211,69,2,0,31,102,0,102
"مازندران","آمل","مرکزی",212,105,6,0,23,134,1,135
"مازندران","آمل","مرکزی",213,286,2,0,90,378,5,383
"مازندران","آمل","دابودشت",1,332,1,0,32,365,2,367
"مازندران","آمل","دابودشت",2,689,6,1,198,894,6,900
"مازندران","آمل","دابودشت",3,599,1,2,74,676,3,679
"مازندران","آمل","دابودشت",4,265,3,0,69,337,2,339
"مازندران","آمل","دابودشت",5,302,7,1,173,483,3,486
"مازندران","آمل","دابودشت",6,307,1,0,85,393,1,394
"مازندران","آمل","دابودشت",7,263,14,0,67,344,2,346
"مازندران","آمل","دابودشت",8,279,0,0,54,333,1,334
"مازندران","آمل","دابودشت",9,863,5,4,146,1018,4,1022
"مازندران","آمل","دابودشت",10,310,3,0,110,423,3,426
"مازندران","آمل","دابودشت",11,972,4,1,294,1271,6,1277
"مازندران","آمل","دابودشت",12,582,8,2,110,702,1,703
"مازندران","آمل","دابودشت",13,438,2,0,144,584,14,598
"مازندران","آمل","دابودشت",14,632,7,0,472,1111,12,1123
"مازندران","آمل","دابودشت",15,493,0,2,166,661,10,671
"مازندران","آمل","دابودشت",16,555,5,0,118,678,3,681
"مازندران","آمل","دابودشت",17,273,0,0,60,333,1,334
"مازندران","آمل","دابودشت",18,539,3,0,71,613,1,614
"مازندران","آمل","دابودشت",19,554,5,5,206,770,12,782
"مازندران","آمل","دابودشت",20,362,0,1,90,453,3,456
"مازندران","آمل","دابودشت",21,764,6,0,163,933,5,938
"مازندران","آمل","دابودشت",22,459,3,0,113,575,4,579
"مازندران","آمل","دابودشت",23,1050,4,0,173,1227,3,1230
"مازندران","آمل","دابودشت",24,114,1,1,55,171,1,172
"مازندران","آمل","دابودشت",25,198,3,0,58,259,1,260
"مازندران","آمل","دابودشت",26,662,6,1,90,759,3,762
"مازندران","آمل","دابودشت",27,903,3,0,238,1144,12,1156
"مازندران","آمل","دابودشت",28,267,2,0,71,340,2,342
"مازندران","آمل","دابودشت",29,989,10,1,406,1406,12,1418
"مازندران","آمل","دابودشت",30,257,0,1,56,314,0,314
"مازندران","آمل","دابودشت",31,413,3,1,65,482,12,494
"مازندران","آمل","دابودشت",32,259,0,1,29,289,1,290
"مازندران","آمل","دابودشت",33,455,3,2,207,667,5,672
"مازندران","آمل","دابودشت",34,734,10,1,186,931,22,953
"مازندران","آمل","دابودشت",35,286,1,0,53,340,4,344
"مازندران","آمل","دابودشت",36,409,1,1,204,615,5,620
"مازندران","آمل","دابودشت",37,139,1,0,46,186,1,187
"مازندران","آمل","دابودشت",38,221,2,0,24,247,3,250
"مازندران","آمل","دابودشت",39,225,3,0,105,333,1,334
"مازندران","آمل","دابودشت",40,599,1,1,107,708,3,711
"مازندران","آمل","دابودشت",41,253,0,1,52,306,3,309
"مازندران","آمل","دابودشت",42,276,2,1,88,367,0,367
"مازندران","آمل","دابودشت",43,355,7,1,89,452,2,454
"مازندران","آمل","دابودشت",44,312,9,1,47,369,0,369
"مازندران","آمل","دابودشت",45,290,0,1,88,379,4,383
"مازندران","آمل","دابودشت",46,249,1,0,31,281,0,281
"مازندران","آمل","دابودشت",47,551,4,2,66,623,4,627
"مازندران","آمل","دابودشت",48,326,3,0,79,408,5,413
"مازندران","آمل","دابودشت",49,373,2,2,95,472,3,475
"مازندران","آمل","دابودشت",50,241,3,0,35,279,2,281
"مازندران","آمل","دابودشت",51,281,1,0,36,318,0,318
"مازندران","آمل","دابودشت",52,150,1,2,26,179,2,181
"مازندران","آمل","دابودشت",53,617,2,0,71,690,2,692
"مازندران","آمل","دابودشت",54,273,1,0,34,308,1,309
"مازندران","آمل","دابودشت",55,256,3,0,21,280,10,290
"مازندران","آمل","دابودشت",56,325,0,1,47,373,2,375
"مازندران","آمل","دابودشت",57,407,6,0,62,475,0,475
"مازندران","آمل","دابودشت",58,390,1,1,24,416,1,417
"مازندران","آمل","دابودشت",59,370,4,1,121,496,4,500
"مازندران","آمل","دابودشت",60,352,5,2,98,457,5,462
"مازندران","آمل","دابودشت",61,278,2,0,32,312,1,313
"مازندران","آمل","دابودشت",62,194,1,0,52,247,6,253
"مازندران","آمل","دابودشت",63,498,2,1,107,608,5,613
"مازندران","آمل","دابودشت",64,184,2,0,25,211,0,211
"مازندران","آمل","دابودشت",65,474,12,1,145,632,9,641
"مازندران","آمل","دابودشت",66,498,6,6,121,631,3,634
"مازندران","آمل","دابودشت",67,558,12,1,88,659,5,664
"مازندران","آمل","دابودشت",68,305,2,0,24,331,1,332
"مازندران","آمل","دابودشت",69,509,3,0,221,733,7,740
"مازندران","آمل","دابودشت",70,243,5,1,109,358,3,361
"مازندران","آمل","دابودشت",71,388,1,0,91,480,3,483
"مازندران","آمل","دابودشت",72,391,6,0,80,477,2,479
"مازندران","آمل","دابودشت",73,515,6,0,112,633,4,637
"مازندران","آمل","دابودشت",74,544,5,1,129,679,0,679
"مازندران","آمل","دابودشت",75,443,6,1,44,494,7,501
"مازندران","آمل","دابودشت",76,495,2,1,35,533,8,541
"مازندران","آمل","دابودشت",77,409,3,0,40,452,4,456
"مازندران","آمل","دابودشت",78,315,3,0,66,384,1,385
"مازندران","آمل","دابودشت",79,357,0,0,35,392,1,393
"مازندران","آمل","دابودشت",80,431,4,0,91,526,4,530
"مازندران","آمل","دابودشت",81,160,2,0,26,188,1,189
"مازندران","آمل","دابودشت",82,388,7,0,65,460,2,462
"مازندران","آمل","دابودشت",83,369,2,0,77,448,0,448
"مازندران","آمل","دابودشت",84,395,3,1,104,503,6,509
"مازندران","آمل","دابودشت",85,362,1,0,63,426,2,428
"مازندران","آمل","دابودشت",86,201,3,1,45,250,0,250
"مازندران","آمل","دابودشت",87,252,0,0,44,296,0,296
"مازندران","آمل","دابودشت",88,207,1,0,45,253,1,254
"مازندران","آمل","دابودشت",89,512,2,1,47,562,0,562
"مازندران","آمل","دابودشت",90,316,2,0,67,385,3,388
"مازندران","آمل","دابودشت",91,263,1,1,32,297,1,298
"مازندران","آمل","دابودشت",92,501,7,2,99,609,8,617
"مازندران","آمل","لاریجان",1,417,15,1,395,828,7,835
"مازندران","آمل","لاریجان",2,185,2,2,51,240,1,241
"مازندران","آمل","لاریجان",3,289,8,3,109,409,8,417
"مازندران","آمل","لاریجان",4,301,4,0,146,451,8,459
"مازندران","آمل","لاریجان",5,211,6,1,225,443,2,445
"مازندران","آمل","لاریجان",6,282,5,1,189,477,7,484
"مازندران","آمل","لاریجان",7,330,4,1,136,471,3,474
"مازندران","آمل","لاریجان",8,210,1,0,118,329,1,330
"مازندران","آمل","لاریجان",9,296,10,2,307,615,4,619
"مازندران","آمل","لاریجان",10,473,4,0,102,579,4,583
"مازندران","آمل","لاریجان",11,301,9,0,114,424,0,424
"مازندران","آمل","لاریجان",12,859,23,3,510,1395,30,1425
"مازندران","آمل","لاریجان",13,170,1,0,44,215,1,216
"مازندران","آمل","لاریجان",14,216,6,1,141,364,4,368
"مازندران","آمل","لاریجان",15,327,8,3,207,545,4,549
"مازندران","آمل","لاریجان",16,335,2,6,166,509,2,511
"مازندران","آمل","لاریجان",17,221,3,1,152,377,1,378
"مازندران","آمل","لاریجان",18,172,1,0,76,249,1,250
"مازندران","آمل","لاریجان",19,291,2,0,156,449,4,453
"مازندران","آمل","لاریجان",20,303,6,0,101,410,9,419
"مازندران","آمل","لاریجان",21,275,1,0,45,321,2,323
"مازندران","آمل","لاریجان",22,328,2,2,97,429,2,431
"مازندران","آمل","لاریجان",23,63,2,0,25,90,0,90
"مازندران","آمل","لاریجان",24,239,2,1,60,302,2,304
"مازندران","آمل","لاریجان",25,154,0,0,27,181,3,184
"مازندران","آمل","لاریجان",26,267,6,2,134,409,1,410
"مازندران","آمل","لاریجان",27,272,3,0,52,327,1,328
"مازندران","آمل","لاریجان",28,164,0,0,52,216,1,217
"مازندران","آمل","لاریجان",29,341,0,2,96,439,3,442
"مازندران","بابل","مرکزی",1,602,26,26,964,1618,23,1641
"مازندران","بابل","مرکزی",2,575,26,17,833,1451,15,1466
"مازندران","بابل","مرکزی",3,162,8,3,264,437,7,444
"مازندران","بابل","مرکزی",4,222,7,5,327,561,3,564
"مازندران","بابل","مرکزی",5,786,19,7,358,1170,18,1188
"مازندران","بابل","مرکزی",6,770,13,2,239,1024,7,1031
"مازندران","بابل","مرکزی",7,831,12,4,185,1032,6,1038
"مازندران","بابل","مرکزی",8,235,20,23,816,1094,13,1107
"مازندران","بابل","مرکزی",9,255,11,30,745,1041,17,1058
"مازندران","بابل","مرکزی",10,1070,16,4,368,1458,21,1479
"مازندران","بابل","مرکزی",11,598,10,2,322,932,8,940
"مازندران","بابل","مرکزی",12,314,15,9,573,911,14,925
"مازندران","بابل","مرکزی",13,380,13,6,518,917,8,925
"مازندران","بابل","مرکزی",14,298,22,15,730,1065,7,1072
"مازندران","بابل","مرکزی",15,374,20,10,747,1151,8,1159
"مازندران","بابل","مرکزی",16,589,15,10,998,1612,12,1624
"مازندران","بابل","مرکزی",17,281,6,4,163,454,4,458
"مازندران","بابل","مرکزی",18,529,16,3,188,736,7,743
"مازندران","بابل","مرکزی",19,425,8,4,262,699,6,705
"مازندران","بابل","مرکزی",20,409,17,24,621,1071,18,1089
"مازندران","بابل","مرکزی",21,527,35,23,899,1484,25,1509
"مازندران","بابل","مرکزی",22,258,11,5,140,414,5,419
"مازندران","بابل","مرکزی",23,223,4,1,128,356,2,358
"مازندران","بابل","مرکزی",24,379,18,2,227,626,4,630
"مازندران","بابل","مرکزی",25,538,29,25,776,1368,16,1384
"مازندران","بابل","مرکزی",26,752,30,9,788,1579,17,1596
"مازندران","بابل","مرکزی",27,340,3,1,120,464,5,469
"مازندران","بابل","مرکزی",28,647,39,35,1384,2105,25,2130
"مازندران","بابل","مرکزی",29,558,34,20,1151,1763,10,1773
"مازندران","بابل","مرکزی",30,448,13,0,293,754,7,761
"مازندران","بابل","مرکزی",31,534,17,4,284,839,8,847
"مازندران","بابل","مرکزی",32,688,2,3,143,836,9,845
"مازندران","بابل","مرکزی",33,394,4,0,136,534,4,538
"مازندران","بابل","مرکزی",34,953,22,1,246,1222,11,1233
"مازندران","بابل","مرکزی",35,390,10,10,380,790,6,796
"مازندران","بابل","مرکزی",36,150,16,1,181,348,5,353
"مازندران","بابل","مرکزی",37,404,27,41,675,1147,10,1157
"مازندران","بابل","مرکزی",38,532,25,11,655,1223,16,1239
"مازندران","بابل","مرکزی",39,612,30,49,1628,2319,22,2341
"مازندران","بابل","مرکزی",40,263,22,17,465,767,9,776
"مازندران","بابل","مرکزی",41,860,47,12,928,1847,30,1877
"مازندران","بابل","مرکزی",42,355,13,2,233,603,7,610
"مازندران","بابل","مرکزی",43,363,9,1,150,523,7,530
"مازندران","بابل","مرکزی",44,1680,19,5,423,2127,26,2153
"مازندران","بابل","مرکزی",45,745,19,4,495,1263,16,1279
"مازندران","بابل","مرکزی",46,832,20,4,412,1268,28,1296
"مازندران","بابل","مرکزی",47,803,9,7,283,1102,8,1110
"مازندران","بابل","مرکزی",48,706,13,3,308,1030,8,1038
"مازندران","بابل","مرکزی",49,347,9,2,279,637,11,648
"مازندران","بابل","مرکزی",50,516,17,0,259,792,6,798
"مازندران","بابل","مرکزی",51,316,9,6,324,655,4,659
"مازندران","بابل","مرکزی",52,398,12,4,273,687,7,694
"مازندران","بابل","مرکزی",53,306,22,18,817,1163,5,1168
"مازندران","بابل","مرکزی",54,401,32,13,871,1317,29,1346
"مازندران","بابل","مرکزی",55,705,19,15,382,1121,13,1134
"مازندران","بابل","مرکزی",56,714,15,1,255,985,10,995
"مازندران","بابل","مرکزی",57,158,9,7,218,392,7,399
"مازندران","بابل","مرکزی",58,1192,8,1,229,1430,14,1444
"مازندران","بابل","مرکزی",59,478,31,5,349,863,7,870
"مازندران","بابل","مرکزی",60,472,20,3,197,692,7,699
"مازندران","بابل","مرکزی",61,545,20,12,636,1213,21,1234
"مازندران","بابل","مرکزی",62,382,25,4,199,610,7,617
"مازندران","بابل","مرکزی",63,544,26,4,182,756,9,765
"مازندران","بابل","مرکزی",64,581,35,8,389,1013,22,1035
"مازندران","بابل","مرکزی",65,281,11,6,221,519,10,529
"مازندران","بابل","مرکزی",66,246,12,9,261,528,3,531
"مازندران","بابل","مرکزی",67,244,7,18,591,860,6,866
"مازندران","بابل","مرکزی",68,361,20,11,542,934,19,953
"مازندران","بابل","مرکزی",69,430,17,5,457,909,10,919
"مازندران","بابل","مرکزی",70,476,17,6,687,1186,15,1201
"مازندران","بابل","مرکزی",71,86,6,5,137,234,3,237
"مازندران","بابل","مرکزی",72,573,7,1,462,1043,19,1062
"مازندران","بابل","مرکزی",73,638,3,1,203,845,10,855
"مازندران","بابل","مرکزی",74,1057,28,2,197,1284,4,1288
"مازندران","بابل","مرکزی",75,782,16,2,232,1032,19,1051
"مازندران","بابل","مرکزی",76,644,5,20,313,982,7,989
"مازندران","بابل","مرکزی",77,787,10,0,222,1019,0,1019
"مازندران","بابل","مرکزی",78,993,3,2,147,1145,15,1160
"مازندران","بابل","مرکزی",79,666,10,1,196,873,17,890
"مازندران","بابل","مرکزی",80,778,5,0,137,920,7,927
"مازندران","بابل","مرکزی",81,614,19,14,810,1457,8,1465
"مازندران","بابل","مرکزی",82,267,11,2,322,602,10,612
"مازندران","بابل","مرکزی",83,319,17,1,248,585,14,599
"مازندران","بابل","مرکزی",84,328,14,13,481,836,4,840
"مازندران","بابل","مرکزی",85,625,36,16,797,1474,11,1485
"مازندران","بابل","مرکزی",86,750,29,5,675,1459,20,1479
"مازندران","بابل","مرکزی",87,425,22,7,422,876,11,887
"مازندران","بابل","مرکزی",88,499,11,1,347,858,9,867
"مازندران","بابل","مرکزی",89,631,12,0,196,839,10,849
"مازندران","بابل","مرکزی",90,352,21,11,567,951,6,957
"مازندران","بابل","مرکزی",91,438,18,9,551,1016,9,1025
"مازندران","بابل","مرکزی",92,376,33,9,541,959,9,968
"مازندران","بابل","مرکزی",93,242,11,4,420,677,7,684
"مازندران","بابل","مرکزی",94,519,6,3,196,724,7,731
"مازندران","بابل","مرکزی",95,408,3,1,103,515,4,519
"مازندران","بابل","مرکزی",96,1327,6,2,199,1534,9,1543
"مازندران","بابل","مرکزی",97,1170,16,5,330,1521,19,1540
"مازندران","بابل","مرکزی",98,938,23,1,309,1271,16,1287
"مازندران","بابل","مرکزی",99,390,6,2,178,576,6,582
"مازندران","بابل","مرکزی",100,835,19,6,325,1185,14,1199
"مازندران","بابل","مرکزی",101,1095,10,2,203,1310,7,1317
"مازندران","بابل","مرکزی",102,417,2,0,63,482,4,486
"مازندران","بابل","مرکزی",103,620,9,1,188,818,13,831
"مازندران","بابل","مرکزی",104,508,26,6,719,1259,19,1278
"مازندران","بابل","مرکزی",105,668,9,6,410,1093,13,1106
"مازندران","بابل","مرکزی",106,879,2,9,333,1223,5,1228
"مازندران","بابل","مرکزی",107,716,23,21,734,1494,17,1511
"مازندران","بابل","مرکزی",108,617,18,3,545,1183,21,1204
"مازندران","بابل","مرکزی",109,475,16,5,240,736,8,744
"مازندران","بابل","مرکزی",110,488,4,3,209,704,6,710
"مازندران","بابل","مرکزی",111,279,5,2,154,440,5,445
"مازندران","بابل","مرکزی",112,404,7,1,184,596,5,601
"مازندران","بابل","مرکزی",113,409,8,6,205,628,4,632
"مازندران","بابل","مرکزی",114,511,6,2,168,687,7,694
"مازندران","بابل","مرکزی",115,233,13,0,221,467,3,470
"مازندران","بابل","مرکزی",116,641,14,2,289,946,9,955
"مازندران","بابل","مرکزی",117,1042,9,1,148,1200,14,1214
"مازندران","بابل","مرکزی",118,389,7,1,75,472,6,478
"مازندران","بابل","مرکزی",119,332,9,0,181,522,12,534
"مازندران","بابل","مرکزی",120,1130,18,5,339,1492,11,1503
"مازندران","بابل","مرکزی",121,514,23,5,368,910,15,925
"مازندران","بابل","مرکزی",122,575,18,3,254,850,9,859
"مازندران","بابل","مرکزی",123,276,23,13,593,905,5,910
"مازندران","بابل","مرکزی",124,390,22,12,554,978,17,995
"مازندران","بابل","مرکزی",125,206,10,5,141,362,2,364
"مازندران","بابل","مرکزی",126,327,16,8,191,542,8,550
"مازندران","بابل","مرکزی",127,394,17,3,186,600,11,611
"مازندران","بابل","مرکزی",128,531,17,2,203,753,5,758
"مازندران","بابل","مرکزی",129,680,7,2,128,817,8,825
"مازندران","بابل","مرکزی",130,232,2,1,76,311,5,316
"مازندران","بابل","مرکزی",131,422,17,3,158,600,4,604
"مازندران","بابل","مرکزی",132,452,12,1,142,607,3,610
"مازندران","بابل","مرکزی",133,925,24,3,475,1427,22,1449
"مازندران","بابل","مرکزی",134,323,5,1,73,402,0,402
"مازندران","بابل","مرکزی",135,823,3,0,277,1103,10,1113
"مازندران","بابل","مرکزی",136,497,4,1,69,571,4,575
"مازندران","بابل","مرکزی",137,919,3,6,220,1148,9,1157
"مازندران","بابل","مرکزی",138,401,1,0,84,486,7,493
"مازندران","بابل","مرکزی",139,832,5,0,209,1046,5,1051
"مازندران","بابل","مرکزی",140,375,5,0,43,423,6,429
"مازندران","بابل","مرکزی",141,363,4,0,76,443,6,449
"مازندران","بابل","مرکزی",142,198,1,1,34,234,1,235
"مازندران","بابل","مرکزی",143,721,4,0,57,782,4,786
"مازندران","بابل","مرکزی",144,371,1,1,102,475,13,488
"مازندران","بابل","مرکزی",145,556,7,0,173,736,5,741
"مازندران","بابل","مرکزی",146,419,2,0,35,456,2,458
"مازندران","بابل","مرکزی",147,508,3,0,63,574,5,579
"مازندران","بابل","مرکزی",148,1006,10,0,219,1235,4,1239
"مازندران","بابل","مرکزی",149,511,1,0,65,577,6,583
"مازندران","بابل","مرکزی",150,372,0,0,37,409,1,410
"مازندران","بابل","مرکزی",151,1374,12,0,193,1579,10,1589
"مازندران","بابل","مرکزی",152,518,6,5,63,592,5,597
"مازندران","بابل","مرکزی",153,597,11,0,88,696,2,698
"مازندران","بابل","مرکزی",154,491,5,2,70,568,6,574
"مازندران","بابل","مرکزی",155,320,3,1,34,358,0,358
"مازندران","بابل","مرکزی",156,725,7,3,170,905,0,905
"مازندران","بابل","مرکزی",157,1192,8,2,232,1434,14,1448
"مازندران","بابل","مرکزی",158,599,8,2,84,693,9,702
"مازندران","بابل","مرکزی",159,505,1,0,113,619,1,620
"مازندران","بابل","مرکزی",160,561,2,0,212,775,5,780
"مازندران","بابل","مرکزی",161,906,12,0,252,1170,6,1176
"مازندران","بابل","مرکزی",162,662,5,0,129,796,14,810
"مازندران","بابل","مرکزی",163,203,1,1,61,266,1,267
"مازندران","بابل","مرکزی",164,343,0,0,43,386,5,391
"مازندران","بابل","مرکزی",165,189,0,0,19,208,3,211
"مازندران","بابل","مرکزی",166,503,4,2,62,571,3,574
"مازندران","بابل","مرکزی",167,899,14,2,99,1014,7,1021
"مازندران","بابل","مرکزی",168,767,9,3,198,977,2,979
"مازندران","بابل","مرکزی",169,578,17,2,205,802,9,811
"مازندران","بابل","مرکزی",170,486,6,0,94,586,5,591
"مازندران","بابل","مرکزی",171,748,14,11,178,951,4,955
"مازندران","بابل","مرکزی",172,167,0,1,66,234,0,234
"مازندران","بابل","مرکزی",173,971,8,0,357,1336,10,1346
"مازندران","بابل","مرکزی",174,395,3,1,101,500,5,505
"مازندران","بابل","مرکزی",175,446,3,0,71,520,2,522
"مازندران","بابل","مرکزی",176,324,3,1,77,405,7,412
"مازندران","بابل","مرکزی",177,904,15,0,144,1063,8,1071
"مازندران","بابل","مرکزی",178,359,2,0,26,387,1,388
"مازندران","بابل","مرکزی",179,371,9,2,186,568,3,571
"مازندران","بابل","مرکزی",180,420,1,1,83,505,1,506
"مازندران","بابل","مرکزی",181,243,1,0,63,307,4,311
"مازندران","بابل","مرکزی",182,264,2,0,95,361,0,361
"مازندران","بابل","مرکزی",183,1042,18,0,178,1238,4,1242
"مازندران","بابل","مرکزی",184,256,1,0,118,375,2,377
"مازندران","بابل","مرکزی",185,265,0,0,75,340,0,340
"مازندران","بابل","مرکزی",186,301,11,0,131,443,2,445
"مازندران","بابل","مرکزی",187,694,16,1,111,822,4,826
"مازندران","بابل","مرکزی",188,281,2,0,18,301,1,302
"مازندران","بابل","مرکزی",189,307,1,0,71,379,2,381
"مازندران","بابل","مرکزی",190,470,2,1,128,601,6,607
"مازندران","بابل","مرکزی",191,357,5,0,132,494,1,495
"مازندران","بابل","مرکزی",192,823,8,1,161,993,8,1001
"مازندران","بابل","مرکزی",193,641,3,1,36,681,3,684
"مازندران","بابل","مرکزی",194,228,2,3,58,291,2,293
"مازندران","بابل","مرکزی",195,491,6,2,256,755,10,765
"مازندران","بابل","مرکزی",196,682,12,1,124,819,9,828
"مازندران","بابل","مرکزی",197,1014,13,1,324,1352,24,1376
"مازندران","بابل","گتاب",1,766,3,1,158,928,3,931
"مازندران","بابل","گتاب",2,674,1,1,197,873,3,876
"مازندران","بابل","گتاب",3,543,4,1,241,789,4,793
"مازندران","بابل","گتاب",4,588,6,0,198,792,4,796
"مازندران","بابل","گتاب",5,693,20,2,85,800,0,800
"مازندران","بابل","گتاب",6,795,10,4,233,1042,9,1051
"مازندران","بابل","گتاب",7,362,2,1,260,625,6,631
"مازندران","بابل","گتاب",8,514,5,1,109,629,4,633
"مازندران","بابل","گتاب",9,401,0,0,157,558,5,563
"مازندران","بابل","گتاب",10,524,14,1,123,662,3,665
"مازندران","بابل","گتاب",11,318,0,0,117,435,5,440
"مازندران","بابل","گتاب",12,592,4,0,123,719,4,723
"مازندران","بابل","گتاب",13,515,3,5,107,630,7,637
"مازندران","بابل","گتاب",14,605,7,1,151,764,6,770
"مازندران","بابل","گتاب",15,635,2,0,137,774,10,784
"مازندران","بابل","گتاب",16,511,4,1,120,636,13,649
"مازندران","بابل","گتاب",17,357,0,1,66,424,1,425
"مازندران","بابل","گتاب",18,908,15,4,98,1025,7,1032
"مازندران","بابل","گتاب",19,1062,8,0,115,1185,7,1192
"مازندران","بابل","گتاب",20,220,2,0,30,252,1,253
"مازندران","بابل","گتاب",21,1180,3,0,110,1293,5,1298
"مازندران","بابل","گتاب",22,927,7,2,358,1294,15,1309
"مازندران","بابل","گتاب",23,561,4,0,124,689,6,695
"مازندران","بابل","گتاب",24,504,4,5,214,727,2,729
"مازندران","بابل","گتاب",25,374,4,0,120,498,2,500
"مازندران","بابل","گتاب",26,790,4,1,317,1112,10,1122
"مازندران","بابل","گتاب",27,883,6,1,217,1107,6,1113
"مازندران","بابل","گتاب",28,840,7,3,407,1257,14,1271
"مازندران","بابل","گتاب",29,716,10,0,207,933,9,942
"مازندران","بابل","گتاب",30,490,2,3,241,736,9,745
"مازندران","بابل","گتاب",31,484,4,4,183,675,0,675
"مازندران","بابل","گتاب",32,921,5,3,332,1261,6,1267
"مازندران","بابل","گتاب",33,635,4,1,174,814,6,820
"مازندران","بابل","گتاب",34,531,1,1,101,634,4,638
"مازندران","بابل","گتاب",35,373,2,0,59,434,2,436
"مازندران","بابل","گتاب",36,341,2,0,103,446,3,449
"مازندران","بابل","گتاب",37,738,8,3,125,874,10,884
"مازندران","بابل","گتاب",38,354,4,0,111,469,1,470
"مازندران","بابل","گتاب",39,655,9,1,122,787,6,793
"مازندران","بابل","گتاب",40,859,5,1,78,943,1,944
"مازندران","بابل","بابل_کنار",1,269,6,0,34,309,0,309
"مازندران","بابل","بابل_کنار",2,441,5,0,72,518,4,522
"مازندران","بابل","بابل_کنار",3,424,13,1,98,536,0,536
"مازندران","بابل","بابل_کنار",4,389,1,0,43,433,5,438
"مازندران","بابل","بابل_کنار",5,274,3,1,63,341,2,343
"مازندران","بابل","بابل_کنار",6,188,1,0,33,222,0,222
"مازندران","بابل","بابل_کنار",7,204,6,0,18,228,2,230
"مازندران","بابل","بابل_کنار",8,201,0,0,6,207,0,207
"مازندران","بابل","بابل_کنار",9,173,1,0,8,182,1,183
"مازندران","بابل","بابل_کنار",10,507,3,0,93,603,4,607
"مازندران","بابل","بابل_کنار",11,772,4,5,148,929,5,934
"مازندران","بابل","بابل_کنار",12,843,5,2,265,1115,12,1127
"مازندران","بابل","بابل_کنار",13,215,2,0,148,365,4,369
"مازندران","بابل","بابل_کنار",14,756,10,0,218,984,4,988
"مازندران","بابل","بابل_کنار",15,391,0,0,121,512,4,516
"مازندران","بابل","بابل_کنار",16,719,1,0,129,849,5,854
"مازندران","بابل","بابل_کنار",17,462,2,0,66,530,1,531
"مازندران","بابل","بابل_کنار",18,548,5,0,229,782,1,783
"مازندران","بابل","بابل_کنار",19,528,7,1,102,638,2,640
"مازندران","بابل","بابل_کنار",20,319,0,0,59,378,4,382
"مازندران","بابل","بابل_کنار",21,399,3,1,81,484,3,487
"مازندران","بابل","بابل_کنار",22,825,7,1,170,1003,2,1005
"مازندران","بابل","بابل_کنار",23,673,8,1,70,752,3,755
"مازندران","بابل","بابل_کنار",24,676,7,2,148,833,8,841
"مازندران","بابل","بابل_کنار",25,363,4,2,81,450,0,450
"مازندران","بابل","بابل_کنار",26,427,2,2,103,534,1,535
"مازندران","بابل","بابل_کنار",27,832,4,1,230,1067,7,1074
"مازندران","بابل","بابل_کنار",28,594,2,2,140,738,3,741
"مازندران","بابل","بابل_کنار",29,730,2,2,273,1007,7,1014
"مازندران","بابل","بابل_کنار",30,392,1,1,60,454,1,455
"مازندران","بابل","بابل_کنار",31,226,6,0,60,292,1,293
"مازندران","بابل","بابل_کنار",32,309,1,0,27,337,4,341
"مازندران","بابل","بابل_کنار",33,85,4,1,10,100,3,103
"مازندران","بابل","بندپی_شرقی",1,884,4,2,150,1040,3,1043
"مازندران","بابل","بندپی_شرقی",2,408,3,1,91,503,6,509
"مازندران","بابل","بندپی_شرقی",3,269,1,0,62,332,3,335
"مازندران","بابل","بندپی_شرقی",4,413,3,6,127,549,7,556
"مازندران","بابل","بندپی_شرقی",5,434,3,0,76,513,4,517
"مازندران","بابل","بندپی_شرقی",6,202,0,1,27,230,1,231
"مازندران","بابل","بندپی_شرقی",7,466,10,2,349,827,3,830
"مازندران","بابل","بندپی_شرقی",8,476,10,3,202,691,8,699
"مازندران","بابل","بندپی_شرقی",9,523,7,1,80,611,8,619
"مازندران","بابل","بندپی_شرقی",10,441,6,0,22,469,0,469
"مازندران","بابل","بندپی_شرقی",11,523,5,1,187,716,6,722
"مازندران","بابل","بندپی_شرقی",12,196,2,0,11,209,2,211
"مازندران","بابل","بندپی_شرقی",13,617,10,5,427,1059,11,1070
"مازندران","بابل","بندپی_شرقی",14,464,9,2,314,789,9,798
"مازندران","بابل","بندپی_شرقی",15,272,4,0,44,320,0,320
"مازندران","بابل","بندپی_شرقی",16,614,4,2,288,908,8,916
"مازندران","بابل","بندپی_شرقی",17,422,7,1,174,604,8,612
"مازندران","بابل","بندپی_شرقی",18,787,3,4,128,922,6,928
"مازندران","بابل","بندپی_شرقی",19,700,9,0,229,938,3,941
"مازندران","بابل","بندپی_شرقی",20,708,23,7,294,1032,7,1039
"مازندران","بابل","بندپی_شرقی",21,624,12,5,249,890,8,898
"مازندران","بابل","بندپی_شرقی",22,468,10,20,277,775,3,778
"مازندران","بابل","بندپی_شرقی",23,547,4,2,146,699,2,701
"مازندران","بابل","بندپی_شرقی",24,730,2,1,180,913,10,923
"مازندران","بابل","بندپی_شرقی",25,435,2,0,18,455,7,462
"مازندران","بابل","بندپی_شرقی",26,207,3,4,55,269,1,270
"مازندران","بابل","بندپی_شرقی",27,308,2,1,40,351,3,354
"مازندران","بابل","بندپی_شرقی",28,388,0,0,59,447,0,447
"مازندران","بابل","بندپی_شرقی",29,140,1,1,8,150,0,150
"مازندران","بابل","بندپی_شرقی",30,188,0,0,7,195,2,197
"مازندران","بابل","بندپی_شرقی",31,198,0,0,17,215,3,218
"مازندران","بابل","بندپی_شرقی",32,239,1,2,28,270,3,273
"مازندران","بابل","بندپی_شرقی",33,385,1,1,47,434,0,434
"مازندران","بابل","بندپی_شرقی",34,266,1,0,11,278,2,280
"مازندران","بابل","بندپی_شرقی",35,156,0,0,7,163,0,163
"مازندران","بابل","بندپی_شرقی",36,231,2,1,57,291,2,293
"مازندران","بابل","بندپی_شرقی",37,164,0,0,17,181,0,181
"مازندران","بابل","بندپی_شرقی",38,97,0,0,18,115,0,115
"مازندران","بابل","بندپی_شرقی",39,256,0,0,44,300,0,300
"مازندران","بابل","بندپی_شرقی",40,353,0,0,36,389,0,389
"مازندران","بابل","بندپی_غربی",1,279,0,0,1,280,1,281
"مازندران","بابل","بندپی_غربی",2,154,0,0,92,246,2,248
"مازندران","بابل","بندپی_غربی",3,276,4,2,206,488,3,491
"مازندران","بابل","بندپی_غربی",4,321,8,8,113,450,1,451
"مازندران","بابل","بندپی_غربی",5,241,6,1,60,308,3,311
"مازندران","بابل","بندپی_غربی",6,314,0,0,40,354,1,355
"مازندران","بابل","بندپی_غربی",7,220,4,2,90,316,0,316
"مازندران","بابل","بندپی_غربی",8,265,4,5,72,346,4,350
"مازندران","بابل","بندپی_غربی",9,217,2,0,12,231,0,231
"مازندران","بابل","بندپی_غربی",10,231,1,0,13,245,1,246
"مازندران","بابل","بندپی_غربی",11,179,3,0,48,230,1,231
"مازندران","بابل","بندپی_غربی",12,151,2,0,103,256,0,256
"مازندران","بابل","بندپی_غربی",13,480,1,0,139,620,8,628
"مازندران","بابل","بندپی_غربی",14,389,3,2,204,598,4,602
"مازندران","بابل","بندپی_غربی",15,301,3,0,131,435,2,437
"مازندران","بابل","بندپی_غربی",16,274,2,0,134,410,2,412
"مازندران","بابل","بندپی_غربی",17,275,2,0,167,444,5,449
"مازندران","بابل","بندپی_غربی",18,376,2,1,115,494,4,498
"مازندران","بابل","بندپی_غربی",19,444,3,1,255,703,4,707
"مازندران","بابل","بندپی_غربی",20,570,9,2,290,871,13,884
"مازندران","بابل","بندپی_غربی",21,435,2,1,157,595,4,599
"مازندران","بابل","بندپی_غربی",22,207,3,3,119,332,4,336
"مازندران","بابل","بندپی_غربی",23,109,0,1,46,156,1,157
"مازندران","بابل","بندپی_غربی",24,406,10,1,140,557,2,559
"مازندران","بابل","بندپی_غربی",25,386,10,2,195,593,8,601
"مازندران","بابل","بندپی_غربی",26,361,3,9,170,543,2,545
"مازندران","بابل","بندپی_غربی",27,418,13,4,140,575,5,580
"مازندران","بابل","بندپی_غربی",28,405,3,8,90,506,5,511
"مازندران","بابل","بندپی_غربی",29,439,2,0,196,637,1,638
"مازندران","بابل","بندپی_غربی",30,236,1,0,32,269,1,270
"مازندران","بابل","بندپی_غربی",31,323,10,2,157,492,2,494
"مازندران","بابل","بندپی_غربی",32,29,0,0,1,30,0,30
"مازندران","بابل","بندپی_غربی",33,349,5,1,78,433,6,439
"مازندران","بابل","بندپی_غربی",34,620,5,0,201,826,5,831
"مازندران","بابل","بندپی_غربی",35,301,0,1,51,353,1,354
"مازندران","بابل","بندپی_غربی",36,282,2,0,64,348,2,350
"مازندران","بابل","بندپی_غربی",37,258,1,0,190,449,4,453
"مازندران","بابل","بندپی_غربی",38,435,4,1,147,587,7,594
"مازندران","بابل","بندپی_غربی",39,244,2,0,57,303,1,304
"مازندران","بابل","بندپی_غربی",40,558,4,1,183,746,5,751
"مازندران","بابل","بندپی_غربی",41,231,0,2,116,349,2,351
"مازندران","بابل","بندپی_غربی",42,207,3,0,123,333,3,336
"مازندران","بابل","بندپی_غربی",43,278,0,0,51,329,5,334
"مازندران","بابل","بندپی_غربی",44,143,1,2,35,181,1,182
"مازندران","بابل","لاله_آباد",1,462,4,1,99,566,0,566
"مازندران","بابل","لاله_آباد",2,762,14,0,195,971,5,976
"مازندران","بابل","لاله_آباد",3,416,6,0,49,471,4,475
"مازندران","بابل","لاله_آباد",4,588,2,0,112,702,0,702
"مازندران","بابل","لاله_آباد",5,473,5,2,37,517,3,520
"مازندران","بابل","لاله_آباد",6,442,1,1,68,512,4,516
"مازندران","بابل","لاله_آباد",7,689,13,7,391,1100,12,1112
"مازندران","بابل","لاله_آباد",8,584,2,1,90,677,3,680
"مازندران","بابل","لاله_آباد",9,96,1,0,29,126,1,127
"مازندران","بابل","لاله_آباد",10,239,9,0,42,290,2,292
"مازندران","بابل","لاله_آباد",11,938,7,0,190,1135,11,1146
"مازندران","بابل","لاله_آباد",12,562,7,0,141,710,4,714
"مازندران","بابل","لاله_آباد",13,286,3,2,85,376,4,380
"مازندران","بابل","لاله_آباد",14,1023,3,0,88,1114,1,1115
"مازندران","بابل","لاله_آباد",15,357,0,0,32,389,0,389
"مازندران","بابل","لاله_آباد",16,558,0,0,133,691,0,691
"مازندران","بابل","لاله_آباد",17,181,0,0,17,198,0,198
"مازندران","بابل","لاله_آباد",18,338,1,1,40,380,3,383
"مازندران","بابل","لاله_آباد",19,686,9,6,341,1042,6,1048
"مازندران","بابل","لاله_آباد",20,437,4,0,156,597,10,607
"مازندران","بابل","لاله_آباد",21,655,1,1,136,793,2,795
"مازندران","بابل","لاله_آباد",22,207,0,0,26,233,2,235
"مازندران","بابل","لاله_آباد",23,799,7,1,114,921,5,926
"مازندران","بابل","لاله_آباد",24,265,1,0,23,289,0,289
"مازندران","بابل","لاله_آباد",25,256,2,3,121,382,4,386
"مازندران","بابل","لاله_آباد",26,610,8,3,117,738,0,738
"مازندران","بابل","لاله_آباد",27,721,1,3,42,767,0,767
"مازندران","بابل","لاله_آباد",28,382,6,2,126,516,4,520
"مازندران","بابل","لاله_آباد",29,308,5,1,137,451,0,451
"مازندران","بابل","لاله_آباد",30,346,2,0,137,485,4,489
"مازندران","بابل","لاله_آباد",31,200,2,0,18,220,1,221
"مازندران","بابل","لاله_آباد",32,261,0,0,37,298,2,300
"مازندران","بابل","لاله_آباد",33,463,4,2,124,593,5,598
"مازندران","بابل","لاله_آباد",34,383,0,0,16,399,0,399
"مازندران","بابل","لاله_آباد",35,469,4,1,66,540,6,546
"مازندران","بابل","لاله_آباد",36,258,4,0,64,326,2,328
"مازندران","بابل","لاله_آباد",37,127,1,0,43,171,0,171
"مازندران","بابل","لاله_آباد",38,557,11,1,140,709,4,713
"مازندران","بابل","لاله_آباد",39,515,3,3,115,636,1,637
"مازندران","بابل","لاله_آباد",40,620,6,3,41,670,3,673
"مازندران","بابل","لاله_آباد",41,511,5,1,102,619,7,626
"مازندران","بابل","لاله_آباد",42,432,12,8,295,747,3,750
"مازندران","بابل","لاله_آباد",43,314,2,0,64,380,3,383
"مازندران","بابل","لاله_آباد",44,404,4,5,53,466,3,469
"مازندران","بابل","لاله_آباد",45,197,1,0,23,221,1,222
"مازندران","بابل","لاله_آباد",46,568,0,1,25,594,5,599
"مازندران","بابل","لاله_آباد",47,415,1,1,87,504,0,504
"مازندران","بابل","لاله_آباد",48,288,1,0,65,354,7,361
"مازندران","بابل","لاله_آباد",49,257,1,0,28,286,1,287
"مازندران","بابل","لاله_آباد",50,192,1,2,55,250,1,251
"مازندران","بابل","لاله_آباد",51,431,0,0,44,475,1,476
"مازندران","بابل","لاله_آباد",52,301,1,0,70,372,3,375
"مازندران","بابل","لاله_آباد",53,404,0,0,44,448,4,452
"مازندران","بابل","لاله_آباد",54,324,3,0,55,382,0,382
"مازندران","بابل","لاله_آباد",55,153,3,0,39,195,0,195
"مازندران","بابل","لاله_آباد",56,218,2,0,42,262,0,262
"مازندران","بابل","لاله_آباد",57,356,2,0,25,383,1,384
"مازندران","بابل","لاله_آباد",58,380,2,2,11,395,0,395
"مازندران","بابل","لاله_آباد",59,373,1,0,22,396,4,400
"مازندران","بابل","لاله_آباد",60,514,1,0,98,613,3,616
"مازندران","بابل","لاله_آباد",61,287,3,0,59,349,6,355
"مازندران","بابل","لاله_آباد",62,172,0,0,48,220,1,221
"مازندران","بابل","لاله_آباد",63,284,0,0,37,321,0,321
"مازندران","بابل","لاله_آباد",64,324,0,0,36,360,1,361
"مازندران","بابل","لاله_آباد",65,301,3,0,71,375,1,376
"مازندران","بابل","لاله_آباد",66,355,0,1,50,406,3,409
"مازندران","بابل","لاله_آباد",67,215,1,0,1,217,1,218
"مازندران","بابل","لاله_آباد",68,320,1,0,24,345,0,345
"مازندران","بابل","لاله_آباد",69,220,1,0,37,258,1,259
"مازندران","بابل","لاله_آباد",70,360,1,2,106,469,6,475
"مازندران","بابل","لاله_آباد",71,514,0,0,52,566,1,567
"مازندران","بابل","لاله_آباد",72,376,1,0,50,427,3,430
"مازندران","بابل","لاله_آباد",73,197,6,0,176,379,5,384
"مازندران","بابل","لاله_آباد",74,421,3,0,117,541,7,548
"مازندران","بابلسر","مرکزی",1,672,21,13,707,1413,16,1429
"مازندران","بابلسر","مرکزی",2,616,21,4,553,1194,7,1201
"مازندران","بابلسر","مرکزی",3,130,16,11,403,560,9,569
"مازندران","بابلسر","مرکزی",4,365,17,5,554,941,7,948
"مازندران","بابلسر","مرکزی",5,365,12,1,460,838,2,840
"مازندران","بابلسر","مرکزی",6,194,11,5,198,408,4,412
"مازندران","بابلسر","مرکزی",7,463,15,12,689,1179,14,1193
"مازندران","بابلسر","مرکزی",8,387,17,13,549,966,9,975
"مازندران","بابلسر","مرکزی",9,137,9,7,314,467,5,472
"مازندران","بابلسر","مرکزی",10,151,8,2,158,319,2,321
"مازندران","بابلسر","مرکزی",11,311,3,1,73,388,0,388
"مازندران","بابلسر","مرکزی",12,306,5,0,93,404,4,408
"مازندران","بابلسر","مرکزی",13,425,6,2,178,611,4,615
"مازندران","بابلسر","مرکزی",14,475,8,0,175,658,3,661
"مازندران","بابلسر","مرکزی",15,182,3,5,199,389,3,392
"مازندران","بابلسر","مرکزی",16,697,18,4,272,991,6,997
"مازندران","بابلسر","مرکزی",17,818,11,1,185,1015,8,1023
"مازندران","بابلسر","مرکزی",18,199,7,6,417,629,4,633
"مازندران","بابلسر","مرکزی",19,643,6,7,488,1144,10,1154
"مازندران","بابلسر","مرکزی",20,693,11,6,428,1138,7,1145
"مازندران","بابلسر","مرکزی",21,69,4,2,54,129,2,131
"مازندران","بابلسر","مرکزی",22,81,6,1,50,138,0,138
"مازندران","بابلسر","مرکزی",23,329,4,1,26,360,4,364
"مازندران","بابلسر","مرکزی",24,580,12,1,325,918,4,922
"مازندران","بابلسر","مرکزی",25,696,10,4,162,872,5,877
"مازندران","بابلسر","مرکزی",26,362,2,4,144,512,6,518
"مازندران","بابلسر","مرکزی",27,282,25,16,574,897,10,907
"مازندران","بابلسر","مرکزی",28,243,7,1,208,459,4,463
"مازندران","بابلسر","مرکزی",29,296,6,0,216,518,3,521
"مازندران","بابلسر","مرکزی",30,183,19,4,657,863,8,871
"مازندران","بابلسر","مرکزی",31,600,15,1,570,1186,18,1204
"مازندران","بابلسر","مرکزی",32,595,30,8,618,1251,8,1259
"مازندران","بابلسر","مرکزی",33,573,16,1,464,1054,10,1064
"مازندران","بابلسر","مرکزی",34,249,13,3,469,734,8,742
"مازندران","بابلسر","مرکزی",35,331,8,4,333,676,10,686
"مازندران","بابلسر","مرکزی",36,461,15,1,298,775,5,780
"مازندران","بابلسر","مرکزی",37,357,12,5,324,698,2,700
"مازندران","بابلسر","مرکزی",38,377,12,9,269,667,5,672
"مازندران","بابلسر","مرکزی",39,385,9,4,401,799,15,814
"مازندران","بابلسر","مرکزی",40,327,4,0,146,477,6,483
"مازندران","بابلسر","مرکزی",41,348,15,3,64,430,0,430
"مازندران","بابلسر","مرکزی",42,244,12,9,245,510,7,517
"مازندران","بابلسر","مرکزی",43,572,4,0,180,756,4,760
"مازندران","بابلسر","مرکزی",44,145,0,3,89,237,4,241
"مازندران","بابلسر","مرکزی",45,173,1,0,51,225,3,228
"مازندران","بابلسر","مرکزی",46,139,3,0,244,386,5,391
"مازندران","بابلسر","مرکزی",47,119,9,2,220,350,3,353
"مازندران","بابلسر","مرکزی",48,739,11,7,186,943,5,948
"مازندران","بابلسر","مرکزی",49,372,23,27,785,1207,17,1224
"مازندران","بابلسر","مرکزی",50,285,9,1,215,510,10,520
"مازندران","بابلسر","مرکزی",51,60,0,4,95,159,4,163
"مازندران","بابلسر","مرکزی",52,191,0,0,38,229,0,229
"مازندران","بابلسر","مرکزی",53,200,6,1,37,244,3,247
"مازندران","بابلسر","مرکزی",54,310,17,10,229,566,28,594
"مازندران","بابلسر","مرکزی",55,159,9,4,251,423,7,430
"مازندران","بابلسر","مرکزی",56,96,3,1,83,183,0,183
"مازندران","بابلسر","مرکزی",57,892,10,1,338,1241,7,1248
"مازندران","بابلسر","مرکزی",58,262,1,1,97,361,1,362
"مازندران","بابلسر","مرکزی",59,601,7,0,82,690,7,697
"مازندران","بابلسر","مرکزی",60,480,1,1,94,576,7,583
"مازندران","بابلسر","مرکزی",61,516,3,3,72,594,3,597
"مازندران","بابلسر","مرکزی",62,253,2,0,34,289,0,289
"مازندران","بابلسر","مرکزی",63,558,137,0,0,695,6,701
"مازندران","بابلسر","مرکزی",64,347,3,3,166,519,4,523
"مازندران","بابلسر","مرکزی",65,192,0,1,54,247,2,249
"مازندران","بابلسر","مرکزی",66,210,2,5,49,266,0,266
"مازندران","بابلسر","مرکزی",67,248,3,3,166,420,3,423
"مازندران","بابلسر","مرکزی",68,574,2,1,142,719,8,727
"مازندران","بابلسر","مرکزی",69,748,7,0,201,956,2,958
"مازندران","بابلسر","مرکزی",70,489,2,0,150,641,8,649
"مازندران","بابلسر","مرکزی",71,241,3,7,129,380,4,384
"مازندران","بابلسر","مرکزی",72,355,3,1,37,396,1,397
"مازندران","بابلسر","مرکزی",73,162,2,0,28,192,2,194
"مازندران","بابلسر","مرکزی",74,86,2,0,39,127,0,127
"مازندران","بابلسر","مرکزی",75,219,4,0,75,298,2,300
"مازندران","بابلسر","مرکزی",76,313,10,1,108,432,6,438
"مازندران","بابلسر","مرکزی",77,142,31,24,894,1091,9,1100
"مازندران","بابلسر","مرکزی",78,52,0,0,13,65,0,65
"مازندران","بابلسر","مرکزی",79,158,1,3,48,210,1,211
"مازندران","بابلسر","رودبست",1,360,4,1,179,544,2,65
"مازندران","بابلسر","رودبست",2,227,3,1,310,541,9,211
"مازندران","بابلسر","رودبست",3,232,1,0,225,458,4,65
"مازندران","بابلسر","رودبست",4,216,3,2,191,412,6,211
"مازندران","بابلسر","رودبست",5,238,11,0,134,383,6,65
"مازندران","بابلسر","رودبست",6,400,3,1,84,488,5,65
"مازندران","بابلسر","رودبست",7,167,0,0,39,206,0,211
"مازندران","بابلسر","رودبست",8,444,6,0,78,528,5,65
"مازندران","بابلسر","رودبست",9,764,4,0,67,835,6,211
"مازندران","بابلسر","رودبست",10,324,4,9,102,439,1,65
"مازندران","بابلسر","رودبست",11,339,4,2,236,581,8,211
"مازندران","بابلسر","رودبست",12,328,0,1,29,358,0,65
"مازندران","بابلسر","رودبست",13,289,4,0,62,355,1,65
"مازندران","بابلسر","رودبست",14,460,6,2,63,531,0,211
"مازندران","بابلسر","رودبست",15,824,14,2,155,995,12,65
"مازندران","بابلسر","رودبست",16,712,9,1,186,908,11,211
"مازندران","بابلسر","رودبست",17,459,11,0,84,554,1,65
"مازندران","بابلسر","رودبست",18,428,1,0,106,535,8,211
"مازندران","بابلسر","رودبست",19,273,0,0,5,278,3,65
"مازندران","بابلسر","رودبست",20,780,10,3,195,988,5,65
"مازندران","بابلسر","رودبست",21,443,10,0,30,483,2,211
"مازندران","بابلسر","رودبست",22,237,3,1,33,274,2,65
"مازندران","بابلسر","رودبست",23,1049,8,3,128,1188,10,211
"مازندران","بابلسر","رودبست",24,354,2,1,29,386,7,65
"مازندران","بابلسر","رودبست",25,629,12,4,273,918,10,211
"مازندران","بابلسر","رودبست",26,567,1,0,24,592,1,65
"مازندران","بابلسر","رودبست",27,436,2,0,128,566,5,65
"مازندران","بابلسر","رودبست",28,845,2,1,79,927,5,211
"مازندران","بابلسر","رودبست",29,200,0,0,19,219,1,65
"مازندران","بابلسر","رودبست",30,366,4,0,32,402,0,211
"مازندران","بابلسر","رودبست",31,267,0,0,62,329,2,65
"مازندران","بابلسر","رودبست",32,175,0,0,46,221,1,211
"مازندران","بابلسر","رودبست",33,338,3,1,68,410,4,65
"مازندران","بابلسر","بهمنمیر",1,217,5,0,157,379,3,382
"مازندران","بابلسر","بهمنمیر",2,248,11,0,120,379,2,381
"مازندران","بابلسر","بهمنمیر",3,341,6,0,76,423,2,425
"مازندران","بابلسر","بهمنمیر",4,139,4,0,79,222,0,222
"مازندران","بابلسر","بهمنمیر",5,182,2,0,53,237,6,243
"مازندران","بابلسر","بهمنمیر",6,268,5,6,188,467,0,467
"مازندران","بابلسر","بهمنمیر",7,264,3,5,88,360,4,364
"مازندران","بابلسر","بهمنمیر",8,174,3,0,80,257,3,260
"مازندران","بابلسر","بهمنمیر",9,210,5,0,70,285,1,286
"مازندران","بابلسر","بهمنمیر",10,189,6,1,135,331,4,335
"مازندران","بابلسر","بهمنمیر",11,182,2,0,78,262,1,263
"مازندران","بابلسر","بهمنمیر",12,196,2,0,65,263,4,267
"مازندران","بابلسر","بهمنمیر",13,182,2,0,78,262,2,264
"مازندران","بابلسر","بهمنمیر",14,228,6,2,80,316,3,319
"مازندران","بابلسر","بهمنمیر",15,92,0,0,42,134,1,135
"مازندران","بابلسر","بهمنمیر",16,376,2,1,133,512,1,513
"مازندران","بابلسر","بهمنمیر",17,297,4,2,60,363,5,368
"مازندران","بابلسر","بهمنمیر",18,103,0,0,46,149,1,150
"مازندران","بابلسر","بهمنمیر",19,122,0,0,18,140,0,140
"مازندران","بابلسر","بهمنمیر",20,441,4,0,63,508,2,510
"مازندران","بابلسر","بهمنمیر",21,391,6,3,125,525,1,526
"مازندران","بابلسر","بهمنمیر",22,382,4,1,84,471,0,471
"مازندران","بابلسر","بهمنمیر",23,307,0,0,27,334,2,336
"مازندران","بابلسر","بهمنمیر",24,212,3,1,34,250,6,256
"مازندران","بابلسر","بهمنمیر",25,300,5,1,18,324,5,329
"مازندران","بابلسر","بهمنمیر",26,355,2,4,66,427,6,433
"مازندران","بابلسر","بهمنمیر",27,350,0,0,52,402,1,403
"مازندران","بابلسر","بهمنمیر",28,460,4,1,98,563,7,570
"مازندران","بابلسر","بهمنمیر",29,348,2,0,37,387,1,388
"مازندران","بابلسر","بهمنمیر",30,268,8,6,119,401,5,406
"مازندران","بابلسر","بهمنمیر",31,346,6,4,97,453,2,455
"مازندران","بابلسر","بهمنمیر",32,582,9,0,157,748,12,760
"مازندران","بابلسر","بهمنمیر",33,296,5,1,80,382,2,384
"مازندران","بابلسر","بهمنمیر",34,384,8,9,78,479,1,480
"مازندران","بابلسر","بهمنمیر",35,302,2,0,117,421,0,421
"مازندران","بابلسر","بهمنمیر",36,301,2,0,72,375,5,380
"مازندران","بابلسر","بهمنمیر",37,161,1,0,76,238,4,242
"مازندران","بابلسر","بهمنمیر",38,472,6,1,144,623,4,627
"مازندران","بابلسر","بهمنمیر",39,284,3,0,78,365,0,365
"مازندران","بابلسر","بهمنمیر",40,254,0,0,101,355,0,355
"مازندران","بابلسر","بهمنمیر",41,75,1,0,14,90,0,90
"مازندران","بابلسر","بهمنمیر",42,85,0,0,5,90,0,90
"مازندران","بهشهر","مرکزی",1,309,5,0,113,427,8,435
"مازندران","بهشهر","مرکزی",2,777,9,1,402,1189,7,1196
"مازندران","بهشهر","مرکزی",3,634,6,0,170,810,8,818
"مازندران","بهشهر","مرکزی",4,374,7,1,145,527,2,529
"مازندران","بهشهر","مرکزی",5,938,10,2,453,1403,16,1419
"مازندران","بهشهر","مرکزی",6,182,2,0,194,378,2,380
"مازندران","بهشهر","مرکزی",7,642,17,27,767,1453,16,1469
"مازندران","بهشهر","مرکزی",8,302,6,6,278,592,7,599
"مازندران","بهشهر","مرکزی",9,85,4,1,109,199,2,201
"مازندران","بهشهر","مرکزی",10,968,16,6,324,1314,10,1324
"مازندران","بهشهر","مرکزی",11,645,19,8,600,1272,6,1278
"مازندران","بهشهر","مرکزی",12,232,22,0,317,571,5,576
"مازندران","بهشهر","مرکزی",13,560,16,2,541,1119,11,1130
"مازندران","بهشهر","مرکزی",14,638,13,14,391,1056,6,1062
"مازندران","بهشهر","مرکزی",15,483,12,3,426,924,11,935
"مازندران","بهشهر","مرکزی",16,472,12,19,332,835,13,848
"مازندران","بهشهر","مرکزی",17,1428,13,2,291,1734,9,1743
"مازندران","بهشهر","مرکزی",18,479,2,1,213,695,9,704
"مازندران","بهشهر","مرکزی",19,1170,4,2,185,1361,4,1365
"مازندران","بهشهر","مرکزی",20,1222,7,6,308,1543,8,1551
"مازندران","بهشهر","مرکزی",21,604,2,0,125,731,7,738
"مازندران","بهشهر","مرکزی",22,950,7,8,209,1174,6,1180
"مازندران","بهشهر","مرکزی",23,1151,12,4,633,1800,12,1812
"مازندران","بهشهر","مرکزی",24,518,9,2,221,750,10,760
"مازندران","بهشهر","مرکزی",25,918,15,6,686,1625,18,1643
"مازندران","بهشهر","مرکزی",26,1279,12,3,312,1606,14,1620
"مازندران","بهشهر","مرکزی",27,595,7,0,138,740,5,745
"مازندران","بهشهر","مرکزی",28,285,6,1,64,356,3,359
"مازندران","بهشهر","مرکزی",29,1405,9,0,255,1669,15,1684
"مازندران","بهشهر","مرکزی",30,615,6,3,116,740,5,745
"مازندران","بهشهر","مرکزی",31,600,5,3,196,804,8,812
"مازندران","بهشهر","مرکزی",32,745,18,4,394,1161,10,1171
"مازندران","بهشهر","مرکزی",33,253,8,3,149,413,2,415
"مازندران","بهشهر","مرکزی",34,1105,13,4,305,1427,17,1444
"مازندران","بهشهر","مرکزی",35,296,7,7,280,590,6,596
"مازندران","بهشهر","مرکزی",36,392,17,9,578,996,20,1016
"مازندران","بهشهر","مرکزی",37,598,11,22,804,1435,19,1454
"مازندران","بهشهر","مرکزی",38,153,3,0,172,328,0,328
"مازندران","بهشهر","مرکزی",39,994,23,5,576,1598,11,1609
"مازندران","بهشهر","مرکزی",40,938,5,7,302,1252,10,1262
"مازندران","بهشهر","مرکزی",41,896,3,5,158,1062,2,1064
"مازندران","بهشهر","مرکزی",42,485,5,1,227,718,12,730
"مازندران","بهشهر","مرکزی",43,212,5,0,98,315,2,317
"مازندران","بهشهر","مرکزی",44,760,16,5,460,1241,18,1259
"مازندران","بهشهر","مرکزی",45,515,20,9,784,1328,10,1338
"مازندران","بهشهر","مرکزی",46,929,17,3,656,1605,10,1615
"مازندران","بهشهر","مرکزی",47,595,9,2,337,943,5,948
"مازندران","بهشهر","مرکزی",48,703,15,15,718,1451,17,1468
"مازندران","بهشهر","مرکزی",49,812,22,7,678,1519,14,1533
"مازندران","بهشهر","مرکزی",50,162,1,0,184,347,0,347
"مازندران","بهشهر","مرکزی",51,569,18,8,771,1366,9,1375
"مازندران","بهشهر","مرکزی",52,367,2,3,109,481,7,488
"مازندران","بهشهر","مرکزی",53,62,2,1,36,101,4,105
"مازندران","بهشهر","مرکزی",54,617,7,5,290,919,9,928
"مازندران","بهشهر","مرکزی",55,573,8,2,198,781,17,798
"مازندران","بهشهر","مرکزی",56,929,7,1,249,1186,12,1198
"مازندران","بهشهر","مرکزی",57,612,11,8,429,1060,14,1074
"مازندران","بهشهر","مرکزی",58,590,14,2,312,918,17,935
"مازندران","بهشهر","مرکزی",59,460,22,4,391,877,5,882
"مازندران","بهشهر","مرکزی",60,176,2,3,95,276,3,279
"مازندران","بهشهر","مرکزی",61,750,2,3,58,813,6,819
"مازندران","بهشهر","مرکزی",62,935,12,2,176,1125,8,1133
"مازندران","بهشهر","مرکزی",63,611,3,0,204,818,5,823
"مازندران","بهشهر","مرکزی",64,779,12,1,420,1212,6,1218
"مازندران","بهشهر","مرکزی",65,353,0,2,190,545,2,547
"مازندران","بهشهر","مرکزی",66,571,1,1,364,937,5,942
"مازندران","بهشهر","مرکزی",67,586,8,4,511,1109,5,1114
"مازندران","بهشهر","مرکزی",68,266,6,18,358,648,7,655
"مازندران","بهشهر","مرکزی",69,343,0,5,246,594,1,595
"مازندران","بهشهر","مرکزی",70,1011,9,2,286,1308,14,1322
"مازندران","بهشهر","مرکزی",71,835,7,0,125,967,9,976
"مازندران","بهشهر","مرکزی",72,441,6,0,138,585,7,592
"مازندران","بهشهر","مرکزی",73,679,19,2,362,1062,12,1074
"مازندران","بهشهر","مرکزی",74,604,12,4,485,1105,12,1117
"مازندران","بهشهر","مرکزی",75,581,1,0,390,972,15,987
"مازندران","بهشهر","مرکزی",76,842,12,3,286,1143,12,1155
"مازندران","بهشهر","مرکزی",77,1051,4,5,438,1498,21,1519
"مازندران","بهشهر","مرکزی",78,273,4,1,52,330,3,333
"مازندران","بهشهر","مرکزی",79,961,7,0,222,1190,6,1196
"مازندران","بهشهر","مرکزی",80,925,0,0,251,1176,11,1187
"مازندران","بهشهر","مرکزی",81,1054,8,1,202,1265,10,1275
"مازندران","بهشهر","مرکزی",82,308,2,3,47,360,2,362
"مازندران","بهشهر","مرکزی",83,905,1,0,308,1214,8,1222
"مازندران","بهشهر","مرکزی",84,325,1,1,101,428,3,431
"مازندران","بهشهر","مرکزی",85,331,0,1,65,397,3,400
"مازندران","بهشهر","مرکزی",86,787,7,2,278,1074,8,1082
"مازندران","بهشهر","مرکزی",87,599,2,3,216,820,5,825
"مازندران","بهشهر","مرکزی",88,1250,9,0,298,1557,10,1567
"مازندران","بهشهر","مرکزی",89,746,6,1,215,968,8,976
"مازندران","بهشهر","مرکزی",90,658,9,3,395,1065,3,1068
"مازندران","بهشهر","مرکزی",91,732,3,2,122,859,4,863
"مازندران","بهشهر","مرکزی",92,875,14,7,528,1424,8,1432
"مازندران","بهشهر","مرکزی",93,590,4,0,210,804,3,807
"مازندران","بهشهر","مرکزی",94,706,1,2,183,892,3,895
"مازندران","بهشهر","مرکزی",95,575,0,0,93,668,7,675
"مازندران","بهشهر","مرکزی",96,237,0,0,56,293,3,296
"مازندران","بهشهر","مرکزی",97,347,0,0,19,366,0,366
"مازندران","بهشهر","مرکزی",98,291,0,0,7,298,0,298
"مازندران","بهشهر","مرکزی",99,322,1,0,48,371,1,372
"مازندران","بهشهر","مرکزی",100,62,0,0,22,84,0,84
"مازندران","بهشهر","مرکزی",101,50,0,1,13,64,1,65
"مازندران","بهشهر","مرکزی",102,177,4,2,93,276,3,279
"مازندران","بهشهر","یانه_سر",1,319,1,0,30,350,1,351
"مازندران","بهشهر","یانه_سر",2,212,0,1,20,233,1,234
"مازندران","بهشهر","یانه_سر",3,259,2,0,3,264,0,264
"مازندران","بهشهر","یانه_سر",4,164,3,0,59,226,1,227
"مازندران","بهشهر","یانه_سر",5,151,0,0,61,212,2,214
"مازندران","بهشهر","یانه_سر",6,320,0,0,12,332,1,333
"مازندران","بهشهر","یانه_سر",7,267,0,0,12,279,1,280
"مازندران","بهشهر","یانه_سر",8,159,0,0,8,167,0,167
"مازندران","بهشهر","یانه_سر",9,224,3,3,98,328,1,329
"مازندران","بهشهر","یانه_سر",10,79,0,0,19,98,0,98
"مازندران","بهشهر","یانه_سر",11,298,0,0,32,330,0,330
"مازندران","بهشهر","یانه_سر",12,174,0,0,17,191,0,191
"مازندران","بهشهر","یانه_سر",13,134,0,0,26,160,1,161
"مازندران","بهشهر","یانه_سر",14,283,0,0,42,325,3,328
"مازندران","بهشهر","یانه_سر",15,380,1,0,13,394,0,394
"مازندران","بهشهر","یانه_سر",16,133,0,1,30,164,0,164
"مازندران","بهشهر","یانه_سر",17,124,1,1,19,145,1,146
"مازندران","بهشهر","یانه_سر",18,233,0,0,3,236,0,236
"مازندران","بهشهر","یانه_سر",19,549,0,0,34,583,4,587
"مازندران","بهشهر","یانه_سر",20,140,0,0,27,167,0,167
"مازندران","بهشهر","یانه_سر",21,373,6,0,30,409,0,409
"مازندران","تنکابن","مرکزی",1,623,20,19,1040,1702,17,1719
"مازندران","تنکابن","مرکزی",2,470,12,11,1023,1516,11,1527
"مازندران","تنکابن","مرکزی",3,560,6,22,571,1159,11,1170
"مازندران","تنکابن","مرکزی",4,165,5,5,455,630,12,642
"مازندران","تنکابن","مرکزی",5,219,8,10,566,803,7,810
"مازندران","تنکابن","مرکزی",6,515,24,28,1086,1653,20,1673
"مازندران","تنکابن","مرکزی",7,96,3,1,166,266,1,267
"مازندران","تنکابن","مرکزی",8,217,14,9,494,734,4,738
"مازندران","تنکابن","مرکزی",9,762,11,8,857,1638,10,1648
"مازندران","تنکابن","مرکزی",10,230,9,3,260,502,6,508
"مازندران","تنکابن","مرکزی",11,860,20,16,760,1656,13,1669
"مازندران","تنکابن","مرکزی",12,340,9,3,430,782,0,782
"مازندران","تنکابن","مرکزی",13,994,11,16,622,1643,14,1657
"مازندران","تنکابن","مرکزی",14,1130,9,0,223,1362,1,1363
"مازندران","تنکابن","مرکزی",15,317,0,0,82,399,7,406
"مازندران","تنکابن","مرکزی",16,309,4,1,302,616,2,618
"مازندران","تنکابن","مرکزی",17,594,6,3,253,856,0,856
"مازندران","تنکابن","مرکزی",18,323,8,4,282,617,6,623
"مازندران","تنکابن","مرکزی",19,648,7,4,418,1077,0,1077
"مازندران","تنکابن","مرکزی",20,436,20,19,899,1374,15,1389
"مازندران","تنکابن","مرکزی",21,231,7,7,288,533,2,535
"مازندران","تنکابن","مرکزی",22,513,6,9,461,989,8,997
"مازندران","تنکابن","مرکزی",23,610,13,11,880,1514,12,1526
"مازندران","تنکابن","مرکزی",24,312,7,18,539,876,9,885
"مازندران","تنکابن","مرکزی",25,433,12,5,429,879,15,894
"مازندران","تنکابن","مرکزی",26,105,2,6,145,258,5,263
"مازندران","تنکابن","مرکزی",27,334,9,7,392,742,9,751
"مازندران","تنکابن","مرکزی",28,700,19,4,867,1590,23,1613
"مازندران","تنکابن","مرکزی",29,1021,10,0,611,1642,3,1645
"مازندران","تنکابن","مرکزی",30,412,8,3,255,678,4,682
"مازندران","تنکابن","مرکزی",31,204,10,3,199,416,0,416
"مازندران","تنکابن","مرکزی",32,1007,14,3,583,1607,10,1617
"مازندران","تنکابن","مرکزی",33,371,4,1,170,546,1,547
"مازندران","تنکابن","مرکزی",34,225,7,4,130,366,6,372
"مازندران","تنکابن","مرکزی",35,633,12,5,539,1189,15,1204
"مازندران","تنکابن","مرکزی",36,561,2,4,259,826,3,829
"مازندران","تنکابن","مرکزی",37,372,0,1,112,485,2,487
"مازندران","تنکابن","مرکزی",38,245,1,1,90,337,3,340
"مازندران","تنکابن","مرکزی",39,479,6,0,239,724,4,728
"مازندران","تنکابن","مرکزی",40,211,1,0,94,306,3,309
"مازندران","تنکابن","مرکزی",41,189,1,0,82,272,1,273
"مازندران","تنکابن","مرکزی",42,461,8,0,159,628,11,639
"مازندران","تنکابن","مرکزی",43,339,9,0,113,461,3,464
"مازندران","تنکابن","مرکزی",44,622,3,5,263,893,6,899
"مازندران","تنکابن","مرکزی",45,501,5,1,124,631,2,633
"مازندران","تنکابن","مرکزی",46,251,4,0,99,354,2,356
"مازندران","تنکابن","مرکزی",47,309,1,0,17,327,2,329
"مازندران","تنکابن","مرکزی",48,554,5,2,273,834,0,834
"مازندران","تنکابن","مرکزی",49,447,0,0,95,542,3,545
"مازندران","تنکابن","مرکزی",50,320,2,0,79,401,0,401
"مازندران","تنکابن","مرکزی",51,227,3,1,83,314,5,319
"مازندران","تنکابن","مرکزی",52,499,3,0,189,691,2,693
"مازندران","تنکابن","مرکزی",53,279,1,0,49,329,1,330
"مازندران","تنکابن","مرکزی",54,464,4,1,167,636,3,639
"مازندران","تنکابن","مرکزی",55,565,5,3,197,770,6,776
"مازندران","تنکابن","مرکزی",56,642,3,0,101,746,5,751
"مازندران","تنکابن","مرکزی",57,629,2,2,327,960,8,968
"مازندران","تنکابن","مرکزی",58,447,4,2,245,698,2,700
"مازندران","تنکابن","مرکزی",59,190,3,0,71,264,0,264
"مازندران","تنکابن","مرکزی",60,191,4,1,108,304,2,306
"مازندران","تنکابن","مرکزی",61,793,13,3,298,1107,0,1107
"مازندران","تنکابن","مرکزی",62,432,3,3,231,669,2,671
"مازندران","تنکابن","مرکزی",63,481,4,4,211,700,4,704
"مازندران","تنکابن","مرکزی",64,559,3,1,139,702,5,707
"مازندران","تنکابن","مرکزی",65,244,4,2,138,388,0,388
"مازندران","تنکابن","مرکزی",66,835,22,17,596,1470,10,1480
"مازندران","تنکابن","مرکزی",67,254,8,6,329,597,3,600
"مازندران","تنکابن","مرکزی",68,738,10,13,323,1084,9,1093
"مازندران","تنکابن","مرکزی",69,116,0,0,31,147,0,147
"مازندران","تنکابن","مرکزی",70,281,1,0,192,474,2,476
"مازندران","تنکابن","مرکزی",71,203,0,0,61,264,0,264
"مازندران","تنکابن","مرکزی",72,627,1,0,132,760,1,761
"مازندران","تنکابن","مرکزی",73,310,2,0,102,414,3,417
"مازندران","تنکابن","مرکزی",74,379,2,0,113,494,0,494
"مازندران","تنکابن","خرم_آباد",1,886,9,7,539,1441,18,1459
"مازندران","تنکابن","خرم_آباد",2,490,11,5,343,849,8,857
"مازندران","تنکابن","خرم_آباد",3,578,8,2,298,886,6,892
"مازندران","تنکابن","خرم_آباد",4,535,11,2,340,888,10,898
"مازندران","تنکابن","خرم_آباد",5,394,3,9,273,679,3,682
"مازندران","تنکابن","خرم_آباد",6,407,5,1,221,634,1,635
"مازندران","تنکابن","خرم_آباد",7,312,4,1,211,528,8,536
"مازندران","تنکابن","خرم_آباد",8,197,2,0,116,315,3,318
"مازندران","تنکابن","خرم_آباد",9,323,4,2,129,458,2,460
"مازندران","تنکابن","خرم_آباد",10,162,8,1,63,234,1,235
"مازندران","تنکابن","خرم_آباد",11,165,5,6,164,340,0,340
"مازندران","تنکابن","خرم_آباد",12,702,13,10,461,1186,17,1203
"مازندران","تنکابن","خرم_آباد",13,586,10,1,331,928,5,933
"مازندران","تنکابن","خرم_آباد",14,598,4,9,283,894,5,899
"مازندران","تنکابن","خرم_آباد",15,789,5,3,618,1415,7,1422
"مازندران","تنکابن","خرم_آباد",16,301,3,5,166,475,2,477
"مازندران","تنکابن","خرم_آباد",17,437,6,0,372,815,7,822
"مازندران","تنکابن","خرم_آباد",18,366,1,1,180,548,2,550
"مازندران","تنکابن","خرم_آباد",19,531,4,1,317,853,3,856
"مازندران","تنکابن","خرم_آباد",20,314,3,3,90,410,4,414
"مازندران","تنکابن","خرم_آباد",21,402,3,12,109,526,3,529
"مازندران","تنکابن","خرم_آباد",22,979,5,7,509,1500,6,1506
"مازندران","تنکابن","خرم_آباد",23,670,4,1,78,753,3,756
"مازندران","تنکابن","خرم_آباد",24,240,3,4,168,415,6,421
"مازندران","تنکابن","خرم_آباد",25,335,6,1,127,469,6,475
"مازندران","تنکابن","خرم_آباد",26,189,1,1,121,312,2,314
"مازندران","تنکابن","خرم_آباد",27,265,1,1,114,381,2,383
"مازندران","تنکابن","خرم_آباد",28,288,4,3,163,458,3,461
"مازندران","تنکابن","خرم_آباد",29,144,1,0,90,235,2,237
"مازندران","تنکابن","خرم_آباد",30,468,5,6,165,644,1,645
"مازندران","تنکابن","خرم_آباد",31,430,1,5,86,522,4,526
"مازندران","تنکابن","خرم_آباد",32,659,3,0,50,712,2,714
"مازندران","تنکابن","خرم_آباد",33,619,9,0,122,750,1,751
"مازندران","تنکابن","خرم_آباد",34,364,3,2,105,474,2,476
"مازندران","تنکابن","خرم_آباد",35,263,2,0,155,420,3,423
"مازندران","تنکابن","خرم_آباد",36,320,1,0,51,372,0,372
"مازندران","تنکابن","خرم_آباد",37,251,0,5,114,370,1,371
"مازندران","تنکابن","خرم_آباد",38,318,5,1,174,498,4,502
"مازندران","تنکابن","خرم_آباد",39,387,3,0,51,441,0,441
"مازندران","تنکابن","خرم_آباد",40,412,3,0,163,578,3,581
"مازندران","تنکابن","خرم_آباد",41,150,0,0,4,154,0,154
"مازندران","تنکابن","خرم_آباد",42,202,0,1,17,220,0,220
"مازندران","تنکابن","خرم_آباد",43,303,0,2,70,375,3,378
"مازندران","تنکابن","خرم_آباد",44,66,0,1,31,98,0,98
"مازندران","تنکابن","خرم_آباد",45,293,1,0,138,432,0,432
"مازندران","تنکابن","خرم_آباد",46,216,2,4,73,295,2,297
"مازندران","تنکابن","خرم_آباد",47,158,1,1,68,228,0,228
"مازندران","تنکابن","عباس_آباد",1,262,8,5,276,551,8,559
"مازندران","تنکابن","عباس_آباد",2,382,15,6,446,849,2,851
"مازندران","تنکابن","عباس_آباد",3,219,0,2,121,342,1,343
"مازندران","تنکابن","عباس_آباد",4,359,14,8,359,740,10,750
"مازندران","تنکابن","عباس_آباد",5,828,16,13,670,1527,6,1533
"مازندران","تنکابن","عباس_آباد",6,683,15,3,345,1046,9,1055
"مازندران","تنکابن","عباس_آباد",7,523,15,0,284,822,4,826
"مازندران","تنکابن","عباس_آباد",8,439,14,2,500,955,11,966
"مازندران","تنکابن","عباس_آباد",9,267,2,5,219,493,7,500
"مازندران","تنکابن","عباس_آباد",10,209,2,3,269,483,4,487
"مازندران","تنکابن","عباس_آباد",11,188,5,1,250,444,4,448
"مازندران","تنکابن","عباس_آباد",12,132,2,0,111,245,1,246
"مازندران","تنکابن","عباس_آباد",13,236,11,3,225,475,3,478
"مازندران","تنکابن","عباس_آباد",14,178,0,1,156,335,2,337
"مازندران","تنکابن","عباس_آباد",15,140,0,1,91,232,5,237
"مازندران","تنکابن","عباس_آباد",16,360,5,0,112,477,1,478
"مازندران","تنکابن","عباس_آباد",17,244,0,1,54,299,3,302
"مازندران","تنکابن","عباس_آباد",18,269,2,2,63,336,0,336
"مازندران","تنکابن","عباس_آباد",19,132,0,0,45,177,1,178
"مازندران","تنکابن","عباس_آباد",20,192,7,3,114,316,3,319
"مازندران","تنکابن","عباس_آباد",21,423,11,1,147,582,2,584
"مازندران","تنکابن","عباس_آباد",22,315,9,1,122,447,3,450
"مازندران","تنکابن","عباس_آباد",23,160,0,0,66,226,1,227
"مازندران","تنکابن","عباس_آباد",24,171,2,0,34,207,0,207
"مازندران","تنکابن","عباس_آباد",25,308,1,1,92,402,0,402
"مازندران","تنکابن","عباس_آباد",26,448,4,3,251,706,5,711
"مازندران","تنکابن","عباس_آباد",27,340,1,5,229,575,11,586
"مازندران","تنکابن","عباس_آباد",28,368,10,7,399,784,8,792
"مازندران","تنکابن","عباس_آباد",29,228,3,1,91,323,1,324
"مازندران","تنکابن","عباس_آباد",30,156,1,0,50,207,1,208
"مازندران","تنکابن","عباس_آباد",31,140,2,0,63,205,0,205
"مازندران","تنکابن","عباس_آباد",32,108,1,0,30,139,3,142
"مازندران","تنکابن","عباس_آباد",33,182,0,5,59,246,1,247
"مازندران","تنکابن","عباس_آباد",34,191,2,11,136,340,1,341
"مازندران","تنکابن","عباس_آباد",35,1011,10,6,621,1648,9,1657
"مازندران","تنکابن","عباس_آباد",36,443,10,9,589,1051,6,1057
"مازندران","تنکابن","عباس_آباد",37,579,19,21,945,1564,15,1579
"مازندران","تنکابن","عباس_آباد",38,405,12,18,606,1041,7,1048
"مازندران","تنکابن","عباس_آباد",39,565,13,8,387,973,5,978
"مازندران","تنکابن","عباس_آباد",40,555,0,2,260,817,0,817
"مازندران","تنکابن","عباس_آباد",41,360,5,15,284,664,7,671
"مازندران","تنکابن","عباس_آباد",42,134,2,9,74,219,0,219
"مازندران","تنکابن","عباس_آباد",43,587,11,11,237,846,3,849
"مازندران","تنکابن","عباس_آباد",44,510,3,5,172,690,11,701
"مازندران","تنکابن","عباس_آباد",45,237,1,21,124,383,4,387
"مازندران","تنکابن","عباس_آباد",46,96,0,2,54,152,1,153
"مازندران","تنکابن","عباس_آباد",47,497,20,8,336,861,4,865
"مازندران","تنکابن","عباس_آباد",48,236,0,3,57,296,1,297
"مازندران","تنکابن","عباس_آباد",49,107,0,1,63,171,0,171
"مازندران","تنکابن","عباس_آباد",50,377,0,4,123,504,4,508
"مازندران","تنکابن","عباس_آباد",51,144,1,9,139,293,4,297
"مازندران","تنکابن","عباس_آباد",52,184,0,10,84,278,2,280
"مازندران","تنکابن","عباس_آباد",53,393,14,6,475,888,5,893
"مازندران","تنکابن","عباس_آباد",54,738,16,2,460,1216,12,1228
"مازندران","تنکابن","عباس_آباد",55,463,8,2,469,942,11,953
"مازندران","تنکابن","عباس_آباد",56,526,21,13,619,1179,10,1189
"مازندران","تنکابن","عباس_آباد",57,285,2,3,246,536,6,542
"مازندران","تنکابن","عباس_آباد",58,309,5,6,332,652,3,655
"مازندران","تنکابن","عباس_آباد",59,432,1,6,121,560,1,561
"مازندران","تنکابن","عباس_آباد",60,287,12,0,268,567,6,573
"مازندران","تنکابن","عباس_آباد",61,124,4,1,102,231,3,234
"مازندران","تنکابن","نشتا",1,679,21,9,684,1393,14,1407
"مازندران","تنکابن","نشتا",2,405,6,7,272,690,10,700
"مازندران","تنکابن","نشتا",3,403,9,3,456,871,4,875
"مازندران","تنکابن","نشتا",4,187,5,10,376,578,3,581
"مازندران","تنکابن","نشتا",5,206,2,4,201,413,0,413
"مازندران","تنکابن","نشتا",6,285,1,1,139,426,7,433
"مازندران","تنکابن","نشتا",7,209,6,3,187,405,2,407
"مازندران","تنکابن","نشتا",8,579,1,0,152,732,5,737
"مازندران","تنکابن","نشتا",9,157,6,2,294,459,1,460
"مازندران","تنکابن","نشتا",10,540,6,3,178,727,3,730
"مازندران","تنکابن","نشتا",11,247,1,0,193,441,1,442
"مازندران","تنکابن","نشتا",12,404,1,3,312,720,6,726
"مازندران","تنکابن","نشتا",13,374,3,0,85,462,2,464
"مازندران","تنکابن","نشتا",14,395,0,1,214,610,3,613
"مازندران","تنکابن","نشتا",15,389,7,2,179,577,9,586
"مازندران","تنکابن","نشتا",16,434,7,4,334,779,6,785
"مازندران","تنکابن","نشتا",17,208,2,1,290,501,3,504
"مازندران","تنکابن","نشتا",18,390,6,1,262,659,7,666
"مازندران","تنکابن","نشتا",19,387,1,1,222,611,0,611
"مازندران","تنکابن","نشتا",20,293,8,0,205,506,3,509
"مازندران","تنکابن","نشتا",21,438,12,5,248,703,7,710
"مازندران","تنکابن","نشتا",22,296,6,0,58,360,0,360
"مازندران","تنکابن","نشتا",23,297,5,1,121,424,1,425
"مازندران","تنکابن","نشتا",24,411,6,3,215,635,7,642
"مازندران","تنکابن","نشتا",25,229,2,1,71,303,0,303
"مازندران","تنکابن","نشتا",26,136,2,0,25,163,1,164
"مازندران","تنکابن","نشتا",27,191,1,1,24,217,0,217
"مازندران","تنکابن","نشتا",28,91,0,0,62,153,1,154
"مازندران","تنکابن","نشتا",29,103,1,0,33,137,1,138
"مازندران","تنکابن","نشتا",30,184,3,1,75,263,0,263
"مازندران","تنکابن","نشتا",31,102,0,0,80,182,1,183
"مازندران","تنکابن","نشتا",32,53,0,0,107,160,0,160
"مازندران","تنکابن","نشتا",33,115,3,2,170,290,2,292
"مازندران","تنکابن","نشتا",34,114,0,0,105,219,1,220
"مازندران","تنکابن","نشتا",35,123,0,0,52,175,0,175
"مازندران","تنکابن","نشتا",36,144,5,0,63,212,1,213
"مازندران","تنکابن","نشتا",37,294,3,0,106,403,3,406
"مازندران","تنکابن","نشتا",38,149,2,0,32,183,0,183
"مازندران","جویبار","مرکزی",1,1022,8,18,384,1432,12,1444
"مازندران","جویبار","مرکزی",2,1188,17,8,413,1626,13,1639
"مازندران","جویبار","مرکزی",3,849,23,36,518,1426,12,1438
"مازندران","جویبار","مرکزی",4,1039,15,67,814,1935,14,1949
"مازندران","جویبار","مرکزی",5,1057,15,22,502,1596,27,1623
"مازندران","جویبار","مرکزی",6,632,16,22,590,1260,14,1274
"مازندران","جویبار","مرکزی",7,394,7,49,309,759,12,771
"مازندران","جویبار","مرکزی",8,900,5,28,283,1216,15,1231
"مازندران","جویبار","مرکزی",9,886,22,11,580,1499,23,1522
"مازندران","جویبار","مرکزی",10,219,6,35,312,572,11,583
"مازندران","جویبار","مرکزی",11,833,9,4,210,1056,15,1071
"مازندران","جویبار","مرکزی",12,356,13,29,183,581,8,589
"مازندران","جویبار","مرکزی",13,274,6,9,100,389,10,399
"مازندران","جویبار","مرکزی",14,622,6,3,179,810,4,814
"مازندران","جویبار","مرکزی",15,189,4,9,65,267,0,267
"مازندران","جویبار","مرکزی",16,201,2,2,20,225,1,226
"مازندران","جویبار","مرکزی",17,559,4,10,111,684,7,691
"مازندران","جویبار","مرکزی",18,282,1,0,191,474,2,476
"مازندران","جویبار","مرکزی",19,686,5,5,121,817,9,826
"مازندران","جویبار","مرکزی",20,197,1,13,40,251,1,252
"مازندران","جویبار","مرکزی",21,416,0,2,61,479,5,484
"مازندران","جویبار","مرکزی",22,566,6,0,122,694,2,696
"مازندران","جویبار","مرکزی",23,458,3,2,120,583,7,590
"مازندران","جویبار","مرکزی",24,910,6,1,69,986,5,991
"مازندران","جویبار","مرکزی",25,500,6,0,73,579,5,584
"مازندران","جویبار","مرکزی",26,665,5,9,276,955,7,962
"مازندران","جویبار","مرکزی",27,834,7,15,199,1055,7,1062
"مازندران","جویبار","مرکزی",28,515,5,0,59,579,2,581
"مازندران","جویبار","مرکزی",29,450,7,0,115,572,2,574
"مازندران","جویبار","مرکزی",30,500,9,3,65,577,2,579
"مازندران","جویبار","مرکزی",31,602,5,0,140,747,0,747
"مازندران","جویبار","مرکزی",32,259,4,0,108,371,2,373
"مازندران","جویبار","مرکزی",33,855,8,1,103,967,4,971
"مازندران","جویبار","مرکزی",34,776,5,1,133,915,7,922
"مازندران","جویبار","مرکزی",35,377,7,3,106,493,6,499
"مازندران","جویبار","مرکزی",36,762,2,5,132,901,2,903
"مازندران","جویبار","مرکزی",37,296,0,0,54,350,3,353
"مازندران","جویبار","مرکزی",38,354,4,0,45,403,1,404
"مازندران","جویبار","گیلخواران",1,497,4,1,216,718,5,723
"مازندران","جویبار","گیلخواران",2,407,11,9,243,670,5,675
"مازندران","جویبار","گیلخواران",3,756,9,3,200,968,8,976
"مازندران","جویبار","گیلخواران",4,628,3,3,167,801,6,807
"مازندران","جویبار","گیلخواران",5,577,3,5,136,721,1,722
"مازندران","جویبار","گیلخواران",6,758,2,1,137,898,2,900
"مازندران","جویبار","گیلخواران",7,776,5,6,208,995,8,1003
"مازندران","جویبار","گیلخواران",8,386,1,15,67,469,5,474
"مازندران","جویبار","گیلخواران",9,834,9,1,264,1108,8,1116
"مازندران","جویبار","گیلخواران",10,643,5,0,208,856,7,863
"مازندران","جویبار","گیلخواران",11,734,6,5,329,1074,11,1085
"مازندران","جویبار","گیلخواران",12,318,3,7,82,410,0,410
"مازندران","جویبار","گیلخواران",13,280,3,4,84,371,3,374
"مازندران","جویبار","گیلخواران",14,262,3,1,83,349,1,350
"مازندران","جویبار","گیلخواران",15,332,6,5,100,443,0,443
"مازندران","جویبار","گیلخواران",16,310,1,0,55,366,4,370
"مازندران","جویبار","گیلخواران",17,371,1,6,56,434,5,439
"مازندران","جویبار","گیلخواران",18,186,0,2,40,228,0,228
"مازندران","جویبار","گیلخواران",19,538,9,2,103,652,5,657
"مازندران","جویبار","گیلخواران",20,520,5,5,170,700,6,706
"مازندران","جویبار","گیلخواران",21,425,2,1,53,481,1,482
"مازندران","جویبار","گیلخواران",22,99,5,10,99,213,1,214
"مازندران","چالوس","مرکزی",1,822,14,5,516,1357,20,1377
"مازندران","چالوس","مرکزی",2,370,13,11,596,990,7,997
"مازندران","چالوس","مرکزی",3,558,15,11,541,1125,12,1137
"مازندران","چالوس","مرکزی",4,908,9,5,384,1306,13,1319
"مازندران","چالوس","مرکزی",5,909,15,1,542,1467,17,1484
"مازندران","چالوس","مرکزی",6,506,6,5,324,841,10,851
"مازندران","چالوس","مرکزی",7,504,24,7,523,1058,17,1075
"مازندران","چالوس","مرکزی",8,237,5,1,287,530,7,537
"مازندران","چالوس","مرکزی",9,836,7,2,226,1071,8,1079
"مازندران","چالوس","مرکزی",10,306,3,0,86,395,5,400
"مازندران","چالوس","مرکزی",11,493,14,6,376,889,5,894
"مازندران","چالوس","مرکزی",12,396,8,2,113,519,10,529
"مازندران","چالوس","مرکزی",13,164,4,0,129,297,1,298
"مازندران","چالوس","مرکزی",14,500,13,11,560,1084,11,1095
"مازندران","چالوس","مرکزی",15,958,17,12,707,1694,18,1712
"مازندران","چالوس","مرکزی",16,502,15,9,318,844,14,858
"مازندران","چالوس","مرکزی",17,453,2,8,373,836,9,845
"مازندران","چالوس","مرکزی",18,784,12,11,415,1222,16,1238
"مازندران","چالوس","مرکزی",19,451,3,3,132,589,9,598
"مازندران","چالوس","مرکزی",20,252,11,1,157,421,3,424
"مازندران","چالوس","مرکزی",21,263,4,1,44,312,0,312
"مازندران","چالوس","مرکزی",22,533,12,7,282,834,5,839
"مازندران","چالوس","مرکزی",23,260,6,5,256,527,7,534
"مازندران","چالوس","مرکزی",24,892,31,15,894,1832,18,1850
"مازندران","چالوس","مرکزی",25,479,14,10,763,1266,16,1282
"مازندران","چالوس","مرکزی",26,468,16,13,772,1269,10,1279
"مازندران","چالوس","مرکزی",27,398,17,4,392,811,8,819
"مازندران","چالوس","مرکزی",28,537,5,0,276,818,6,824
"مازندران","چالوس","مرکزی",29,435,10,6,596,1047,7,1054
"مازندران","چالوس","مرکزی",30,184,7,2,280,473,6,479
"مازندران","چالوس","مرکزی",31,374,4,1,204,583,4,587
"مازندران","چالوس","مرکزی",32,652,10,4,260,926,7,933
"مازندران","چالوس","مرکزی",33,448,1,1,240,690,10,700
"مازندران","چالوس","مرکزی",34,617,11,5,390,1023,7,1030
"مازندران","چالوس","مرکزی",35,638,12,8,300,958,9,967
"مازندران","چالوس","مرکزی",36,496,5,0,177,678,8,686
"مازندران","چالوس","مرکزی",37,343,22,3,485,853,12,865
"مازندران","چالوس","مرکزی",38,724,8,1,184,917,6,923
"مازندران","چالوس","مرکزی",39,883,4,4,289,1180,8,1188
"مازندران","چالوس","مرکزی",40,230,1,6,78,315,1,316
"مازندران","چالوس","مرکزی",41,571,18,6,597,1192,7,1199
"مازندران","چالوس","مرکزی",42,481,3,2,293,779,5,784
"مازندران","چالوس","مرکزی",43,511,6,2,104,623,7,630
"مازندران","چالوس","مرکزی",44,761,4,0,168,933,2,935
"مازندران","چالوس","مرکزی",45,489,4,1,81,575,2,577
"مازندران","چالوس","مرکزی",46,162,2,0,106,270,2,272
"مازندران","چالوس","مرکزی",47,401,0,1,168,570,3,573
"مازندران","چالوس","مرکزی",48,538,10,2,132,682,2,684
"مازندران","چالوس","مرکزی",49,517,2,1,170,690,6,696
"مازندران","چالوس","مرکزی",50,496,6,0,95,597,4,601
"مازندران","چالوس","مرکزی",51,541,6,1,220,768,2,770
"مازندران","چالوس","مرکزی",52,687,5,2,144,838,2,840
"مازندران","چالوس","مرکزی",53,555,1,26,153,735,5,740
"مازندران","چالوس","مرکزی",54,551,2,2,135,690,6,696
"مازندران","چالوس","مرکزی",55,433,13,2,429,877,3,880
"مازندران","چالوس","مرکزی",56,388,8,10,565,971,2,973
"مازندران","چالوس","مرکزی",57,342,10,0,139,491,2,493
"مازندران","چالوس","مرکزی",58,126,0,104,67,297,3,300
"مازندران","چالوس","مرکزی",59,213,1,1,197,412,0,412
"مازندران","چالوس","مرکزی",60,290,1,17,186,494,1,495
"مازندران","چالوس","مرکزی",61,723,18,2,418,1161,13,1174
"مازندران","چالوس","مرکزی",62,603,3,3,219,828,6,834
"مازندران","چالوس","مرکزی",63,379,6,4,248,637,5,642
"مازندران","چالوس","مرکزی",64,851,5,0,270,1126,8,1134
"مازندران","چالوس","مرکزی",65,463,14,0,443,920,8,928
"مازندران","چالوس","مرکزی",66,583,3,3,446,1035,5,1040
"مازندران","چالوس","مرکزی",67,387,6,1,197,591,1,592
"مازندران","چالوس","مرکزی",68,321,11,5,457,794,9,803
"مازندران","چالوس","کلاردشت",1,492,9,10,434,945,13,958
"مازندران","چالوس","کلاردشت",2,342,11,13,472,838,13,851
"مازندران","چالوس","کلاردشت",3,481,24,24,845,1374,4,1378
"مازندران","چالوس","کلاردشت",4,516,14,21,520,1071,6,1077
"مازندران","چالوس","کلاردشت",5,365,11,5,426,807,5,812
"مازندران","چالوس","کلاردشت",6,721,12,11,759,1503,13,1516
"مازندران","چالوس","کلاردشت",7,605,12,16,737,1370,14,1384
"مازندران","چالوس","کلاردشت",8,552,4,4,255,815,5,820
"مازندران","چالوس","کلاردشت",9,336,2,12,435,785,0,785
"مازندران","چالوس","کلاردشت",10,1427,40,11,793,2271,17,2288
"مازندران","چالوس","کلاردشت",11,536,15,8,262,821,4,825
"مازندران","چالوس","کلاردشت",12,311,1,3,143,458,6,464
"مازندران","چالوس","کلاردشت",13,178,5,5,104,292,8,300
"مازندران","چالوس","کلاردشت",14,531,5,4,268,808,7,815
"مازندران","چالوس","کلاردشت",15,171,4,210,187,572,4,576
"مازندران","چالوس","کلاردشت",16,151,2,290,178,621,1,622
"مازندران","چالوس","کلاردشت",17,395,5,87,398,885,7,892
"مازندران","چالوس","کلاردشت",18,459,7,3,440,909,2,911
"مازندران","چالوس","کلاردشت",19,305,1,5,146,457,0,457
"مازندران","چالوس","کلاردشت",20,290,2,4,313,609,0,609
"مازندران","چالوس","کلاردشت",21,521,13,2,376,912,10,922
"مازندران","چالوس","کلاردشت",22,479,6,0,142,627,6,633
"مازندران","چالوس","کلاردشت",23,578,6,9,510,1103,2,1105
"مازندران","چالوس","کلاردشت",24,187,0,0,151,338,3,341
"مازندران","چالوس","کلاردشت",25,460,3,18,264,745,2,747
"مازندران","چالوس","کلاردشت",26,148,5,0,217,370,2,372
"مازندران","چالوس","کلاردشت",27,153,6,2,76,237,1,238
"مازندران","چالوس","کلاردشت",28,359,6,1,275,641,12,653
"مازندران","چالوس","کلاردشت",29,260,1,1,41,303,0,303
"مازندران","چالوس","کلاردشت",30,300,0,0,15,315,0,315
"مازندران","چالوس","کلاردشت",31,255,2,0,124,381,3,384
"مازندران","چالوس","کلاردشت",32,364,0,11,79,454,0,454
"مازندران","چالوس","کلاردشت",33,189,0,1,33,223,1,224
"مازندران","چالوس","کلاردشت",34,460,2,0,50,512,1,513
"مازندران","چالوس","کلاردشت",35,195,0,0,47,242,4,246
"مازندران","چالوس","کلاردشت",36,367,1,1,57,426,0,426
"مازندران","چالوس","کلاردشت",37,44,0,0,5,49,0,49
"مازندران","چالوس","کلاردشت",38,182,0,0,1,183,0,183
"مازندران","چالوس","کلاردشت",39,278,1,1,73,353,1,354
"مازندران","چالوس","کلاردشت",40,459,4,0,124,587,5,592
"مازندران","چالوس","کلاردشت",41,313,2,0,21,336,0,336
"مازندران","چالوس","کلاردشت",42,200,0,0,20,220,0,220
"مازندران","چالوس","کلاردشت",43,212,25,3,233,473,5,478
"مازندران","رامسر","مرکزی",1,471,10,5,360,846,12,858
"مازندران","رامسر","مرکزی",2,406,6,0,322,734,8,742
"مازندران","رامسر","مرکزی",3,538,14,6,438,996,11,1007
"مازندران","رامسر","مرکزی",4,150,5,2,124,281,3,284
"مازندران","رامسر","مرکزی",5,380,3,1,272,656,2,658
"مازندران","رامسر","مرکزی",6,212,9,3,268,492,4,496
"مازندران","رامسر","مرکزی",7,581,19,5,668,1273,25,1298
"مازندران","رامسر","مرکزی",8,274,4,0,331,609,6,615
"مازندران","رامسر","مرکزی",9,405,7,0,199,611,9,620
"مازندران","رامسر","مرکزی",10,295,7,6,246,554,9,563
"مازندران","رامسر","مرکزی",11,592,10,6,508,1116,12,1128
"مازندران","رامسر","مرکزی",12,219,5,4,330,558,9,567
"مازندران","رامسر","مرکزی",13,710,11,1,569,1291,7,1298
"مازندران","رامسر","مرکزی",14,470,20,3,798,1291,9,1300
"مازندران","رامسر","مرکزی",15,523,24,11,507,1065,9,1074
"مازندران","رامسر","مرکزی",16,594,9,1,255,859,6,865
"مازندران","رامسر","مرکزی",17,204,6,4,346,560,8,568
"مازندران","رامسر","مرکزی",18,316,7,4,502,829,14,843
"مازندران","رامسر","مرکزی",19,617,25,10,756,1408,15,1423
"مازندران","رامسر","مرکزی",20,255,5,0,302,562,7,569
"مازندران","رامسر","مرکزی",21,423,14,6,476,919,10,929
"مازندران","رامسر","مرکزی",22,184,5,2,237,428,4,432
"مازندران","رامسر","مرکزی",23,546,10,1,540,1097,11,1108
"مازندران","رامسر","مرکزی",24,609,23,11,763,1406,9,1415
"مازندران","رامسر","مرکزی",25,179,1,1,248,429,5,434
"مازندران","رامسر","مرکزی",26,191,3,6,149,349,3,352
"مازندران","رامسر","مرکزی",27,590,10,4,365,969,9,978
"مازندران","رامسر","مرکزی",28,356,10,4,409,779,15,794
"مازندران","رامسر","مرکزی",29,197,4,6,120,327,4,331
"مازندران","رامسر","مرکزی",30,98,3,2,183,286,6,292
"مازندران","رامسر","مرکزی",31,771,15,2,672,1460,21,1481
"مازندران","رامسر","مرکزی",32,551,4,8,461,1024,2,1026
"مازندران","رامسر","مرکزی",33,411,7,5,541,964,11,975
"مازندران","رامسر","مرکزی",34,195,7,1,316,519,12,531
"مازندران","رامسر","مرکزی",35,556,7,0,338,901,6,907
"مازندران","رامسر","مرکزی",36,538,12,1,396,947,13,960
"مازندران","رامسر","مرکزی",37,534,11,2,324,871,1,872
"مازندران","رامسر","مرکزی",38,874,8,6,537,1425,9,1434
"مازندران","رامسر","مرکزی",39,183,1,0,105,289,3,292
"مازندران","رامسر","مرکزی",40,338,9,1,188,536,4,540
"مازندران","رامسر","مرکزی",41,478,1,0,146,625,8,633
"مازندران","رامسر","مرکزی",42,362,8,4,227,601,6,607
"مازندران","رامسر","مرکزی",43,339,0,0,145,484,2,486
"مازندران","رامسر","مرکزی",44,361,6,5,196,568,4,572
"مازندران","رامسر","مرکزی",45,136,2,5,184,327,6,333
"مازندران","رامسر","مرکزی",46,360,1,0,128,489,4,493
"مازندران","رامسر","مرکزی",47,227,0,1,152,380,4,384
"مازندران","رامسر","مرکزی",48,137,5,3,134,279,8,287
"مازندران","رامسر","مرکزی",49,301,3,1,175,480,7,487
"مازندران","رامسر","مرکزی",50,512,9,0,246,767,8,775
"مازندران","رامسر","مرکزی",51,282,2,0,94,378,3,381
"مازندران","رامسر","مرکزی",52,337,2,0,178,517,4,521
"مازندران","رامسر","مرکزی",53,192,0,0,37,229,2,231
"مازندران","رامسر","مرکزی",54,311,1,1,102,415,1,416
"مازندران","رامسر","مرکزی",55,572,6,3,366,947,6,953
"مازندران","رامسر","مرکزی",56,78,0,0,30,108,0,108
"مازندران","رامسر","مرکزی",57,144,1,0,67,212,2,214
"مازندران","رامسر","مرکزی",58,144,3,2,79,228,2,230
"مازندران","رامسر","مرکزی",59,135,2,3,155,295,2,297
"مازندران","رامسر","مرکزی",60,195,2,0,120,317,3,320
"مازندران","رامسر","مرکزی",61,478,7,3,298,786,6,792
"مازندران","رامسر","مرکزی",62,431,10,1,320,762,2,764
"مازندران","رامسر","مرکزی",63,326,2,0,119,447,7,454
"مازندران","رامسر","مرکزی",64,445,5,2,192,644,3,647
"مازندران","رامسر","مرکزی",65,329,2,1,186,518,8,526
"مازندران","رامسر","مرکزی",66,274,7,1,146,428,3,431
"مازندران","رامسر","مرکزی",67,493,7,2,319,821,4,825
"مازندران","رامسر","مرکزی",68,214,2,1,135,352,2,354
"مازندران","رامسر","مرکزی",69,182,5,0,96,283,5,288
"مازندران","رامسر","مرکزی",70,125,0,0,84,209,0,209
"مازندران","رامسر","مرکزی",71,438,4,0,102,544,2,546
"مازندران","رامسر","مرکزی",72,440,6,3,187,636,4,640
"مازندران","رامسر","مرکزی",73,313,1,1,70,385,2,387
"مازندران","رامسر","مرکزی",74,425,1,1,32,459,0,459
"مازندران","رامسر","مرکزی",75,239,0,0,20,259,0,259
"مازندران","رامسر","مرکزی",76,235,2,1,14,252,2,254
"مازندران","ساری","مرکزی",1,147,10,10,424,591,8,599
"مازندران","ساری","مرکزی",2,1134,8,4,184,1330,5,1335
"مازندران","ساری","مرکزی",3,493,13,2,335,843,6,849
"مازندران","ساری","مرکزی",4,699,28,27,638,1392,17,1409
"مازندران","ساری","مرکزی",5,732,20,7,849,1608,14,1622
"مازندران","ساری","مرکزی",6,686,25,10,696,1417,9,1426
"مازندران","ساری","مرکزی",7,704,13,3,334,1054,18,1072
"مازندران","ساری","مرکزی",8,744,8,1,247,1000,11,1011
"مازندران","ساری","مرکزی",9,757,9,1,170,937,12,949
"مازندران","ساری","مرکزی",10,710,20,9,643,1382,12,1394
"مازندران","ساری","مرکزی",11,316,20,11,585,932,15,947
"مازندران","ساری","مرکزی",12,531,42,11,928,1512,25,1537
"مازندران","ساری","مرکزی",13,504,20,7,388,919,15,934
"مازندران","ساری","مرکزی",14,557,14,3,345,919,13,932
"مازندران","ساری","مرکزی",15,359,18,10,473,860,17,877
"مازندران","ساری","مرکزی",16,651,5,10,602,1268,10,1278
"مازندران","ساری","مرکزی",17,399,19,5,206,629,1,630
"مازندران","ساری","مرکزی",18,635,15,8,421,1079,8,1087
"مازندران","ساری","مرکزی",19,834,13,4,345,1196,11,1207
"مازندران","ساری","مرکزی",20,988,20,10,393,1411,14,1425
"مازندران","ساری","مرکزی",21,271,13,15,491,790,9,799
"مازندران","ساری","مرکزی",22,275,7,11,422,715,12,727
"مازندران","ساری","مرکزی",23,585,12,10,428,1035,11,1046
"مازندران","ساری","مرکزی",24,380,11,15,521,927,8,935
"مازندران","ساری","مرکزی",25,417,15,10,465,907,12,919
"مازندران","ساری","مرکزی",26,312,10,1,300,623,9,632
"مازندران","ساری","مرکزی",27,591,22,20,549,1182,13,1195
"مازندران","ساری","مرکزی",28,231,11,12,380,634,6,640
"مازندران","ساری","مرکزی",29,625,31,9,469,1134,12,1146
"مازندران","ساری","مرکزی",30,375,16,5,216,612,11,623
"مازندران","ساری","مرکزی",31,495,18,6,553,1072,18,1090
"مازندران","ساری","مرکزی",32,208,9,4,346,567,5,572
"مازندران","ساری","مرکزی",33,185,4,1,263,453,4,457
"مازندران","ساری","مرکزی",34,282,11,28,1284,1605,12,1617
"مازندران","ساری","مرکزی",35,516,19,24,1181,1740,20,1760
"مازندران","ساری","مرکزی",36,357,9,22,607,995,9,1004
"مازندران","ساری","مرکزی",37,506,15,15,877,1413,13,1426
"مازندران","ساری","مرکزی",38,314,18,13,405,750,7,757
"مازندران","ساری","مرکزی",39,363,16,13,469,861,10,871
"مازندران","ساری","مرکزی",40,413,4,10,287,714,2,716
"مازندران","ساری","مرکزی",41,805,12,13,261,1091,9,1100
"مازندران","ساری","مرکزی",42,1023,3,1,174,1201,4,1205
"مازندران","ساری","مرکزی",43,663,2,5,132,802,7,809
"مازندران","ساری","مرکزی",44,488,15,2,282,787,12,799
"مازندران","ساری","مرکزی",45,625,15,3,280,923,7,930
"مازندران","ساری","مرکزی",46,729,6,3,196,934,6,940
"مازندران","ساری","مرکزی",47,522,8,5,160,695,8,703
"مازندران","ساری","مرکزی",48,884,6,1,239,1130,6,1136
"مازندران","ساری","مرکزی",49,235,5,6,164,410,2,412
"مازندران","ساری","مرکزی",50,578,9,4,342,933,5,938
"مازندران","ساری","مرکزی",51,767,11,5,422,1205,10,1215
"مازندران","ساری","مرکزی",52,246,4,1,275,526,4,530
"مازندران","ساری","مرکزی",53,320,15,4,335,674,7,681
"مازندران","ساری","مرکزی",54,109,17,31,1009,1166,7,1173
"مازندران","ساری","مرکزی",55,959,27,14,431,1431,13,1444
"مازندران","ساری","مرکزی",56,815,16,1,324,1156,9,1165
"مازندران","ساری","مرکزی",57,507,19,4,417,947,9,956
"مازندران","ساری","مرکزی",58,543,15,3,342,903,3,906
"مازندران","ساری","مرکزی",59,935,27,10,305,1277,10,1287
"مازندران","ساری","مرکزی",60,846,10,2,186,1044,10,1054
"مازندران","ساری","مرکزی",61,757,4,0,138,899,1,900
"مازندران","ساری","مرکزی",62,525,8,6,131,670,10,680
"مازندران","ساری","مرکزی",63,754,7,4,134,899,3,902
"مازندران","ساری","مرکزی",64,1190,19,3,436,1648,6,1654
"مازندران","ساری","مرکزی",65,1152,10,4,272,1438,4,1442
"مازندران","ساری","مرکزی",66,454,18,4,243,719,6,725
"مازندران","ساری","مرکزی",67,657,13,5,233,908,7,915
"مازندران","ساری","مرکزی",68,586,8,3,226,823,8,831
"مازندران","ساری","مرکزی",69,504,13,3,147,667,5,672
"مازندران","ساری","مرکزی",70,547,8,3,104,662,1,663
"مازندران","ساری","مرکزی",71,898,4,4,145,1051,3,1054
"مازندران","ساری","مرکزی",72,627,6,0,155,788,7,795
"مازندران","ساری","مرکزی",73,708,8,1,101,818,6,824
"مازندران","ساری","مرکزی",74,238,1,1,27,267,3,270
"مازندران","ساری","مرکزی",75,572,2,1,72,647,3,650
"مازندران","ساری","مرکزی",76,845,2,2,95,944,3,947
"مازندران","ساری","مرکزی",77,1185,11,2,159,1357,3,1360
"مازندران","ساری","مرکزی",78,373,3,0,42,418,1,419
"مازندران","ساری","مرکزی",79,782,6,2,117,907,11,918
"مازندران","ساری","مرکزی",80,637,9,1,207,854,3,857
"مازندران","ساری","مرکزی",81,1203,14,0,273,1490,10,1500
"مازندران","ساری","مرکزی",82,609,3,2,218,832,6,838
"مازندران","ساری","مرکزی",83,771,14,5,414,1204,10,1214
"مازندران","ساری","مرکزی",84,267,18,18,498,801,4,805
"مازندران","ساری","مرکزی",85,181,21,39,753,994,9,1003
"مازندران","ساری","مرکزی",86,464,40,39,982,1525,17,1542
"مازندران","ساری","مرکزی",87,527,26,10,830,1393,12,1405
"مازندران","ساری","مرکزی",88,403,28,26,888,1345,14,1359
"مازندران","ساری","مرکزی",89,435,22,14,822,1293,7,1300
"مازندران","ساری","مرکزی",90,220,18,29,1057,1324,3,1327
"مازندران","ساری","مرکزی",91,788,31,14,731,1564,24,1588
"مازندران","ساری","مرکزی",92,372,28,23,657,1080,13,1093
"مازندران","ساری","مرکزی",93,464,29,16,644,1153,9,1162
"مازندران","ساری","مرکزی",94,161,16,11,553,741,5,746
"مازندران","ساری","مرکزی",95,281,25,18,1161,1485,3,1488
"مازندران","ساری","مرکزی",96,232,16,24,1134,1406,7,1413
"مازندران","ساری","مرکزی",97,250,5,3,338,596,8,604
"مازندران","ساری","مرکزی",98,563,19,8,528,1118,15,1133
"مازندران","ساری","مرکزی",99,689,34,9,640,1372,10,1382
"مازندران","ساری","مرکزی",100,245,10,2,243,500,6,506
"مازندران","ساری","مرکزی",101,515,18,8,388,929,20,949
"مازندران","ساری","مرکزی",102,621,23,6,402,1052,9,1061
"مازندران","ساری","مرکزی",103,339,11,11,597,958,11,969
"مازندران","ساری","مرکزی",104,371,10,11,621,1013,18,1031
"مازندران","ساری","مرکزی",105,666,15,17,505,1203,12,1215
"مازندران","ساری","مرکزی",106,616,12,1,275,904,16,920
"مازندران","ساری","مرکزی",107,525,8,4,306,843,9,852
"مازندران","ساری","مرکزی",108,822,23,2,382,1229,13,1242
"مازندران","ساری","مرکزی",109,390,33,20,1146,1589,15,1604
"مازندران","ساری","مرکزی",110,646,29,37,919,1631,16,1647
"مازندران","ساری","مرکزی",111,393,20,9,515,937,14,951
"مازندران","ساری","مرکزی",112,636,16,12,441,1105,20,1125
"مازندران","ساری","مرکزی",113,721,23,8,395,1147,9,1156
"مازندران","ساری","مرکزی",114,576,10,1,227,814,2,816
"مازندران","ساری","مرکزی",115,267,15,0,136,418,9,427
"مازندران","ساری","مرکزی",116,721,18,9,407,1155,6,1161
"مازندران","ساری","مرکزی",117,267,12,21,814,1114,16,1130
"مازندران","ساری","مرکزی",118,951,28,8,593,1580,12,1592
"مازندران","ساری","مرکزی",119,756,25,1,372,1154,8,1162
"مازندران","ساری","مرکزی",120,892,12,4,459,1367,11,1378
"مازندران","ساری","مرکزی",121,362,2,0,162,526,2,528
"مازندران","ساری","مرکزی",122,946,9,1,274,1230,10,1240
"مازندران","ساری","مرکزی",123,390,13,19,386,808,8,816
"مازندران","ساری","مرکزی",124,1107,13,3,242,1365,7,1372
"مازندران","ساری","مرکزی",125,265,5,0,113,383,3,386
"مازندران","ساری","مرکزی",126,427,9,7,206,649,10,659
"مازندران","ساری","مرکزی",127,590,8,3,200,801,6,807
"مازندران","ساری","مرکزی",128,872,19,3,392,1286,12,1298
"مازندران","ساری","مرکزی",129,401,6,0,88,495,5,500
"مازندران","ساری","مرکزی",130,653,13,4,216,886,5,891
"مازندران","ساری","مرکزی",131,1271,18,4,269,1562,13,1575
"مازندران","ساری","مرکزی",132,455,9,2,158,624,5,629
"مازندران","ساری","مرکزی",133,579,36,2,346,963,8,971
"مازندران","ساری","مرکزی",134,883,29,19,846,1777,23,1800
"مازندران","ساری","مرکزی",135,203,15,6,270,494,5,499
"مازندران","ساری","مرکزی",136,152,9,7,324,492,5,497
"مازندران","ساری","مرکزی",137,403,23,15,587,1028,9,1037
"مازندران","ساری","مرکزی",138,267,19,7,299,592,7,599
"مازندران","ساری","مرکزی",139,607,28,25,1191,1851,20,1871
"مازندران","ساری","مرکزی",140,648,36,20,1066,1770,14,1784
"مازندران","ساری","مرکزی",141,238,8,6,168,420,6,426
"مازندران","ساری","مرکزی",142,171,10,16,536,733,4,737
"مازندران","ساری","مرکزی",143,237,19,11,321,588,9,597
"مازندران","ساری","مرکزی",144,389,7,1,94,491,8,499
"مازندران","ساری","مرکزی",145,499,5,0,83,587,5,592
"مازندران","ساری","مرکزی",146,342,21,11,926,1300,11,1311
"مازندران","ساری","مرکزی",147,514,34,24,972,1544,18,1562
"مازندران","ساری","مرکزی",148,958,28,5,328,1319,1,1320
"مازندران","ساری","مرکزی",149,307,18,0,241,566,3,569
"مازندران","ساری","مرکزی",150,540,38,23,1027,1628,24,1652
"مازندران","ساری","مرکزی",151,635,23,8,712,1378,22,1400
"مازندران","ساری","مرکزی",152,569,17,7,356,949,9,958
"مازندران","ساری","مرکزی",153,954,43,32,1046,2075,25,2100
"مازندران","ساری","مرکزی",154,570,41,10,537,1158,11,1169
"مازندران","ساری","مرکزی",155,575,30,10,379,994,6,1000
"مازندران","ساری","مرکزی",156,313,16,5,181,515,6,521
"مازندران","ساری","مرکزی",157,389,9,0,156,554,6,560
"مازندران","ساری","مرکزی",158,736,23,2,192,953,13,966
"مازندران","ساری","مرکزی",159,210,7,1,134,352,4,356
"مازندران","ساری","مرکزی",160,284,9,6,324,623,4,627
"مازندران","ساری","مرکزی",161,265,3,4,130,402,5,407
"مازندران","ساری","مرکزی",162,454,3,1,96,554,5,559
"مازندران","ساری","مرکزی",163,323,3,0,69,395,4,399
"مازندران","ساری","مرکزی",164,426,23,0,113,562,3,565
"مازندران","ساری","مرکزی",165,518,7,2,156,683,0,683
"مازندران","ساری","مرکزی",166,817,3,3,163,986,5,991
"مازندران","ساری","مرکزی",167,346,2,3,92,443,3,446
"مازندران","ساری","مرکزی",168,798,5,1,126,930,4,934
"مازندران","ساری","مرکزی",169,353,4,0,109,466,4,470
"مازندران","ساری","مرکزی",170,542,9,1,115,667,8,675
"مازندران","ساری","مرکزی",171,489,12,13,400,914,12,926
"مازندران","ساری","مرکزی",172,952,9,3,392,1356,12,1368
"مازندران","ساری","مرکزی",173,822,10,1,125,958,8,966
"مازندران","ساری","مرکزی",174,329,3,2,75,409,4,413
"مازندران","ساری","مرکزی",175,316,8,1,93,418,3,421
"مازندران","ساری","مرکزی",176,436,4,0,142,582,2,584
"مازندران","ساری","مرکزی",177,555,10,2,129,696,5,701
"مازندران","ساری","مرکزی",178,389,8,1,168,566,5,571
"مازندران","ساری","مرکزی",179,501,9,4,114,628,4,632
"مازندران","ساری","مرکزی",180,499,5,0,110,614,3,617
"مازندران","ساری","مرکزی",181,614,2,1,75,692,8,700
"مازندران","ساری","مرکزی",182,372,8,1,108,489,7,496
"مازندران","ساری","مرکزی",183,417,3,0,78,498,2,500
"مازندران","ساری","مرکزی",184,484,6,8,143,641,7,648
"مازندران","ساری","مرکزی",185,472,2,0,100,574,5,579
"مازندران","ساری","مرکزی",186,515,2,3,214,734,3,737
"مازندران","ساری","مرکزی",187,457,3,0,74,534,6,540
"مازندران","ساری","مرکزی",188,585,7,0,75,667,4,671
"مازندران","ساری","مرکزی",189,685,5,2,240,932,0,932
"مازندران","ساری","مرکزی",190,752,5,0,177,934,9,943
"مازندران","ساری","مرکزی",191,501,5,2,185,693,9,702
"مازندران","ساری","مرکزی",192,279,1,0,79,359,0,359
"مازندران","ساری","مرکزی",193,348,4,4,107,463,6,469
"مازندران","ساری","مرکزی",194,1157,13,4,330,1504,9,1513
"مازندران","ساری","مرکزی",195,449,7,0,111,567,3,570
"مازندران","ساری","مرکزی",196,905,24,2,287,1218,15,1233
"مازندران","ساری","مرکزی",197,380,6,0,156,542,4,546
"مازندران","ساری","مرکزی",198,239,1,0,66,306,6,312
"مازندران","ساری","مرکزی",199,606,7,0,165,778,6,784
"مازندران","ساری","مرکزی",200,325,6,1,71,403,2,405
"مازندران","ساری","مرکزی",201,452,3,2,141,598,2,600
"مازندران","ساری","مرکزی",202,125,0,0,51,176,0,176
"مازندران","ساری","مرکزی",203,232,4,0,111,347,1,348
"مازندران","ساری","مرکزی",204,385,13,1,193,592,4,596
"مازندران","ساری","مرکزی",205,380,5,0,135,520,10,530
"مازندران","ساری","مرکزی",206,511,2,0,149,662,4,666
"مازندران","ساری","مرکزی",207,596,10,5,195,806,9,815
"مازندران","ساری","مرکزی",208,344,5,1,89,439,3,442
"مازندران","ساری","مرکزی",209,458,1,0,152,611,4,615
"مازندران","ساری","مرکزی",210,386,0,5,53,444,1,445
"مازندران","ساری","مرکزی",211,518,1,1,126,646,3,649
"مازندران","ساری","مرکزی",212,671,1,0,117,789,7,796
"مازندران","ساری","مرکزی",213,276,1,0,60,337,2,339
"مازندران","ساری","مرکزی",214,341,4,0,132,477,4,481
"مازندران","ساری","مرکزی",215,628,3,1,171,803,4,807
"مازندران","ساری","مرکزی",216,887,16,2,277,1182,16,1198
"مازندران","ساری","مرکزی",217,764,7,5,138,914,5,919
"مازندران","ساری","مرکزی",218,540,8,1,67,616,1,617
"مازندران","ساری","مرکزی",219,407,1,0,60,468,3,471
"مازندران","ساری","مرکزی",220,331,1,0,83,415,4,419
"مازندران","ساری","مرکزی",221,335,3,1,58,397,0,397
"مازندران","ساری","مرکزی",222,843,12,5,204,1064,13,1077
"مازندران","ساری","مرکزی",223,443,1,0,109,553,2,555
"مازندران","ساری","مرکزی",224,474,3,0,177,654,4,658
"مازندران","ساری","مرکزی",225,252,6,1,134,393,4,397
"مازندران","ساری","مرکزی",226,595,7,1,246,849,7,856
"مازندران","ساری","مرکزی",227,398,1,0,124,523,0,523
"مازندران","ساری","مرکزی",228,748,7,0,320,1075,8,1083
"مازندران","ساری","مرکزی",229,195,0,0,106,301,3,304
"مازندران","ساری","مرکزی",230,596,4,2,146,748,0,748
"مازندران","ساری","مرکزی",231,618,7,2,403,1030,9,1039
"مازندران","ساری","مرکزی",232,667,4,0,289,960,7,967
"مازندران","ساری","مرکزی",233,620,4,2,121,747,2,749
"مازندران","ساری","مرکزی",234,215,4,3,167,389,2,391
"مازندران","ساری","مرکزی",235,630,10,4,305,949,6,955
"مازندران","ساری","مرکزی",236,268,11,5,210,494,5,499
"مازندران","ساری","مرکزی",237,421,2,1,124,548,5,553
"مازندران","ساری","مرکزی",238,523,15,5,158,701,12,713
"مازندران","ساری","مرکزی",239,312,3,0,48,363,3,366
"مازندران","ساری","مرکزی",240,363,3,1,119,486,0,486
"مازندران","ساری","مرکزی",241,834,4,1,103,942,3,945
"مازندران","ساری","مرکزی",242,415,9,0,194,618,8,626
"مازندران","ساری","مرکزی",243,632,4,2,187,825,5,830
"مازندران","ساری","مرکزی",244,531,5,2,223,761,0,761
"مازندران","ساری","مرکزی",245,270,0,0,18,288,3,291
"مازندران","ساری","مرکزی",246,623,9,2,123,757,7,764
"مازندران","ساری","مرکزی",247,809,0,2,157,968,7,975
"مازندران","ساری","مرکزی",248,522,5,5,245,777,11,788
"مازندران","ساری","مرکزی",249,295,1,4,153,453,4,457
"مازندران","ساری","مرکزی",250,495,7,3,177,682,7,689
"مازندران","ساری","مرکزی",251,643,2,1,79,725,1,726
"مازندران","ساری","مرکزی",252,638,5,0,75,718,0,718
"مازندران","ساری","مرکزی",253,560,9,23,250,842,5,847
"مازندران","ساری","مرکزی",254,906,10,11,150,1077,8,1085
"مازندران","ساری","مرکزی",255,525,2,1,88,616,7,623
"مازندران","ساری","مرکزی",256,528,1,1,85,615,4,619
"مازندران","ساری","مرکزی",257,825,9,1,279,1114,5,1119
"مازندران","ساری","مرکزی",258,283,3,1,155,442,6,448
"مازندران","ساری","مرکزی",259,687,8,0,211,906,1,907
"مازندران","ساری","مرکزی",260,429,5,0,113,547,7,554
"مازندران","ساری","مرکزی",261,315,3,0,53,371,2,373
"مازندران","ساری","مرکزی",262,884,1,1,134,1020,7,1027
"مازندران","ساری","مرکزی",263,571,0,1,80,652,2,654
"مازندران","ساری","مرکزی",264,699,3,1,64,767,5,772
"مازندران","ساری","مرکزی",265,984,11,2,282,1279,11,1290
"مازندران","ساری","مرکزی",266,560,4,0,152,716,6,722
"مازندران","ساری","مرکزی",267,846,0,1,129,976,2,978
"مازندران","ساری","مرکزی",268,468,0,0,75,543,5,548
"مازندران","ساری","مرکزی",269,1030,9,0,154,1193,1,1194
"مازندران","ساری","مرکزی",270,673,0,0,123,796,4,800
"مازندران","ساری","مرکزی",271,907,4,0,79,990,10,1000
"مازندران","ساری","مرکزی",272,1142,7,0,181,1330,15,1345
"مازندران","ساری","مرکزی",273,738,3,2,160,903,4,907
"مازندران","ساری","مرکزی",274,989,5,1,158,1153,4,1157
"مازندران","ساری","مرکزی",275,662,5,0,205,872,7,879
"مازندران","ساری","مرکزی",276,416,10,0,247,673,11,684
"مازندران","ساری","مرکزی",277,678,0,0,187,865,2,867
"مازندران","ساری","مرکزی",278,507,1,2,166,676,3,679
"مازندران","ساری","مرکزی",279,853,7,2,183,1045,15,1060
"مازندران","ساری","مرکزی",280,194,3,1,102,300,4,304
"مازندران","ساری","مرکزی",281,286,11,12,158,467,13,480
"مازندران","ساری","مرکزی",282,245,4,1,92,342,2,344
"مازندران","ساری","مرکزی",283,238,8,2,72,320,3,323
"مازندران","ساری","میاندورود",1,984,11,4,271,1270,8,1278
"مازندران","ساری","میاندورود",2,795,2,0,339,1136,4,1140
"مازندران","ساری","میاندورود",3,1110,4,2,397,1513,12,1525
"مازندران","ساری","میاندورود",4,639,7,0,205,851,6,857
"مازندران","ساری","میاندورود",5,298,3,1,150,452,6,458
"مازندران","ساری","میاندورود",6,685,4,1,206,896,10,906
"مازندران","ساری","میاندورود",7,222,1,2,81,306,1,307
"مازندران","ساری","میاندورود",8,538,0,0,99,637,3,640
"مازندران","ساری","میاندورود",9,349,7,1,89,446,2,448
"مازندران","ساری","میاندورود",10,152,0,0,64,216,3,219
"مازندران","ساری","میاندورود",11,35,3,0,43,81,3,84
"مازندران","ساری","میاندورود",12,812,4,0,131,947,1,948
"مازندران","ساری","میاندورود",13,989,7,1,233,1230,4,1234
"مازندران","ساری","میاندورود",14,785,8,1,226,1020,6,1026
"مازندران","ساری","میاندورود",15,809,7,0,139,955,5,960
"مازندران","ساری","میاندورود",16,428,6,0,124,558,5,563
"مازندران","ساری","میاندورود",17,246,0,0,17,263,2,265
"مازندران","ساری","میاندورود",18,143,0,1,25,169,1,170
"مازندران","ساری","میاندورود",19,839,2,1,259,1101,4,1105
"مازندران","ساری","میاندورود",20,629,15,0,166,810,5,815
"مازندران","ساری","میاندورود",21,760,6,0,175,941,6,947
"مازندران","ساری","میاندورود",22,662,8,1,72,743,1,744
"مازندران","ساری","میاندورود",23,1038,8,1,142,1189,11,1200
"مازندران","ساری","میاندورود",24,1096,4,0,175,1275,6,1281
"مازندران","ساری","میاندورود",25,276,5,0,37,318,0,318
"مازندران","ساری","میاندورود",26,210,4,0,39,253,0,253
"مازندران","ساری","میاندورود",27,1258,1,1,185,1445,7,1452
"مازندران","ساری","میاندورود",28,637,0,1,82,720,2,722
"مازندران","ساری","میاندورود",29,919,0,0,80,999,0,999
"مازندران","ساری","میاندورود",30,273,4,1,57,335,0,335
"مازندران","ساری","میاندورود",31,643,2,0,79,724,0,724
"مازندران","ساری","میاندورود",32,819,1,1,290,1111,3,1114
"مازندران","ساری","میاندورود",33,398,2,2,188,590,4,594
"مازندران","ساری","میاندورود",34,530,6,0,419,955,4,959
"مازندران","ساری","میاندورود",35,464,4,0,126,594,5,599
"مازندران","ساری","میاندورود",36,732,4,1,43,780,2,782
"مازندران","ساری","میاندورود",37,357,6,0,55,418,2,420
"مازندران","ساری","میاندورود",38,1034,8,1,175,1218,0,1218
"مازندران","ساری","میاندورود",39,513,0,0,80,593,7,600
"مازندران","ساری","میاندورود",40,741,9,4,163,917,2,919
"مازندران","ساری","میاندورود",41,671,2,0,62,735,6,741
"مازندران","ساری","میاندورود",42,706,2,1,133,842,5,847
"مازندران","ساری","میاندورود",43,840,4,1,148,993,0,993
"مازندران","ساری","میاندورود",44,843,2,0,124,969,0,969
"مازندران","ساری","میاندورود",45,326,3,0,44,373,0,373
"مازندران","ساری","میاندورود",46,537,9,0,149,695,5,700
"مازندران","ساری","میاندورود",47,505,2,0,63,570,1,571
"مازندران","ساری","میاندورود",48,122,2,0,39,163,0,163
"مازندران","ساری","میاندورود",49,442,4,0,61,507,7,514
"مازندران","ساری","میاندورود",50,358,17,1,126,502,0,502
"مازندران","ساری","چهاردانگه",1,538,0,0,69,607,0,607
"مازندران","ساری","چهاردانگه",2,589,1,0,48,638,2,640
"مازندران","ساری","چهاردانگه",3,442,0,2,27,471,1,472
"مازندران","ساری","چهاردانگه",4,424,0,0,21,445,0,445
"مازندران","ساری","چهاردانگه",5,369,0,0,40,409,2,411
"مازندران","ساری","چهاردانگه",6,424,6,0,93,523,0,523
"مازندران","ساری","چهاردانگه",7,936,8,5,299,1248,21,1269
"مازندران","ساری","چهاردانگه",8,365,1,1,58,425,4,429
"مازندران","ساری","چهاردانگه",9,302,6,6,102,416,6,422
"مازندران","ساری","چهاردانگه",10,451,1,0,48,500,0,500
"مازندران","ساری","چهاردانگه",11,359,0,1,49,409,1,410
"مازندران","ساری","چهاردانگه",12,435,0,0,51,486,1,487
"مازندران","ساری","چهاردانگه",13,317,3,0,20,340,0,340
"مازندران","ساری","چهاردانگه",14,138,1,0,32,171,4,175
"مازندران","ساری","چهاردانگه",15,394,5,0,41,440,2,442
"مازندران","ساری","چهاردانگه",16,221,3,0,28,252,1,253
"مازندران","ساری","چهاردانگه",17,243,1,0,17,261,2,263
"مازندران","ساری","چهاردانگه",18,192,3,0,71,266,0,266
"مازندران","ساری","چهاردانگه",19,262,0,0,61,323,0,323
"مازندران","ساری","چهاردانگه",20,406,0,0,17,423,0,423
"مازندران","ساری","چهاردانگه",21,378,1,1,38,418,4,422
"مازندران","ساری","چهاردانگه",22,431,1,1,23,456,3,459
"مازندران","ساری","چهاردانگه",23,449,5,1,73,528,0,528
"مازندران","ساری","چهاردانگه",24,791,0,0,8,799,2,801
"مازندران","ساری","چهاردانگه",25,181,0,0,4,185,2,187
"مازندران","ساری","چهاردانگه",26,167,0,3,14,184,0,184
"مازندران","ساری","چهاردانگه",27,400,0,0,14,414,0,414
"مازندران","ساری","چهاردانگه",28,385,1,0,12,398,0,398
"مازندران","ساری","چهاردانگه",29,402,1,0,35,438,0,438
"مازندران","ساری","کلیجارنستاق",1,509,4,4,134,651,2,653
"مازندران","ساری","کلیجارنستاق",2,105,4,1,95,205,4,209
"مازندران","ساری","کلیجارنستاق",3,1196,22,2,211,1431,12,1443
"مازندران","ساری","کلیجارنستاق",4,373,1,1,116,491,8,499
"مازندران","ساری","کلیجارنستاق",5,431,4,0,90,525,5,530
"مازندران","ساری","کلیجارنستاق",6,397,1,0,109,507,2,509
"مازندران","ساری","کلیجارنستاق",7,449,8,4,109,570,1,571
"مازندران","ساری","کلیجارنستاق",8,352,2,0,53,407,2,409
"مازندران","ساری","کلیجارنستاق",9,237,1,0,76,314,1,315
"مازندران","ساری","کلیجارنستاق",10,504,2,0,54,560,3,563
"مازندران","ساری","کلیجارنستاق",11,335,1,0,81,417,1,418
"مازندران","ساری","کلیجارنستاق",12,771,12,4,138,925,4,929
"مازندران","ساری","کلیجارنستاق",13,781,5,0,183,969,6,975
"مازندران","ساری","کلیجارنستاق",14,354,1,1,47,403,2,405
"مازندران","ساری","کلیجارنستاق",15,326,1,0,104,431,1,432
"مازندران","ساری","کلیجارنستاق",16,423,1,0,155,579,1,580
"مازندران","ساری","کلیجارنستاق",17,466,4,0,22,492,0,492
"مازندران","ساری","کلیجارنستاق",18,507,0,0,43,550,0,550
"مازندران","ساری","کلیجارنستاق",19,98,0,0,40,138,0,138
"مازندران","ساری","کلیجارنستاق",20,406,4,0,13,423,1,424
"مازندران","ساری","کلیجارنستاق",21,171,0,0,68,239,0,239
"مازندران","ساری","دودانگه",1,506,2,0,51,559,2,561
"مازندران","ساری","دودانگه",2,442,1,1,40,484,1,485
"مازندران","ساری","دودانگه",3,309,0,0,50,359,2,361
"مازندران","ساری","دودانگه",4,422,5,1,74,502,1,503
"مازندران","ساری","دودانگه",5,169,0,0,89,258,0,258
"مازندران","ساری","دودانگه",6,347,4,0,36,387,1,388
"مازندران","ساری","دودانگه",7,314,2,0,63,379,3,382
"مازندران","ساری","دودانگه",8,391,3,0,69,463,2,465
"مازندران","ساری","دودانگه",9,452,2,0,62,516,2,518
"مازندران","ساری","دودانگه",10,352,0,1,28,381,0,381
"مازندران","ساری","دودانگه",11,245,0,0,30,275,0,275
"مازندران","ساری","دودانگه",12,285,2,0,55,342,2,344
"مازندران","ساری","دودانگه",13,324,1,0,59,384,1,385
"مازندران","ساری","دودانگه",14,399,7,0,99,505,4,509
"مازندران","ساری","دودانگه",15,519,12,1,219,751,8,759
"مازندران","ساری","دودانگه",16,487,0,0,37,524,2,526
"مازندران","ساری","دودانگه",17,325,0,1,54,380,0,380
"مازندران","ساری","دودانگه",18,292,4,0,114,410,2,412
"مازندران","سوادکوه","مرکزی",1,1040,15,6,234,1295,12,1307
"مازندران","سوادکوه","مرکزی",2,534,19,3,239,795,8,803
"مازندران","سوادکوه","مرکزی",3,380,8,1,105,494,2,496
"مازندران","سوادکوه","مرکزی",4,528,6,1,40,575,3,578
"مازندران","سوادکوه","مرکزی",5,494,1,0,70,565,0,565
"مازندران","سوادکوه","مرکزی",6,397,0,0,31,428,2,430
"مازندران","سوادکوه","مرکزی",7,315,2,1,40,358,1,359
"مازندران","سوادکوه","مرکزی",8,311,4,0,40,355,2,357
"مازندران","سوادکوه","مرکزی",9,325,2,2,65,394,1,395
"مازندران","سوادکوه","مرکزی",10,329,6,2,74,411,4,415
"مازندران","سوادکوه","مرکزی",11,149,2,0,47,198,3,201
"مازندران","سوادکوه","مرکزی",12,1372,17,17,530,1936,0,1936
"مازندران","سوادکوه","مرکزی",13,1460,23,3,432,1918,16,1934
"مازندران","سوادکوه","مرکزی",14,451,11,9,99,570,5,575
"مازندران","سوادکوه","مرکزی",15,671,6,17,139,833,6,839
"مازندران","سوادکوه","مرکزی",16,679,5,9,146,839,5,844
"مازندران","سوادکوه","مرکزی",17,288,5,1,79,373,1,374
"مازندران","سوادکوه","مرکزی",18,552,8,8,200,768,4,772
"مازندران","سوادکوه","مرکزی",19,182,1,0,47,230,2,232
"مازندران","سوادکوه","مرکزی",20,159,2,3,48,212,2,214
"مازندران","سوادکوه","مرکزی",21,1176,18,2,251,1447,17,1464
"مازندران","سوادکوه","مرکزی",22,922,19,4,170,1115,8,1123
"مازندران","سوادکوه","مرکزی",23,347,0,0,87,434,3,437
"مازندران","سوادکوه","مرکزی",24,264,1,0,44,309,1,310
"مازندران","سوادکوه","مرکزی",25,566,3,1,131,701,3,704
"مازندران","سوادکوه","مرکزی",26,143,0,5,58,206,0,206
"مازندران","سوادکوه","مرکزی",27,246,0,1,67,314,2,316
"مازندران","سوادکوه","مرکزی",28,303,0,0,19,322,0,322
"مازندران","سوادکوه","مرکزی",29,565,8,0,85,658,1,659
"مازندران","سوادکوه","مرکزی",30,471,11,0,100,582,4,586
"مازندران","سوادکوه","مرکزی",31,319,2,0,56,377,1,378
"مازندران","سوادکوه","مرکزی",32,190,0,1,96,287,1,288
"مازندران","سوادکوه","مرکزی",33,538,5,0,94,637,2,639
"مازندران","سوادکوه","مرکزی",34,333,4,1,37,375,2,377
"مازندران","سوادکوه","مرکزی",35,109,2,0,29,140,0,140
"مازندران","سوادکوه","مرکزی",36,364,2,0,82,448,0,448
"مازندران","سوادکوه","مرکزی",37,125,1,1,23,150,0,150
"مازندران","سوادکوه","مرکزی",38,213,1,0,33,247,0,247
"مازندران","سوادکوه","مرکزی",39,378,0,0,36,414,1,415
"مازندران","سوادکوه","مرکزی",40,224,8,1,36,269,1,270
"مازندران","سوادکوه","مرکزی",41,289,4,4,145,442,10,452
"مازندران","سوادکوه","مرکزی",42,200,4,2,60,266,0,266
"مازندران","سوادکوه","مرکزی",43,396,1,2,79,478,8,486
"مازندران","سوادکوه","مرکزی",44,183,4,0,36,223,1,224
"مازندران","سوادکوه","مرکزی",45,243,8,1,52,304,5,309
"مازندران","سوادکوه","مرکزی",46,126,0,0,29,155,0,155
"مازندران","سوادکوه","مرکزی",47,176,2,0,57,235,2,237
"مازندران","سوادکوه","مرکزی",48,198,2,1,76,277,3,280
"مازندران","سوادکوه","مرکزی",49,163,4,0,33,200,1,201
"مازندران","سوادکوه","مرکزی",50,411,3,0,180,594,7,601
"مازندران","سوادکوه","مرکزی",51,208,0,0,13,221,0,221
"مازندران","سوادکوه","مرکزی",52,303,2,0,84,389,0,389
"مازندران","سوادکوه","مرکزی",53,338,0,1,61,400,3,403
"مازندران","سوادکوه","مرکزی",54,188,7,0,47,242,0,242
"مازندران","سوادکوه","شیرگاه",1,954,15,6,369,1344,11,1355
"مازندران","سوادکوه","شیرگاه",2,503,7,2,287,799,13,812
"مازندران","سوادکوه","شیرگاه",3,395,2,0,178,575,7,582
"مازندران","سوادکوه","شیرگاه",4,740,11,9,274,1034,6,1040
"مازندران","سوادکوه","شیرگاه",5,314,4,1,125,444,0,444
"مازندران","سوادکوه","شیرگاه",6,376,4,3,107,490,4,494
"مازندران","سوادکوه","شیرگاه",7,260,4,1,115,380,5,385
"مازندران","سوادکوه","شیرگاه",8,388,5,4,126,523,8,531
"مازندران","سوادکوه","شیرگاه",9,275,1,3,56,335,1,336
"مازندران","سوادکوه","شیرگاه",10,238,1,1,64,304,0,304
"مازندران","سوادکوه","شیرگاه",11,721,13,3,191,928,6,934
"مازندران","سوادکوه","شیرگاه",12,410,7,1,136,554,1,555
"مازندران","سوادکوه","شیرگاه",13,403,3,2,101,509,3,512
"مازندران","سوادکوه","شیرگاه",14,564,3,1,136,704,2,706
"مازندران","سوادکوه","شیرگاه",15,713,8,0,79,800,2,802
"مازندران","سوادکوه","شیرگاه",16,531,4,0,91,626,4,630
"مازندران","سوادکوه","شیرگاه",17,309,3,0,56,368,5,373
"مازندران","سوادکوه","شیرگاه",18,343,0,1,63,407,2,409
"مازندران","سوادکوه","شیرگاه",19,403,2,0,133,538,1,539
"مازندران","سوادکوه","شیرگاه",20,837,14,2,279,1132,5,1137
"مازندران","سوادکوه","شیرگاه",21,681,3,0,85,769,5,774
"مازندران","سوادکوه","شیرگاه",22,223,0,0,33,256,1,257
"مازندران","سوادکوه","شیرگاه",23,388,4,2,74,468,3,471
"مازندران","سوادکوه","شیرگاه",24,171,3,0,35,209,1,210
"مازندران","سوادکوه","شیرگاه",25,282,0,0,43,325,1,326
"مازندران","سوادکوه","شیرگاه",26,425,2,1,33,461,4,465
"مازندران","سوادکوه","شیرگاه",27,482,2,5,57,546,1,547
"مازندران","سوادکوه","شیرگاه",28,368,4,0,68,440,2,442
"مازندران","سوادکوه","شیرگاه",29,152,2,0,24,178,0,178
"مازندران","سوادکوه","شیرگاه",30,236,4,1,32,273,0,273
"مازندران","سوادکوه","شیرگاه",31,184,6,3,100,293,2,295
"مازندران","فریدونکنار","مرکزی",1,725,11,3,446,1185,14,1199
"مازندران","فریدونکنار","مرکزی",2,202,7,0,137,346,3,349
"مازندران","فریدونکنار","مرکزی",3,394,16,5,340,755,5,760
"مازندران","فریدونکنار","مرکزی",4,112,8,0,155,275,2,277
"مازندران","فریدونکنار","مرکزی",5,311,6,0,214,531,6,537
"مازندران","فریدونکنار","مرکزی",6,606,10,2,385,1003,13,1016
"مازندران","فریدونکنار","مرکزی",7,196,5,0,85,286,3,289
"مازندران","فریدونکنار","مرکزی",8,650,7,1,145,803,7,810
"مازندران","فریدونکنار","مرکزی",9,393,3,0,109,505,2,507
"مازندران","فریدونکنار","مرکزی",10,556,6,0,102,664,3,667
"مازندران","فریدونکنار","مرکزی",11,527,4,2,162,695,11,706
"مازندران","فریدونکنار","مرکزی",12,696,15,8,679,1398,20,1418
"مازندران","فریدونکنار","مرکزی",13,272,8,2,204,486,4,490
"مازندران","فریدونکنار","مرکزی",14,620,15,5,551,1191,11,1202
"مازندران","فریدونکنار","مرکزی",15,453,13,6,222,694,9,703
"مازندران","فریدونکنار","مرکزی",16,346,6,1,113,466,4,470
"مازندران","فریدونکنار","مرکزی",17,572,21,0,404,997,8,1005
"مازندران","فریدونکنار","مرکزی",18,374,6,0,215,595,10,605
"مازندران","فریدونکنار","مرکزی",19,1021,19,5,440,1485,14,1499
"مازندران","فریدونکنار","مرکزی",20,599,3,0,126,728,7,735
"مازندران","فریدونکنار","مرکزی",21,602,3,2,243,850,3,853
"مازندران","فریدونکنار","مرکزی",22,897,40,4,499,1440,23,1463
"مازندران","فریدونکنار","مرکزی",23,249,12,1,198,460,7,467
"مازندران","فریدونکنار","مرکزی",24,313,11,4,291,619,7,626
"مازندران","فریدونکنار","مرکزی",25,542,10,8,106,666,3,669
"مازندران","فریدونکنار","مرکزی",26,1007,10,6,164,1187,12,1199
"مازندران","فریدونکنار","مرکزی",27,179,3,4,53,239,0,239
"مازندران","فریدونکنار","مرکزی",28,34,0,9,187,230,0,230
"مازندران","فریدونکنار","مرکزی",29,147,0,0,75,222,0,222
"مازندران","فریدونکنار","مرکزی",30,356,6,3,138,503,7,510
"مازندران","فریدونکنار","مرکزی",31,419,3,0,124,546,2,548
"مازندران","فریدونکنار","مرکزی",32,685,14,0,86,785,5,790
"مازندران","فریدونکنار","مرکزی",33,284,2,0,41,327,5,332
"مازندران","فریدونکنار","مرکزی",34,110,1,0,56,167,1,168
"مازندران","فریدونکنار","مرکزی",35,351,5,0,49,405,3,408
"مازندران","فریدونکنار","مرکزی",36,326,5,0,23,354,4,358
"مازندران","فریدونکنار","مرکزی",37,290,3,0,33,326,2,328
"مازندران","فریدونکنار","مرکزی",38,265,0,0,55,320,5,325
"مازندران","فریدونکنار","مرکزی",39,203,3,0,5,211,3,214
"مازندران","فریدونکنار","مرکزی",40,435,5,0,40,480,3,483
"مازندران","فریدونکنار","مرکزی",41,308,10,2,49,369,6,375
"مازندران","فریدونکنار","مرکزی",42,442,6,0,81,529,0,529
"مازندران","فریدونکنار","مرکزی",43,290,4,0,46,340,0,340
"مازندران","فریدونکنار","دهفری",44,505,7,13,77,602,5,607
"مازندران","فریدونکنار","دهفری",45,651,2,1,79,733,2,735
"مازندران","فریدونکنار","دهفری",46,94,1,0,9,104,0,104
"مازندران","فریدونکنار","دهفری",47,465,9,1,124,599,2,601
"مازندران","فریدونکنار","دهفری",48,542,3,0,89,634,3,637
"مازندران","فریدونکنار","دهفری",49,578,3,2,127,710,5,715
"مازندران","فریدونکنار","دهفری",50,686,4,1,69,760,4,764
"مازندران","فریدونکنار","دهفری",51,617,10,0,130,757,4,761
"مازندران","فریدونکنار","دهفری",52,715,7,1,56,779,7,786
"مازندران","فریدونکنار","دهفری",53,689,22,0,88,799,6,805
"مازندران","فریدونکنار","دهفری",54,563,3,1,51,618,0,618
"مازندران","فریدونکنار","دهفری",55,366,5,1,76,448,3,451
"مازندران","فریدونکنار","دهفری",56,210,2,109,211,532,4,536
"مازندران","قائمشهر","مرکزی",1,609,13,25,598,1245,26,1271
"مازندران","قائمشهر","مرکزی",2,664,19,21,534,1238,15,1253
"مازندران","قائمشهر","مرکزی",3,464,14,9,502,989,15,1004
"مازندران","قائمشهر","مرکزی",4,995,29,35,1103,2162,28,2190
"مازندران","قائمشهر","مرکزی",5,508,14,11,544,1077,19,1096
"مازندران","قائمشهر","مرکزی",6,490,29,23,1144,1686,19,1705
"مازندران","قائمشهر","مرکزی",7,472,16,33,779,1300,18,1318
"مازندران","قائمشهر","مرکزی",8,1027,42,26,800,1895,16,1911
"مازندران","قائمشهر","مرکزی",9,863,8,8,312,1191,23,1214
"مازندران","قائمشهر","مرکزی",10,353,11,4,236,604,17,621
"مازندران","قائمشهر","مرکزی",11,467,7,6,205,685,9,694
"مازندران","قائمشهر","مرکزی",12,434,15,11,369,829,9,838
"مازندران","قائمشهر","مرکزی",13,1141,26,10,515,1692,16,1708
"مازندران","قائمشهر","مرکزی",14,916,12,10,439,1377,23,1400
"مازندران","قائمشهر","مرکزی",15,982,16,11,280,1289,9,1298
"مازندران","قائمشهر","مرکزی",16,940,15,5,441,1401,21,1422
"مازندران","قائمشهر","مرکزی",17,539,6,7,332,884,14,898
"مازندران","قائمشهر","مرکزی",18,586,19,6,493,1104,20,1124
"مازندران","قائمشهر","مرکزی",19,923,21,9,392,1345,13,1358
"مازندران","قائمشهر","مرکزی",20,650,19,11,342,1022,13,1035
"مازندران","قائمشهر","مرکزی",21,511,7,7,269,794,17,811
"مازندران","قائمشهر","مرکزی",22,1071,10,9,318,1408,11,1419
"مازندران","قائمشهر","مرکزی",23,546,1,5,272,824,11,835
"مازندران","قائمشهر","مرکزی",24,815,28,15,823,1681,27,1708
"مازندران","قائمشهر","مرکزی",25,1102,41,6,624,1773,25,1798
"مازندران","قائمشهر","مرکزی",26,638,18,14,474,1144,14,1158
"مازندران","قائمشهر","مرکزی",27,628,8,5,510,1151,8,1159
"مازندران","قائمشهر","مرکزی",28,522,5,2,209,738,5,743
"مازندران","قائمشهر","مرکزی",29,963,12,8,455,1438,17,1455
"مازندران","قائمشهر","مرکزی",30,960,34,22,533,1549,25,1574
"مازندران","قائمشهر","مرکزی",31,670,31,21,744,1466,13,1479
"مازندران","قائمشهر","مرکزی",32,1260,17,13,287,1577,17,1594
"مازندران","قائمشهر","مرکزی",33,1453,17,7,376,1853,19,1872
"مازندران","قائمشهر","مرکزی",34,1005,30,23,818,1876,35,1911
"مازندران","قائمشهر","مرکزی",35,733,17,24,658,1432,18,1450
"مازندران","قائمشهر","مرکزی",36,437,18,15,646,1116,17,1133
"مازندران","قائمشهر","مرکزی",37,470,14,13,407,904,9,913
"مازندران","قائمشهر","مرکزی",38,375,18,14,594,1001,24,1025
"مازندران","قائمشهر","مرکزی",39,305,9,8,466,788,10,798
"مازندران","قائمشهر","مرکزی",40,591,25,21,852,1489,22,1511
"مازندران","قائمشهر","مرکزی",41,326,17,6,641,990,9,999
"مازندران","قائمشهر","مرکزی",42,500,35,14,760,1309,19,1328
"مازندران","قائمشهر","مرکزی",43,957,19,5,369,1350,13,1363
"مازندران","قائمشهر","مرکزی",44,660,33,13,706,1412,15,1427
"مازندران","قائمشهر","مرکزی",45,956,20,5,533,1514,19,1533
"مازندران","قائمشهر","مرکزی",46,801,22,15,413,1251,13,1264
"مازندران","قائمشهر","مرکزی",47,181,8,2,124,315,2,317
"مازندران","قائمشهر","مرکزی",48,547,7,5,280,839,15,854
"مازندران","قائمشهر","مرکزی",49,264,22,5,240,531,9,540
"مازندران","قائمشهر","مرکزی",50,790,16,6,255,1067,14,1081
"مازندران","قائمشهر","مرکزی",51,380,10,2,177,569,9,578
"مازندران","قائمشهر","مرکزی",52,790,16,9,615,1430,24,1454
"مازندران","قائمشهر","مرکزی",53,547,19,11,458,1035,13,1048
"مازندران","قائمشهر","مرکزی",54,265,7,5,342,619,5,624
"مازندران","قائمشهر","مرکزی",55,515,7,3,265,790,8,798
"مازندران","قائمشهر","مرکزی",56,695,18,10,562,1285,20,1305
"مازندران","قائمشهر","مرکزی",57,811,14,6,385,1216,12,1228
"مازندران","قائمشهر","مرکزی",58,1094,24,22,729,1869,31,1900
"مازندران","قائمشهر","مرکزی",59,504,9,8,381,902,6,908
"مازندران","قائمشهر","مرکزی",60,737,17,2,411,1167,14,1181
"مازندران","قائمشهر","مرکزی",61,576,13,7,412,1008,14,1022
"مازندران","قائمشهر","مرکزی",62,304,14,11,483,812,11,823
"مازندران","قائمشهر","مرکزی",63,1192,20,16,698,1926,18,1944
"مازندران","قائمشهر","مرکزی",64,391,3,0,152,546,4,550
"مازندران","قائمشهر","مرکزی",65,765,14,4,270,1053,22,1075
"مازندران","قائمشهر","مرکزی",66,737,5,1,194,937,8,945
"مازندران","قائمشهر","مرکزی",67,636,6,5,273,920,10,930
"مازندران","قائمشهر","مرکزی",68,720,15,13,596,1344,14,1358
"مازندران","قائمشهر","مرکزی",69,810,15,12,371,1208,14,1222
"مازندران","قائمشهر","مرکزی",70,326,9,2,142,479,6,485
"مازندران","قائمشهر","مرکزی",71,908,11,4,377,1300,16,1316
"مازندران","قائمشهر","مرکزی",72,718,9,6,168,901,15,916
"مازندران","قائمشهر","مرکزی",73,1026,23,10,677,1736,22,1758
"مازندران","قائمشهر","مرکزی",74,753,24,6,291,1074,25,1099
"مازندران","قائمشهر","مرکزی",75,1460,10,5,273,1748,13,1761
"مازندران","قائمشهر","مرکزی",76,1620,11,6,344,1981,19,2000
"مازندران","قائمشهر","مرکزی",77,1205,28,18,554,1805,21,1826
"مازندران","قائمشهر","مرکزی",78,780,14,4,638,1436,19,1455
"مازندران","قائمشهر","مرکزی",79,1319,11,7,378,1715,22,1737
"مازندران","قائمشهر","مرکزی",80,631,13,5,239,888,7,895
"مازندران","قائمشهر","مرکزی",81,1303,22,8,352,1685,7,1692
"مازندران","قائمشهر","مرکزی",82,1096,16,4,503,1619,11,1630
"مازندران","قائمشهر","مرکزی",83,303,7,6,255,571,8,579
"مازندران","قائمشهر","مرکزی",84,817,12,8,193,1030,15,1045
"مازندران","قائمشهر","مرکزی",85,601,6,2,130,739,7,746
"مازندران","قائمشهر","مرکزی",86,385,3,0,89,477,2,479
"مازندران","قائمشهر","مرکزی",87,230,3,0,31,264,3,267
"مازندران","قائمشهر","مرکزی",88,1073,15,4,265,1357,14,1371
"مازندران","قائمشهر","مرکزی",89,1097,8,5,208,1318,13,1331
"مازندران","قائمشهر","مرکزی",90,565,4,0,109,678,4,682
"مازندران","قائمشهر","مرکزی",91,410,1,0,59,470,9,479
"مازندران","قائمشهر","مرکزی",92,439,3,0,71,513,5,518
"مازندران","قائمشهر","مرکزی",93,410,3,0,38,451,5,456
"مازندران","قائمشهر","مرکزی",94,652,9,1,95,757,7,764
"مازندران","قائمشهر","مرکزی",95,596,7,0,57,660,14,674
"مازندران","قائمشهر","مرکزی",96,547,3,3,216,769,10,779
"مازندران","قائمشهر","مرکزی",97,761,5,2,88,856,5,861
"مازندران","قائمشهر","مرکزی",98,742,12,8,182,944,12,956
"مازندران","قائمشهر","مرکزی",99,858,9,6,266,1139,11,1150
"مازندران","قائمشهر","مرکزی",100,547,6,1,134,688,11,699
"مازندران","قائمشهر","مرکزی",101,1117,5,1,106,1229,6,1235
"مازندران","قائمشهر","مرکزی",102,617,4,1,73,695,5,700
"مازندران","قائمشهر","مرکزی",103,755,3,0,80,838,7,845
"مازندران","قائمشهر","مرکزی",104,1116,13,4,323,1456,25,1481
"مازندران","قائمشهر","مرکزی",105,948,13,3,163,1127,7,1134
"مازندران","قائمشهر","مرکزی",106,1077,6,0,112,1195,3,1198
"مازندران","قائمشهر","مرکزی",107,998,3,1,157,1159,8,1167
"مازندران","قائمشهر","مرکزی",108,1020,8,0,191,1219,2,1221
"مازندران","قائمشهر","مرکزی",109,497,5,1,60,563,2,565
"مازندران","قائمشهر","مرکزی",110,927,13,5,201,1146,13,1159
"مازندران","قائمشهر","مرکزی",111,1284,30,4,382,1700,10,1710
"مازندران","قائمشهر","مرکزی",112,680,6,7,187,880,8,888
"مازندران","قائمشهر","مرکزی",113,1174,8,5,258,1445,24,1469
"مازندران","قائمشهر","مرکزی",114,713,8,1,144,866,8,874
"مازندران","قائمشهر","مرکزی",115,1005,22,2,185,1214,8,1222
"مازندران","قائمشهر","مرکزی",116,842,8,2,107,959,3,962
"مازندران","قائمشهر","مرکزی",117,772,15,2,175,964,5,969
"مازندران","قائمشهر","مرکزی",118,634,5,3,197,839,11,850
"مازندران","قائمشهر","مرکزی",119,359,2,0,73,434,1,435
"مازندران","قائمشهر","مرکزی",120,845,7,1,209,1062,8,1070
"مازندران","قائمشهر","مرکزی",121,772,7,0,104,883,5,888
"مازندران","قائمشهر","مرکزی",122,936,5,1,125,1067,5,1072
"مازندران","قائمشهر","مرکزی",123,522,2,5,127,656,3,659
"مازندران","قائمشهر","مرکزی",124,704,10,5,141,860,3,863
"مازندران","قائمشهر","مرکزی",125,371,7,1,77,456,3,459
"مازندران","قائمشهر","مرکزی",126,610,3,1,54,668,3,671
"مازندران","قائمشهر","مرکزی",127,644,7,1,247,899,8,907
"مازندران","قائمشهر","مرکزی",128,354,1,1,55,411,5,416
"مازندران","قائمشهر","مرکزی",129,609,9,3,80,701,3,704
"مازندران","قائمشهر","مرکزی",130,632,4,3,117,756,3,759
"مازندران","قائمشهر","مرکزی",131,440,3,0,94,537,3,540
"مازندران","قائمشهر","مرکزی",132,1205,17,6,374,1602,17,1619
"مازندران","قائمشهر","مرکزی",133,657,16,9,364,1046,14,1060
"مازندران","قائمشهر","مرکزی",134,747,6,1,65,819,7,826
"مازندران","قائمشهر","مرکزی",135,508,3,0,50,561,3,564
"مازندران","قائمشهر","مرکزی",136,962,8,2,256,1228,20,1248
"مازندران","قائمشهر","مرکزی",137,352,3,0,83,438,5,443
"مازندران","قائمشهر","مرکزی",138,558,5,2,154,719,7,726
"مازندران","قائمشهر","مرکزی",139,995,3,6,224,1228,10,1238
"مازندران","قائمشهر","مرکزی",140,684,5,3,89,781,7,788
"مازندران","قائمشهر","مرکزی",141,1028,6,4,122,1160,12,1172
"مازندران","قائمشهر","مرکزی",142,639,7,2,81,729,4,733
"مازندران","قائمشهر","مرکزی",143,897,2,2,122,1023,13,1036
"مازندران","قائمشهر","مرکزی",144,946,8,1,155,1110,9,1119
"مازندران","قائمشهر","مرکزی",145,591,3,1,94,689,4,693
"مازندران","قائمشهر","مرکزی",146,932,11,0,130,1073,10,1083
"مازندران","قائمشهر","مرکزی",147,729,1,0,73,803,2,805
"مازندران","قائمشهر","مرکزی",148,493,13,3,172,681,2,683
"مازندران","قائمشهر","مرکزی",149,1003,9,21,227,1260,9,1269
"مازندران","قائمشهر","مرکزی",150,466,5,5,274,750,10,760
"مازندران","قائمشهر","مرکزی",151,1041,5,2,283,1331,12,1343
"مازندران","قائمشهر","مرکزی",152,603,3,1,93,700,9,709
"مازندران","قائمشهر","مرکزی",153,822,2,0,135,959,3,962
"مازندران","قائمشهر","مرکزی",154,372,3,0,75,450,4,454
"مازندران","قائمشهر","مرکزی",155,397,5,1,57,460,5,465
"مازندران","قائمشهر","مرکزی",156,568,6,1,159,734,12,746
"مازندران","قائمشهر","مرکزی",157,357,3,0,104,464,6,470
"مازندران","قائمشهر","کیاکلاء",1,764,14,6,468,1252,13,1265
"مازندران","قائمشهر","کیاکلاء",2,732,9,4,275,1020,13,1033
"مازندران","قائمشهر","کیاکلاء",3,363,6,1,109,479,5,484
"مازندران","قائمشهر","کیاکلاء",4,593,4,0,193,790,10,800
"مازندران","قائمشهر","کیاکلاء",5,734,2,0,89,825,7,832
"مازندران","قائمشهر","کیاکلاء",6,353,0,0,51,404,4,408
"مازندران","قائمشهر","کیاکلاء",7,734,2,0,155,891,8,899
"مازندران","قائمشهر","کیاکلاء",8,503,4,0,103,610,1,611
"مازندران","قائمشهر","کیاکلاء",9,475,2,0,72,549,0,549
"مازندران","قائمشهر","کیاکلاء",10,488,1,0,52,541,2,543
"مازندران","قائمشهر","کیاکلاء",11,236,6,0,77,319,2,321
"مازندران","قائمشهر","کیاکلاء",12,254,2,2,76,334,2,336
"مازندران","قائمشهر","کیاکلاء",13,154,1,2,72,229,4,233
"مازندران","قائمشهر","کیاکلاء",14,444,2,5,162,613,4,617
"مازندران","قائمشهر","کیاکلاء",15,303,4,0,72,379,1,380
"مازندران","قائمشهر","کیاکلاء",16,347,1,0,86,434,2,436
"مازندران","قائمشهر","کیاکلاء",17,535,2,1,105,643,7,650
"مازندران","قائمشهر","کیاکلاء",18,268,8,1,102,379,2,381
"مازندران","قائمشهر","کیاکلاء",19,261,0,0,32,293,4,297
"مازندران","قائمشهر","کیاکلاء",20,402,0,0,82,484,2,486
"مازندران","قائمشهر","کیاکلاء",21,260,0,0,70,330,2,332
"مازندران","قائمشهر","کیاکلاء",22,296,3,0,68,367,0,367
"مازندران","قائمشهر","کیاکلاء",23,190,0,2,60,252,1,253
"مازندران","قائمشهر","کیاکلاء",24,289,8,0,57,354,3,357
"مازندران","گلوگاه","مرکزی",1,510,7,4,643,1164,9,1173
"مازندران","گلوگاه","مرکزی",2,499,6,5,263,773,3,776
"مازندران","گلوگاه","مرکزی",3,661,5,2,480,1148,10,1158
"مازندران","گلوگاه","مرکزی",4,824,5,7,422,1258,4,1262
"مازندران","گلوگاه","مرکزی",5,600,9,1,306,916,9,925
"مازندران","گلوگاه","مرکزی",6,621,8,3,583,1215,16,1231
"مازندران","گلوگاه","مرکزی",7,654,9,2,607,1272,12,1284
"مازندران","گلوگاه","مرکزی",8,677,2,2,222,903,10,913
"مازندران","گلوگاه","مرکزی",9,596,6,4,262,868,10,878
"مازندران","گلوگاه","مرکزی",10,808,4,0,321,1133,4,1137
"مازندران","گلوگاه","مرکزی",11,212,0,0,102,314,2,316
"مازندران","گلوگاه","مرکزی",12,415,1,0,91,507,6,513
"مازندران","گلوگاه","مرکزی",13,150,2,0,87,239,0,239
"مازندران","گلوگاه","مرکزی",14,286,2,3,149,440,5,445
"مازندران","گلوگاه","مرکزی",15,814,5,0,169,988,5,993
"مازندران","گلوگاه","مرکزی",16,141,1,3,84,229,1,230
"مازندران","گلوگاه","مرکزی",17,456,11,4,172,643,5,648
"مازندران","گلوگاه","مرکزی",18,526,6,1,197,730,3,733
"مازندران","گلوگاه","مرکزی",19,297,5,0,37,339,0,339
"مازندران","گلوگاه","مرکزی",20,180,0,0,16,196,1,197
"مازندران","گلوگاه","مرکزی",21,247,0,1,56,304,0,304
"مازندران","گلوگاه","مرکزی",22,508,1,0,26,535,5,540
"مازندران","گلوگاه","مرکزی",23,146,0,0,5,151,2,153
"مازندران","گلوگاه","مرکزی",24,235,0,5,6,246,0,246
"مازندران","گلوگاه","مرکزی",25,376,0,0,10,386,1,387
"مازندران","گلوگاه","مرکزی",26,126,0,0,4,130,0,130
"مازندران","گلوگاه","مرکزی",27,364,2,1,33,400,0,400
"مازندران","گلوگاه","مرکزی",28,80,2,0,34,116,0,116
"مازندران","گلوگاه","کلباد",1,826,7,2,208,1043,5,1048
"مازندران","گلوگاه","کلباد",2,455,0,0,73,528,1,529
"مازندران","گلوگاه","کلباد",3,268,1,0,127,396,3,399
"مازندران","گلوگاه","کلباد",4,705,2,2,221,930,4,934
"مازندران","گلوگاه","کلباد",5,502,3,0,149,654,4,658
"مازندران","گلوگاه","کلباد",6,232,1,0,93,326,1,327
"مازندران","گلوگاه","کلباد",7,537,3,2,148,690,3,693
"مازندران","گلوگاه","کلباد",8,310,2,0,137,449,5,454
"مازندران","گلوگاه","کلباد",9,686,0,1,84,771,2,773
"مازندران","گلوگاه","کلباد",10,647,3,39,188,877,3,880
"مازندران","گلوگاه","کلباد",11,797,0,0,158,955,2,957
"مازندران","گلوگاه","کلباد",12,220,1,0,35,256,5,261
"مازندران","گلوگاه","کلباد",13,619,1,2,351,973,4,977
"مازندران","گلوگاه","کلباد",14,335,4,1,300,640,4,644
"مازندران","محمودآباد","مرکزی",1,284,5,3,258,550,5,555
"مازندران","محمودآباد","مرکزی",2,518,17,11,594,1140,7,1147
"مازندران","محمودآباد","مرکزی",3,312,4,4,277,597,15,612
"مازندران","محمودآباد","مرکزی",4,254,4,0,130,388,5,393
"مازندران","محمودآباد","مرکزی",5,674,21,4,458,1157,15,1172
"مازندران","محمودآباد","مرکزی",6,477,18,12,695,1202,17,1219
"مازندران","محمودآباد","مرکزی",7,588,16,8,644,1256,13,1269
"مازندران","محمودآباد","مرکزی",8,175,2,2,163,342,4,346
"مازندران","محمودآباد","مرکزی",9,847,16,6,363,1232,13,1245
"مازندران","محمودآباد","مرکزی",10,196,9,0,172,377,1,378
"مازندران","محمودآباد","مرکزی",11,587,12,3,607,1209,9,1218
"مازندران","محمودآباد","مرکزی",12,393,7,1,248,649,9,658
"مازندران","محمودآباد","مرکزی",13,431,9,2,255,697,7,704
"مازندران","محمودآباد","مرکزی",14,587,16,2,369,974,8,982
"مازندران","محمودآباد","مرکزی",15,656,11,2,264,933,12,945
"مازندران","محمودآباد","مرکزی",16,460,8,2,356,826,11,837
"مازندران","محمودآباد","مرکزی",17,934,14,2,439,1389,11,1400
"مازندران","محمودآباد","مرکزی",18,379,8,1,294,682,4,686
"مازندران","محمودآباد","مرکزی",19,534,1,0,244,779,2,781
"مازندران","محمودآباد","مرکزی",20,748,15,6,267,1036,10,1046
"مازندران","محمودآباد","مرکزی",21,310,12,0,105,427,1,428
"مازندران","محمودآباد","مرکزی",22,395,1,0,173,569,4,573
"مازندران","محمودآباد","مرکزی",23,542,12,1,262,817,6,823
"مازندران","محمودآباد","مرکزی",24,357,4,1,115,477,1,478
"مازندران","محمودآباد","مرکزی",25,110,9,2,85,206,6,212
"مازندران","محمودآباد","مرکزی",26,305,34,5,433,777,8,785
"مازندران","محمودآباد","مرکزی",27,64,0,2,34,100,2,102
"مازندران","محمودآباد","مرکزی",28,399,18,0,32,449,1,450
"مازندران","محمودآباد","مرکزی",29,494,3,2,203,702,1,703
"مازندران","محمودآباد","مرکزی",30,168,2,0,48,218,2,220
"مازندران","محمودآباد","مرکزی",31,537,0,0,142,679,5,684
"مازندران","محمودآباد","مرکزی",32,668,8,4,152,832,6,838
"مازندران","محمودآباد","مرکزی",33,335,2,0,69,406,3,409
"مازندران","محمودآباد","مرکزی",34,405,3,7,40,455,6,461
"مازندران","محمودآباد","مرکزی",35,386,5,1,53,445,6,451
"مازندران","محمودآباد","مرکزی",36,286,6,0,78,370,3,373
"مازندران","محمودآباد","مرکزی",37,288,14,0,122,424,0,424
"مازندران","محمودآباد","مرکزی",38,358,5,0,98,461,2,463
"مازندران","محمودآباد","مرکزی",39,450,1,0,65,516,3,519
"مازندران","محمودآباد","مرکزی",40,635,8,0,82,725,4,729
"مازندران","محمودآباد","مرکزی",41,278,2,0,53,333,4,337
"مازندران","محمودآباد","مرکزی",42,359,7,0,69,435,2,437
"مازندران","محمودآباد","مرکزی",43,235,3,1,31,270,0,270
"مازندران","محمودآباد","مرکزی",44,374,7,1,79,461,5,466
"مازندران","محمودآباد","مرکزی",45,189,1,0,48,238,0,238
"مازندران","محمودآباد","مرکزی",46,291,1,0,124,416,4,420
"مازندران","محمودآباد","مرکزی",47,261,1,1,83,346,2,348
"مازندران","محمودآباد","مرکزی",48,197,2,0,134,333,4,337
"مازندران","محمودآباد","مرکزی",49,452,2,0,96,550,3,553
"مازندران","محمودآباد","مرکزی",50,646,3,1,119,769,0,769
"مازندران","محمودآباد","مرکزی",51,770,2,2,299,1073,5,1078
"مازندران","محمودآباد","مرکزی",52,698,2,3,228,931,11,942
"مازندران","محمودآباد","مرکزی",53,307,9,1,228,545,6,551
"مازندران","محمودآباد","مرکزی",54,940,3,0,280,1223,8,1231
"مازندران","محمودآباد","مرکزی",55,208,3,0,80,291,3,294
"مازندران","محمودآباد","مرکزی",56,220,8,1,122,351,3,354
"مازندران","محمودآباد","مرکزی",57,460,8,0,92,560,1,561
"مازندران","محمودآباد","مرکزی",58,269,1,0,29,299,1,300
"مازندران","محمودآباد","مرکزی",59,665,8,2,47,722,8,730
"مازندران","محمودآباد","مرکزی",60,224,2,0,139,365,1,366
"مازندران","محمودآباد","مرکزی",61,228,0,0,33,261,0,261
"مازندران","محمودآباد","مرکزی",62,501,1,0,59,561,4,565
"مازندران","محمودآباد","مرکزی",63,279,6,0,182,467,5,472
"مازندران","محمودآباد","مرکزی",64,430,1,0,126,557,0,557
"مازندران","محمودآباد","مرکزی",65,749,5,0,145,899,1,900
"مازندران","محمودآباد","مرکزی",66,561,2,1,104,668,2,670
"مازندران","محمودآباد","مرکزی",67,527,0,0,63,590,7,597
"مازندران","محمودآباد","مرکزی",68,302,2,0,35,339,1,340
"مازندران","محمودآباد","سرخرود",1,167,1,2,183,353,1,354
"مازندران","محمودآباد","سرخرود",2,431,5,0,158,594,3,597
"مازندران","محمودآباد","سرخرود",3,407,5,1,113,526,2,528
"مازندران","محمودآباد","سرخرود",4,548,12,1,130,691,8,699
"مازندران","محمودآباد","سرخرود",5,219,4,3,118,344,2,346
"مازندران","محمودآباد","سرخرود",6,756,17,7,393,1173,0,1173
"مازندران","محمودآباد","سرخرود",7,204,3,0,99,306,4,310
"مازندران","محمودآباد","سرخرود",8,521,3,1,57,582,4,586
"مازندران","محمودآباد","سرخرود",9,598,5,0,92,695,5,700
"مازندران","محمودآباد","سرخرود",10,616,4,1,74,695,4,699
"مازندران","محمودآباد","سرخرود",11,360,6,0,186,552,5,557
"مازندران","محمودآباد","سرخرود",12,360,3,4,125,492,1,493
"مازندران","محمودآباد","سرخرود",13,352,8,0,185,545,3,548
"مازندران","محمودآباد","سرخرود",14,504,6,0,89,599,6,605
"مازندران","محمودآباد","سرخرود",15,434,4,0,90,528,3,531
"مازندران","محمودآباد","سرخرود",16,600,10,0,53,663,0,663
"مازندران","محمودآباد","سرخرود",17,524,11,0,153,688,3,691
"مازندران","محمودآباد","سرخرود",18,385,6,1,70,462,0,462
"مازندران","محمودآباد","سرخرود",19,551,3,0,65,619,5,624
"مازندران","محمودآباد","سرخرود",20,122,1,5,133,261,2,263
"مازندران","محمودآباد","سرخرود",21,268,5,0,48,321,4,325
"مازندران","محمودآباد","سرخرود",22,530,3,1,88,622,1,623
"مازندران","محمودآباد","سرخرود",23,597,1,0,98,696,4,700
"مازندران","محمودآباد","سرخرود",24,263,2,1,73,339,3,342
"مازندران","محمودآباد","سرخرود",25,688,10,2,97,797,2,799
"مازندران","محمودآباد","سرخرود",26,278,0,0,74,352,3,355
"مازندران","محمودآباد","سرخرود",27,714,10,0,150,874,9,883
"مازندران","محمودآباد","سرخرود",28,433,2,0,47,482,4,486
"مازندران","محمودآباد","سرخرود",29,278,1,0,77,356,0,356
"مازندران","محمودآباد","سرخرود",30,205,1,0,28,234,0,234
"مازندران","محمودآباد","سرخرود",31,320,4,0,45,369,0,369
"مازندران","محمودآباد","سرخرود",32,357,1,0,20,378,0,378
"مازندران","محمودآباد","سرخرود",33,310,8,0,80,398,1,399
"مازندران","محمودآباد","سرخرود",34,380,0,5,76,461,2,463
"مازندران","محمودآباد","سرخرود",35,313,5,0,112,430,4,434
"مازندران","محمودآباد","سرخرود",36,617,13,2,180,812,6,818
"مازندران","محمودآباد","سرخرود",37,381,1,1,60,443,2,445
"مازندران","محمودآباد","سرخرود",38,189,2,0,38,229,0,229
"مازندران","محمودآباد","سرخرود",39,404,0,0,174,578,3,581
"مازندران","محمودآباد","سرخرود",40,304,0,0,142,446,4,450
"مازندران","محمودآباد","سرخرود",41,345,3,0,98,446,3,449
"مازندران","نکا","مرکزی",1,306,7,2,93,408,2,410
"مازندران","نکا","مرکزی",2,749,9,3,175,936,13,949
"مازندران","نکا","مرکزی",3,148,6,3,71,228,4,232
"مازندران","نکا","مرکزی",4,719,11,5,207,942,9,951
"مازندران","نکا","مرکزی",5,519,3,4,111,637,4,641
"مازندران","نکا","مرکزی",6,745,3,2,123,873,12,885
"مازندران","نکا","مرکزی",7,291,3,0,87,381,2,383
"مازندران","نکا","مرکزی",8,1006,13,8,380,1407,14,1421
"مازندران","نکا","مرکزی",9,444,3,1,100,548,3,551
"مازندران","نکا","مرکزی",10,275,6,2,226,509,4,513
"مازندران","نکا","مرکزی",11,381,6,5,366,758,13,771
"مازندران","نکا","مرکزی",12,471,8,6,476,961,13,974
"مازندران","نکا","مرکزی",13,316,8,28,159,511,2,513
"مازندران","نکا","مرکزی",14,259,1,1,56,317,0,317
"مازندران","نکا","مرکزی",15,1077,13,6,247,1343,12,1355
"مازندران","نکا","مرکزی",16,151,1,3,56,211,1,212
"مازندران","نکا","مرکزی",17,986,17,4,322,1329,11,1340
"مازندران","نکا","مرکزی",18,537,9,5,143,694,3,697
"مازندران","نکا","مرکزی",19,833,20,7,270,1130,6,1136
"مازندران","نکا","مرکزی",20,320,6,4,174,504,5,509
"مازندران","نکا","مرکزی",21,487,6,21,254,768,5,773
"مازندران","نکا","مرکزی",22,320,6,3,377,706,12,718
"مازندران","نکا","مرکزی",23,448,10,11,304,773,5,778
"مازندران","نکا","مرکزی",24,754,24,18,560,1356,13,1369
"مازندران","نکا","مرکزی",25,217,10,27,124,378,5,383
"مازندران","نکا","مرکزی",26,586,6,8,263,863,4,867
"مازندران","نکا","مرکزی",27,1115,8,6,246,1375,7,1382
"مازندران","نکا","مرکزی",28,212,5,3,109,329,2,331
"مازندران","نکا","مرکزی",29,701,3,9,69,782,5,787
"مازندران","نکا","مرکزی",30,651,10,1,127,789,7,796
"مازندران","نکا","مرکزی",31,143,4,2,73,222,0,222
"مازندران","نکا","مرکزی",32,159,3,2,87,251,3,254
"مازندران","نکا","مرکزی",33,644,9,21,223,897,5,902
"مازندران","نکا","مرکزی",34,493,4,1,140,638,3,641
"مازندران","نکا","مرکزی",35,617,8,6,142,773,3,776
"مازندران","نکا","مرکزی",36,424,7,7,154,592,12,604
"مازندران","نکا","مرکزی",37,461,14,36,259,770,7,777
"مازندران","نکا","مرکزی",38,498,0,2,47,547,0,547
"مازندران","نکا","مرکزی",39,374,1,2,32,409,4,413
"مازندران","نکا","مرکزی",40,347,3,0,60,410,0,410
"مازندران","نکا","مرکزی",41,206,3,7,52,268,1,269
"مازندران","نکا","مرکزی",42,416,2,3,182,603,2,605
"مازندران","نکا","مرکزی",43,468,1,1,55,525,4,529
"مازندران","نکا","مرکزی",44,913,1,2,140,1056,8,1064
"مازندران","نکا","مرکزی",45,190,0,0,28,218,0,218
"مازندران","نکا","مرکزی",46,437,2,0,60,499,0,499
"مازندران","نکا","مرکزی",47,227,5,1,23,256,1,257
"مازندران","نکا","مرکزی",48,274,3,0,24,301,1,302
"مازندران","نکا","مرکزی",49,215,1,1,50,267,5,272
"مازندران","نکا","مرکزی",50,338,3,1,37,379,3,382
"مازندران","نکا","مرکزی",51,767,11,0,81,859,7,866
"مازندران","نکا","مرکزی",52,304,3,0,80,387,1,388
"مازندران","نکا","مرکزی",53,1018,8,4,199,1229,8,1237
"مازندران","نکا","مرکزی",54,264,2,1,40,307,1,308
"مازندران","نکا","مرکزی",55,376,1,2,126,505,2,507
"مازندران","نکا","مرکزی",56,324,4,8,137,473,3,476
"مازندران","نکا","مرکزی",57,600,10,0,90,700,9,709
"مازندران","نکا","مرکزی",58,892,13,7,198,1110,8,1118
"مازندران","نکا","مرکزی",59,833,12,11,278,1134,11,1145
"مازندران","نکا","مرکزی",60,1216,10,1,144,1371,8,1379
"مازندران","نکا","مرکزی",61,1055,4,1,189,1249,11,1260
"مازندران","نکا","مرکزی",62,1095,28,6,279,1408,6,1414
"مازندران","نکا","مرکزی",63,1109,21,2,199,1331,0,1331
"مازندران","نکا","مرکزی",64,622,1,1,198,822,7,829
"مازندران","نکا","مرکزی",65,305,1,1,89,396,10,406
"مازندران","نکا","مرکزی",66,477,7,5,94,583,2,585
"مازندران","نکا","مرکزی",67,335,2,1,200,538,7,545
"مازندران","نکا","مرکزی",68,465,0,5,123,593,5,598
"مازندران","نکا","مرکزی",69,392,0,1,33,426,1,427
"مازندران","نکا","مرکزی",70,894,2,5,213,1114,8,1122
"مازندران","نکا","مرکزی",71,276,0,1,43,320,0,320
"مازندران","نکا","مرکزی",72,301,2,2,83,388,5,393
"مازندران","نکا","مرکزی",73,821,2,1,158,982,10,992
"مازندران","نکا","مرکزی",74,525,1,3,162,691,3,694
"مازندران","نکا","مرکزی",75,549,0,0,84,633,1,634
"مازندران","نکا","مرکزی",76,889,5,1,277,1172,8,1180
"مازندران","نکا","مرکزی",77,861,1,13,154,1029,9,1038
"مازندران","نکا","مرکزی",78,541,1,1,63,606,4,610
"مازندران","نکا","مرکزی",79,709,12,1,200,922,6,928
"مازندران","نکا","مرکزی",80,506,7,0,120,633,5,638
"مازندران","نکا","مرکزی",81,431,0,0,11,442,2,444
"مازندران","نکا","مرکزی",82,478,16,0,39,533,4,537
"مازندران","نکا","مرکزی",83,366,2,0,79,447,4,451
"مازندران","نکا","مرکزی",84,267,3,0,11,281,0,281
"مازندران","نکا","مرکزی",85,261,2,0,19,282,3,285
"مازندران","نکا","مرکزی",86,165,3,0,18,186,0,186
"مازندران","نکا","مرکزی",87,282,3,4,18,307,0,307
"مازندران","نکا","مرکزی",88,323,1,1,36,361,0,361
"مازندران","نکا","مرکزی",89,207,0,0,30,237,2,239
"مازندران","نکا","هزارجریب",1,572,1,0,24,597,1,598
"مازندران","نکا","هزارجریب",2,208,0,0,5,213,1,214
"مازندران","نکا","هزارجریب",3,301,0,1,21,323,0,323
"مازندران","نکا","هزارجریب",4,701,2,2,56,761,1,762
"مازندران","نکا","هزارجریب",5,232,0,0,9,241,0,241
"مازندران","نکا","هزارجریب",6,467,0,1,31,499,1,500
"مازندران","نکا","هزارجریب",7,268,1,0,12,281,0,281
"مازندران","نکا","هزارجریب",8,278,0,0,4,282,0,282
"مازندران","نکا","هزارجریب",9,282,0,0,5,287,0,287
"مازندران","نکا","هزارجریب",10,414,0,0,9,423,0,423
"مازندران","نکا","هزارجریب",11,205,0,0,14,219,1,220
"مازندران","نکا","هزارجریب",12,311,2,1,128,442,0,442
"مازندران","نکا","هزارجریب",13,756,1,0,170,927,3,930
"مازندران","نکا","هزارجریب",14,412,15,0,19,446,3,449
"مازندران","نکا","هزارجریب",15,305,9,2,137,453,2,455
"مازندران","نکا","هزارجریب",16,277,2,4,18,301,1,302
"مازندران","نکا","هزارجریب",17,489,1,0,12,502,0,502
"مازندران","نکا","هزارجریب",18,461,1,0,5,467,1,468
"مازندران","نکا","هزارجریب",19,305,0,0,18,323,0,323
"مازندران","نکا","هزارجریب",20,238,0,1,24,263,1,264
"مازندران","نکا","هزارجریب",21,483,0,0,3,486,0,486
"مازندران","نکا","هزارجریب",22,261,1,4,1,267,1,268
"مازندران","نکا","هزارجریب",23,250,2,0,10,262,0,262
"مازندران","نکا","هزارجریب",24,217,1,0,15,233,0,233
"مازندران","نکا","هزارجریب",25,389,3,0,7,399,1,400
"مازندران","نکا","هزارجریب",26,243,0,0,2,245,0,245
"مازندران","نکا","هزارجریب",27,72,0,0,1,73,1,74
"مازندران","نکا","هزارجریب",28,92,1,0,1,94,0,94
"مازندران","نکا","هزارجریب",29,140,0,0,14,154,0,154
"مازندران","نکا","هزارجریب",30,106,0,0,5,111,0,111
"مازندران","نور","مرکزی",1,697,36,11,1216,1960,17,1977
"مازندران","نور","مرکزی",2,987,23,16,885,1911,21,1932
"مازندران","نور","مرکزی",3,176,4,0,97,277,2,279
"مازندران","نور","مرکزی",4,670,20,3,412,1105,10,1115
"مازندران","نور","مرکزی",5,432,7,3,340,782,7,789
"مازندران","نور","مرکزی",6,730,21,5,669,1425,13,1438
"مازندران","نور","مرکزی",7,492,14,2,363,871,5,876
"مازندران","نور","مرکزی",8,481,13,3,349,846,19,865
"مازندران","نور","مرکزی",9,480,8,2,350,840,8,848
"مازندران","نور","مرکزی",10,408,20,2,545,975,15,990
"مازندران","نور","مرکزی",11,414,11,6,558,989,14,1003
"مازندران","نور","مرکزی",12,523,21,3,610,1157,10,1167
"مازندران","نور","مرکزی",13,690,26,9,553,1278,13,1291
"مازندران","نور","مرکزی",14,170,8,0,132,310,12,322
"مازندران","نور","مرکزی",15,311,19,2,486,818,8,826
"مازندران","نور","مرکزی",16,631,25,5,545,1206,2,1208
"مازندران","نور","مرکزی",17,567,8,3,377,955,10,965
"مازندران","نور","مرکزی",18,438,10,4,409,861,14,875
"مازندران","نور","مرکزی",19,495,29,9,897,1430,14,1444
"مازندران","نور","مرکزی",20,200,6,4,178,388,7,395
"مازندران","نور","مرکزی",21,353,14,2,210,579,3,582
"مازندران","نور","مرکزی",22,276,5,1,137,419,2,421
"مازندران","نور","مرکزی",23,416,3,2,176,597,5,602
"مازندران","نور","مرکزی",24,789,6,11,503,1309,7,1316
"مازندران","نور","مرکزی",25,555,4,7,500,1066,5,1071
"مازندران","نور","مرکزی",26,454,10,1,477,942,13,955
"مازندران","نور","مرکزی",27,639,2,2,437,1080,3,1083
"مازندران","نور","مرکزی",28,629,10,8,459,1106,10,1116
"مازندران","نور","مرکزی",29,449,5,9,332,795,7,802
"مازندران","نور","مرکزی",30,696,9,0,187,892,8,900
"مازندران","نور","مرکزی",31,375,7,0,156,538,6,544
"مازندران","نور","مرکزی",32,393,1,0,135,529,7,536
"مازندران","نور","مرکزی",33,424,2,0,164,590,5,595
"مازندران","نور","مرکزی",34,280,1,0,18,299,1,300
"مازندران","نور","مرکزی",35,333,2,1,85,421,0,421
"مازندران","نور","مرکزی",36,283,3,2,155,443,0,443
"مازندران","نور","مرکزی",37,390,4,3,173,570,10,580
"مازندران","نور","مرکزی",38,863,4,1,233,1101,8,1109
"مازندران","نور","مرکزی",39,510,8,0,132,650,2,652
"مازندران","نور","مرکزی",40,532,3,1,219,755,6,761
"مازندران","نور","مرکزی",41,166,1,0,72,239,1,240
"مازندران","نور","مرکزی",42,153,4,0,80,237,1,238
"مازندران","نور","مرکزی",43,127,0,2,34,163,0,163
"مازندران","نور","مرکزی",44,169,4,1,43,217,1,218
"مازندران","نور","مرکزی",45,183,1,0,34,218,0,218
"مازندران","نور","مرکزی",46,159,1,1,61,222,1,223
"مازندران","نور","مرکزی",47,159,1,0,134,294,4,298
"مازندران","نور","مرکزی",48,577,14,11,396,998,5,1003
"مازندران","نور","مرکزی",49,437,7,0,128,572,8,580
"مازندران","نور","مرکزی",50,647,1,5,284,937,11,948
"مازندران","نور","مرکزی",51,255,12,2,139,408,7,415
"مازندران","نور","مرکزی",52,271,6,0,100,377,1,378
"مازندران","نور","مرکزی",53,485,3,0,174,662,8,670
"مازندران","نور","مرکزی",54,633,21,0,216,870,6,876
"مازندران","نور","مرکزی",55,369,9,1,231,610,7,617
"مازندران","نور","مرکزی",56,302,10,0,153,465,1,466
"مازندران","نور","چمستان",1,775,15,5,379,1174,12,1186
"مازندران","نور","چمستان",2,881,11,2,300,1194,12,1206
"مازندران","نور","چمستان",3,972,23,4,604,1603,0,1603
"مازندران","نور","چمستان",4,201,0,0,69,270,0,270
"مازندران","نور","چمستان",5,496,5,13,179,693,1,694
"مازندران","نور","چمستان",6,333,6,1,97,437,1,438
"مازندران","نور","چمستان",7,564,5,2,205,776,2,778
"مازندران","نور","چمستان",8,330,12,2,152,496,2,498
"مازندران","نور","چمستان",9,514,3,3,99,619,2,621
"مازندران","نور","چمستان",10,500,7,2,183,692,7,699
"مازندران","نور","چمستان",11,414,0,1,59,474,4,478
"مازندران","نور","چمستان",12,612,5,0,146,763,8,771
"مازندران","نور","چمستان",13,842,11,5,213,1071,12,1083
"مازندران","نور","چمستان",14,387,4,0,100,491,3,494
"مازندران","نور","چمستان",15,633,5,8,290,936,0,936
"مازندران","نور","چمستان",16,657,9,0,155,821,1,822
"مازندران","نور","چمستان",17,345,4,0,116,465,5,470
"مازندران","نور","چمستان",18,339,6,1,70,416,1,417
"مازندران","نور","چمستان",19,628,2,0,109,739,1,740
"مازندران","نور","چمستان",20,533,8,24,153,718,3,721
"مازندران","نور","چمستان",21,791,7,2,192,992,4,996
"مازندران","نور","چمستان",22,390,0,0,58,448,0,448
"مازندران","نور","چمستان",23,579,1,2,172,754,3,757
"مازندران","نور","چمستان",24,582,2,0,173,757,1,758
"مازندران","نور","چمستان",25,463,3,0,114,580,4,584
"مازندران","نور","چمستان",26,506,1,0,69,576,0,576
"مازندران","نور","چمستان",27,636,3,2,146,787,5,792
"مازندران","نور","چمستان",28,679,4,0,165,848,4,852
"مازندران","نور","چمستان",29,517,1,0,73,591,5,596
"مازندران","نور","چمستان",30,719,0,1,104,824,6,830
"مازندران","نور","چمستان",31,331,2,0,80,413,2,415
"مازندران","نور","چمستان",32,320,1,0,59,380,1,381
"مازندران","نور","چمستان",33,583,6,3,58,650,1,651
"مازندران","نور","چمستان",34,488,5,0,175,668,1,669
"مازندران","نور","چمستان",35,557,6,0,230,793,0,793
"مازندران","نور","چمستان",36,182,0,0,71,253,0,253
"مازندران","نور","چمستان",37,534,1,1,146,682,4,686
"مازندران","نور","چمستان",38,266,3,3,82,354,2,356
"مازندران","نور","چمستان",39,494,4,0,38,536,2,538
"مازندران","نور","چمستان",40,170,1,1,43,215,0,215
"مازندران","نور","بلده",1,565,1,0,101,667,2,669
"مازندران","نور","بلده",2,317,1,0,47,365,0,365
"مازندران","نور","بلده",3,219,0,0,65,284,2,286
"مازندران","نور","بلده",4,146,0,0,16,162,2,164
"مازندران","نور","بلده",5,175,1,0,29,205,2,207
"مازندران","نور","بلده",6,136,0,0,7,143,0,143
"مازندران","نور","بلده",7,277,3,0,86,366,5,371
"مازندران","نور","بلده",8,468,3,3,153,627,2,629
"مازندران","نور","بلده",9,235,1,0,48,284,1,285
"مازندران","نور","بلده",10,123,2,0,24,149,1,150
"مازندران","نور","بلده",11,270,4,0,60,334,5,339
"مازندران","نور","بلده",12,176,2,0,26,204,4,208
"مازندران","نور","بلده",13,199,0,0,35,234,3,237
"مازندران","نور","بلده",14,263,0,0,34,297,1,298
"مازندران","نور","بلده",15,570,8,2,121,701,4,705
"مازندران","نور","بلده",16,264,4,0,52,320,0,320
"مازندران","نور","بلده",17,422,2,0,91,515,2,517
"مازندران","نور","بلده",18,394,9,1,98,502,3,505
"مازندران","نور","بلده",19,456,12,1,126,595,8,603
"مازندران","نور","بلده",20,498,7,0,47,552,2,554
"مازندران","نوشهر","مرکزی",1,1039,34,15,967,2055,27,2082
"مازندران","نوشهر","مرکزی",2,568,20,8,571,1167,11,1178
"مازندران","نوشهر","مرکزی",3,510,15,8,562,1095,7,1102
"مازندران","نوشهر","مرکزی",4,379,6,12,370,767,4,771
"مازندران","نوشهر","مرکزی",5,873,11,6,511,1401,16,1417
"مازندران","نوشهر","مرکزی",6,854,26,20,1033,1933,17,1950
"مازندران","نوشهر","مرکزی",7,898,16,11,716,1641,12,1653
"مازندران","نوشهر","مرکزی",8,513,14,17,509,1053,11,1064
"مازندران","نوشهر","مرکزی",9,845,20,12,489,1366,8,1374
"مازندران","نوشهر","مرکزی",10,493,14,9,324,840,9,849
"مازندران","نوشهر","مرکزی",11,656,17,7,331,1011,10,1021
"مازندران","نوشهر","مرکزی",12,221,12,6,233,472,3,475
"مازندران","نوشهر","مرکزی",13,532,14,9,349,904,15,919
"مازندران","نوشهر","مرکزی",14,676,13,10,740,1439,13,1452
"مازندران","نوشهر","مرکزی",15,434,8,3,372,817,6,823
"مازندران","نوشهر","مرکزی",16,589,20,13,1203,1825,20,1845
"مازندران","نوشهر","مرکزی",17,556,10,8,384,958,13,971
"مازندران","نوشهر","مرکزی",18,631,15,14,771,1431,24,1455
"مازندران","نوشهر","مرکزی",19,687,5,19,595,1306,14,1320
"مازندران","نوشهر","مرکزی",20,574,8,7,290,879,6,885
"مازندران","نوشهر","مرکزی",21,827,22,19,471,1339,15,1354
"مازندران","نوشهر","مرکزی",22,467,5,16,341,829,2,831
"مازندران","نوشهر","مرکزی",23,514,23,9,800,1346,9,1355
"مازندران","نوشهر","مرکزی",24,907,11,9,423,1350,13,1363
"مازندران","نوشهر","مرکزی",25,665,4,10,267,946,7,953
"مازندران","نوشهر","مرکزی",26,402,13,5,223,643,7,650
"مازندران","نوشهر","مرکزی",27,599,33,5,283,920,16,936
"مازندران","نوشهر","مرکزی",28,408,3,5,249,665,5,670
"مازندران","نوشهر","مرکزی",29,570,10,9,431,1020,4,1024
"مازندران","نوشهر","مرکزی",30,657,5,0,247,909,6,915
"مازندران","نوشهر","مرکزی",31,445,4,1,291,741,3,744
"مازندران","نوشهر","مرکزی",32,1029,15,1,420,1465,8,1473
"مازندران","نوشهر","مرکزی",33,421,3,1,161,586,1,587
"مازندران","نوشهر","مرکزی",34,733,11,5,477,1226,7,1233
"مازندران","نوشهر","مرکزی",35,727,6,6,563,1302,8,1310
"مازندران","نوشهر","مرکزی",36,806,10,2,461,1279,4,1283
"مازندران","نوشهر","مرکزی",37,597,6,5,425,1033,6,1039
"مازندران","نوشهر","مرکزی",38,449,3,1,75,528,1,529
"مازندران","نوشهر","مرکزی",39,759,8,2,239,1008,8,1016
"مازندران","نوشهر","مرکزی",40,852,11,2,338,1203,7,1210
"مازندران","نوشهر","مرکزی",41,892,8,1,420,1321,5,1326
"مازندران","نوشهر","مرکزی",42,875,14,2,411,1302,1,1303
"مازندران","نوشهر","مرکزی",43,809,9,13,660,1491,3,1494
"مازندران","نوشهر","مرکزی",44,651,8,2,524,1185,8,1193
"مازندران","نوشهر","مرکزی",45,464,9,3,253,729,4,733
"مازندران","نوشهر","مرکزی",46,652,6,8,511,1177,4,1181
"مازندران","نوشهر","مرکزی",47,448,6,8,548,1010,14,1024
"مازندران","نوشهر","مرکزی",48,255,2,1,159,417,2,419
"مازندران","نوشهر","مرکزی",49,729,3,5,361,1098,5,1103
"مازندران","نوشهر","مرکزی",50,739,14,0,265,1018,4,1022
"مازندران","نوشهر","مرکزی",51,535,6,7,407,955,6,961
"مازندران","نوشهر","مرکزی",52,667,4,10,354,1035,5,1040
"مازندران","نوشهر","مرکزی",53,369,3,4,124,500,5,505
"مازندران","نوشهر","مرکزی",54,722,10,4,310,1046,4,1050
"مازندران","نوشهر","مرکزی",55,533,2,3,186,724,5,729
"مازندران","نوشهر","مرکزی",56,1051,10,0,273,1334,10,1344
"مازندران","نوشهر","مرکزی",57,863,7,5,252,1127,10,1137
"مازندران","نوشهر","مرکزی",58,1065,17,2,339,1423,9,1432
"مازندران","نوشهر","مرکزی",59,1055,9,1,257,1322,8,1330
"مازندران","نوشهر","مرکزی",60,936,13,1,240,1190,17,1207
"مازندران","نوشهر","مرکزی",61,476,14,10,323,823,12,835
"مازندران","نوشهر","مرکزی",62,665,9,1,235,910,5,915
"مازندران","نوشهر","مرکزی",63,868,10,2,310,1190,0,1190
"مازندران","نوشهر","کجور",1,512,9,41,151,713,3,716
"مازندران","نوشهر","کجور",2,925,4,11,215,1155,1,1156
"مازندران","نوشهر","کجور",3,302,3,0,72,377,1,378
"مازندران","نوشهر","کجور",4,200,0,0,16,216,1,217
"مازندران","نوشهر","کجور",5,312,1,0,27,340,0,340
"مازندران","نوشهر","کجور",6,215,4,1,107,327,0,327
"مازندران","نوشهر","کجور",7,280,1,2,70,353,2,355
"مازندران","نوشهر","کجور",8,356,9,0,173,538,5,543
"مازندران","نوشهر","کجور",9,171,1,0,124,296,3,299
"مازندران","نوشهر","کجور",10,302,2,4,69,377,1,378
"مازندران","نوشهر","کجور",11,276,3,2,35,316,1,317
"مازندران","نوشهر","کجور",12,219,5,1,55,280,0,280
"مازندران","نوشهر","کجور",13,263,1,0,9,273,2,275
"مازندران","نوشهر","کجور",14,412,7,0,31,450,2,452
"مازندران","نوشهر","کجور",15,326,1,1,45,373,2,375
"مازندران","نوشهر","کجور",16,315,0,0,40,355,0,355
"مازندران","نوشهر","کجور",17,226,0,0,35,261,0,261
"مازندران","نوشهر","کجور",18,154,0,2,82,238,2,240
"مازندران","نوشهر","کجور",19,339,2,0,17,358,1,359
"مازندران","نوشهر","کجور",20,416,2,2,60,480,1,481
"مازندران","نوشهر","کجور",21,636,2,1,50,689,2,691
"مازندران","نوشهر","کجور",22,485,3,1,87,576,0,576
"مازندران","نوشهر","کجور",23,337,5,0,46,388,1,389
"مازندران","نوشهر","کجور",24,339,1,6,54,400,0,400
"مازندران","نوشهر","کجور",25,296,2,1,49,348,2,350
"مازندران","نوشهر","کجور",26,275,1,0,49,325,2,327
"مازندران","نوشهر","کجور",27,408,1,0,87,496,2,498
"مازندران","نوشهر","کجور",28,280,2,5,65,352,1,353
"مرکزی","آشتیان","مرکزی",1,965,28,6,405,1404,19,1423
"مرکزی","آشتیان","مرکزی",2,410,15,2,110,537,6,543
"مرکزی","آشتیان","مرکزی",3,271,6,0,76,353,7,360
"مرکزی","آشتیان","مرکزی",4,534,21,1,286,842,12,854
"مرکزی","آشتیان","مرکزی",5,436,16,3,224,679,7,686
"مرکزی","آشتیان","مرکزی",6,530,14,5,203,752,8,760
"مرکزی","آشتیان","مرکزی",7,408,14,0,103,525,12,537
"مرکزی","آشتیان","مرکزی",8,333,3,2,129,467,2,469
"مرکزی","آشتیان","مرکزی",9,512,13,3,55,583,11,594
"مرکزی","آشتیان","مرکزی",10,660,8,2,97,767,12,779
"مرکزی","آشتیان","مرکزی",11,529,3,0,35,567,4,571
"مرکزی","آشتیان","مرکزی",12,447,5,2,82,536,7,543
"مرکزی","آشتیان","مرکزی",13,492,7,0,28,527,2,529
"مرکزی","آشتیان","مرکزی",14,306,2,1,62,371,2,373
"مرکزی","آشتیان","مرکزی",15,416,5,0,86,507,6,513
"مرکزی","آشتیان","مرکزی",16,775,2,1,103,881,11,892
"مرکزی","آشتیان","مرکزی",17,342,4,0,52,398,6,404
"مرکزی","آشتیان","مرکزی",18,446,5,2,97,550,8,558
"مرکزی","آشتیان","مرکزی",19,310,6,0,100,416,7,423
"مرکزی","آشتیان","مرکزی",20,288,6,0,98,392,3,395
"مرکزی","اراک","مرکزی",1,2020,38,4,371,2433,20,2453
"مرکزی","اراک","مرکزی",2,2138,21,2,274,2435,28,2463
"مرکزی","اراک","مرکزی",3,1811,20,10,233,2074,8,2082
"مرکزی","اراک","مرکزی",4,1574,26,13,466,2079,20,2099
"مرکزی","اراک","مرکزی",5,1864,28,4,343,2239,28,2267
"مرکزی","اراک","مرکزی",6,1509,19,12,206,1746,11,1757
"مرکزی","اراک","مرکزی",7,1870,21,8,167,2066,17,2083
"مرکزی","اراک","مرکزی",8,1228,40,12,559,1839,29,1868
"مرکزی","اراک","مرکزی",9,1236,49,12,894,2191,34,2225
"مرکزی","اراک","مرکزی",10,1012,54,23,1283,2372,26,2398
"مرکزی","اراک","مرکزی",11,1252,46,16,683,1997,32,2029
"مرکزی","اراک","مرکزی",12,990,45,13,857,1905,31,1936
"مرکزی","اراک","مرکزی",13,1177,39,7,596,1819,23,1842
"مرکزی","اراک","مرکزی",14,1376,17,2,404,1799,17,1816
"مرکزی","اراک","مرکزی",15,1030,39,9,577,1655,12,1667
"مرکزی","اراک","مرکزی",16,994,50,16,714,1774,29,1803
"مرکزی","اراک","مرکزی",17,754,31,11,528,1324,23,1347
"مرکزی","اراک","مرکزی",18,1905,25,5,462,2397,24,2421
"مرکزی","اراک","مرکزی",19,2125,17,5,345,2492,25,2517
"مرکزی","اراک","مرکزی",20,1725,27,6,261,2019,28,2047
"مرکزی","اراک","مرکزی",21,1415,17,2,406,1840,26,1866
"مرکزی","اراک","مرکزی",22,1768,20,4,273,2065,19,2084
"مرکزی","اراک","مرکزی",23,1134,36,14,552,1736,24,1760
"مرکزی","اراک","مرکزی",24,1960,38,4,319,2321,32,2353
"مرکزی","اراک","مرکزی",25,1557,38,17,590,2202,13,2215
"مرکزی","اراک","مرکزی",26,1461,45,8,412,1926,27,1953
"مرکزی","اراک","مرکزی",27,2307,30,11,351,2699,29,2728
"مرکزی","اراک","مرکزی",28,1298,46,8,387,1739,20,1759
"مرکزی","اراک","مرکزی",29,1269,47,10,614,1940,20,1960
"مرکزی","اراک","مرکزی",30,971,39,4,355,1369,13,1382
"مرکزی","اراک","مرکزی",31,1130,43,9,492,1674,18,1692
"مرکزی","اراک","مرکزی",32,1700,51,18,627,2396,23,2419
"مرکزی","اراک","مرکزی",33,1787,38,9,573,2407,35,2442
"مرکزی","اراک","مرکزی",34,1848,25,3,330,2206,31,2237
"مرکزی","اراک","مرکزی",35,1279,22,3,411,1715,21,1736
"مرکزی","اراک","مرکزی",36,679,37,15,687,1418,24,1442
"مرکزی","اراک","مرکزی",37,1002,41,11,812,1866,34,1900
"مرکزی","اراک","مرکزی",38,1262,35,5,379,1681,36,1717
"مرکزی","اراک","مرکزی",39,1330,22,7,413,1772,27,1799
"مرکزی","اراک","مرکزی",40,982,46,9,462,1499,19,1518
"مرکزی","اراک","مرکزی",41,804,47,5,461,1317,24,1341
"مرکزی","اراک","مرکزی",42,1240,35,8,698,1981,40,2021
"مرکزی","اراک","مرکزی",43,1529,29,3,460,2021,35,2056
"مرکزی","اراک","مرکزی",44,1353,24,7,400,1784,12,1796
"مرکزی","اراک","مرکزی",45,1355,27,18,374,1774,26,1800
"مرکزی","اراک","مرکزی",46,1593,25,9,280,1907,30,1937
"مرکزی","اراک","مرکزی",47,1711,18,9,395,2133,23,2156
"مرکزی","اراک","مرکزی",48,1037,43,24,796,1900,37,1937
"مرکزی","اراک","مرکزی",49,594,60,20,676,1350,21,1371
"مرکزی","اراک","مرکزی",50,555,43,14,762,1374,27,1401
"مرکزی","اراک","مرکزی",51,416,35,30,903,1384,15,1399
"مرکزی","اراک","مرکزی",52,738,35,14,666,1453,25,1478
"مرکزی","اراک","مرکزی",53,1275,49,15,947,2286,36,2322
"مرکزی","اراک","مرکزی",54,967,33,25,669,1694,34,1728
"مرکزی","اراک","مرکزی",55,562,32,32,497,1123,18,1141
"مرکزی","اراک","مرکزی",56,814,26,37,544,1421,29,1450
"مرکزی","اراک","مرکزی",57,582,36,11,890,1519,21,1540
"مرکزی","اراک","مرکزی",58,1145,61,14,778,1998,18,2016
"مرکزی","اراک","مرکزی",59,1270,47,21,974,2312,34,2346
"مرکزی","اراک","مرکزی",60,1130,61,46,1027,2264,37,2301
"مرکزی","اراک","مرکزی",61,1022,54,26,926,2028,42,2070
"مرکزی","اراک","مرکزی",62,956,37,24,671,1688,41,1729
"مرکزی","اراک","مرکزی",63,1569,48,18,781,2416,52,2468
"مرکزی","اراک","مرکزی",64,1275,25,7,398,1705,19,1724
"مرکزی","اراک","مرکزی",65,1296,30,4,281,1611,11,1622
"مرکزی","اراک","مرکزی",66,1123,59,25,967,2174,35,2209
"مرکزی","اراک","مرکزی",67,1129,61,37,1144,2371,37,2408
"مرکزی","اراک","مرکزی",68,883,32,6,581,1502,32,1534
"مرکزی","اراک","مرکزی",69,1001,56,21,969,2047,30,2077
"مرکزی","اراک","مرکزی",70,1515,59,30,857,2461,24,2485
"مرکزی","اراک","مرکزی",71,784,46,19,521,1370,13,1383
"مرکزی","اراک","مرکزی",72,1127,46,12,726,1911,25,1936
"مرکزی","اراک","مرکزی",73,895,40,21,992,1948,26,1974
"مرکزی","اراک","مرکزی",74,788,28,57,828,1701,27,1728
"مرکزی","اراک","مرکزی",75,579,27,13,519,1138,22,1160
"مرکزی","اراک","مرکزی",76,683,25,12,830,1550,42,1592
"مرکزی","اراک","مرکزی",77,1098,32,13,637,1780,26,1806
"مرکزی","اراک","مرکزی",78,907,46,12,674,1639,16,1655
"مرکزی","اراک","مرکزی",79,1480,49,22,943,2494,29,2523
"مرکزی","اراک","مرکزی",80,1044,24,9,490,1567,20,1587
"مرکزی","اراک","مرکزی",81,846,37,4,787,1674,27,1701
"مرکزی","اراک","مرکزی",82,886,66,48,1180,2180,48,2228
"مرکزی","اراک","مرکزی",83,737,40,25,782,1584,25,1609
"مرکزی","اراک","مرکزی",84,760,38,31,760,1589,30,1619
"مرکزی","اراک","مرکزی",85,902,57,26,1070,2055,29,2084
"مرکزی","اراک","مرکزی",86,689,40,17,954,1700,34,1734
"مرکزی","اراک","مرکزی",87,488,29,39,1868,2424,28,2452
"مرکزی","اراک","مرکزی",88,751,68,27,1126,1972,16,1988
"مرکزی","اراک","مرکزی",89,438,29,38,1018,1523,33,1556
"مرکزی","اراک","مرکزی",90,395,22,36,873,1326,12,1338
"مرکزی","اراک","مرکزی",91,987,36,21,732,1776,24,1800
"مرکزی","اراک","مرکزی",92,900,4,5,123,1032,5,1037
"مرکزی","اراک","مرکزی",93,719,24,2,152,897,10,907
"مرکزی","اراک","مرکزی",94,1277,14,7,159,1457,19,1476
"مرکزی","اراک","مرکزی",95,729,4,3,131,867,7,874
"مرکزی","اراک","مرکزی",96,926,9,3,150,1088,7,1095
"مرکزی","اراک","مرکزی",97,559,43,25,990,1617,23,1640
"مرکزی","اراک","مرکزی",98,663,52,33,1130,1878,38,1916
"مرکزی","اراک","مرکزی",99,549,40,44,1281,1914,27,1941
"مرکزی","اراک","مرکزی",100,704,37,62,1525,2328,32,2360
"مرکزی","اراک","مرکزی",101,969,58,42,1249,2318,39,2357
"مرکزی","اراک","مرکزی",102,442,32,16,793,1283,19,1302
"مرکزی","اراک","مرکزی",103,878,29,5,372,1284,18,1302
"مرکزی","اراک","مرکزی",104,1260,43,25,908,2236,27,2263
"مرکزی","اراک","مرکزی",105,1158,66,42,1638,2904,40,2944
"مرکزی","اراک","مرکزی",106,1424,34,8,520,1986,44,2030
"مرکزی","اراک","مرکزی",107,1577,20,2,320,1919,20,1939
"مرکزی","اراک","مرکزی",108,1538,32,11,419,2000,19,2019
"مرکزی","اراک","مرکزی",109,768,31,20,437,1256,15,1271
"مرکزی","اراک","مرکزی",110,533,23,6,234,796,13,809
"مرکزی","اراک","مرکزی",111,1414,41,6,375,1836,28,1864
"مرکزی","اراک","مرکزی",112,1166,33,10,405,1614,20,1634
"مرکزی","اراک","مرکزی",113,1325,13,12,383,1733,15,1748
"مرکزی","اراک","مرکزی",114,675,25,35,611,1346,23,1369
"مرکزی","اراک","مرکزی",115,917,20,8,137,1082,12,1094
"مرکزی","اراک","مرکزی",116,1205,10,2,194,1411,17,1428
"مرکزی","اراک","مرکزی",117,1404,38,8,325,1775,13,1788
"مرکزی","اراک","مرکزی",118,1228,40,3,568,1839,27,1866
"مرکزی","اراک","مرکزی",119,366,13,19,483,881,18,899
"مرکزی","اراک","مرکزی",120,574,25,7,440,1046,15,1061
"مرکزی","اراک","مرکزی",121,1085,48,10,533,1676,24,1700
"مرکزی","اراک","مرکزی",122,831,13,10,475,1329,23,1352
"مرکزی","اراک","مرکزی",123,1263,31,13,397,1704,18,1722
"مرکزی","اراک","مرکزی",124,322,32,13,1092,1459,13,1472
"مرکزی","اراک","مرکزی",125,415,41,31,1118,1605,19,1624
"مرکزی","اراک","مرکزی",126,1027,47,19,864,1957,29,1986
"مرکزی","اراک","مرکزی",127,1297,33,12,808,2150,36,2186
"مرکزی","اراک","مرکزی",128,541,59,51,1392,2043,18,2061
"مرکزی","اراک","مرکزی",129,551,57,23,1057,1688,12,1700
"مرکزی","اراک","مرکزی",130,147,15,3,152,317,4,321
"مرکزی","اراک","مرکزی",131,272,21,16,451,760,10,770
"مرکزی","اراک","مرکزی",132,513,5,2,166,686,8,694
"مرکزی","اراک","مرکزی",133,226,28,30,339,623,9,632
"مرکزی","اراک","مرکزی",134,1289,15,6,270,1580,15,1595
"مرکزی","اراک","مرکزی",135,1767,18,14,383,2182,17,2199
"مرکزی","اراک","مرکزی",136,573,20,7,252,852,13,865
"مرکزی","اراک","مرکزی",137,649,15,8,313,985,28,1003
"مرکزی","اراک","مرکزی",138,697,29,7,346,1079,27,1106
"مرکزی","اراک","مرکزی",139,467,8,4,194,673,17,690
"مرکزی","اراک","مرکزی",140,1025,22,6,314,1367,9,1376
"مرکزی","اراک","مرکزی",141,810,17,7,429,1263,13,1276
"مرکزی","اراک","مرکزی",142,1068,14,2,186,1270,16,1286
"مرکزی","اراک","مرکزی",143,1830,20,10,295,2155,13,2168
"مرکزی","اراک","مرکزی",144,1411,22,14,482,1929,25,1954
"مرکزی","اراک","مرکزی",145,1376,26,18,393,1813,13,1826
"مرکزی","اراک","مرکزی",146,1188,22,4,308,1522,22,1544
"مرکزی","اراک","مرکزی",147,1206,10,13,200,1429,17,1446
"مرکزی","اراک","مرکزی",148,1574,17,11,247,1849,8,1857
"مرکزی","اراک","مرکزی",149,974,12,9,298,1293,27,1320
"مرکزی","اراک","مرکزی",150,714,17,4,274,1009,13,1022
"مرکزی","اراک","مرکزی",151,689,12,2,232,935,10,945
"مرکزی","اراک","مرکزی",152,377,8,1,111,497,5,502
"مرکزی","اراک","مرکزی",153,1148,30,6,447,1631,19,1650
"مرکزی","اراک","مرکزی",154,1010,5,6,88,1109,6,1115
"مرکزی","اراک","مرکزی",155,769,4,0,43,816,1,817
"مرکزی","اراک","مرکزی",156,499,10,1,82,592,5,597
"مرکزی","اراک","مرکزی",157,633,4,0,60,697,9,706
"مرکزی","اراک","مرکزی",158,425,5,4,71,505,8,513
"مرکزی","اراک","مرکزی",159,1024,31,1,188,1244,7,1251
"مرکزی","اراک","مرکزی",160,1148,9,10,235,1402,7,1409
"مرکزی","اراک","مرکزی",161,1204,7,3,134,1348,11,1359
"مرکزی","اراک","مرکزی",162,1068,14,5,196,1283,14,1297
"مرکزی","اراک","مرکزی",163,865,4,1,138,1008,4,1012
"مرکزی","اراک","مرکزی",164,459,13,1,94,567,5,572
"مرکزی","اراک","مرکزی",165,952,6,0,67,1025,7,1032
"مرکزی","اراک","مرکزی",166,1002,8,0,76,1086,8,1094
"مرکزی","اراک","مرکزی",167,1462,19,4,358,1843,11,1854
"مرکزی","اراک","مرکزی",168,673,11,0,39,723,0,723
"مرکزی","اراک","مرکزی",169,479,5,6,103,593,6,599
"مرکزی","اراک","مرکزی",170,1209,18,7,249,1483,26,1509
"مرکزی","اراک","مرکزی",171,1333,8,4,165,1510,5,1515
"مرکزی","اراک","مرکزی",172,409,2,1,95,507,6,513
"مرکزی","اراک","مرکزی",173,604,3,0,79,686,1,687
"مرکزی","اراک","مرکزی",174,536,1,2,64,603,2,605
"مرکزی","اراک","مرکزی",175,1383,12,5,235,1635,16,1651
"مرکزی","اراک","مرکزی",176,686,4,0,77,767,5,772
"مرکزی","اراک","مرکزی",177,568,2,1,35,606,2,608
"مرکزی","اراک","مرکزی",178,676,7,10,228,921,11,932
"مرکزی","اراک","مرکزی",179,465,3,1,72,541,6,547
"مرکزی","اراک","مرکزی",180,476,1,0,72,549,2,551
"مرکزی","اراک","مرکزی",181,479,7,4,111,601,10,611
"مرکزی","اراک","مرکزی",182,1193,3,2,45,1243,3,1246
"مرکزی","اراک","مرکزی",183,1243,17,12,407,1679,20,1699
"مرکزی","اراک","مرکزی",184,296,1,1,18,316,0,316
"مرکزی","اراک","مرکزی",185,425,7,1,94,527,5,532
"مرکزی","اراک","مرکزی",186,945,7,1,85,1038,2,1040
"مرکزی","اراک","مرکزی",187,219,0,1,12,232,2,234
"مرکزی","اراک","مرکزی",188,593,5,0,29,627,7,634
"مرکزی","اراک","مرکزی",189,433,2,3,87,525,7,532
"مرکزی","اراک","مرکزی",190,550,0,2,42,594,3,597
"مرکزی","اراک","مرکزی",191,318,1,1,56,376,0,376
"مرکزی","اراک","مرکزی",192,313,0,0,8,321,1,322
"مرکزی","اراک","مرکزی",193,376,3,0,25,404,1,405
"مرکزی","اراک","مرکزی",194,678,4,0,44,726,0,726
"مرکزی","اراک","مرکزی",195,473,8,2,95,578,2,580
"مرکزی","اراک","مرکزی",196,301,8,6,92,407,3,410
"مرکزی","اراک","مرکزی",197,359,2,0,75,436,0,438
"مرکزی","اراک","مرکزی",198,215,3,0,26,244,3,247
"مرکزی","اراک","مرکزی",199,737,8,2,65,812,8,820
"مرکزی","اراک","مرکزی",200,476,16,1,156,649,4,653
"مرکزی","اراک","مرکزی",201,451,5,4,188,648,3,651
"مرکزی","اراک","مرکزی",202,632,2,2,59,695,3,698
"مرکزی","اراک","مرکزی",203,551,1,5,59,616,5,621
"مرکزی","اراک","مرکزی",204,358,10,0,35,403,3,406
"مرکزی","اراک","مرکزی",205,333,4,0,154,491,11,510
"مرکزی","اراک","مرکزی",206,667,4,1,100,772,12,784
"مرکزی","اراک","مرکزی",207,610,5,2,75,692,6,698
"مرکزی","اراک","مرکزی",208,258,4,2,155,419,2,421
"مرکزی","اراک","مرکزی",209,346,5,0,95,446,2,448
"مرکزی","اراک","مرکزی",210,677,3,0,51,731,1,732
"مرکزی","اراک","مرکزی",211,628,4,5,105,742,8,750
"مرکزی","اراک","مرکزی",212,359,1,1,117,478,6,484
"مرکزی","اراک","مرکزی",213,449,3,1,24,477,0,477
"مرکزی","اراک","مرکزی",214,373,6,11,70,460,6,466
"مرکزی","اراک","مرکزی",215,655,15,3,151,824,11,835
"مرکزی","اراک","مرکزی",216,536,5,1,64,606,3,609
"مرکزی","اراک","مرکزی",217,955,7,0,71,1033,5,1038
"مرکزی","اراک","مرکزی",218,526,2,0,51,579,3,582
"مرکزی","اراک","مرکزی",219,975,9,0,73,1057,10,1067
"مرکزی","اراک","مرکزی",220,303,1,1,17,322,0,322
"مرکزی","اراک","مرکزی",221,874,2,1,33,910,0,910
"مرکزی","اراک","مرکزی",222,802,6,0,50,858,5,863
"مرکزی","اراک","مرکزی",223,202,5,0,37,244,7,251
"مرکزی","اراک","مرکزی",224,561,5,2,84,652,0,652
"مرکزی","تفرش","مرکزی",1,924,18,4,483,1429,10,1439
"مرکزی","تفرش","مرکزی",2,834,12,2,231,1079,8,1087
"مرکزی","تفرش","مرکزی",3,893,22,4,417,1336,14,1350
"مرکزی","تفرش","مرکزی",4,1036,19,4,282,1341,14,1355
"مرکزی","تفرش","مرکزی",5,771,16,5,363,1155,10,1165
"مرکزی","تفرش","مرکزی",6,1008,11,0,369,1388,14,1402
"مرکزی","تفرش","مرکزی",7,795,8,7,444,1254,13,1267
"مرکزی","تفرش","مرکزی",8,516,18,4,364,902,9,911
"مرکزی","تفرش","مرکزی",9,464,10,1,182,657,10,667
"مرکزی","تفرش","مرکزی",10,294,6,0,139,439,3,442
"مرکزی","تفرش","مرکزی",11,320,4,1,108,433,3,436
"مرکزی","تفرش","مرکزی",12,578,1,0,104,683,4,687
"مرکزی","تفرش","مرکزی",13,316,1,0,31,348,1,349
"مرکزی","تفرش","مرکزی",14,509,0,0,40,549,7,556
"مرکزی","تفرش","مرکزی",15,519,1,1,49,570,1,571
"مرکزی","تفرش","مرکزی",16,366,0,0,14,380,1,381
"مرکزی","تفرش","مرکزی",17,312,0,2,34,348,1,349
"مرکزی","تفرش","مرکزی",18,549,0,0,24,573,1,574
"مرکزی","تفرش","مرکزی",19,754,3,0,49,806,1,807
"مرکزی","تفرش","مرکزی",20,477,1,0,72,550,3,553
"مرکزی","تفرش","مرکزی",21,483,0,0,37,520,1,521
"مرکزی","تفرش","مرکزی",22,548,1,1,50,600,0,600
"مرکزی","تفرش","مرکزی",23,403,12,3,68,486,5,491
"مرکزی","تفرش","فراهان",1,440,4,2,282,728,5,733
"مرکزی","تفرش","فراهان",2,381,15,1,213,610,9,619
"مرکزی","تفرش","فراهان",3,770,21,3,309,1103,24,1127
"مرکزی","تفرش","فراهان",4,43,2,0,25,70,1,71
"مرکزی","تفرش","فراهان",5,801,4,0,74,879,7,886
"مرکزی","تفرش","فراهان",6,697,4,0,112,813,6,819
"مرکزی","تفرش","فراهان",7,743,1,2,66,812,7,819
"مرکزی","تفرش","فراهان",8,277,2,0,52,331,3,334
"مرکزی","تفرش","فراهان",9,509,10,2,136,657,3,660
"مرکزی","تفرش","فراهان",10,380,3,2,133,518,4,522
"مرکزی","تفرش","فراهان",11,376,5,1,93,475,0,475
"مرکزی","تفرش","فراهان",12,606,4,0,106,716,9,725
"مرکزی","تفرش","فراهان",13,748,9,0,171,928,18,946
"مرکزی","تفرش","فراهان",14,386,1,0,47,434,2,436
"مرکزی","تفرش","فراهان",15,973,0,1,77,1051,6,1057
"مرکزی","تفرش","فراهان",16,730,9,1,61,801,12,813
"مرکزی","تفرش","فراهان",17,490,4,0,28,522,2,524
"مرکزی","تفرش","فراهان",18,278,0,0,146,424,2,426
"مرکزی","تفرش","فراهان",19,224,3,2,52,281,0,281
"مرکزی","تفرش","فراهان",20,743,0,1,45,789,0,789
"مرکزی","تفرش","فراهان",21,505,1,3,77,586,6,592
"مرکزی","تفرش","فراهان",22,369,0,0,26,395,2,397
"مرکزی","تفرش","فراهان",23,697,3,0,26,726,2,728
"مرکزی","خمین","مرکزی",1,539,11,11,256,817,12,829
"مرکزی","خمین","مرکزی",2,518,10,6,179,713,10,723
"مرکزی","خمین","مرکزی",3,578,10,4,220,812,14,826
"مرکزی","خمین","مرکزی",4,126,4,1,60,191,0,191
"مرکزی","خمین","مرکزی",5,424,15,9,210,658,11,669
"مرکزی","خمین","مرکزی",6,321,10,3,197,531,5,536
"مرکزی","خمین","مرکزی",7,734,18,15,442,1209,14,1223
"مرکزی","خمین","مرکزی",8,693,5,5,226,929,11,940
"مرکزی","خمین","مرکزی",9,401,6,2,197,606,9,615
"مرکزی","خمین","مرکزی",10,613,14,8,376,1011,14,1025
"مرکزی","خمین","مرکزی",11,421,8,5,288,722,13,735
"مرکزی","خمین","مرکزی",12,437,12,3,204,656,6,662
"مرکزی","خمین","مرکزی",13,1137,15,15,288,1455,24,1479
"مرکزی","خمین","مرکزی",14,953,4,6,194,1157,8,1165
"مرکزی","خمین","مرکزی",15,1383,12,9,177,1581,15,1596
"مرکزی","خمین","مرکزی",16,386,4,3,61,454,3,457
"مرکزی","خمین","مرکزی",17,625,15,4,161,805,9,814
"مرکزی","خمین","مرکزی",18,783,9,7,124,923,5,928
"مرکزی","خمین","مرکزی",19,937,12,22,243,1214,13,1227
"مرکزی","خمین","مرکزی",20,815,13,7,189,1024,6,1030
"مرکزی","خمین","مرکزی",21,679,11,12,221,923,13,936
"مرکزی","خمین","مرکزی",22,944,29,5,374,1352,18,1370
"مرکزی","خمین","مرکزی",23,1028,16,2,238,1284,14,1298
"مرکزی","خمین","مرکزی",24,385,1,4,123,513,6,519
"مرکزی","خمین","مرکزی",25,255,5,4,101,365,4,369
"مرکزی","خمین","مرکزی",26,705,16,10,250,981,12,993
"مرکزی","خمین","مرکزی",27,436,5,6,97,544,6,550
"مرکزی","خمین","مرکزی",28,408,1,2,86,497,10,507
"مرکزی","خمین","مرکزی",29,712,20,3,589,1324,14,1338
"مرکزی","خمین","مرکزی",30,226,5,6,304,541,11,552
"مرکزی","خمین","مرکزی",31,582,12,3,196,793,7,800
"مرکزی","خمین","مرکزی",32,572,8,1,165,746,3,749
"مرکزی","خمین","مرکزی",33,837,17,11,184,1049,6,1055
"مرکزی","خمین","مرکزی",34,884,21,12,448,1365,23,1388
"مرکزی","خمین","مرکزی",35,860,12,5,284,1161,13,1174
"مرکزی","خمین","مرکزی",36,736,11,7,262,1016,15,1031
"مرکزی","خمین","مرکزی",37,873,9,4,207,1093,8,1101
"مرکزی","خمین","مرکزی",38,548,10,7,320,885,7,892
"مرکزی","خمین","مرکزی",39,1138,16,6,391,1551,15,1566
"مرکزی","خمین","مرکزی",40,512,15,1,340,868,8,876
"مرکزی","خمین","مرکزی",41,626,11,2,253,892,12,904
"مرکزی","خمین","مرکزی",42,640,21,8,312,981,14,995
"مرکزی","خمین","مرکزی",43,406,4,2,116,528,7,535
"مرکزی","خمین","مرکزی",44,309,5,0,209,523,9,532
"مرکزی","خمین","مرکزی",45,236,5,0,90,331,5,336
"مرکزی","خمین","مرکزی",46,582,5,1,114,702,11,713
"مرکزی","خمین","مرکزی",47,393,1,2,40,436,2,438
"مرکزی","خمین","مرکزی",48,535,1,0,38,574,3,577
"مرکزی","خمین","مرکزی",49,620,3,3,74,700,4,704
"مرکزی","خمین","مرکزی",50,647,3,1,35,686,2,688
"مرکزی","خمین","مرکزی",51,645,4,0,41,690,3,693
"مرکزی","خمین","مرکزی",52,702,6,3,91,802,7,809
"مرکزی","خمین","مرکزی",53,209,2,1,17,229,1,230
"مرکزی","خمین","مرکزی",54,563,2,9,139,713,11,724
"مرکزی","خمین","مرکزی",55,557,6,8,167,738,3,741
"مرکزی","خمین","مرکزی",56,772,6,7,83,868,5,873
"مرکزی","خمین","مرکزی",57,760,6,0,75,841,5,846
"مرکزی","خمین","مرکزی",58,499,10,5,82,596,3,599
"مرکزی","خمین","مرکزی",59,342,1,1,55,399,4,403
"مرکزی","خمین","مرکزی",60,431,1,1,31,464,2,466
"مرکزی","خمین","مرکزی",61,836,6,0,101,943,4,947
"مرکزی","خمین","مرکزی",62,538,5,0,52,595,0,595
"مرکزی","خمین","مرکزی",63,550,8,0,45,603,2,605
"مرکزی","خمین","مرکزی",64,392,1,1,29,423,1,424
"مرکزی","خمین","مرکزی",65,482,5,0,57,544,2,546
"مرکزی","خمین","مرکزی",66,307,2,2,26,337,1,338
"مرکزی","خمین","مرکزی",67,571,16,9,55,651,4,655
"مرکزی","خمین","مرکزی",68,766,9,0,162,937,8,945
"مرکزی","خمین","مرکزی",69,652,7,5,100,764,4,768
"مرکزی","خمین","مرکزی",70,385,3,5,66,459,0,459
"مرکزی","خمین","مرکزی",71,562,30,14,53,659,8,667
"مرکزی","خمین","مرکزی",72,552,4,3,57,616,2,618
"مرکزی","خمین","مرکزی",73,567,4,0,73,644,5,649
"مرکزی","خمین","مرکزی",74,259,3,1,17,280,3,283
"مرکزی","خمین","مرکزی",75,667,7,36,98,808,3,811
"مرکزی","خمین","مرکزی",76,644,20,62,50,776,3,779
"مرکزی","خمین","مرکزی",77,271,10,7,53,341,3,344
"مرکزی","خمین","مرکزی",78,420,12,67,93,592,5,597
"مرکزی","خمین","مرکزی",79,447,15,108,48,618,2,620
"مرکزی","خمین","کمره",1,515,1,1,39,556,3,559
"مرکزی","خمین","کمره",2,482,7,5,96,590,3,593
"مرکزی","خمین","کمره",3,330,19,19,27,395,3,398
"مرکزی","خمین","کمره",4,522,4,19,80,625,2,627
"مرکزی","خمین","کمره",5,371,8,2,48,429,2,431
"مرکزی","خمین","کمره",6,476,0,1,20,497,3,500
"مرکزی","خمین","کمره",7,737,3,0,55,795,12,807
"مرکزی","خمین","کمره",8,625,0,1,90,716,4,720
"مرکزی","خمین","کمره",9,746,8,3,49,806,2,808
"مرکزی","خمین","کمره",10,185,5,0,25,215,1,216
"مرکزی","خمین","کمره",11,465,3,5,56,529,7,536
"مرکزی","خمین","کمره",12,645,1,5,69,720,5,725
"مرکزی","خمین","کمره",13,600,1,0,46,647,1,648
"مرکزی","خمین","کمره",14,937,1,0,52,990,2,992
"مرکزی","خمین","کمره",15,285,0,1,6,292,2,294
"مرکزی","خمین","کمره",16,587,4,0,42,633,3,636
"مرکزی","خمین","کمره",17,304,0,1,19,324,0,324
"مرکزی","خنداب","مرکزی",1,460,5,3,71,539,2,541
"مرکزی","خنداب","مرکزی",2,811,6,7,189,1013,8,1021
"مرکزی","خنداب","مرکزی",3,419,21,3,174,617,8,625
"مرکزی","خنداب","مرکزی",4,371,8,1,146,526,7,533
"مرکزی","خنداب","مرکزی",5,702,6,1,91,800,0,800
"مرکزی","خنداب","مرکزی",6,656,2,0,111,769,4,773
"مرکزی","خنداب","مرکزی",7,378,2,0,66,446,5,451
"مرکزی","خنداب","مرکزی",8,697,11,1,28,737,7,744
"مرکزی","خنداب","مرکزی",9,681,4,3,45,733,2,735
"مرکزی","خنداب","مرکزی",10,572,0,0,44,616,4,620
"مرکزی","خنداب","مرکزی",11,651,5,0,35,691,26,717
"مرکزی","خنداب","مرکزی",12,388,3,0,42,433,2,435
"مرکزی","خنداب","مرکزی",13,423,5,3,72,503,5,508
"مرکزی","خنداب","مرکزی",14,690,2,1,22,715,6,721
"مرکزی","خنداب","مرکزی",15,601,9,5,193,808,6,814
"مرکزی","خنداب","مرکزی",16,550,1,0,26,577,0,577
"مرکزی","خنداب","مرکزی",17,296,2,0,40,338,3,341
"مرکزی","خنداب","مرکزی",18,466,1,1,22,490,0,490
"مرکزی","خنداب","مرکزی",19,277,0,0,12,289,0,289
"مرکزی","خنداب","مرکزی",20,227,5,2,63,297,3,300
"مرکزی","خنداب","مرکزی",21,454,3,1,18,476,1,477
"مرکزی","خنداب","مرکزی",22,344,2,1,20,367,2,369
"مرکزی","خنداب","مرکزی",23,443,2,5,41,491,3,494
"مرکزی","خنداب","مرکزی",24,367,3,1,28,399,2,401
"مرکزی","خنداب","مرکزی",25,332,1,1,43,377,1,378
"مرکزی","خنداب","مرکزی",26,202,0,1,8,211,0,211
"مرکزی","خنداب","مرکزی",27,382,0,0,20,402,1,403
"مرکزی","خنداب","قره_چای",1,954,2,13,143,1112,18,1130
"مرکزی","خنداب","قره_چای",2,826,5,4,102,937,5,942
"مرکزی","خنداب","قره_چای",3,566,2,3,86,657,5,662
"مرکزی","خنداب","قره_چای",4,841,1,2,95,939,5,944
"مرکزی","خنداب","قره_چای",5,520,6,0,79,605,6,611
"مرکزی","خنداب","قره_چای",6,548,5,1,79,633,1,634
"مرکزی","خنداب","قره_چای",7,351,3,0,28,382,2,384
"مرکزی","خنداب","قره_چای",8,579,7,7,100,693,8,701
"مرکزی","خنداب","قره_چای",9,619,5,8,221,853,13,866
"مرکزی","خنداب","قره_چای",10,572,1,4,71,648,0,648
"مرکزی","خنداب","قره_چای",11,394,8,2,57,461,3,464
"مرکزی","خنداب","قره_چای",12,749,4,0,62,815,8,823
"مرکزی","خنداب","قره_چای",13,515,4,4,61,584,9,593
"مرکزی","خنداب","قره_چای",14,748,2,8,57,815,5,820
"مرکزی","خنداب","قره_چای",15,535,2,2,39,578,10,588
"مرکزی","خنداب","قره_چای",16,541,1,2,109,653,3,656
"مرکزی","خنداب","قره_چای",17,587,4,4,85,680,3,683
"مرکزی","خنداب","قره_چای",18,544,6,3,50,603,4,607
"مرکزی","خنداب","قره_چای",19,504,5,0,119,628,1,629
"مرکزی","خنداب","قره_چای",20,728,5,3,109,845,6,851
"مرکزی","خنداب","قره_چای",21,406,2,3,40,451,2,453
"مرکزی","خنداب","قره_چای",22,351,1,0,17,369,2,371
"مرکزی","خنداب","قره_چای",23,594,6,1,49,650,3,653
"مرکزی","خنداب","قره_چای",24,215,1,1,32,249,0,249
"مرکزی","خنداب","قره_چای",25,655,0,0,123,778,1,779
"مرکزی","خنداب","قره_چای",26,429,1,1,25,456,0,456
"مرکزی","خنداب","قره_چای",27,346,2,2,32,382,2,384
"مرکزی","خنداب","قره_چای",28,264,1,1,10,276,0,276
"مرکزی","خنداب","قره_چای",29,579,2,9,29,619,7,626
"مرکزی","خنداب","قره_چای",30,359,12,0,23,394,2,396
"مرکزی","خنداب","قره_چای",31,505,4,4,20,533,1,534
"مرکزی","دلیجان","مرکزی",1,199,3,1,92,295,6,301
"مرکزی","دلیجان","مرکزی",2,389,4,6,185,584,9,593
"مرکزی","دلیجان","مرکزی",3,493,13,8,406,920,11,931
"مرکزی","دلیجان","مرکزی",4,642,13,7,334,996,13,1009
"مرکزی","دلیجان","مرکزی",5,352,8,19,231,610,5,615
"مرکزی","دلیجان","مرکزی",6,288,10,20,248,566,5,571
"مرکزی","دلیجان","مرکزی",7,683,3,2,240,928,8,936
"مرکزی","دلیجان","مرکزی",8,589,9,5,282,885,13,898
"مرکزی","دلیجان","مرکزی",9,680,7,3,235,925,14,939
"مرکزی","دلیجان","مرکزی",10,281,6,6,168,461,10,471
"مرکزی","دلیجان","مرکزی",11,253,11,2,86,352,4,356
"مرکزی","دلیجان","مرکزی",12,746,10,2,379,1137,14,1151
"مرکزی","دلیجان","مرکزی",13,626,10,4,304,944,4,948
"مرکزی","دلیجان","مرکزی",14,614,8,6,375,1003,11,1014
"مرکزی","دلیجان","مرکزی",15,379,9,7,397,792,7,799
"مرکزی","دلیجان","مرکزی",16,302,4,6,296,608,3,611
"مرکزی","دلیجان","مرکزی",17,629,11,25,415,1080,10,1090
"مرکزی","دلیجان","مرکزی",18,572,10,1,252,835,5,840
"مرکزی","دلیجان","مرکزی",19,708,7,4,282,1001,11,1012
"مرکزی","دلیجان","مرکزی",20,474,6,4,270,754,13,767
"مرکزی","دلیجان","مرکزی",21,356,2,6,236,600,4,604
"مرکزی","دلیجان","مرکزی",22,447,4,7,281,739,7,746
"مرکزی","دلیجان","مرکزی",23,362,3,1,84,450,4,454
"مرکزی","دلیجان","مرکزی",24,461,5,9,138,613,7,620
"مرکزی","دلیجان","مرکزی",25,466,5,0,78,549,5,554
"مرکزی","دلیجان","مرکزی",26,384,1,0,44,429,2,431
"مرکزی","دلیجان","مرکزی",27,481,4,0,177,662,7,669
"مرکزی","دلیجان","مرکزی",28,431,3,1,115,550,10,560
"مرکزی","دلیجان","مرکزی",29,162,5,1,51,219,3,222
"مرکزی","دلیجان","مرکزی",30,698,1,0,134,833,0,833
"مرکزی","دلیجان","مرکزی",31,567,2,0,65,634,4,638
"مرکزی","دلیجان","مرکزی",32,222,0,0,29,251,2,253
"مرکزی","دلیجان","مرکزی",33,250,0,0,41,291,3,294
"مرکزی","دلیجان","مرکزی",34,328,2,0,28,358,6,364
"مرکزی","دلیجان","مرکزی",35,922,10,0,89,1021,7,1028
"مرکزی","دلیجان","مرکزی",36,440,1,1,60,502,2,504
"مرکزی","دلیجان","مرکزی",37,450,5,0,53,508,5,513
"مرکزی","دلیجان","مرکزی",38,338,6,1,60,405,5,410
"مرکزی","دلیجان","مرکزی",39,348,4,4,88,444,6,450
"مرکزی","دلیجان","مرکزی",40,428,15,0,144,587,7,594
"مرکزی","دلیجان","مرکزی",41,768,1,0,58,827,2,829
"مرکزی","دلیجان","مرکزی",42,281,5,3,34,323,1,324
"مرکزی","زرندیه","مرکزی",1,1376,21,10,613,2020,17,2037
"مرکزی","زرندیه","مرکزی",2,1008,26,3,594,1631,23,1654
"مرکزی","زرندیه","مرکزی",3,1524,20,0,359,1903,11,1914
"مرکزی","زرندیه","مرکزی",4,625,10,0,281,916,8,924
"مرکزی","زرندیه","مرکزی",5,964,13,2,255,1234,8,1242
"مرکزی","زرندیه","مرکزی",6,944,8,3,186,1141,6,1147
"مرکزی","زرندیه","مرکزی",7,963,16,2,205,1186,9,1195
"مرکزی","زرندیه","مرکزی",8,539,4,0,127,670,8,678
"مرکزی","زرندیه","مرکزی",9,1316,15,7,465,1803,19,1822
"مرکزی","زرندیه","مرکزی",10,1458,13,0,325,1796,11,1807
"مرکزی","زرندیه","مرکزی",11,1470,12,3,227,1712,10,1722
"مرکزی","زرندیه","مرکزی",12,1594,6,0,130,1730,4,1734
"مرکزی","زرندیه","مرکزی",13,384,0,0,20,404,3,407
"مرکزی","زرندیه","مرکزی",14,152,1,0,61,214,0,214
"مرکزی","زرندیه","مرکزی",15,147,2,0,37,186,2,188
"مرکزی","زرندیه","مرکزی",16,1123,8,1,128,1260,12,1272
"مرکزی","زرندیه","مرکزی",17,794,8,1,106,909,4,913
"مرکزی","زرندیه","مرکزی",18,979,10,0,133,1122,6,1128
"مرکزی","زرندیه","مرکزی",19,694,8,0,86,788,5,793
"مرکزی","زرندیه","مرکزی",20,557,4,1,101,663,2,665
"مرکزی","زرندیه","مرکزی",21,383,2,0,18,403,1,404
"مرکزی","زرندیه","مرکزی",22,1326,3,0,160,1489,8,1497
"مرکزی","زرندیه","مرکزی",23,1137,2,0,41,1180,2,1182
"مرکزی","زرندیه","مرکزی",24,1055,3,1,47,1106,2,1108
"مرکزی","زرندیه","مرکزی",25,617,0,2,122,741,4,745
"مرکزی","زرندیه","مرکزی",26,266,5,1,99,371,1,372
"مرکزی","زرندیه","مرکزی",27,173,2,0,12,187,0,187
"مرکزی","زرندیه","خرقان",1,419,7,0,87,513,4,517
"مرکزی","زرندیه","خرقان",2,669,1,0,30,700,3,703
"مرکزی","زرندیه","خرقان",3,657,3,0,116,776,3,779
"مرکزی","زرندیه","خرقان",4,654,6,2,107,769,3,772
"مرکزی","زرندیه","خرقان",5,537,4,0,40,581,1,582
"مرکزی","زرندیه","خرقان",6,401,3,1,38,443,1,444
"مرکزی","زرندیه","خرقان",7,269,1,0,36,306,1,307
"مرکزی","زرندیه","خرقان",8,431,2,1,53,487,0,487
"مرکزی","زرندیه","خرقان",9,484,3,1,45,533,0,533
"مرکزی","زرندیه","خرقان",10,222,1,0,24,247,0,247
"مرکزی","زرندیه","خرقان",11,634,3,0,70,707,5,712
"مرکزی","زرندیه","خرقان",12,161,0,0,45,206,0,206
"مرکزی","زرندیه","خرقان",13,275,4,1,118,398,0,398
"مرکزی","ساوه","مرکزی",1,1371,20,6,486,1883,18,1901
"مرکزی","ساوه","مرکزی",2,1355,13,1,372,1741,10,1751
"مرکزی","ساوه","مرکزی",3,1145,18,8,551,1722,28,1750
"مرکزی","ساوه","مرکزی",4,1196,27,12,827,2062,15,2077
"مرکزی","ساوه","مرکزی",5,1209,29,12,754,2004,22,2026
"مرکزی","ساوه","مرکزی",6,1096,42,11,925,2074,32,2106
"مرکزی","ساوه","مرکزی",7,912,32,15,923,1882,17,1899
"مرکزی","ساوه","مرکزی",8,1444,13,5,277,1739,12,1751
"مرکزی","ساوه","مرکزی",9,1196,25,11,468,1700,26,1726
"مرکزی","ساوه","مرکزی",10,922,18,6,579,1525,19,1544
"مرکزی","ساوه","مرکزی",11,1415,22,8,744,2189,33,2222
"مرکزی","ساوه","مرکزی",12,1190,30,9,527,1756,26,1782
"مرکزی","ساوه","مرکزی",13,1011,18,2,558,1589,18,1607
"مرکزی","ساوه","مرکزی",14,692,7,3,302,1004,9,1013
"مرکزی","ساوه","مرکزی",15,1285,33,11,750,2079,32,2111
"مرکزی","ساوه","مرکزی",16,1303,26,3,532,1864,10,1874
"مرکزی","ساوه","مرکزی",17,1200,32,8,594,1834,14,1848
"مرکزی","ساوه","مرکزی",18,1474,22,3,372,1871,13,1884
"مرکزی","ساوه","مرکزی",19,1158,19,11,364,1552,20,1572
"مرکزی","ساوه","مرکزی",20,950,10,5,318,1283,14,1297
"مرکزی","ساوه","مرکزی",21,1248,17,6,453,1724,17,1741
"مرکزی","ساوه","مرکزی",22,1009,15,8,400,1432,18,1450
"مرکزی","ساوه","مرکزی",23,1106,21,4,630,1761,30,1791
"مرکزی","ساوه","مرکزی",24,1087,20,1,603,1711,25,1736
"مرکزی","ساوه","مرکزی",25,1353,10,5,469,1837,14,1851
"مرکزی","ساوه","مرکزی",26,1388,25,1,561,1975,24,1999
"مرکزی","ساوه","مرکزی",27,1562,10,7,315,1894,17,1911
"مرکزی","ساوه","مرکزی",28,1595,18,5,594,2212,21,2233
"مرکزی","ساوه","مرکزی",29,1790,27,10,503,2330,17,2347
"مرکزی","ساوه","مرکزی",30,1706,6,3,242,1957,22,1979
"مرکزی","ساوه","مرکزی",31,1375,8,6,206,1595,8,1603
"مرکزی","ساوه","مرکزی",32,1477,10,2,203,1692,6,1698
"مرکزی","ساوه","مرکزی",33,1116,16,5,377,1514,10,1524
"مرکزی","ساوه","مرکزی",34,2295,28,7,500,2830,25,2855
"مرکزی","ساوه","مرکزی",35,1362,10,3,372,1747,9,1756
"مرکزی","ساوه","مرکزی",36,1716,19,11,522,2268,28,2296
"مرکزی","ساوه","مرکزی",37,1258,12,13,432,1715,23,1738
"مرکزی","ساوه","مرکزی",38,1235,7,2,531,1775,25,1800
"مرکزی","ساوه","مرکزی",39,1753,32,8,670,2463,25,2488
"مرکزی","ساوه","مرکزی",40,1567,22,3,613,2205,15,2220
"مرکزی","ساوه","مرکزی",41,2013,33,7,555,2608,24,2632
"مرکزی","ساوه","مرکزی",42,1525,12,4,423,1964,20,1984
"مرکزی","ساوه","مرکزی",43,1148,16,2,425,1591,17,1608
"مرکزی","ساوه","مرکزی",44,1542,13,4,272,1831,23,1854
"مرکزی","ساوه","مرکزی",45,443,7,6,158,614,4,618
"مرکزی","ساوه","مرکزی",46,297,2,0,100,399,4,403
"مرکزی","ساوه","مرکزی",47,815,11,2,111,939,8,947
"مرکزی","ساوه","مرکزی",48,903,10,2,182,1097,16,1113
"مرکزی","ساوه","مرکزی",49,778,3,0,317,1098,3,1101
"مرکزی","ساوه","مرکزی",50,289,3,1,116,409,6,415
"مرکزی","ساوه","مرکزی",51,667,4,6,150,827,9,836
"مرکزی","ساوه","مرکزی",52,494,4,0,51,549,0,549
"مرکزی","ساوه","مرکزی",53,398,2,0,26,426,3,429
"مرکزی","ساوه","مرکزی",54,855,3,0,52,910,3,913
"مرکزی","ساوه","مرکزی",55,642,6,4,80,732,7,739
"مرکزی","ساوه","مرکزی",56,1006,12,4,130,1152,3,1155
"مرکزی","ساوه","مرکزی",57,447,5,0,47,499,0,499
"مرکزی","ساوه","مرکزی",58,336,2,1,30,369,1,370
"مرکزی","ساوه","مرکزی",59,792,1,2,141,936,7,943
"مرکزی","ساوه","مرکزی",60,833,9,1,291,1134,4,1138
"مرکزی","ساوه","مرکزی",61,1108,5,1,202,1316,22,1338
"مرکزی","ساوه","مرکزی",62,150,1,0,17,168,0,168
"مرکزی","ساوه","مرکزی",63,61,0,0,8,69,0,69
"مرکزی","ساوه","مرکزی",64,924,34,7,657,1622,16,1638
"مرکزی","ساوه","مرکزی",65,240,1,0,120,361,6,367
"مرکزی","ساوه","مرکزی",66,810,0,1,92,903,5,908
"مرکزی","ساوه","مرکزی",67,402,3,0,85,490,1,491
"مرکزی","ساوه","مرکزی",68,1017,2,4,91,1114,7,1121
"مرکزی","ساوه","مرکزی",69,269,2,0,39,310,0,310
"مرکزی","ساوه","مرکزی",70,854,2,6,93,955,1,956
"مرکزی","ساوه","مرکزی",71,207,0,0,33,240,0,240
"مرکزی","ساوه","مرکزی",72,417,3,1,74,495,2,497
"مرکزی","ساوه","مرکزی",73,170,0,1,38,209,1,210
"مرکزی","ساوه","مرکزی",74,381,1,0,74,456,0,456
"مرکزی","ساوه","مرکزی",75,426,5,1,79,511,4,515
"مرکزی","ساوه","مرکزی",76,845,14,6,291,1156,14,1170
"مرکزی","ساوه","مرکزی",77,578,5,3,150,736,3,739
"مرکزی","ساوه","مرکزی",78,668,7,5,148,828,2,830
"مرکزی","ساوه","مرکزی",79,1050,8,3,346,1407,10,1417
"مرکزی","ساوه","مرکزی",80,301,5,0,62,368,3,371
"مرکزی","ساوه","مرکزی",81,437,4,0,39,480,5,485
"مرکزی","ساوه","مرکزی",82,359,2,0,45,406,5,411
"مرکزی","ساوه","مرکزی",83,247,1,0,48,296,2,298
"مرکزی","ساوه","مرکزی",84,341,3,3,11,358,3,361
"مرکزی","ساوه","مرکزی",85,627,7,1,28,663,4,667
"مرکزی","ساوه","مرکزی",86,381,0,0,49,430,1,431
"مرکزی","ساوه","مرکزی",87,367,2,0,110,479,0,479
"مرکزی","ساوه","مرکزی",88,442,5,1,110,558,11,569
"مرکزی","ساوه","مرکزی",89,374,0,2,56,432,3,435
"مرکزی","ساوه","مرکزی",90,598,3,2,98,701,1,702
"مرکزی","ساوه","مرکزی",91,853,5,4,129,991,9,1000
"مرکزی","ساوه","مرکزی",92,403,0,0,13,416,3,419
"مرکزی","ساوه","مرکزی",93,453,1,0,59,513,4,517
"مرکزی","ساوه","مرکزی",94,321,0,0,63,384,7,391
"مرکزی","ساوه","مرکزی",95,474,2,1,50,527,1,528
"مرکزی","ساوه","مرکزی",96,298,4,1,22,325,0,325
"مرکزی","ساوه","مرکزی",97,213,1,0,39,253,1,254
"مرکزی","ساوه","مرکزی",98,366,2,0,66,434,4,438
"مرکزی","ساوه","مرکزی",99,245,4,0,77,326,2,328
"مرکزی","ساوه","مرکزی",100,444,3,0,95,542,1,543
"مرکزی","شازند","مرکزی",1,795,29,26,321,1171,15,1186
"مرکزی","شازند","مرکزی",2,976,46,31,573,1626,29,1655
"مرکزی","شازند","مرکزی",3,883,18,21,216,1138,17,1155
"مرکزی","شازند","مرکزی",4,604,17,36,276,933,21,954
"مرکزی","شازند","مرکزی",5,996,3,15,476,1490,21,1511
"مرکزی","شازند","مرکزی",6,373,10,17,232,632,15,647
"مرکزی","شازند","مرکزی",7,1038,23,45,394,1500,28,1528
"مرکزی","شازند","مرکزی",8,691,18,9,228,946,12,958
"مرکزی","شازند","مرکزی",9,899,10,4,192,1105,1,1106
"مرکزی","شازند","مرکزی",10,713,17,7,198,935,12,947
"مرکزی","شازند","مرکزی",11,147,2,3,92,244,0,244
"مرکزی","شازند","مرکزی",12,208,11,7,122,348,6,354
"مرکزی","شازند","مرکزی",13,1020,20,9,447,1496,13,1509
"مرکزی","شازند","مرکزی",14,562,13,7,286,868,8,876
"مرکزی","شازند","مرکزی",15,635,9,4,218,866,5,871
"مرکزی","شازند","مرکزی",16,456,0,0,163,619,3,622
"مرکزی","شازند","مرکزی",17,263,4,4,138,409,3,412
"مرکزی","شازند","مرکزی",18,879,11,0,115,1005,4,1009
"مرکزی","شازند","مرکزی",19,705,1,2,64,772,5,777
"مرکزی","شازند","مرکزی",20,800,3,1,89,893,6,899
"مرکزی","شازند","مرکزی",21,843,9,0,108,960,5,965
"مرکزی","شازند","مرکزی",22,991,6,3,198,1198,6,1204
"مرکزی","شازند","مرکزی",23,825,5,3,169,1002,9,1011
"مرکزی","شازند","مرکزی",24,375,8,3,122,508,12,520
"مرکزی","شازند","مرکزی",25,1113,3,7,213,1336,13,1349
"مرکزی","شازند","مرکزی",26,1379,19,4,142,1544,14,1558
"مرکزی","شازند","مرکزی",27,1472,4,4,182,1662,17,1679
"مرکزی","شازند","مرکزی",28,844,7,6,173,1030,12,1042
"مرکزی","شازند","مرکزی",29,904,5,2,91,1002,7,1009
"مرکزی","شازند","مرکزی",30,700,3,2,89,794,5,799
"مرکزی","شازند","مرکزی",31,837,4,3,81,925,6,931
"مرکزی","شازند","مرکزی",32,667,9,3,98,777,6,783
"مرکزی","شازند","مرکزی",33,749,1,2,22,774,8,782
"مرکزی","شازند","مرکزی",34,683,2,4,19,708,5,713
"مرکزی","شازند","مرکزی",35,895,7,4,139,1045,18,1063
"مرکزی","شازند","مرکزی",36,1096,5,10,149,1260,9,1269
"مرکزی","شازند","مرکزی",37,1080,4,2,145,1231,5,1236
"مرکزی","شازند","مرکزی",38,754,8,1,67,830,3,833
"مرکزی","شازند","مرکزی",39,672,1,4,48,725,5,730
"مرکزی","شازند","مرکزی",40,618,2,3,62,685,5,690
"مرکزی","شازند","مرکزی",41,614,1,5,146,766,2,768
"مرکزی","شازند","مرکزی",42,1262,13,4,81,1360,10,1370
"مرکزی","شازند","مرکزی",43,941,23,4,323,1291,14,1305
"مرکزی","شازند","مرکزی",44,238,71,6,210,525,3,528
"مرکزی","شازند","مرکزی",45,351,15,7,186,559,7,566
"مرکزی","شازند","مرکزی",46,653,6,5,73,737,7,744
"مرکزی","شازند","زالیان",1,1224,3,7,236,1470,9,1479
"مرکزی","شازند","زالیان",2,698,3,1,90,792,7,799
"مرکزی","شازند","زالیان",3,1286,1,6,164,1457,6,1463
"مرکزی","شازند","زالیان",4,757,3,4,90,854,6,860
"مرکزی","شازند","زالیان",5,793,4,0,95,892,6,898
"مرکزی","شازند","زالیان",6,1091,1,1,23,1116,0,1116
"مرکزی","شازند","زالیان",7,712,0,3,40,755,3,758
"مرکزی","شازند","زالیان",8,475,2,0,58,535,0,535
"مرکزی","شازند","زالیان",9,693,103,19,793,1608,15,1623
"مرکزی","شازند","زالیان",10,748,38,39,727,1552,22,1574
"مرکزی","شازند","زالیان",11,1081,51,37,914,2083,33,2116
"مرکزی","شازند","زالیان",12,663,8,7,184,862,4,866
"مرکزی","شازند","زالیان",13,304,10,6,170,490,6,496
"مرکزی","شازند","زالیان",14,814,2,1,48,865,7,872
"مرکزی","شازند","زالیان",15,909,9,0,203,1121,5,1126
"مرکزی","شازند","زالیان",16,687,5,0,86,778,3,781
"مرکزی","شازند","زالیان",17,352,3,3,61,419,3,422
"مرکزی","شازند","زالیان",18,556,1,2,55,614,3,617
"مرکزی","شازند","زالیان",19,167,5,3,91,266,7,273
"مرکزی","شازند","زالیان",20,1033,3,5,37,1078,2,1080
"مرکزی","شازند","زالیان",21,974,5,4,64,1047,5,1052
"مرکزی","شازند","زالیان",22,793,5,1,72,871,8,879
"مرکزی","شازند","زالیان",23,347,0,0,24,371,2,373
"مرکزی","شازند","زالیان",24,777,2,0,47,826,4,830
"مرکزی","شازند","زالیان",25,273,5,0,38,316,2,318
"مرکزی","شازند","زالیان",26,239,0,0,20,259,0,259
"مرکزی","شازند","سربند",1,555,8,1,95,659,5,664
"مرکزی","شازند","سربند",2,472,6,5,110,593,6,599
"مرکزی","شازند","سربند",3,625,7,3,69,704,3,707
"مرکزی","شازند","سربند",4,231,3,2,14,250,0,250
"مرکزی","شازند","سربند",5,485,0,1,12,498,2,500
"مرکزی","شازند","سربند",6,284,4,0,42,330,0,330
"مرکزی","شازند","سربند",7,466,2,1,16,485,2,487
"مرکزی","شازند","سربند",8,254,4,4,23,285,1,286
"مرکزی","شازند","سربند",9,363,4,0,15,382,4,386
"مرکزی","شازند","سربند",10,379,2,0,13,394,1,395
"مرکزی","شازند","سربند",11,384,8,0,18,410,1,411
"مرکزی","شازند","سربند",12,509,1,3,54,567,2,569
"مرکزی","شازند","سربند",13,267,2,0,18,287,1,288
"مرکزی","شازند","سربند",14,134,0,0,8,142,0,142
"مرکزی","شازند","سربند",15,65,0,3,59,127,2,129
"مرکزی","شازند","سربند",16,187,0,0,7,194,2,196
"مرکزی","شازند","سربند",17,388,2,1,97,488,3,491
"مرکزی","شازند","سربند",18,365,3,2,30,400,2,402
"مرکزی","شازند","سربند",19,346,1,0,36,383,3,386
"مرکزی","شازند","سربند",20,359,3,0,18,380,4,384
"مرکزی","شازند","سربند",21,375,1,1,14,391,0,391
"مرکزی","شازند","سربند",22,292,4,2,11,309,5,314
"مرکزی","شازند","سربند",23,243,0,0,8,251,0,251
"مرکزی","شازند","سربند",24,517,4,1,11,533,3,536
"مرکزی","کمیجان","مرکزی",1,812,6,4,243,1065,3,1068
"مرکزی","کمیجان","مرکزی",2,692,3,2,243,940,6,946
"مرکزی","کمیجان","مرکزی",3,388,7,1,213,609,0,609
"مرکزی","کمیجان","مرکزی",4,502,1,1,96,600,5,605
"مرکزی","کمیجان","مرکزی",5,522,7,2,208,739,4,743
"مرکزی","کمیجان","مرکزی",6,454,8,1,190,653,5,658
"مرکزی","کمیجان","مرکزی",7,638,3,1,55,697,3,700
"مرکزی","کمیجان","مرکزی",8,729,6,0,93,828,3,831
"مرکزی","کمیجان","مرکزی",9,574,7,2,94,677,7,684
"مرکزی","کمیجان","مرکزی",10,274,1,0,36,311,0,311
"مرکزی","کمیجان","مرکزی",11,469,0,1,63,533,4,537
"مرکزی","کمیجان","مرکزی",12,711,4,0,107,822,7,829
"مرکزی","کمیجان","مرکزی",13,874,6,2,71,953,7,960
"مرکزی","کمیجان","مرکزی",14,486,0,0,50,536,2,538
"مرکزی","کمیجان","مرکزی",15,250,1,0,64,315,1,316
"مرکزی","کمیجان","مرکزی",16,656,3,0,20,679,0,679
"مرکزی","کمیجان","مرکزی",17,486,2,2,8,498,2,500
"مرکزی","کمیجان","مرکزی",18,540,2,6,40,588,2,590
"مرکزی","کمیجان","مرکزی",19,518,4,1,49,572,0,572
"مرکزی","کمیجان","مرکزی",20,136,1,1,55,193,2,195
"مرکزی","کمیجان","مرکزی",21,499,0,1,33,533,5,538
"مرکزی","کمیجان","مرکزی",22,418,1,0,20,439,3,442
"مرکزی","کمیجان","مرکزی",23,374,0,0,8,382,2,384
"مرکزی","کمیجان","مرکزی",24,378,0,3,5,386,0,386
"مرکزی","کمیجان","مرکزی",25,362,0,1,11,374,0,374
"مرکزی","کمیجان","مرکزی",26,551,2,0,115,668,2,670
"مرکزی","کمیجان","مرکزی",27,312,0,0,10,322,0,322
"مرکزی","کمیجان","مرکزی",28,403,2,0,22,427,0,427
"مرکزی","کمیجان","مرکزی",29,224,3,0,23,250,0,250
"مرکزی","کمیجان","میلاجرد",1,865,11,0,52,928,4,932
"مرکزی","کمیجان","میلاجرد",2,1131,23,7,124,1285,10,1295
"مرکزی","کمیجان","میلاجرد",3,711,3,1,34,749,4,753
"مرکزی","کمیجان","میلاجرد",4,767,6,14,28,815,3,818
"مرکزی","کمیجان","میلاجرد",5,519,9,2,51,581,10,591
"مرکزی","کمیجان","میلاجرد",6,628,3,1,52,684,4,688
"مرکزی","کمیجان","میلاجرد",7,415,1,2,21,439,1,440
"مرکزی","کمیجان","میلاجرد",8,674,5,4,29,712,1,713
"مرکزی","کمیجان","میلاجرد",9,799,12,6,103,920,7,927
"مرکزی","کمیجان","میلاجرد",10,473,1,2,27,503,5,508
"مرکزی","کمیجان","میلاجرد",11,554,4,0,36,594,1,595
"مرکزی","کمیجان","میلاجرد",12,326,2,0,18,346,0,346
"مرکزی","کمیجان","میلاجرد",13,321,1,1,14,337,0,337
"مرکزی","کمیجان","میلاجرد",14,354,4,0,30,388,0,388
"مرکزی","کمیجان","میلاجرد",15,348,6,1,45,400,1,401
"مرکزی","کمیجان","میلاجرد",16,212,2,0,12,226,0,226
"مرکزی","کمیجان","میلاجرد",17,247,3,0,47,297,3,300
"مرکزی","کمیجان","میلاجرد",18,275,0,0,16,291,2,293
"مرکزی","کمیجان","میلاجرد",19,395,2,2,25,424,1,425
"مرکزی","محلات","مرکزی",1,387,16,10,441,854,16,870
"مرکزی","محلات","مرکزی",2,490,24,7,397,918,16,934
"مرکزی","محلات","مرکزی",3,704,26,7,576,1313,21,1334
"مرکزی","محلات","مرکزی",4,421,8,5,284,718,14,732
"مرکزی","محلات","مرکزی",5,443,13,1,228,685,6,691
"مرکزی","محلات","مرکزی",6,525,20,1,181,727,7,734
"مرکزی","محلات","مرکزی",7,634,22,10,513,1179,13,1192
"مرکزی","محلات","مرکزی",8,723,20,4,334,1081,17,1098
"مرکزی","محلات","مرکزی",9,552,7,9,217,785,8,793
"مرکزی","محلات","مرکزی",10,447,8,2,137,594,2,596
"مرکزی","محلات","مرکزی",11,706,10,20,142,878,3,881
"مرکزی","محلات","مرکزی",12,499,10,5,234,748,4,752
"مرکزی","محلات","مرکزی",13,767,18,3,253,1041,10,1051
"مرکزی","محلات","مرکزی",14,898,26,1,162,1087,9,1096
"مرکزی","محلات","مرکزی",15,630,16,5,297,948,11,959
"مرکزی","محلات","مرکزی",16,884,12,6,282,1184,13,1197
"مرکزی","محلات","مرکزی",17,366,11,8,212,597,5,602
"مرکزی","محلات","مرکزی",18,340,13,7,224,584,12,596
"مرکزی","محلات","مرکزی",19,597,26,1,459,1083,18,1101
"مرکزی","محلات","مرکزی",20,650,22,4,560,1236,14,1250
"مرکزی","محلات","مرکزی",21,494,31,3,692,1220,14,1234
"مرکزی","محلات","مرکزی",22,456,22,2,504,984,15,999
"مرکزی","محلات","مرکزی",23,388,6,1,152,547,2,549
"مرکزی","محلات","مرکزی",24,401,6,5,183,595,8,603
"مرکزی","محلات","مرکزی",25,402,14,3,336,755,9,764
"مرکزی","محلات","مرکزی",26,421,19,5,253,698,6,704
"مرکزی","محلات","مرکزی",27,358,9,1,312,680,7,687
"مرکزی","محلات","مرکزی",28,686,6,2,211,905,5,910
"مرکزی","محلات","مرکزی",29,250,0,1,62,313,1,314
"مرکزی","محلات","مرکزی",30,187,0,1,17,205,0,205
"مرکزی","محلات","مرکزی",31,212,0,1,58,271,0,271
"مرکزی","محلات","مرکزی",32,429,7,1,34,471,4,475
"مرکزی","محلات","مرکزی",33,591,6,1,138,736,4,740
"مرکزی","محلات","مرکزی",34,139,6,0,139,284,2,286
"مرکزی","محلات","مرکزی",35,363,4,0,151,518,2,520
"مرکزی","محلات","مرکزی",36,411,2,0,77,490,4,494
"مرکزی","محلات","مرکزی",37,365,4,1,25,395,2,397
"مرکزی","محلات","مرکزی",38,249,1,0,46,296,2,298
"مرکزی","محلات","مرکزی",39,164,2,2,68,236,1,237
"مرکزی","محلات","مرکزی",40,198,2,0,18,218,0,218
"مرکزی","محلات","مرکزی",41,361,2,1,42,406,2,408
"هرمزگان","ابوموسی","مرکزی",1,693,10,3,95,801,5,806
"هرمزگان","ابوموسی","مرکزی",2,495,7,0,72,574,7,581
"هرمزگان","ابوموسی","مرکزی",3,216,1,1,39,257,2,259
"هرمزگان","ابوموسی","مرکزی",4,427,9,10,238,684,5,689
"هرمزگان","ابوموسی","مرکزی",5,281,65,2,146,494,2,496
"هرمزگان","ابوموسی","تنب",6,400,2,0,37,439,3,442
"هرمزگان","ابوموسی","تنب",7,219,2,0,18,239,1,240
"هرمزگان","بستک","مرکزی",1,260,10,17,744,1031,6,1037
"هرمزگان","بستک","مرکزی",2,132,4,10,474,620,7,627
"هرمزگان","بستک","مرکزی",3,122,4,5,875,1006,6,1012
"هرمزگان","بستک","مرکزی",4,171,3,11,660,845,13,858
"هرمزگان","بستک","مرکزی",5,234,2,1,454,691,5,696
"هرمزگان","بستک","مرکزی",6,25,2,1,96,124,0,124
"هرمزگان","بستک","مرکزی",7,94,4,4,296,398,3,401
"هرمزگان","بستک","مرکزی",8,115,1,3,382,501,1,502
"هرمزگان","بستک","مرکزی",9,62,1,2,149,214,3,217
"هرمزگان","بستک","مرکزی",10,50,1,2,183,236,1,237
"هرمزگان","بستک","مرکزی",11,168,6,13,561,748,4,752
"هرمزگان","بستک","مرکزی",12,101,2,3,111,217,3,220
"هرمزگان","بستک","مرکزی",13,103,1,5,374,483,7,490
"هرمزگان","بستک","مرکزی",14,232,4,16,184,436,5,441
"هرمزگان","بستک","مرکزی",15,149,5,19,350,523,7,530
"هرمزگان","بستک","مرکزی",16,170,4,14,362,550,7,557
"هرمزگان","بستک","مرکزی",17,51,1,6,314,372,2,374
"هرمزگان","بستک","مرکزی",18,26,0,0,62,88,0,88
"هرمزگان","بستک","مرکزی",19,160,2,1,347,510,7,517
"هرمزگان","بستک","مرکزی",20,39,2,8,280,329,3,332
"هرمزگان","بستک","مرکزی",21,119,1,3,503,626,5,631
"هرمزگان","بستک","مرکزی",22,146,2,4,261,413,3,416
"هرمزگان","بستک","مرکزی",23,150,18,6,389,563,6,569
"هرمزگان","بستک","مرکزی",24,217,1,4,131,353,3,356
"هرمزگان","بستک","مرکزی",25,77,1,4,183,265,4,269
"هرمزگان","بستک","مرکزی",26,66,1,0,144,211,2,213
"هرمزگان","بستک","مرکزی",27,93,0,1,235,329,2,331
"هرمزگان","بستک","مرکزی",28,317,3,8,215,543,6,549
"هرمزگان","بستک","مرکزی",29,312,5,4,245,566,6,572
"هرمزگان","بستک","مرکزی",30,148,1,44,281,474,0,474
"هرمزگان","بستک","مرکزی",31,213,2,1,129,345,0,345
"هرمزگان","بستک","مرکزی",32,109,0,1,58,168,0,168
"هرمزگان","بستک","جناح",1,83,5,15,523,626,14,640
"هرمزگان","بستک","جناح",2,92,3,5,643,743,9,752
"هرمزگان","بستک","جناح",3,84,3,11,620,718,10,728
"هرمزگان","بستک","جناح",4,72,3,8,553,636,8,644
"هرمزگان","بستک","جناح",5,42,2,0,205,249,1,250
"هرمزگان","بستک","جناح",6,75,2,1,148,226,1,227
"هرمزگان","بستک","جناح",7,219,6,16,513,754,10,764
"هرمزگان","بستک","جناح",8,242,6,5,536,789,6,795
"هرمزگان","بستک","جناح",9,81,3,25,546,655,13,668
"هرمزگان","بستک","جناح",10,79,5,17,580,681,11,692
"هرمزگان","بستک","جناح",11,157,3,3,605,768,10,778
"هرمزگان","بستک","جناح",12,163,3,1,411,578,8,586
"هرمزگان","بستک","جناح",13,324,7,96,290,717,13,730
"هرمزگان","بستک","جناح",14,254,9,154,499,916,22,938
"هرمزگان","بستک","جناح",15,119,3,5,489,616,0,616
"هرمزگان","بستک","جناح",16,135,0,5,537,677,0,677
"هرمزگان","بستک","جناح",17,78,3,5,440,526,2,528
"هرمزگان","بستک","جناح",18,112,4,4,334,454,2,456
"هرمزگان","بستک","جناح",19,96,2,5,401,504,6,510
"هرمزگان","بستک","جناح",20,189,2,1,195,387,3,390
"هرمزگان","بستک","جناح",21,253,1,2,402,658,5,663
"هرمزگان","بستک","جناح",22,227,7,6,279,519,8,527
"هرمزگان","بستک","جناح",23,126,7,3,321,457,6,463
"هرمزگان","بستک","جناح",24,162,1,3,253,419,2,421
"هرمزگان","بستک","جناح",25,79,1,16,290,386,5,391
"هرمزگان","بستک","جناح",26,46,0,2,168,216,0,216
"هرمزگان","بستک","جناح",27,59,2,3,191,255,2,257
"هرمزگان","بستک","جناح",28,280,0,0,177,457,0,457
"هرمزگان","بستک","جناح",29,7,0,0,133,140,0,140
"هرمزگان","بستک","جناح",30,9,1,2,119,131,0,131
"هرمزگان","بستک","جناح",31,34,2,1,174,211,1,212
"هرمزگان","بندرلنگه","مرکزی",1,938,1,7,105,1051,2,1053
"هرمزگان","بندرلنگه","مرکزی",2,336,3,17,231,587,8,595
"هرمزگان","بندرلنگه","مرکزی",3,737,13,22,527,1299,14,1313
"هرمزگان","بندرلنگه","مرکزی",4,938,10,19,394,1361,18,1379
"هرمزگان","بندرلنگه","مرکزی",5,736,13,9,223,981,11,992
"هرمزگان","بندرلنگه","مرکزی",6,1535,11,11,294,1851,11,1862
"هرمزگان","بندرلنگه","مرکزی",7,634,6,13,580,1233,12,1245
"هرمزگان","بندرلنگه","مرکزی",8,698,5,3,108,814,12,826
"هرمزگان","بندرلنگه","مرکزی",9,766,14,8,365,1153,37,1190
"هرمزگان","بندرلنگه","مرکزی",10,628,16,25,525,1194,16,1210
"هرمزگان","بندرلنگه","مرکزی",11,1195,2,4,115,1316,6,1322
"هرمزگان","بندرلنگه","مرکزی",12,205,2,17,439,663,9,672
"هرمزگان","بندرلنگه","مرکزی",13,188,3,1,149,341,7,348
"هرمزگان","بندرلنگه","مرکزی",14,297,6,3,253,559,5,564
"هرمزگان","بندرلنگه","مرکزی",15,178,5,3,111,297,9,306
"هرمزگان","بندرلنگه","مرکزی",16,580,14,22,779,1395,14,1409
"هرمزگان","بندرلنگه","مرکزی",17,631,7,11,180,829,10,839
"هرمزگان","بندرلنگه","مرکزی",18,559,11,31,472,1073,6,1079
"هرمزگان","بندرلنگه","مرکزی",19,851,3,9,156,1019,4,1023
"هرمزگان","بندرلنگه","مرکزی",20,391,9,17,237,654,4,658
"هرمزگان","بندرلنگه","مرکزی",21,677,8,9,322,1016,7,1023
"هرمزگان","بندرلنگه","مرکزی",22,328,17,22,446,813,8,821
"هرمزگان","بندرلنگه","مرکزی",23,481,4,17,499,1001,16,1017
"هرمزگان","بندرلنگه","مرکزی",24,127,0,5,52,184,4,188
"هرمزگان","بندرلنگه","مرکزی",25,664,3,3,414,1084,3,1087
"هرمزگان","بندرلنگه","مرکزی",26,197,3,1,246,447,4,451
"هرمزگان","بندرلنگه","مرکزی",27,134,6,4,193,337,0,337
"هرمزگان","بندرلنگه","مرکزی",28,182,7,5,198,392,2,394
"هرمزگان","بندرلنگه","مرکزی",29,160,1,0,140,301,0,301
"هرمزگان","بندرلنگه","مرکزی",30,232,0,1,125,358,4,362
"هرمزگان","بندرلنگه","مرکزی",31,704,5,5,476,1190,13,1203
"هرمزگان","بندرلنگه","مرکزی",32,735,1,1,401,1138,10,1148
"هرمزگان","بندرلنگه","مرکزی",33,258,2,4,262,526,5,531
"هرمزگان","بندرلنگه","مرکزی",34,233,1,10,450,694,9,703
"هرمزگان","بندرلنگه","مرکزی",35,340,13,32,315,700,12,712
"هرمزگان","بندرلنگه","مرکزی",36,594,4,3,131,732,0,732
"هرمزگان","بندرلنگه","مرکزی",37,44,4,14,521,583,3,586
"هرمزگان","بندرلنگه","مرکزی",38,252,0,1,265,518,5,523
"هرمزگان","بندرلنگه","مرکزی",39,577,8,5,328,918,7,925
"هرمزگان","بندرلنگه","مرکزی",40,417,1,5,201,624,1,625
"هرمزگان","بندرلنگه","مرکزی",41,25,1,2,352,380,3,383
"هرمزگان","بندرلنگه","مرکزی",42,278,4,11,566,859,5,864
"هرمزگان","بندرلنگه","مرکزی",43,7,0,0,213,220,0,220
"هرمزگان","بندرلنگه","مرکزی",44,189,2,4,181,376,0,376
"هرمزگان","بندرلنگه","مرکزی",45,166,3,5,345,519,2,521
"هرمزگان","بندرلنگه","مرکزی",46,188,5,3,329,525,6,531
"هرمزگان","بندرلنگه","مرکزی",47,329,4,4,386,723,6,729
"هرمزگان","بندرلنگه","مرکزی",48,336,6,7,467,816,4,820
"هرمزگان","بندرلنگه","مرکزی",49,653,6,7,1001,1667,8,1675
"هرمزگان","بندرلنگه","شیکوه",1,436,11,4,358,809,12,821
"هرمزگان","بندرلنگه","شیکوه",2,303,7,2,250,562,9,571
"هرمزگان","بندرلنگه","شیکوه",3,108,1,1,59,169,1,170
"هرمزگان","بندرلنگه","شیکوه",4,326,5,3,222,556,9,565
"هرمزگان","بندرلنگه","شیکوه",5,103,1,1,208,313,1,314
"هرمزگان","بندرلنگه","شیکوه",6,208,4,3,327,542,9,551
"هرمزگان","بندرلنگه","شیکوه",7,166,2,7,123,298,2,300
"هرمزگان","بندرلنگه","شیکوه",8,221,2,10,180,413,4,417
"هرمزگان","بندرلنگه","شیکوه",9,259,4,7,249,519,2,521
"هرمزگان","بندرلنگه","شیکوه",10,195,4,5,393,597,6,603
"هرمزگان","بندرلنگه","شیکوه",11,82,1,0,236,319,2,321
"هرمزگان","بندرلنگه","شیکوه",12,161,3,1,138,303,3,306
"هرمزگان","بندرلنگه","شیکوه",13,105,1,0,159,265,1,266
"هرمزگان","بندرلنگه","شیکوه",14,413,2,2,178,595,5,600
"هرمزگان","بندرلنگه","شیکوه",15,345,0,1,118,464,2,466
"هرمزگان","بندرلنگه","کیش",1,1073,38,25,862,1998,20,2018
"هرمزگان","بندرلنگه","کیش",2,656,23,16,497,1192,7,1199
"هرمزگان","بندرلنگه","کیش",3,925,16,17,498,1456,14,1470
"هرمزگان","بندرلنگه","کیش",4,609,26,20,828,1483,12,1495
"هرمزگان","بندرلنگه","کیش",5,344,9,8,501,862,2,864
"هرمزگان","بندرلنگه","کیش",6,892,56,25,1662,2635,28,2663
"هرمزگان","بندرلنگه","کیش",7,327,24,19,1024,1394,5,1399
"هرمزگان","بندرلنگه","کیش",8,336,28,23,1087,1474,15,1489
"هرمزگان","بندرلنگه","کیش",9,742,37,38,1616,2433,10,2443
"هرمزگان","بندرلنگه","کیش",10,622,57,22,1380,2081,27,2108
"هرمزگان","بندرلنگه","کیش",11,369,11,4,178,562,12,574
"هرمزگان","بندرلنگه","کیش",12,414,1,4,124,543,3,546
"هرمزگان","بندرلنگه","کیش",13,308,21,6,305,640,8,648
"هرمزگان","بندرلنگه","کیش",14,471,25,6,555,1057,21,1078
"هرمزگان","بندرلنگه","کیش",15,364,10,8,493,875,6,881
"هرمزگان","بندرلنگه","کیش",16,878,28,9,646,1561,12,1573
"هرمزگان","بندرلنگه","کیش",17,179,28,9,167,383,4,387
"هرمزگان","بندعباس","مرکزی",1,657,11,9,223,900,15,915
"هرمزگان","بندعباس","مرکزی",2,985,6,1,154,1146,5,1151
"هرمزگان","بندعباس","مرکزی",3,1036,7,7,381,1431,12,1443
"هرمزگان","بندعباس","مرکزی",4,1019,20,10,824,1873,12,1885
"هرمزگان","بندعباس","مرکزی",5,1210,3,7,162,1382,3,1385
"هرمزگان","بندعباس","مرکزی",6,717,31,17,631,1396,12,1408
"هرمزگان","بندعباس","مرکزی",7,1017,44,9,406,1476,13,1489
"هرمزگان","بندعباس","مرکزی",8,820,15,3,456,1294,12,1306
"هرمزگان","بندعباس","مرکزی",9,378,11,0,177,566,4,570
"هرمزگان","بندعباس","مرکزی",10,473,25,5,306,809,18,827
"هرمزگان","بندعباس","مرکزی",11,826,33,42,1085,1986,22,2008
"هرمزگان","بندعباس","مرکزی",12,850,20,25,910,1805,20,1825
"هرمزگان","بندعباس","مرکزی",13,1283,29,28,1247,2587,34,2621
"هرمزگان","بندعباس","مرکزی",14,786,41,18,1246,2091,20,2111
"هرمزگان","بندعباس","مرکزی",15,1171,37,27,1059,2294,33,2327
"هرمزگان","بندعباس","مرکزی",16,586,28,18,825,1457,15,1472
"هرمزگان","بندعباس","مرکزی",17,808,39,18,1207,2072,22,2094
"هرمزگان","بندعباس","مرکزی",18,963,38,25,1573,2599,19,2618
"هرمزگان","بندعباس","مرکزی",19,954,31,31,929,1945,30,1975
"هرمزگان","بندعباس","مرکزی",20,1137,7,12,252,1408,6,1414
"هرمزگان","بندعباس","مرکزی",21,1132,13,6,300,1451,4,1455
"هرمزگان","بندعباس","مرکزی",22,1070,3,3,191,1267,5,1272
"هرمزگان","بندعباس","مرکزی",23,864,8,10,389,1271,6,1277
"هرمزگان","بندعباس","مرکزی",24,968,29,18,614,1629,9,1638
"هرمزگان","بندعباس","مرکزی",25,765,36,61,1034,1896,22,1918
"هرمزگان","بندعباس","مرکزی",26,898,47,30,1191,2166,34,2200
"هرمزگان","بندعباس","مرکزی",27,731,30,18,973,1752,21,1773
"هرمزگان","بندعباس","مرکزی",28,637,27,9,831,1504,7,1511
"هرمزگان","بندعباس","مرکزی",29,1029,18,14,476,1537,24,1561
"هرمزگان","بندعباس","مرکزی",30,871,28,30,911,1840,22,1862
"هرمزگان","بندعباس","مرکزی",31,904,25,20,800,1749,21,1770
"هرمزگان","بندعباس","مرکزی",32,1384,23,9,570,1986,17,2003
"هرمزگان","بندعباس","مرکزی",33,1294,20,17,904,2235,32,2267
"هرمزگان","بندعباس","مرکزی",34,1102,12,0,341,1455,11,1466
"هرمزگان","بندعباس","مرکزی",35,755,12,5,413,1185,16,1201
"هرمزگان","بندعباس","مرکزی",36,1462,16,23,284,1785,17,1802
"هرمزگان","بندعباس","مرکزی",37,831,43,22,1096,1992,33,2025
"هرمزگان","بندعباس","مرکزی",38,991,14,10,385,1400,15,1415
"هرمزگان","بندعباس","مرکزی",39,793,6,5,263,1067,6,1073
"هرمزگان","بندعباس","مرکزی",40,855,7,0,187,1049,5,1054
"هرمزگان","بندعباس","مرکزی",41,1248,26,6,454,1734,16,1750
"هرمزگان","بندعباس","مرکزی",42,1297,9,6,278,1590,6,1596
"هرمزگان","بندعباس","مرکزی",43,1118,22,18,774,1932,11,1943
"هرمزگان","بندعباس","مرکزی",44,505,6,15,919,1445,17,1462
"هرمزگان","بندعباس","مرکزی",45,804,9,10,447,1270,9,1279
"هرمزگان","بندعباس","مرکزی",46,1003,35,16,819,1873,28,1901
"هرمزگان","بندعباس","مرکزی",47,739,39,24,716,1518,17,1535
"هرمزگان","بندعباس","مرکزی",48,586,29,19,886,1520,16,1536
"هرمزگان","بندعباس","مرکزی",49,1514,29,40,795,2378,17,2395
"هرمزگان","بندعباس","مرکزی",50,1271,6,13,157,1447,4,1451
"هرمزگان","بندعباس","مرکزی",51,819,21,12,904,1756,23,1779
"هرمزگان","بندعباس","مرکزی",52,543,1,11,110,665,7,672
"هرمزگان","بندعباس","مرکزی",53,851,1,5,156,1013,8,1021
"هرمزگان","بندعباس","مرکزی",54,1022,26,28,830,1906,10,1916
"هرمزگان","بندعباس","مرکزی",55,648,14,8,529,1199,15,1214
"هرمزگان","بندعباس","مرکزی",56,622,17,16,743,1398,8,1406
"هرمزگان","بندعباس","مرکزی",57,409,20,5,509,943,10,953
"هرمزگان","بندعباس","مرکزی",58,569,13,10,382,974,15,989
"هرمزگان","بندعباس","مرکزی",59,1133,12,5,497,1647,17,1664
"هرمزگان","بندعباس","مرکزی",60,978,12,6,309,1305,17,1322
"هرمزگان","بندعباس","مرکزی",61,1031,13,12,268,1324,9,1333
"هرمزگان","بندعباس","مرکزی",62,891,9,7,289,1196,16,1212
"هرمزگان","بندعباس","مرکزی",63,456,12,10,498,976,13,989
"هرمزگان","بندعباس","مرکزی",64,545,9,0,194,748,7,755
"هرمزگان","بندعباس","مرکزی",65,1228,20,15,461,1724,15,1739
"هرمزگان","بندعباس","مرکزی",66,1011,12,2,351,1376,17,1393
"هرمزگان","بندعباس","مرکزی",67,399,5,9,411,824,14,838
"هرمزگان","بندعباس","مرکزی",68,466,8,6,545,1025,12,1037
"هرمزگان","بندعباس","مرکزی",69,481,15,3,657,1156,9,1165
"هرمزگان","بندعباس","مرکزی",70,830,19,20,521,1390,11,1401
"هرمزگان","بندعباس","مرکزی",71,657,16,7,470,1150,10,1160
"هرمزگان","بندعباس","مرکزی",72,731,14,13,586,1344,16,1360
"هرمزگان","بندعباس","مرکزی",73,382,19,13,772,1186,12,1198
"هرمزگان","بندعباس","مرکزی",74,222,6,21,1402,1651,8,1659
"هرمزگان","بندعباس","مرکزی",75,288,7,3,493,791,2,793
"هرمزگان","بندعباس","مرکزی",76,431,8,15,551,1005,8,1013
"هرمزگان","بندعباس","مرکزی",77,1208,17,6,545,1776,15,1791
"هرمزگان","بندعباس","مرکزی",78,469,19,16,628,1132,16,1148
"هرمزگان","بندعباس","مرکزی",79,640,5,3,548,1196,16,1212
"هرمزگان","بندعباس","مرکزی",80,787,11,2,305,1105,12,1117
"هرمزگان","بندعباس","مرکزی",81,636,6,1,202,845,7,852
"هرمزگان","بندعباس","مرکزی",82,981,19,9,849,1858,18,1876
"هرمزگان","بندعباس","مرکزی",83,766,10,13,623,1412,5,1417
"هرمزگان","بندعباس","مرکزی",84,864,10,9,371,1254,23,1277
"هرمزگان","بندعباس","مرکزی",85,1232,10,9,536,1787,13,1800
"هرمزگان","بندعباس","مرکزی",86,1598,23,21,501,2143,21,2164
"هرمزگان","بندعباس","مرکزی",87,1250,18,22,230,1520,7,1527
"هرمزگان","بندعباس","مرکزی",88,1110,6,9,127,1252,7,1259
"هرمزگان","بندعباس","مرکزی",89,1304,13,5,309,1631,15,1646
"هرمزگان","بندعباس","مرکزی",90,846,21,19,702,1588,15,1603
"هرمزگان","بندعباس","مرکزی",91,792,5,5,429,1231,20,1251
"هرمزگان","بندعباس","مرکزی",92,309,18,2,581,910,5,915
"هرمزگان","بندعباس","مرکزی",93,615,30,24,1633,2302,15,2317
"هرمزگان","بندعباس","مرکزی",94,336,6,10,724,1076,7,1083
"هرمزگان","بندعباس","مرکزی",95,1009,13,13,388,1423,13,1436
"هرمزگان","بندعباس","مرکزی",96,946,23,3,367,1339,12,1351
"هرمزگان","بندعباس","مرکزی",97,887,16,3,545,1451,18,1469
"هرمزگان","بندعباس","مرکزی",98,350,9,8,290,657,10,667
"هرمزگان","بندعباس","مرکزی",99,1029,17,14,540,1600,17,1617
"هرمزگان","بندعباس","مرکزی",100,700,16,6,605,1327,26,1353
"هرمزگان","بندعباس","مرکزی",101,943,16,12,578,1549,20,1569
"هرمزگان","بندعباس","مرکزی",102,722,14,12,429,1177,15,1192
"هرمزگان","بندعباس","مرکزی",103,1411,18,7,403,1839,10,1849
"هرمزگان","بندعباس","مرکزی",104,1436,1,5,96,1538,0,1538
"هرمزگان","بندعباس","مرکزی",105,1418,1,0,98,1517,2,1519
"هرمزگان","بندعباس","مرکزی",106,1416,7,5,154,1582,10,1592
"هرمزگان","بندعباس","مرکزی",107,1221,11,3,134,1369,13,1382
"هرمزگان","بندعباس","مرکزی",108,996,5,3,145,1149,6,1155
"هرمزگان","بندعباس","مرکزی",109,814,3,2,88,907,6,913
"هرمزگان","بندعباس","مرکزی",110,1143,11,2,198,1354,9,1363
"هرمزگان","بندعباس","مرکزی",111,1225,6,4,137,1372,9,1381
"هرمزگان","بندعباس","مرکزی",112,1489,10,3,183,1685,13,1698
"هرمزگان","بندعباس","مرکزی",113,1157,3,2,188,1350,2,1352
"هرمزگان","بندعباس","مرکزی",114,976,9,2,144,1131,13,1144
"هرمزگان","بندعباس","مرکزی",115,1495,11,5,255,1766,20,1786
"هرمزگان","بندعباس","مرکزی",116,1186,15,12,476,1689,24,1713
"هرمزگان","بندعباس","مرکزی",117,1690,14,3,325,2032,12,2044
"هرمزگان","بندعباس","مرکزی",118,1828,20,4,219,2071,10,2081
"هرمزگان","بندعباس","مرکزی",119,282,9,6,196,493,7,500
"هرمزگان","بندعباس","مرکزی",120,1325,26,16,385,1752,19,1771
"هرمزگان","بندعباس","مرکزی",121,1119,1,3,75,1198,8,1206
"هرمزگان","بندعباس","مرکزی",122,765,10,10,319,1104,6,1110
"هرمزگان","بندعباس","مرکزی",123,1493,4,3,134,1634,16,1650
"هرمزگان","بندعباس","مرکزی",124,555,7,0,177,739,14,753
"هرمزگان","بندعباس","مرکزی",125,1010,8,1,112,1131,1,1132
"هرمزگان","بندعباس","مرکزی",126,1287,3,3,156,1449,9,1458
"هرمزگان","بندعباس","مرکزی",127,1518,10,5,153,1686,8,1694
"هرمزگان","بندعباس","مرکزی",128,1152,4,4,159,1319,9,1328
"هرمزگان","بندعباس","مرکزی",129,1548,14,6,379,1947,18,1965
"هرمزگان","بندعباس","مرکزی",130,1547,27,10,737,2321,33,2354
"هرمزگان","بندعباس","مرکزی",131,628,26,9,1069,1732,19,1751
"هرمزگان","بندعباس","مرکزی",132,1058,14,13,376,1461,23,1484
"هرمزگان","بندعباس","مرکزی",133,1240,19,28,492,1779,15,1794
"هرمزگان","بندعباس","مرکزی",134,628,7,4,262,901,13,914
"هرمزگان","بندعباس","مرکزی",135,804,29,11,465,1309,11,1320
"هرمزگان","بندعباس","مرکزی",136,1014,23,9,326,1372,27,1399
"هرمزگان","بندعباس","مرکزی",137,330,26,14,491,861,8,869
"هرمزگان","بندعباس","مرکزی",138,413,3,5,150,571,12,583
"هرمزگان","بندعباس","مرکزی",139,386,15,12,422,835,10,845
"هرمزگان","بندعباس","مرکزی",140,531,17,11,375,934,11,945
"هرمزگان","بندعباس","مرکزی",141,484,42,9,665,1200,15,1215
"هرمزگان","بندعباس","مرکزی",142,243,36,15,456,750,15,765
"هرمزگان","بندعباس","مرکزی",143,586,30,8,612,1236,6,1242
"هرمزگان","بندعباس","مرکزی",144,538,16,4,323,881,10,891
"هرمزگان","بندعباس","مرکزی",145,480,3,5,254,742,10,752
"هرمزگان","بندعباس","مرکزی",146,329,9,3,164,505,7,512
"هرمزگان","بندعباس","مرکزی",147,334,16,8,390,748,5,753
"هرمزگان","بندعباس","مرکزی",148,804,15,7,178,1004,5,1009
"هرمزگان","بندعباس","مرکزی",149,318,14,8,186,526,9,535
"هرمزگان","بندعباس","مرکزی",150,364,9,4,211,588,10,598
"هرمزگان","بندعباس","مرکزی",151,411,27,27,447,912,12,924
"هرمزگان","بندعباس","مرکزی",152,810,11,14,431,1266,2,1268
"هرمزگان","بندعباس","مرکزی",153,254,47,12,155,468,7,475
"هرمزگان","بندعباس","مرکزی",154,1307,7,11,226,1551,8,1559
"هرمزگان","بندعباس","مرکزی",155,998,7,2,208,1215,5,1220
"هرمزگان","بندعباس","مرکزی",156,1199,1,4,100,1304,8,1312
"هرمزگان","بندعباس","مرکزی",157,859,3,2,37,901,4,905
"هرمزگان","بندعباس","مرکزی",158,454,4,2,229,689,4,693
"هرمزگان","بندعباس","مرکزی",159,684,6,7,495,1192,14,1206
"هرمزگان","بندعباس","مرکزی",160,768,5,5,231,1009,5,1014
"هرمزگان","بندعباس","مرکزی",161,750,4,1,74,829,0,829
"هرمزگان","بندعباس","مرکزی",162,785,3,1,61,850,1,851
"هرمزگان","بندعباس","مرکزی",163,282,0,2,146,430,4,434
"هرمزگان","بندعباس","مرکزی",164,237,1,0,7,245,0,245
"هرمزگان","بندعباس","مرکزی",165,232,5,0,47,284,1,285
"هرمزگان","بندعباس","مرکزی",166,580,4,2,96,682,4,686
"هرمزگان","بندعباس","مرکزی",167,930,3,2,112,1047,2,1049
"هرمزگان","بندعباس","مرکزی",168,1230,1,1,84,1316,5,1321
"هرمزگان","بندعباس","مرکزی",169,1160,6,2,169,1337,15,1352
"هرمزگان","بندعباس","مرکزی",170,634,1,2,19,656,2,658
"هرمزگان","بندعباس","مرکزی",171,1023,4,0,108,1135,5,1140
"هرمزگان","بندعباس","مرکزی",172,104,2,1,672,779,6,785
"هرمزگان","بندعباس","مرکزی",173,239,2,10,697,948,5,953
"هرمزگان","بندعباس","مرکزی",174,55,3,4,457,519,1,520
"هرمزگان","بندعباس","مرکزی",175,415,0,2,83,500,0,500
"هرمزگان","بندعباس","مرکزی",176,134,2,11,191,338,3,341
"هرمزگان","بندعباس","مرکزی",177,500,4,3,326,833,2,835
"هرمزگان","بندعباس","مرکزی",178,230,4,3,250,487,5,492
"هرمزگان","بندعباس","مرکزی",179,183,0,0,494,677,9,686
"هرمزگان","بندعباس","مرکزی",180,618,18,16,634,1286,8,1294
"هرمزگان","بندعباس","مرکزی",181,277,10,2,617,906,13,919
"هرمزگان","بندعباس","مرکزی",182,306,5,3,429,743,5,748
"هرمزگان","بندعباس","مرکزی",183,309,2,3,808,1122,17,1139
"هرمزگان","بندعباس","مرکزی",184,180,2,4,331,517,14,531
"هرمزگان","بندعباس","مرکزی",185,213,8,12,412,645,5,650
"هرمزگان","بندعباس","مرکزی",186,391,2,1,336,730,11,741
"هرمزگان","بندعباس","مرکزی",187,125,3,9,421,558,7,565
"هرمزگان","بندعباس","مرکزی",188,179,4,4,104,291,2,293
"هرمزگان","بندعباس","مرکزی",189,302,18,4,328,652,7,659
"هرمزگان","بندعباس","مرکزی",190,445,64,7,269,785,8,793
"هرمزگان","بندعباس","مرکزی",191,429,21,10,260,720,16,736
"هرمزگان","بندعباس","مرکزی",192,449,0,0,26,475,2,477
"هرمزگان","بندعباس","مرکزی",193,1197,5,1,103,1306,7,1313
"هرمزگان","بندعباس","مرکزی",194,896,2,3,96,997,5,1002
"هرمزگان","بندعباس","مرکزی",195,470,2,0,39,511,2,513
"هرمزگان","بندعباس","قلعه_قاضی",1,618,2,3,192,815,1,816
"هرمزگان","بندعباس","قلعه_قاضی",2,754,2,2,75,833,10,843
"هرمزگان","بندعباس","قلعه_قاضی",3,562,1,0,123,686,1,687
"هرمزگان","بندعباس","قلعه_قاضی",4,383,2,0,27,412,6,418
"هرمزگان","بندعباس","قلعه_قاضی",5,371,0,2,52,425,1,426
"هرمزگان","بندعباس","قلعه_قاضی",6,402,1,0,12,415,0,415
"هرمزگان","بندعباس","قلعه_قاضی",7,598,0,0,8,606,0,606
"هرمزگان","بندعباس","قلعه_قاضی",8,667,0,0,35,702,2,704
"هرمزگان","بندعباس","قلعه_قاضی",9,929,1,1,68,999,0,999
"هرمزگان","بندعباس","قلعه_قاضی",10,177,4,0,389,570,5,575
"هرمزگان","بندعباس","قلعه_قاضی",11,486,1,3,129,619,2,621
"هرمزگان","بندعباس","قلعه_قاضی",12,325,0,1,51,377,0,377
"هرمزگان","بندعباس","قلعه_قاضی",13,215,2,0,18,235,1,236
"هرمزگان","بندعباس","تخت",1,635,2,3,118,758,6,764
"هرمزگان","بندعباس","تخت",2,811,2,0,54,867,8,875
"هرمزگان","بندعباس","تخت",3,693,2,1,23,719,1,720
"هرمزگان","بندعباس","تخت",4,556,1,0,41,598,3,601
"هرمزگان","بندعباس","تخت",5,804,3,2,66,875,0,875
"هرمزگان","بندعباس","تخت",6,723,4,0,60,787,8,795
"هرمزگان","بندعباس","تخت",7,333,2,2,61,398,0,398
"هرمزگان","بندعباس","تخت",8,238,0,0,23,261,0,261
"هرمزگان","بندعباس","تخت",9,255,1,0,15,271,0,271
"هرمزگان","بندعباس","تخت",10,923,4,0,53,980,0,980
"هرمزگان","بندعباس","تخت",11,888,0,0,8,896,4,900
"هرمزگان","بندعباس","تخت",12,878,0,0,12,890,1,891
"هرمزگان","بندعباس","تخت",13,672,2,0,6,680,0,680
"هرمزگان","بندعباس","تخت",14,785,0,1,38,824,2,826
"هرمزگان","بندعباس","تخت",15,600,1,0,31,632,1,633
"هرمزگان","بندعباس","تخت",16,1107,1,0,30,1138,1,1139
"هرمزگان","بندعباس","تخت",17,403,3,9,393,808,1,809
"هرمزگان","بندعباس","تخت",18,606,1,1,155,763,5,768
"هرمزگان","بندعباس","تخت",19,329,2,1,147,479,1,480
"هرمزگان","بندعباس","تخت",20,370,0,1,90,461,0,461
"هرمزگان","بندعباس","تخت",21,500,1,0,37,538,0,538
"هرمزگان","بندعباس","تخت",22,558,0,0,7,565,0,565
"هرمزگان","بندعباس","تخت",23,283,0,0,21,304,2,306
"هرمزگان","بندعباس","تخت",24,482,0,0,12,494,2,496
"هرمزگان","بندعباس","تخت",25,143,0,1,6,150,1,151
"هرمزگان","بندعباس","تخت",26,280,1,0,8,289,1,290
"هرمزگان","بندعباس","تخت",27,370,0,0,24,394,4,398
"هرمزگان","بندعباس","تخت",28,354,0,0,13,367,1,368
"هرمزگان","بندعباس","تخت",29,385,0,1,13,399,0,399
"هرمزگان","بندعباس","تخت",30,390,0,0,3,393,1,394
"هرمزگان","بندعباس","فین",1,671,5,5,116,797,7,804
"هرمزگان","بندعباس","فین",2,226,1,2,61,290,8,298
"هرمزگان","بندعباس","فین",3,410,0,2,148,560,0,560
"هرمزگان","بندعباس","فین",4,480,4,1,87,572,6,578
"هرمزگان","بندعباس","فین",5,805,13,2,122,942,8,950
"هرمزگان","بندعباس","فین",6,968,3,2,35,1008,5,1013
"هرمزگان","بندعباس","فین",7,591,4,3,66,664,8,672
"هرمزگان","بندعباس","فین",8,210,1,1,25,237,0,237
"هرمزگان","بندعباس","فین",9,415,3,3,126,547,1,548
"هرمزگان","بندعباس","فین",10,130,0,0,16,146,0,146
"هرمزگان","بندعباس","فین",11,212,0,0,3,215,0,215
"هرمزگان","بندعباس","فین",12,411,3,4,16,434,2,436
"هرمزگان","بندعباس","فین",13,341,0,0,1,342,5,347
"هرمزگان","بندعباس","فین",14,136,1,0,9,146,0,146
"هرمزگان","بندعباس","فین",15,54,0,0,1,55,0,55
"هرمزگان","بندعباس","فین",16,499,0,0,16,515,0,515
"هرمزگان","بندعباس","فین",17,251,1,1,25,278,1,279
"هرمزگان","بندعباس","فین",18,539,0,4,75,618,2,620
"هرمزگان","بندعباس","فین",19,465,3,1,36,505,4,509
"هرمزگان","بندعباس","فین",20,149,0,3,45,197,1,198
"هرمزگان","بندعباس","فین",21,215,1,0,32,248,1,249
"هرمزگان","بندعباس","فین",22,406,5,3,136,550,3,553
"هرمزگان","بندعباس","فین",23,220,0,0,31,251,0,251
"هرمزگان","بندعباس","فین",24,290,0,0,28,318,2,320
"هرمزگان","بندعباس","فین",25,259,1,0,25,285,2,287
"هرمزگان","بندعباس","فین",26,277,0,0,13,290,1,291
"هرمزگان","بندعباس","فین",27,468,2,1,65,536,1,537
"هرمزگان","بندعباس","فین",28,571,0,3,53,627,0,627
"هرمزگان","بندعباس","فین",29,186,0,0,14,200,0,200
"هرمزگان","بندعباس","فین",30,86,2,0,5,93,0,93
"هرمزگان","بندعباس","فین",31,231,0,0,4,235,0,235
"هرمزگان","بندعباس","فین",32,133,0,0,7,140,1,141
"هرمزگان","بندعباس","فین",33,452,0,0,13,465,4,469
"هرمزگان","بندعباس","فین",34,278,0,0,29,307,1,308
"هرمزگان","بندعباس","فین",35,162,0,0,4,166,7,173
"هرمزگان","بندعباس","فین",36,172,2,2,45,221,3,224
"هرمزگان","بندعباس","فین",37,211,0,0,47,258,0,258
"هرمزگان","بندعباس","فین",38,291,2,2,49,344,0,344
"هرمزگان","بندعباس","فین",39,45,0,0,12,57,0,57
"هرمزگان","پارسیان","مرکزی",1,568,22,31,910,1531,10,1541
"هرمزگان","پارسیان","مرکزی",2,458,2,12,407,879,7,886
"هرمزگان","پارسیان","مرکزی",3,237,3,10,364,614,5,619
"هرمزگان","پارسیان","مرکزی",4,206,4,3,297,510,4,514
"هرمزگان","پارسیان","مرکزی",5,308,3,15,311,637,2,639
"هرمزگان","پارسیان","مرکزی",6,534,2,6,556,1098,5,1103
"هرمزگان","پارسیان","مرکزی",7,102,2,25,659,788,17,805
"هرمزگان","پارسیان","مرکزی",8,155,3,24,730,912,17,929
"هرمزگان","پارسیان","مرکزی",9,163,0,13,373,549,2,551
"هرمزگان","پارسیان","مرکزی",10,108,7,9,661,785,3,788
"هرمزگان","پارسیان","مرکزی",11,330,1,1,13,345,0,345
"هرمزگان","پارسیان","مرکزی",12,179,0,2,335,516,2,518
"هرمزگان","پارسیان","مرکزی",13,220,1,3,609,833,6,839
"هرمزگان","پارسیان","مرکزی",14,286,2,3,827,1118,6,1124
"هرمزگان","پارسیان","مرکزی",15,275,2,6,236,519,8,527
"هرمزگان","پارسیان","مرکزی",16,445,2,3,337,787,5,792
"هرمزگان","پارسیان","مرکزی",17,76,1,3,394,474,2,476
"هرمزگان","پارسیان","مرکزی",18,155,2,3,269,429,1,430
"هرمزگان","پارسیان","مرکزی",19,219,3,8,308,538,4,542
"هرمزگان","پارسیان","مرکزی",20,81,3,0,27,111,0,111
"هرمزگان","پارسیان","کوشکنار",1,238,6,11,624,879,6,885
"هرمزگان","پارسیان","کوشکنار",2,90,2,15,347,454,14,468
"هرمزگان","پارسیان","کوشکنار",3,127,2,2,251,382,0,382
"هرمزگان","پارسیان","کوشکنار",4,27,0,0,166,193,4,197
"هرمزگان","پارسیان","کوشکنار",5,282,3,11,580,876,16,892
"هرمزگان","پارسیان","کوشکنار",6,178,8,4,385,575,4,579
"هرمزگان","پارسیان","کوشکنار",7,89,1,0,305,395,6,401
"هرمزگان","پارسیان","کوشکنار",8,291,4,8,450,753,7,760
"هرمزگان","پارسیان","کوشکنار",9,325,2,0,151,478,0,478
"هرمزگان","جاسک","ایردف",1,222,6,4,196,428,5,433
"هرمزگان","جاسک","ایردف",2,153,0,1,243,397,9,406
"هرمزگان","جاسک","ایردف",3,126,0,1,171,298,2,300
"هرمزگان","جاسک","ایردف",4,139,6,1,378,524,8,532
"هرمزگان","جاسک","ایردف",5,211,7,3,357,578,4,582
"هرمزگان","جاسک","ایردف",6,133,1,1,380,515,5,520
"هرمزگان","جاسک","ایردف",7,119,1,3,425,548,3,551
"هرمزگان","جاسک","ایردف",8,246,1,0,168,415,0,415
"هرمزگان","جاسک","ایردف",9,128,1,1,202,332,1,333
"هرمزگان","جاسک","ایردف",10,203,3,1,101,308,3,311
"هرمزگان","جاسک","ایردف",11,57,0,1,382,440,3,443
"هرمزگان","جاسک","ایردف",12,100,1,0,105,206,0,206
"هرمزگان","جاسک","ایردف",13,273,0,1,93,367,0,367
"هرمزگان","جاسک","ایردف",14,269,1,0,39,309,7,316
"هرمزگان","جاسک","ایردف",15,220,1,1,78,300,1,301
"هرمزگان","جاسک","ایردف",16,95,1,1,28,125,0,125
"هرمزگان","جاسک","ایردف",17,216,0,0,26,242,0,242
"هرمزگان","جاسک","مرکزی",1,258,10,7,323,598,8,606
"هرمزگان","جاسک","مرکزی",2,172,4,3,221,400,2,402
"هرمزگان","جاسک","مرکزی",3,110,3,0,154,267,2,269
"هرمزگان","جاسک","مرکزی",4,110,4,0,120,234,0,234
"هرمزگان","جاسک","مرکزی",5,504,0,2,110,616,6,622
"هرمزگان","جاسک","مرکزی",6,344,1,0,59,404,3,407
"هرمزگان","جاسک","مرکزی",7,192,2,2,143,339,6,345
"هرمزگان","جاسک","مرکزی",8,231,3,8,133,375,7,382
"هرمزگان","جاسک","مرکزی",9,83,2,0,100,185,3,188
"هرمزگان","جاسک","مرکزی",10,51,3,1,125,180,3,183
"هرمزگان","جاسک","مرکزی",11,182,3,5,327,517,5,522
"هرمزگان","جاسک","مرکزی",12,223,1,1,269,494,2,496
"هرمزگان","جاسک","مرکزی",13,439,1,0,22,462,3,465
"هرمزگان","جاسک","مرکزی",14,457,0,0,11,468,1,469
"هرمزگان","جاسک","مرکزی",15,310,1,8,119,438,2,440
"هرمزگان","جاسک","مرکزی",16,368,0,3,336,707,7,714
"هرمزگان","جاسک","مرکزی",17,284,3,3,131,421,0,421
"هرمزگان","جاسک","مرکزی",18,178,0,0,99,277,1,278
"هرمزگان","جاسک","مرکزی",19,203,2,4,290,499,10,509
"هرمزگان","جاسک","مرکزی",20,168,1,2,121,292,2,294
"هرمزگان","جاسک","مرکزی",21,382,1,0,88,471,1,472
"هرمزگان","جاسک","مرکزی",22,184,0,0,25,209,0,209
"هرمزگان","جاسک","مرکزی",23,373,3,0,236,612,1,613
"هرمزگان","جاسک","مرکزی",24,207,12,1,429,649,2,651
"هرمزگان","جاسک","مرکزی",25,113,2,3,298,416,4,420
"هرمزگان","جاسک","مرکزی",26,25,1,3,306,335,4,339
"هرمزگان","جاسک","مرکزی",27,95,4,0,146,245,5,250
"هرمزگان","جاسک","مرکزی",28,37,5,0,408,450,0,450
"هرمزگان","جاسک","مرکزی",29,68,3,0,349,420,2,422
"هرمزگان","جاسک","مرکزی",30,91,1,3,427,522,3,525
"هرمزگان","جاسک","مرکزی",31,27,1,2,209,239,0,239
"هرمزگان","جاسک","مرکزی",32,210,7,1,187,405,7,412
"هرمزگان","جاسک","مرکزی",33,93,1,1,245,340,1,341
"هرمزگان","جاسک","مرکزی",34,121,0,0,48,169,0,169
"هرمزگان","جاسک","مرکزی",35,238,0,0,13,251,1,252
"هرمزگان","جاسک","مرکزی",36,40,1,0,119,160,0,160
"هرمزگان","جاسک","مرکزی",37,125,0,0,213,338,8,346
"هرمزگان","جاسک","مرکزی",38,47,1,1,350,399,1,400
"هرمزگان","جاسک","مرکزی",39,83,0,2,111,196,1,197
"هرمزگان","جاسک","بشاگرد",1,372,0,8,183,563,2,565
"هرمزگان","جاسک","بشاگرد",2,587,1,2,22,612,0,612
"هرمزگان","جاسک","بشاگرد",3,348,0,0,9,357,0,357
"هرمزگان","جاسک","بشاگرد",4,236,1,1,37,275,2,277
"هرمزگان","جاسک","بشاگرد",5,374,2,2,24,402,0,402
"هرمزگان","جاسک","بشاگرد",6,563,0,0,9,572,1,573
"هرمزگان","جاسک","بشاگرد",7,526,0,3,9,538,2,540
"هرمزگان","جاسک","بشاگرد",8,590,0,0,5,595,2,597
"هرمزگان","جاسک","بشاگرد",9,645,1,0,2,648,0,648
"هرمزگان","جاسک","بشاگرد",10,500,1,2,18,521,1,522
"هرمزگان","جاسک","بشاگرد",11,282,0,1,1,284,0,284
"هرمزگان","جاسک","بشاگرد",12,568,0,0,5,573,1,574
"هرمزگان","جاسک","بشاگرد",13,156,0,0,0,156,0,156
"هرمزگان","جاسک","بشاگرد",14,163,0,2,1,166,0,166
"هرمزگان","جاسک","بشاگرد",15,245,1,1,3,250,1,251
"هرمزگان","جاسک","بشاگرد",16,185,0,0,0,185,0,185
"هرمزگان","جاسک","بشاگرد",17,341,0,0,1,342,0,342
"هرمزگان","جاسک","بشاگرد",18,292,0,0,0,292,0,292
"هرمزگان","جاسک","بشاگرد",19,205,0,0,1,206,0,206
"هرمزگان","جاسک","بشاگرد",20,461,0,1,4,466,0,466
"هرمزگان","جاسک","بشاگرد",21,146,0,1,3,150,0,150
"هرمزگان","جاسک","بشاگرد",22,503,0,3,20,526,2,528
"هرمزگان","جاسک","بشاگرد",23,470,0,3,11,484,1,485
"هرمزگان","جاسک","بشاگرد",24,315,0,0,0,315,0,315
"هرمزگان","جاسک","بشاگرد",25,223,0,0,8,231,0,231
"هرمزگان","جاسک","بشاگرد",26,245,0,0,128,373,0,373
"هرمزگان","جاسک","بشاگرد",27,309,0,4,6,319,2,321
"هرمزگان","جاسک","بشاگرد",28,361,0,1,13,375,1,376
"هرمزگان","جاسک","بشاگرد",29,571,0,3,18,592,2,594
"هرمزگان","جاسک","بشاگرد",30,356,0,1,11,368,0,368
"هرمزگان","جاسک","بشاگرد",31,667,0,1,14,682,9,691
"هرمزگان","جاسک","بشاگرد",32,361,0,1,6,368,0,368
"هرمزگان","جاسک","بشاگرد",33,345,0,0,0,345,0,345
"هرمزگان","جاسک","بشاگرد",34,615,0,0,3,618,5,623
"هرمزگان","جاسک","بشاگرد",35,384,0,0,0,384,0,384
"هرمزگان","حاجی_آباد","احمدی",1,668,1,3,35,707,2,709
"هرمزگان","حاجی_آباد","احمدی",2,343,3,0,26,372,4,376
"هرمزگان","حاجی_آباد","احمدی",3,781,1,0,25,807,1,808
"هرمزگان","حاجی_آباد","احمدی",4,127,0,0,15,142,0,142
"هرمزگان","حاجی_آباد","احمدی",5,487,0,1,25,513,0,513
"هرمزگان","حاجی_آباد","احمدی",6,325,4,9,26,364,2,366
"هرمزگان","حاجی_آباد","احمدی",7,436,0,0,57,493,2,495
"هرمزگان","حاجی_آباد","احمدی",8,407,0,0,22,429,2,431
"هرمزگان","حاجی_آباد","احمدی",9,420,0,0,4,424,1,425
"هرمزگان","حاجی_آباد","احمدی",10,356,0,0,15,371,0,371
"هرمزگان","حاجی_آباد","احمدی",11,245,0,1,53,299,0,299
"هرمزگان","حاجی_آباد","احمدی",12,350,0,0,89,439,2,441
"هرمزگان","حاجی_آباد","احمدی",13,303,1,0,32,336,3,339
"هرمزگان","حاجی_آباد","فارغان",1,385,0,0,67,452,0,452
"هرمزگان","حاجی_آباد","فارغان",2,486,0,0,31,517,0,517
"هرمزگان","حاجی_آباد","فارغان",3,574,1,0,45,620,3,623
"هرمزگان","حاجی_آباد","فارغان",4,681,2,0,64,747,0,747
"هرمزگان","حاجی_آباد","فارغان",5,318,5,1,107,431,2,433
"هرمزگان","حاجی_آباد","فارغان",6,681,3,1,111,796,3,799
"هرمزگان","حاجی_آباد","فارغان",7,796,1,0,53,850,3,853
"هرمزگان","حاجی_آباد","فارغان",8,821,8,0,165,994,4,998
"هرمزگان","حاجی_آباد","فارغان",9,388,4,2,134,528,3,531
"هرمزگان","حاجی_آباد","فارغان",10,394,1,1,30,426,3,429
"هرمزگان","حاجی_آباد","فارغان",11,377,0,1,22,400,2,402
"هرمزگان","حاجی_آباد","فارغان",12,350,4,3,107,464,1,465
"هرمزگان","حاجی_آباد","فارغان",13,423,2,0,37,462,0,462
"هرمزگان","حاجی_آباد","فارغان",14,299,1,3,46,349,5,354
"هرمزگان","حاجی_آباد","شهر_حاجی_آباد",1,778,6,4,312,1100,10,1110
"هرمزگان","حاجی_آباد","شهر_حاجی_آباد",2,632,10,5,405,1052,11,1063
"هرمزگان","حاجی_آباد","شهر_حاجی_آباد",3,812,8,13,357,1190,0,1190
"هرمزگان","حاجی_آباد","شهر_حاجی_آباد",4,504,8,0,236,748,0,748
"هرمزگان","حاجی_آباد","شهر_حاجی_آباد",5,440,2,3,184,629,2,631
"هرمزگان","حاجی_آباد","شهر_حاجی_آباد",6,546,4,4,266,820,12,832
"هرمزگان","حاجی_آباد","شهر_حاجی_آباد",7,944,9,4,282,1239,11,1250
"هرمزگان","حاجی_آباد","شهر_حاجی_آباد",8,718,2,2,126,848,4,852
"هرمزگان","حاجی_آباد","شهر_حاجی_آباد",9,514,10,1,105,630,4,634
"هرمزگان","حاجی_آباد","شهر_حاجی_آباد",10,563,7,5,280,855,5,860
"هرمزگان","حاجی_آباد","شهر_حاجی_آباد",11,729,7,3,251,990,5,995
"هرمزگان","حاجی_آباد","شهر_حاجی_آباد",12,186,2,1,101,290,1,291
"هرمزگان","حاجی_آباد","شهر_حاجی_آباد",13,274,1,2,135,412,4,416
"هرمزگان","حاجی_آباد","مرکزی",14,173,2,1,51,227,2,229
"هرمزگان","حاجی_آباد","مرکزی",15,228,1,0,27,256,1,257
"هرمزگان","حاجی_آباد","مرکزی",16,756,3,2,143,904,0,904
"هرمزگان","حاجی_آباد","مرکزی",17,82,1,0,23,106,0,106
"هرمزگان","حاجی_آباد","مرکزی",18,278,5,1,50,334,3,337
"هرمزگان","حاجی_آباد","مرکزی",19,301,1,2,19,323,3,326
"هرمزگان","حاجی_آباد","مرکزی",20,341,1,0,75,417,0,417
"هرمزگان","حاجی_آباد","مرکزی",21,520,0,2,24,546,2,548
"هرمزگان","حاجی_آباد","مرکزی",22,417,0,0,42,459,1,460
"هرمزگان","حاجی_آباد","مرکزی",23,322,6,0,52,380,1,381
"هرمزگان","حاجی_آباد","مرکزی",24,500,1,1,72,574,0,574
"هرمزگان","حاجی_آباد","مرکزی",25,421,0,1,38,460,5,465
"هرمزگان","حاجی_آباد","مرکزی",26,873,2,0,20,895,0,895
"هرمزگان","حاجی_آباد","مرکزی",27,933,1,1,66,1001,0,1001
"هرمزگان","حاجی_آباد","مرکزی",28,212,1,2,10,225,0,225
"هرمزگان","حاجی_آباد","مرکزی",29,190,0,1,8,199,0,199
"هرمزگان","حاجی_آباد","مرکزی",30,472,2,1,31,506,1,507
"هرمزگان","حاجی_آباد","مرکزی",31,556,0,2,31,589,4,593
"هرمزگان","حاجی_آباد","مرکزی",32,466,2,7,215,690,1,691
"هرمزگان","حاجی_آباد","مرکزی",33,745,0,1,142,888,2,890
"هرمزگان","حاجی_آباد","مرکزی",34,573,0,0,51,624,0,624
"هرمزگان","حاجی_آباد","مرکزی",35,550,1,1,41,593,4,597
"هرمزگان","بندر_خمیر","مرکزی",1,826,16,28,648,1518,13,1531
"هرمزگان","بندر_خمیر","مرکزی",2,174,4,14,561,753,4,757
"هرمزگان","بندر_خمیر","مرکزی",3,311,5,14,866,1196,11,1207
"هرمزگان","بندر_خمیر","مرکزی",4,239,8,8,598,853,8,861
"هرمزگان","بندر_خمیر","مرکزی",5,193,4,20,393,610,1,611
"هرمزگان","بندر_خمیر","مرکزی",6,154,0,1,78,233,5,238
"هرمزگان","بندر_خمیر","مرکزی",7,269,4,11,304,588,12,600
"هرمزگان","بندر_خمیر","مرکزی",8,390,5,6,533,934,5,939
"هرمزگان","بندر_خمیر","مرکزی",9,521,8,2,424,955,15,970
"هرمزگان","بندر_خمیر","مرکزی",10,48,5,6,287,346,3,349
"هرمزگان","بندر_خمیر","مرکزی",11,208,5,4,488,705,6,711
"هرمزگان","بندر_خمیر","مرکزی",12,129,4,5,357,495,7,502
"هرمزگان","بندر_خمیر","مرکزی",13,260,6,8,616,890,8,898
"هرمزگان","بندر_خمیر","مرکزی",14,467,3,1,157,628,3,631
"هرمزگان","بندر_خمیر","مرکزی",15,87,11,0,351,449,3,452
"هرمزگان","بندر_خمیر","مرکزی",16,314,7,4,405,730,6,736
"هرمزگان","بندر_خمیر","مرکزی",17,165,3,7,317,492,2,494
"هرمزگان","بندر_خمیر","مرکزی",18,147,1,4,495,647,6,653
"هرمزگان","بندر_خمیر","مرکزی",19,281,12,4,670,967,10,977
"هرمزگان","بندر_خمیر","مرکزی",20,203,2,0,253,458,6,464
"هرمزگان","بندر_خمیر","مرکزی",21,44,1,0,183,228,0,228
"هرمزگان","بندر_خمیر","مرکزی",22,188,7,2,497,694,7,701
"هرمزگان","بندر_خمیر","مرکزی",23,135,0,4,403,542,1,543
"هرمزگان","بندر_خمیر","مرکزی",24,128,4,1,279,412,3,415
"هرمزگان","بندر_خمیر","مرکزی",25,186,6,3,305,500,4,504
"هرمزگان","بندر_خمیر","مرکزی",26,207,1,1,206,415,6,421
"هرمزگان","بندر_خمیر","رویدر",1,159,0,4,625,788,9,797
"هرمزگان","بندر_خمیر","رویدر",2,129,1,6,643,779,7,786
"هرمزگان","بندر_خمیر","رویدر",3,119,6,4,598,727,9,736
"هرمزگان","بندر_خمیر","رویدر",4,298,0,2,426,726,1,727
"هرمزگان","بندر_خمیر","رویدر",5,351,0,0,20,371,0,371
"هرمزگان","بندر_خمیر","رویدر",6,64,0,2,469,535,4,539
"هرمزگان","بندر_خمیر","رویدر",7,212,4,5,526,747,6,753
"هرمزگان","بندر_خمیر","رویدر",8,295,5,4,208,512,4,516
"هرمزگان","بندر_خمیر","رویدر",9,89,0,3,235,327,0,327
"هرمزگان","بندر_خمیر","رویدر",10,273,2,3,519,797,12,809
"هرمزگان","رودان","مرکزی_و_شهر_رودان",1,551,4,1,118,674,5,679
"هرمزگان","رودان","مرکزی_و_شهر_رودان",2,850,10,6,319,1185,10,1195
"هرمزگان","رودان","مرکزی_و_شهر_رودان",3,991,9,16,297,1313,8,1321
"هرمزگان","رودان","مرکزی_و_شهر_رودان",4,670,8,12,342,1032,3,1035
"هرمزگان","رودان","مرکزی_و_شهر_رودان",5,712,3,7,357,1079,5,1084
"هرمزگان","رودان","مرکزی_و_شهر_رودان",6,797,13,1,258,1069,5,1074
"هرمزگان","رودان","مرکزی_و_شهر_رودان",7,474,7,12,292,785,12,797
"هرمزگان","رودان","مرکزی_و_شهر_رودان",8,796,29,3,362,1190,8,1198
"هرمزگان","رودان","مرکزی_و_شهر_رودان",9,409,9,1,210,629,4,633
"هرمزگان","رودان","مرکزی_و_شهر_رودان",10,655,13,10,261,939,8,947
"هرمزگان","رودان","مرکزی_و_شهر_رودان",11,336,6,2,131,475,4,479
"هرمزگان","رودان","مرکزی_و_شهر_رودان",12,761,21,2,125,909,1,910
"هرمزگان","رودان","مرکزی_و_شهر_رودان",13,694,13,1,164,872,11,883
"هرمزگان","رودان","مرکزی_و_شهر_رودان",14,688,8,0,62,758,3,761
"هرمزگان","رودان","مرکزی_و_شهر_رودان",15,860,12,4,245,1121,6,1127
"هرمزگان","رودان","مرکزی_و_شهر_رودان",16,1091,8,2,200,1301,12,1313
"هرمزگان","رودان","مرکزی_و_شهر_رودان",17,978,8,1,75,1062,2,1064
"هرمزگان","رودان","مرکزی_و_شهر_رودان",18,183,5,0,76,264,2,266
"هرمزگان","رودان","مرکزی_و_شهر_رودان",19,1042,5,4,102,1153,2,1155
"هرمزگان","رودان","مرکزی_و_شهر_رودان",20,624,3,3,68,698,1,699
"هرمزگان","رودان","مرکزی_و_شهر_رودان",21,316,0,2,43,361,0,361
"هرمزگان","رودان","مرکزی_و_شهر_رودان",22,191,1,0,25,217,1,218
"هرمزگان","رودان","مرکزی_و_شهر_رودان",23,114,1,0,14,129,0,129
"هرمزگان","رودان","مرکزی_و_شهر_رودان",24,870,14,4,64,952,3,955
"هرمزگان","رودان","مرکزی_و_شهر_رودان",25,362,4,1,44,411,0,411
"هرمزگان","رودان","مرکزی_و_شهر_رودان",26,1042,4,3,131,1180,3,1183
"هرمزگان","رودان","مرکزی_و_شهر_رودان",27,754,6,1,93,854,2,856
"هرمزگان","رودان","مرکزی_و_شهر_رودان",28,724,6,2,114,846,7,853
"هرمزگان","رودان","مرکزی_و_شهر_رودان",29,1022,5,5,39,1071,8,1079
"هرمزگان","رودان","مرکزی_و_شهر_رودان",30,948,8,1,47,1004,1,1005
"هرمزگان","رودان","مرکزی_و_شهر_رودان",31,722,1,0,57,780,0,780
"هرمزگان","رودان","مرکزی_و_شهر_رودان",32,827,3,3,133,966,0,966
"هرمزگان","رودان","مرکزی_و_شهر_رودان",33,649,7,1,76,733,2,735
"هرمزگان","رودان","مرکزی_و_شهر_رودان",34,1193,4,0,50,1247,1,1248
"هرمزگان","رودان","مرکزی_و_شهر_رودان",35,459,8,2,95,564,4,568
"هرمزگان","رودان","مرکزی_و_شهر_رودان",36,529,4,0,216,749,8,757
"هرمزگان","رودان","بیکاه",1,967,3,0,53,1023,4,1027
"هرمزگان","رودان","بیکاه",2,936,3,3,52,994,5,999
"هرمزگان","رودان","بیکاه",3,1024,3,0,41,1068,2,1070
"هرمزگان","رودان","بیکاه",4,689,4,0,26,719,0,719
"هرمزگان","رودان","بیکاه",5,802,2,2,47,853,1,854
"هرمزگان","رودان","بیکاه",6,464,7,0,52,523,3,526
"هرمزگان","رودان","بیکاه",7,1018,4,1,79,1102,8,1110
"هرمزگان","رودان","بیکاه",8,500,3,1,23,527,3,530
"هرمزگان","رودان","بیکاه",9,1096,1,0,84,1181,6,1187
"هرمزگان","رودان","بیکاه",10,1077,3,50,65,1195,5,1200
"هرمزگان","رودان","بیکاه",11,642,0,3,80,725,2,727
"هرمزگان","رودان","بیکاه",12,1394,2,1,92,1489,4,1493
"هرمزگان","رودان","بیکاه",13,855,6,6,259,1126,4,1130
"هرمزگان","رودان","بیکاه",14,447,1,0,62,510,3,513
"هرمزگان","رودان","جغین",1,908,2,3,43,956,7,963
"هرمزگان","رودان","جغین",2,766,2,2,79,849,2,851
"هرمزگان","رودان","جغین",3,729,4,1,37,771,4,775
"هرمزگان","رودان","جغین",4,690,1,1,48,740,5,745
"هرمزگان","رودان","جغین",5,571,3,0,89,663,2,665
"هرمزگان","رودان","جغین",6,558,1,1,28,588,0,588
"هرمزگان","رودان","جغین",7,128,1,0,29,158,1,159
"هرمزگان","رودان","جغین",8,557,1,1,27,586,2,588
"هرمزگان","رودان","جغین",9,392,1,0,15,408,3,411
"هرمزگان","رودان","جغین",10,731,2,1,25,759,4,763
"هرمزگان","رودان","جغین",11,708,0,0,8,716,3,719
"هرمزگان","رودان","رودخانه",1,753,0,3,156,912,3,915
"هرمزگان","رودان","رودخانه",2,391,3,0,130,524,1,525
"هرمزگان","رودان","رودخانه",3,269,2,0,58,329,0,329
"هرمزگان","رودان","رودخانه",4,418,4,0,70,492,2,494
"هرمزگان","رودان","رودخانه",5,334,4,2,80,420,3,423
"هرمزگان","رودان","رودخانه",6,583,2,3,63,651,2,653
"هرمزگان","رودان","رودخانه",7,619,4,0,24,647,3,650
"هرمزگان","رودان","رودخانه",8,529,2,0,60,591,1,592
"هرمزگان","رودان","رودخانه",9,568,2,1,36,607,1,608
"هرمزگان","رودان","رودخانه",10,694,5,1,92,792,1,793
"هرمزگان","رودان","رودخانه",11,324,1,3,53,381,2,383
"هرمزگان","رودان","رودخانه",12,429,2,2,55,488,2,490
"هرمزگان","رودان","رودخانه",13,563,1,3,74,641,3,644
"هرمزگان","رودان","رودخانه",14,227,0,0,21,248,2,250
"هرمزگان","رودان","رودخانه",15,673,7,0,36,716,0,716
"هرمزگان","رودان","رودخانه",16,626,1,1,47,675,1,676
"هرمزگان","رودان","رودخانه",17,470,1,0,49,520,1,521
"هرمزگان","رودان","رودخانه",18,392,0,2,66,460,0,460
"هرمزگان","رودان","رودخانه",19,191,1,0,18,210,1,211
"هرمزگان","رودان","رودخانه",20,240,0,0,12,252,0,252
"هرمزگان","سیریک","مرکزی",1,270,4,4,297,575,6,581
"هرمزگان","سیریک","مرکزی",2,105,2,8,229,344,3,347
"هرمزگان","سیریک","مرکزی",3,132,2,0,128,262,0,262
"هرمزگان","سیریک","مرکزی",4,224,0,0,52,276,4,280
"هرمزگان","سیریک","مرکزی",5,183,4,10,194,391,1,392
"هرمزگان","سیریک","مرکزی",6,363,3,2,490,858,9,867
"هرمزگان","سیریک","مرکزی",7,382,7,4,467,860,12,872
"هرمزگان","سیریک","مرکزی",8,307,1,4,238,550,1,551
"هرمزگان","سیریک","مرکزی",9,283,5,0,246,534,8,542
"هرمزگان","سیریک","مرکزی",10,168,1,0,89,258,4,262
"هرمزگان","سیریک","مرکزی",11,289,0,0,74,363,2,365
"هرمزگان","سیریک","مرکزی",12,267,0,3,88,358,0,358
"هرمزگان","سیریک","مرکزی",13,269,2,2,205,478,5,483
"هرمزگان","سیریک","مرکزی",14,144,1,3,239,387,4,391
"هرمزگان","سیریک","مرکزی",15,51,3,1,234,289,3,292
"هرمزگان","سیریک","مرکزی",16,229,2,2,239,472,5,477
"هرمزگان","سیریک","مرکزی",17,253,3,7,400,663,7,670
"هرمزگان","سیریک","مرکزی",18,201,4,7,208,420,2,422
"هرمزگان","سیریک","مرکزی",19,432,2,4,166,604,8,612
"هرمزگان","سیریک","مرکزی",20,228,2,0,92,322,0,322
"هرمزگان","سیریک","مرکزی",21,78,2,3,198,281,4,285
"هرمزگان","سیریک","مرکزی",22,226,0,1,31,258,2,260
"هرمزگان","سیریک","مرکزی",23,237,2,11,85,335,4,339
"هرمزگان","سیریک","مرکزی",24,432,2,12,360,806,9,815
"هرمزگان","سیریک","مرکزی",25,160,5,1,81,247,4,251
"هرمزگان","سیریک","بمانی",1,271,3,3,514,791,6,797
"هرمزگان","سیریک","بمانی",2,459,2,1,91,553,4,557
"هرمزگان","سیریک","بمانی",3,522,10,4,230,766,11,777
"هرمزگان","سیریک","بمانی",4,338,3,3,130,474,11,485
"هرمزگان","سیریک","بمانی",5,353,6,3,222,584,9,593
"هرمزگان","سیریک","بمانی",6,184,6,3,182,375,4,379
"هرمزگان","سیریک","بمانی",7,587,8,2,82,679,3,682
"هرمزگان","سیریک","بمانی",8,706,1,1,16,724,0,724
"هرمزگان","سیریک","بمانی",9,679,1,0,39,719,3,722
"هرمزگان","سیریک","بمانی",10,364,2,1,66,433,4,437
"هرمزگان","قشم","مرکزی",1,124,6,5,522,657,11,668
"هرمزگان","قشم","مرکزی",2,821,29,12,379,1241,11,1252
"هرمزگان","قشم","مرکزی",3,214,4,6,510,734,6,740
"هرمزگان","قشم","مرکزی",4,500,20,13,1068,1601,10,1611
"هرمزگان","قشم","مرکزی",5,497,8,2,211,718,7,725
"هرمزگان","قشم","مرکزی",6,244,18,9,686,957,5,962
"هرمزگان","قشم","مرکزی",7,234,2,3,371,610,3,613
"هرمزگان","قشم","مرکزی",8,489,5,10,187,691,3,694
"هرمزگان","قشم","مرکزی",9,238,9,3,242,492,4,496
"هرمزگان","قشم","مرکزی",10,461,5,3,134,603,5,608
"هرمزگان","قشم","مرکزی",11,153,10,15,524,702,4,706
"هرمزگان","قشم","مرکزی",12,629,6,5,256,896,2,898
"هرمزگان","قشم","مرکزی",13,1711,6,4,183,1904,10,1914
"هرمزگان","قشم","مرکزی",14,64,3,4,508,579,3,582
"هرمزگان","قشم","مرکزی",15,232,9,6,173,420,2,422
"هرمزگان","قشم","مرکزی",16,579,32,14,919,1544,30,1574
"هرمزگان","قشم","مرکزی",17,166,7,4,307,484,2,486
"هرمزگان","قشم","مرکزی",18,85,4,8,546,643,1,644
"هرمزگان","قشم","مرکزی",19,246,9,6,350,611,1,612
"هرمزگان","قشم","مرکزی",20,107,1,2,73,183,4,187
"هرمزگان","قشم","مرکزی",21,295,8,7,358,668,5,673
"هرمزگان","قشم","مرکزی",22,67,0,3,129,199,0,199
"هرمزگان","قشم","مرکزی",23,233,15,16,812,1076,18,1094
"هرمزگان","قشم","مرکزی",24,94,2,5,264,365,4,369
"هرمزگان","قشم","مرکزی",25,187,2,3,350,542,7,549
"هرمزگان","قشم","مرکزی",26,307,14,16,886,1223,12,1235
"هرمزگان","قشم","مرکزی",27,170,6,8,330,514,8,522
"هرمزگان","قشم","مرکزی",28,114,1,4,358,477,3,480
"هرمزگان","قشم","مرکزی",29,120,7,2,359,488,7,495
"هرمزگان","قشم","مرکزی",30,179,19,7,430,635,4,639
"هرمزگان","قشم","مرکزی",31,85,9,2,464,560,5,565
"هرمزگان","قشم","مرکزی",32,224,9,11,522,766,15,781
"هرمزگان","قشم","مرکزی",33,283,1,6,435,725,16,741
"هرمزگان","قشم","مرکزی",34,272,12,14,481,779,9,788
"هرمزگان","قشم","مرکزی",35,340,13,2,336,691,5,696
"هرمزگان","قشم","مرکزی",36,491,2,5,162,660,2,662
"هرمزگان","قشم","مرکزی",37,178,0,1,128,307,3,310
"هرمزگان","قشم","مرکزی",38,131,0,0,172,303,3,306
"هرمزگان","قشم","مرکزی",39,118,5,3,183,309,6,315
"هرمزگان","قشم","مرکزی",40,265,9,16,608,898,11,909
"هرمزگان","قشم","مرکزی",41,184,6,2,341,533,4,537
"هرمزگان","قشم","مرکزی",42,93,6,3,312,414,5,419
"هرمزگان","قشم","مرکزی",43,120,1,1,225,347,2,349
"هرمزگان","قشم","مرکزی",44,46,1,2,119,168,0,168
"هرمزگان","قشم","مرکزی",45,39,2,2,138,181,0,181
"هرمزگان","قشم","مرکزی",46,219,1,0,167,387,1,388
"هرمزگان","قشم","مرکزی",47,111,8,5,385,509,6,515
"هرمزگان","قشم","مرکزی",48,125,1,2,329,457,2,459
"هرمزگان","قشم","مرکزی",49,256,3,2,166,427,4,431
"هرمزگان","قشم","مرکزی",50,126,9,10,432,577,5,582
"هرمزگان","قشم","مرکزی",51,128,3,3,338,472,2,474
"هرمزگان","قشم","مرکزی",52,90,3,19,772,884,9,893
"هرمزگان","قشم","مرکزی",53,79,2,13,515,609,4,613
"هرمزگان","قشم","مرکزی",54,33,2,0,75,110,1,111
"هرمزگان","قشم","مرکزی",55,116,2,0,50,168,1,169
"هرمزگان","قشم","شهاب",1,272,0,3,106,381,0,381
"هرمزگان","قشم","شهاب",2,367,1,0,324,692,7,699
"هرمزگان","قشم","شهاب",3,315,6,1,438,760,7,767
"هرمزگان","قشم","شهاب",4,123,3,3,271,400,7,407
"هرمزگان","قشم","شهاب",5,227,2,5,275,509,3,512
"هرمزگان","قشم","شهاب",6,512,4,2,281,799,7,806
"هرمزگان","قشم","شهاب",7,306,73,4,398,781,8,789
"هرمزگان","قشم","شهاب",8,173,10,0,79,262,7,269
"هرمزگان","قشم","شهاب",9,360,2,4,99,465,1,466
"هرمزگان","قشم","شهاب",10,306,5,1,277,589,5,594
"هرمزگان","قشم","شهاب",11,212,35,10,561,818,2,820
"هرمزگان","قشم","شهاب",12,80,36,3,203,322,3,325
"هرمزگان","قشم","شهاب",13,227,250,0,837,1314,18,1332
"هرمزگان","قشم","شهاب",14,283,3,1,427,714,10,724
"هرمزگان","قشم","شهاب",15,332,9,1,121,463,6,469
"هرمزگان","قشم","شهاب",16,294,57,3,399,753,14,767
"هرمزگان","قشم","شهاب",17,180,34,11,339,564,7,571
"هرمزگان","قشم","شهاب",18,137,17,14,448,616,7,623
"هرمزگان","قشم","شهاب",19,190,12,6,343,551,4,555
"هرمزگان","قشم","شهاب",20,226,9,6,211,452,0,452
"هرمزگان","قشم","شهاب",21,142,77,4,199,422,2,424
"هرمزگان","قشم","شهاب",22,126,11,11,272,420,1,421
"هرمزگان","قشم","شهاب",23,410,56,5,215,686,2,688
"هرمزگان","قشم","شهاب",24,259,0,0,17,276,0,276
"هرمزگان","قشم","هرمز",1,522,3,0,21,546,4,550
"هرمزگان","قشم","هرمز",2,855,2,1,38,896,3,899
"هرمزگان","قشم","هرمز",3,350,0,3,198,551,6,557
"هرمزگان","قشم","هرمز",4,463,4,2,33,502,3,505
"هرمزگان","قشم","هرمز",5,533,17,1,65,616,7,623
"هرمزگان","قشم","هرمز",6,285,2,3,34,324,2,326
"هرمزگان","قشم","هرمز",7,241,0,1,75,317,2,319
"هرمزگان","میناب","مرکزی",1,887,17,10,449,1363,7,1370
"هرمزگان","میناب","مرکزی",2,686,16,4,243,949,10,959
"هرمزگان","میناب","مرکزی",3,1015,14,7,174,1210,7,1217
"هرمزگان","میناب","مرکزی",4,492,8,1,95,596,4,600
"هرمزگان","میناب","مرکزی",5,577,12,7,226,822,7,829
"هرمزگان","میناب","مرکزی",6,1314,21,8,279,1622,9,1631
"هرمزگان","میناب","مرکزی",7,1061,14,13,410,1498,7,1505
"هرمزگان","میناب","مرکزی",8,757,6,6,193,962,6,968
"هرمزگان","میناب","مرکزی",9,677,9,1,143,830,5,835
"هرمزگان","میناب","مرکزی",10,1321,12,7,346,1686,5,1691
"هرمزگان","میناب","مرکزی",11,950,26,11,327,1314,8,1322
"هرمزگان","میناب","مرکزی",12,767,17,12,222,1018,23,1041
"هرمزگان","میناب","مرکزی",13,221,14,9,208,452,9,461
"هرمزگان","میناب","مرکزی",14,1037,17,10,353,1417,5,1422
"هرمزگان","میناب","مرکزی",15,1038,9,1,67,1115,9,1124
"هرمزگان","میناب","مرکزی",16,459,6,5,128,598,2,600
"هرمزگان","میناب","مرکزی",17,534,15,15,410,974,69,1043
"هرمزگان","میناب","مرکزی",18,818,17,8,433,1276,15,1291
"هرمزگان","میناب","مرکزی",19,607,6,1,63,677,4,681
"هرمزگان","میناب","مرکزی",20,640,14,3,210,867,5,872
"هرمزگان","میناب","مرکزی",21,1192,16,4,206,1418,11,1429
"هرمزگان","میناب","مرکزی",22,694,3,0,84,781,9,790
"هرمزگان","میناب","مرکزی",23,581,6,2,50,639,4,643
"هرمزگان","میناب","مرکزی",24,706,8,1,33,748,2,750
"هرمزگان","میناب","مرکزی",25,212,8,3,79,302,2,304
"هرمزگان","میناب","مرکزی",26,461,4,0,101,566,9,575
"هرمزگان","میناب","مرکزی",27,287,14,4,208,513,7,520
"هرمزگان","میناب","مرکزی",28,690,1,10,42,743,7,750
"هرمزگان","میناب","مرکزی",23,727,6,0,79,812,4,816
"هرمزگان","میناب","مرکزی",30,1023,10,1,89,1123,7,1130
"هرمزگان","میناب","مرکزی",31,810,5,0,67,882,1,883
"هرمزگان","میناب","مرکزی",32,526,4,5,80,615,3,618
"هرمزگان","میناب","مرکزی",33,877,0,1,66,944,0,944
"هرمزگان","میناب","مرکزی",34,1213,3,2,31,1249,7,1256
"هرمزگان","میناب","مرکزی",35,553,4,0,20,577,0,577
"هرمزگان","میناب","مرکزی",36,920,2,1,262,1185,7,1192
"هرمزگان","میناب","مرکزی",37,1035,0,0,85,1120,4,1124
"هرمزگان","میناب","مرکزی",38,1400,5,1,153,1559,2,1561
"هرمزگان","میناب","مرکزی",39,579,1,1,87,668,5,673
"هرمزگان","میناب","مرکزی",40,469,1,0,97,567,1,568
"هرمزگان","میناب","مرکزی",41,814,0,1,102,917,2,919
"هرمزگان","میناب","مرکزی",42,845,0,2,63,910,4,914
"هرمزگان","میناب","مرکزی",43,660,0,0,36,696,2,698
"هرمزگان","میناب","مرکزی",44,558,3,1,57,619,5,624
"هرمزگان","میناب","مرکزی",45,424,3,1,32,460,6,466
"هرمزگان","میناب","مرکزی",46,810,2,1,39,852,5,857
"هرمزگان","میناب","مرکزی",47,706,1,0,43,750,5,755
"هرمزگان","میناب","مرکزی",48,349,0,0,11,360,0,360
"هرمزگان","میناب","مرکزی",49,795,2,0,13,810,1,811
"هرمزگان","میناب","مرکزی",50,775,1,0,30,806,0,806
"هرمزگان","میناب","مرکزی",51,831,6,1,35,873,3,876
"هرمزگان","میناب","مرکزی",52,615,2,0,40,657,3,660
"هرمزگان","میناب","مرکزی",53,1136,10,1,28,1175,4,1179
"هرمزگان","میناب","مرکزی",54,1057,18,10,284,1369,12,1381
"هرمزگان","میناب","مرکزی",55,524,2,2,81,609,6,615
"هرمزگان","میناب","مرکزی",56,1055,6,6,164,1231,12,1243
"هرمزگان","میناب","مرکزی",57,724,0,4,28,756,5,761
"هرمزگان","میناب","مرکزی",58,608,1,3,88,700,30,730
"هرمزگان","میناب","مرکزی",59,750,4,8,344,1106,6,1112
"هرمزگان","میناب","مرکزی",60,407,7,2,291,707,8,715
"هرمزگان","میناب","مرکزی",61,911,6,0,12,929,2,931
"هرمزگان","میناب","مرکزی",62,1313,5,2,44,1364,8,1372
"هرمزگان","میناب","مرکزی",63,1087,10,0,94,1191,9,1200
"هرمزگان","میناب","مرکزی",64,1115,6,2,63,1186,10,1196
"هرمزگان","میناب","مرکزی",65,229,0,0,31,260,2,262
"هرمزگان","میناب","مرکزی",66,991,3,1,26,1021,6,1027
"هرمزگان","میناب","مرکزی",67,602,13,1,28,644,2,646
"هرمزگان","میناب","مرکزی",68,834,4,5,31,874,2,876
"هرمزگان","میناب","مرکزی",69,1056,5,3,86,1150,5,1155
"هرمزگان","میناب","مرکزی",70,601,0,3,30,634,1,635
"هرمزگان","میناب","مرکزی",71,848,3,0,19,870,3,873
"هرمزگان","میناب","مرکزی",72,1416,0,2,87,1505,4,1509
"هرمزگان","میناب","مرکزی",73,610,1,0,74,685,1,686
"هرمزگان","میناب","مرکزی",74,728,3,3,44,778,7,785
"هرمزگان","میناب","مرکزی",75,804,2,1,45,852,5,857
"هرمزگان","میناب","مرکزی",76,846,4,1,29,880,4,884
"هرمزگان","میناب","مرکزی",77,1537,12,5,101,1655,7,1662
"هرمزگان","میناب","مرکزی",78,1029,1,6,43,1079,0,1079
"هرمزگان","میناب","مرکزی",79,1187,2,4,180,1373,10,1383
"هرمزگان","میناب","مرکزی",80,859,7,1,112,979,3,982
"هرمزگان","میناب","مرکزی",81,1089,6,6,67,1168,2,1170
"هرمزگان","میناب","مرکزی",82,752,7,6,90,855,2,857
"هرمزگان","میناب","مرکزی",83,765,7,14,674,1460,8,1468
"هرمزگان","میناب","مرکزی",84,580,14,7,513,1114,6,1120
"هرمزگان","میناب","مرکزی",85,430,2,1,46,479,8,487
"هرمزگان","میناب","مرکزی",86,594,2,3,32,631,3,634
"هرمزگان","میناب","مرکزی",87,555,7,2,70,634,4,638
"هرمزگان","میناب","مرکزی",88,955,7,5,186,1153,7,1160
"هرمزگان","میناب","مرکزی",89,662,4,1,84,751,2,753
"هرمزگان","میناب","مرکزی",90,734,2,0,150,886,9,895
"هرمزگان","میناب","مرکزی",91,877,3,1,190,1071,8,1079
"هرمزگان","میناب","مرکزی",92,519,0,0,101,620,3,623
"هرمزگان","میناب","مرکزی",93,582,4,1,53,640,4,644
"هرمزگان","میناب","مرکزی",94,321,1,2,7,331,4,335
"هرمزگان","میناب","مرکزی",95,654,1,4,43,702,3,705
"هرمزگان","میناب","مرکزی",96,1111,7,4,72,1194,7,1201
"هرمزگان","میناب","مرکزی",97,1193,7,3,44,1247,7,1254
"هرمزگان","میناب","مرکزی",98,466,1,1,11,479,2,481
"هرمزگان","میناب","مرکزی",99,860,6,0,84,950,6,956
"هرمزگان","میناب","مرکزی",100,424,4,1,16,445,5,450
"هرمزگان","میناب","مرکزی",101,594,5,0,34,633,3,636
"هرمزگان","میناب","مرکزی",102,546,0,0,39,585,0,585
"هرمزگان","میناب","مرکزی",103,157,0,0,13,170,3,173
"هرمزگان","میناب","مرکزی",104,345,0,0,19,364,4,368
"هرمزگان","میناب","مرکزی",105,179,3,0,30,212,0,212
"هرمزگان","میناب","توکهور",1,626,1,0,12,639,0,639
"هرمزگان","میناب","توکهور",2,518,0,0,37,555,2,557
"هرمزگان","میناب","توکهور",3,470,1,0,27,498,0,498
"هرمزگان","میناب","توکهور",4,641,0,0,7,648,1,649
"هرمزگان","میناب","توکهور",5,239,1,1,8,249,0,249
"هرمزگان","میناب","توکهور",6,475,0,0,9,484,0,484
"هرمزگان","میناب","توکهور",7,438,1,0,77,516,1,517
"هرمزگان","میناب","توکهور",8,347,0,1,7,355,0,355
"هرمزگان","میناب","توکهور",9,819,4,0,58,881,13,894
"هرمزگان","میناب","توکهور",10,801,2,1,23,827,0,827
"هرمزگان","میناب","توکهور",11,665,1,1,55,722,3,725
"هرمزگان","میناب","توکهور",12,639,5,2,40,686,0,686
"هرمزگان","میناب","توکهور",13,445,1,0,8,454,2,456
"هرمزگان","میناب","توکهور",14,519,2,0,9,530,5,535
"هرمزگان","میناب","توکهور",15,257,2,0,12,271,0,271
"هرمزگان","میناب","توکهور",16,684,0,0,51,735,4,739
"هرمزگان","میناب","توکهور",17,453,1,0,16,470,1,471
"هرمزگان","میناب","توکهور",18,385,1,0,4,390,1,391
"هرمزگان","میناب","توکهور",19,601,0,0,6,607,1,608
"هرمزگان","میناب","توکهور",20,215,2,0,19,236,0,236
"هرمزگان","میناب","توکهور",21,434,4,0,43,481,1,482
"هرمزگان","میناب","توکهور",22,300,0,3,7,310,3,313
"هرمزگان","میناب","توکهور",23,418,0,0,34,452,0,452
"هرمزگان","میناب","توکهور",24,186,2,0,11,199,2,201
"هرمزگان","میناب","سندرک",1,507,3,3,49,562,3,565
"هرمزگان","میناب","سندرک",2,547,4,2,99,652,8,660
"هرمزگان","میناب","سندرک",3,511,2,0,49,562,0,562
"هرمزگان","میناب","سندرک",4,505,2,1,7,515,2,517
"هرمزگان","میناب","سندرک",5,583,0,0,16,599,2,601
"هرمزگان","میناب","سندرک",6,507,3,5,51,566,3,569
"هرمزگان","میناب","سندرک",7,482,3,0,18,503,1,504
"هرمزگان","میناب","سندرک",8,115,0,0,4,119,0,119
"هرمزگان","میناب","سندرک",9,370,2,0,63,435,2,437
"هرمزگان","میناب","سندرک",10,620,5,2,36,663,2,665
"هرمزگان","میناب","سندرک",11,647,2,0,39,688,1,689
"هرمزگان","میناب","سندرک",12,551,5,0,17,573,0,573
"هرمزگان","میناب","سندرک",13,396,1,1,10,408,2,410
"هرمزگان","میناب","سندرک",14,320,4,1,107,432,1,433
"هرمزگان","میناب","سندرک",15,370,1,0,91,462,1,463
"هرمزگان","میناب","سندرک",16,392,0,0,44,436,0,436
"هرمزگان","میناب","سندرک",17,346,1,1,7,355,0,355
"هرمزگان","میناب","سندرک",18,694,4,0,10,708,3,711
"هرمزگان","میناب","سندرک",19,474,1,0,7,482,1,483
"هرمزگان","میناب","سندرک",20,362,1,0,2,365,1,366
"همدان","اسدآباد","مرکزی",1,320,13,20,186,539,6,545
"همدان","اسدآباد","مرکزی",2,618,15,25,309,967,10,977
"همدان","اسدآباد","مرکزی",3,420,14,10,208,652,5,657
"همدان","اسدآباد","مرکزی",4,321,4,2,97,424,7,431
"همدان","اسدآباد","مرکزی",5,854,14,1,330,1199,8,1207
"همدان","اسدآباد","مرکزی",6,630,17,11,368,1026,16,1042
"همدان","اسدآباد","مرکزی",7,699,18,7,498,1222,11,1233
"همدان","اسدآباد","مرکزی",8,179,14,3,214,410,7,417
"همدان","اسدآباد","مرکزی",9,141,6,3,167,317,7,324
"همدان","اسدآباد","مرکزی",10,898,17,14,640,1569,25,1594
"همدان","اسدآباد","مرکزی",11,489,7,7,467,970,7,977
"همدان","اسدآباد","مرکزی",12,742,10,5,322,1079,19,1098
"همدان","اسدآباد","مرکزی",13,167,5,2,109,283,6,289
"همدان","اسدآباد","مرکزی",14,486,11,20,508,1025,22,1047
"همدان","اسدآباد","مرکزی",15,394,6,2,170,572,3,575
"همدان","اسدآباد","مرکزی",16,529,12,19,349,909,12,921
"همدان","اسدآباد","مرکزی",17,748,2,5,221,976,9,985
"همدان","اسدآباد","مرکزی",18,648,6,7,355,1016,13,1029
"همدان","اسدآباد","مرکزی",19,1095,10,22,251,1378,13,1391
"همدان","اسدآباد","مرکزی",20,780,7,3,180,970,16,986
"همدان","اسدآباد","مرکزی",21,1432,4,3,118,1557,5,1562
"همدان","اسدآباد","مرکزی",22,540,1,1,57,599,1,600
"همدان","اسدآباد","مرکزی",23,781,14,2,198,995,12,1007
"همدان","اسدآباد","مرکزی",24,343,2,4,180,529,5,534
"همدان","اسدآباد","مرکزی",25,398,8,1,136,543,5,548
"همدان","اسدآباد","مرکزی",26,413,14,0,200,627,10,637
"همدان","اسدآباد","مرکزی",27,396,1,3,50,450,4,454
"همدان","اسدآباد","مرکزی",28,719,3,0,82,804,6,810
"همدان","اسدآباد","مرکزی",29,935,3,6,116,1060,13,1073
"همدان","اسدآباد","مرکزی",30,662,14,39,454,1169,7,1176
"همدان","اسدآباد","مرکزی",31,592,12,6,205,815,13,828
"همدان","اسدآباد","مرکزی",32,215,1,5,44,265,1,266
"همدان","اسدآباد","مرکزی",33,340,14,2,296,652,5,657
"همدان","اسدآباد","مرکزی",34,526,8,10,252,796,7,803
"همدان","اسدآباد","مرکزی",35,91,2,2,71,166,5,171
"همدان","اسدآباد","مرکزی",36,432,3,7,64,506,11,517
"همدان","اسدآباد","مرکزی",37,713,2,1,36,752,0,752
"همدان","اسدآباد","مرکزی",38,674,1,2,55,732,1,733
"همدان","اسدآباد","مرکزی",39,377,3,3,46,429,0,429
"همدان","اسدآباد","مرکزی",40,569,1,0,46,616,6,622
"همدان","اسدآباد","مرکزی",41,251,1,0,28,280,1,281
"همدان","اسدآباد","مرکزی",42,232,1,0,17,250,3,253
"همدان","اسدآباد","مرکزی",43,297,1,0,22,320,3,323
"همدان","اسدآباد","مرکزی",44,347,2,1,35,385,0,385
"همدان","اسدآباد","مرکزی",45,336,0,0,15,351,0,351
"همدان","اسدآباد","مرکزی",46,585,3,0,63,651,3,654
"همدان","اسدآباد","مرکزی",47,334,0,0,18,352,0,352
"همدان","اسدآباد","مرکزی",48,250,2,1,32,285,5,290
"همدان","اسدآباد","مرکزی",49,539,1,0,24,564,2,566
"همدان","اسدآباد","مرکزی",50,626,1,0,37,664,3,667
"همدان","اسدآباد","مرکزی",51,304,3,0,20,327,2,329
"همدان","اسدآباد","مرکزی",52,320,2,0,24,346,0,346
"همدان","اسدآباد","مرکزی",53,413,1,0,24,438,3,441
"همدان","اسدآباد","مرکزی",54,461,1,0,13,475,2,477
"همدان","اسدآباد","مرکزی",55,534,0,2,43,579,5,584
"همدان","اسدآباد","مرکزی",56,589,3,0,54,646,5,651
"همدان","اسدآباد","مرکزی",57,600,9,3,72,684,6,690
"همدان","اسدآباد","مرکزی",58,551,2,0,27,580,1,581
"همدان","اسدآباد","مرکزی",59,331,4,4,66,405,2,407
"همدان","اسدآباد","مرکزی",60,642,5,2,79,728,0,728
"همدان","اسدآباد","مرکزی",61,335,1,0,47,383,0,383
"همدان","اسدآباد","مرکزی",62,595,1,0,92,688,1,689
"همدان","اسدآباد","مرکزی",63,652,2,3,44,701,2,703
"همدان","اسدآباد","مرکزی",64,811,4,0,23,838,2,840
"همدان","اسدآباد","مرکزی",65,998,3,0,53,1054,6,1060
"همدان","اسدآباد","مرکزی",66,319,19,0,45,383,10,393
"همدان","اسدآباد","مرکزی",67,332,4,1,21,358,6,364
"همدان","اسدآباد","مرکزی",68,768,7,1,75,851,13,864
"همدان","اسدآباد","مرکزی",69,556,4,1,56,617,9,626
"همدان","اسدآباد","مرکزی",70,706,9,2,102,819,1,820
"همدان","اسدآباد","مرکزی",71,260,2,0,24,286,0,286
"همدان","اسدآباد","مرکزی",72,507,6,2,30,545,3,548
"همدان","اسدآباد","مرکزی",73,410,4,2,135,551,6,557
"همدان","اسدآباد","مرکزی",74,492,1,0,58,551,0,551
"همدان","اسدآباد","مرکزی",75,430,10,1,172,613,1,614
"همدان","اسدآباد","مرکزی",76,529,5,4,98,636,4,640
"همدان","اسدآباد","مرکزی",77,371,2,1,51,425,4,429
"همدان","اسدآباد","مرکزی",78,338,3,0,42,383,0,383
"همدان","اسدآباد","مرکزی",79,226,1,7,38,272,2,274
"همدان","اسدآباد","مرکزی",80,260,1,246,54,561,0,561
"همدان","اسدآباد","مرکزی",81,909,2,2,84,997,1,998
"همدان","اسدآباد","مرکزی",82,209,2,0,95,306,4,310
"همدان","اسدآباد","مرکزی",83,432,2,2,58,494,4,498
"همدان","اسدآباد","مرکزی",84,203,5,382,38,628,6,634
"همدان","اسدآباد","مرکزی",85,213,2,318,19,552,3,555
"همدان","اسدآباد","مرکزی",86,905,3,1,108,1017,9,1026
"همدان","اسدآباد","مرکزی",87,342,0,61,61,464,1,465
"همدان","اسدآباد","مرکزی",88,392,2,0,15,409,7,416
"همدان","اسدآباد","مرکزی",89,750,3,1,79,833,0,833
"همدان","اسدآباد","مرکزی",90,302,3,1,21,327,2,329
"همدان","اسدآباد","مرکزی",91,290,2,0,28,320,0,320
"همدان","اسدآباد","مرکزی",92,698,3,1,29,731,0,731
"همدان","اسدآباد","مرکزی",93,374,1,66,15,456,4,460
"همدان","اسدآباد","مرکزی",94,511,1,0,15,527,0,527
"همدان","بهار","مرکزی",1,889,5,1,138,1033,3,1036
"همدان","بهار","مرکزی",2,717,6,1,68,792,5,797
"همدان","بهار","مرکزی",3,1030,24,3,301,1358,7,1365
"همدان","بهار","مرکزی",4,856,15,0,220,1091,9,1100
"همدان","بهار","مرکزی",5,277,5,0,82,364,9,373
"همدان","بهار","مرکزی",6,629,19,5,216,869,15,884
"همدان","بهار","مرکزی",7,556,12,0,118,686,7,693
"همدان","بهار","مرکزی",8,403,4,0,64,471,5,476
"همدان","بهار","مرکزی",9,292,2,0,42,336,1,337
"همدان","بهار","مرکزی",10,850,16,3,229,1098,9,1107
"همدان","بهار","مرکزی",11,535,6,3,106,650,6,656
"همدان","بهار","مرکزی",12,727,12,2,181,922,12,934
"همدان","بهار","مرکزی",13,894,26,0,213,1133,9,1142
"همدان","بهار","مرکزی",14,450,9,2,90,551,4,555
"همدان","بهار","مرکزی",15,722,24,2,263,1011,14,1025
"همدان","بهار","مرکزی",16,884,24,9,188,1105,3,1108
"همدان","بهار","مرکزی",17,647,13,8,119,787,11,798
"همدان","بهار","مرکزی",18,809,16,6,153,984,5,989
"همدان","بهار","مرکزی",19,462,1,2,62,527,1,528
"همدان","بهار","مرکزی",20,875,6,2,73,956,5,961
"همدان","بهار","مرکزی",21,179,8,0,59,246,4,250
"همدان","بهار","مرکزی",22,839,3,1,109,952,4,956
"همدان","بهار","مرکزی",23,926,6,0,75,1007,4,1011
"همدان","بهار","مرکزی",24,882,3,2,74,961,0,961
"همدان","بهار","مرکزی",25,971,0,6,26,1003,1,1004
"همدان","بهار","مرکزی",26,624,7,0,16,647,1,648
"همدان","بهار","مرکزی",27,454,10,1,59,524,3,527
"همدان","بهار","مرکزی",28,496,4,0,39,539,0,539
"همدان","بهار","مرکزی",29,448,0,0,12,460,2,462
"همدان","بهار","مرکزی",30,379,4,0,38,421,4,425
"همدان","بهار","مرکزی",31,401,1,0,12,414,3,417
"همدان","بهار","مرکزی",32,796,1,0,7,804,4,808
"همدان","بهار","مرکزی",33,540,0,3,46,589,0,589
"همدان","بهار","مرکزی",34,481,8,3,81,573,3,576
"همدان","بهار","مرکزی",35,523,9,1,46,579,3,582
"همدان","بهار","مرکزی",36,824,2,1,16,843,1,844
"همدان","بهار","مرکزی",37,346,9,1,48,404,1,405
"همدان","بهار","مرکزی",38,182,2,5,186,375,3,378
"همدان","بهار","مرکزی",39,174,0,2,101,277,1,278
"همدان","بهار","مرکزی",40,734,6,0,50,790,0,790
"همدان","بهار","مرکزی",41,459,2,0,28,489,1,490
"همدان","بهار","مرکزی",42,212,0,0,29,241,4,245
"همدان","بهار","مرکزی",43,720,2,1,63,786,5,791
"همدان","بهار","مرکزی",44,148,4,0,29,181,0,181
"همدان","بهار","لالجین",1,934,20,3,334,1291,10,1301
"همدان","بهار","لالجین",2,907,29,2,404,1342,16,1358
"همدان","بهار","لالجین",3,935,17,0,306,1258,16,1274
"همدان","بهار","لالجین",4,910,6,1,255,1172,5,1177
"همدان","بهار","لالجین",5,765,9,1,229,1004,9,1013
"همدان","بهار","لالجین",6,590,12,0,130,732,2,734
"همدان","بهار","لالجین",7,504,8,2,62,576,5,581
"همدان","بهار","لالجین",8,1001,12,3,282,1298,11,1309
"همدان","بهار","لالجین",9,626,25,3,358,1012,13,1025
"همدان","بهار","لالجین",10,189,2,2,64,257,0,257
"همدان","بهار","لالجین",11,551,5,1,28,585,1,586
"همدان","بهار","لالجین",12,665,6,0,22,693,5,698
"همدان","بهار","لالجین",13,536,7,1,67,611,3,614
"همدان","بهار","لالجین",14,583,4,0,30,617,5,622
"همدان","بهار","لالجین",15,493,6,2,83,584,2,586
"همدان","بهار","لالجین",16,669,10,0,62,741,4,745
"همدان","بهار","لالجین",17,653,7,0,33,693,3,696
"همدان","بهار","لالجین",18,502,3,1,42,548,9,557
"همدان","بهار","لالجین",19,491,1,1,25,518,2,520
"همدان","بهار","لالجین",20,436,0,0,32,468,2,470
"همدان","بهار","لالجین",21,315,9,0,25,349,1,350
"همدان","بهار","لالجین",22,977,20,0,129,1126,10,1136
"همدان","بهار","لالجین",23,1084,16,2,51,1153,5,1158
"همدان","بهار","لالجین",24,973,4,0,26,1003,3,1006
"همدان","بهار","لالجین",25,988,5,0,31,1024,2,1026
"همدان","بهار","لالجین",26,563,12,4,89,668,8,676
"همدان","بهار","لالجین",27,866,1,0,36,903,1,904
"همدان","بهار","لالجین",28,711,16,2,54,783,10,793
"همدان","بهار","لالجین",29,626,1,3,31,661,2,663
"همدان","بهار","لالجین",30,624,2,1,45,672,4,676
"همدان","بهار","لالجین",31,797,9,8,110,924,9,933
"همدان","بهار","لالجین",32,868,5,3,69,945,3,948
"همدان","بهار","لالجین",33,537,2,0,50,589,4,593
"همدان","بهار","لالجین",34,822,4,3,101,930,4,934
"همدان","بهار","لالجین",35,230,0,1,31,262,0,262
"همدان","بهار","صالح_آباد",1,718,10,1,214,943,11,954
"همدان","بهار","صالح_آباد",2,910,12,3,394,1319,11,1330
"همدان","بهار","صالح_آباد",3,691,5,2,257,955,6,961
"همدان","بهار","صالح_آباد",4,576,4,0,107,687,3,690
"همدان","بهار","صالح_آباد",5,413,3,0,106,522,4,526
"همدان","بهار","صالح_آباد",6,326,2,0,64,392,1,393
"همدان","بهار","صالح_آباد",7,181,2,1,38,222,3,225
"همدان","بهار","صالح_آباد",8,851,2,2,130,985,1,986
"همدان","بهار","صالح_آباد",9,458,1,0,46,505,3,508
"همدان","بهار","صالح_آباد",10,490,0,0,42,532,2,534
"همدان","بهار","صالح_آباد",11,771,10,0,102,883,8,891
"همدان","بهار","صالح_آباد",12,697,4,0,48,749,3,752
"همدان","بهار","صالح_آباد",13,429,3,0,29,461,2,463
"همدان","بهار","صالح_آباد",14,615,4,0,19,638,0,638
"همدان","بهار","صالح_آباد",15,721,2,0,28,751,1,752
"همدان","بهار","صالح_آباد",16,490,3,0,22,515,5,520
"همدان","بهار","صالح_آباد",17,276,8,1,55,340,2,342
"همدان","بهار","صالح_آباد",18,390,10,2,50,452,0,452
"همدان","بهار","صالح_آباد",19,624,0,0,35,659,3,662
"همدان","بهار","صالح_آباد",20,649,2,2,42,695,3,698
"همدان","بهار","صالح_آباد",21,373,2,1,50,426,0,426
"همدان","بهار","صالح_آباد",22,437,1,1,15,454,2,456
"همدان","بهار","صالح_آباد",23,543,3,0,24,570,2,572
"همدان","بهار","صالح_آباد",24,327,3,1,10,341,0,341
"همدان","بهار","صالح_آباد",25,327,1,2,32,362,2,364
"همدان","بهار","صالح_آباد",26,533,4,2,59,598,3,601
"همدان","بهار","صالح_آباد",27,458,8,0,57,523,5,528
"همدان","بهار","صالح_آباد",28,299,3,0,7,309,0,309
"همدان","بهار","صالح_آباد",29,509,1,2,66,578,2,580
"همدان","بهار","صالح_آباد",30,134,0,1,13,148,2,150
"همدان","رزن","مرکزی",1,676,19,2,600,1297,16,1313
"همدان","رزن","مرکزی",2,621,12,1,317,951,8,959
"همدان","رزن","مرکزی",3,498,13,5,432,948,17,965
"همدان","رزن","مرکزی",4,266,5,1,233,505,6,511
"همدان","رزن","مرکزی",5,470,25,1,319,815,4,819
"همدان","رزن","مرکزی",6,261,15,1,276,553,3,556
"همدان","رزن","مرکزی",7,390,9,2,243,644,4,648
"همدان","رزن","مرکزی",8,588,20,3,342,953,7,960
"همدان","رزن","مرکزی",9,389,6,1,290,686,4,690
"همدان","رزن","مرکزی",10,352,2,1,46,401,2,403
"همدان","رزن","مرکزی",11,331,1,1,27,360,0,360
"همدان","رزن","مرکزی",12,481,2,0,28,511,0,511
"همدان","رزن","مرکزی",13,293,1,1,71,366,5,371
"همدان","رزن","مرکزی",14,745,0,0,82,827,5,832
"همدان","رزن","مرکزی",15,536,6,0,28,570,3,573
"همدان","رزن","مرکزی",16,643,7,2,76,728,2,730
"همدان","رزن","مرکزی",17,769,11,1,184,965,4,969
"همدان","رزن","مرکزی",18,543,3,2,108,656,5,661
"همدان","رزن","مرکزی",19,255,5,0,71,331,1,332
"همدان","رزن","مرکزی",20,481,3,0,82,566,3,569
"همدان","رزن","مرکزی",21,514,4,1,49,568,3,571
"همدان","رزن","مرکزی",22,431,5,0,168,604,6,610
"همدان","رزن","مرکزی",23,267,1,0,32,300,0,300
"همدان","رزن","مرکزی",24,1027,1,0,63,1091,2,1093
"همدان","رزن","مرکزی",25,474,3,0,27,504,4,508
"همدان","رزن","مرکزی",26,330,1,1,51,383,4,387
"همدان","رزن","مرکزی",27,269,1,0,71,341,0,341
"همدان","رزن","مرکزی",28,465,3,0,54,522,1,523
"همدان","رزن","مرکزی",29,263,3,1,26,293,1,294
"همدان","رزن","مرکزی",30,172,1,0,41,214,2,216
"همدان","رزن","مرکزی",31,408,1,0,21,430,1,431
"همدان","رزن","مرکزی",32,529,7,0,63,599,1,600
"همدان","رزن","مرکزی",33,281,1,0,29,311,0,311
"همدان","رزن","مرکزی",34,642,0,0,90,732,2,734
"همدان","رزن","مرکزی",35,334,3,0,17,354,1,355
"همدان","رزن","مرکزی",36,131,9,1,123,264,3,267
"همدان","رزن","مرکزی",37,92,1,0,33,126,2,128
"همدان","رزن","سردرود",1,418,12,1,152,583,7,590
"همدان","رزن","سردرود",2,645,7,0,112,764,0,764
"همدان","رزن","سردرود",3,401,4,0,70,475,0,475
"همدان","رزن","سردرود",4,239,0,0,35,274,0,274
"همدان","رزن","سردرود",5,597,4,0,68,669,4,673
"همدان","رزن","سردرود",6,368,4,0,63,435,2,437
"همدان","رزن","سردرود",7,744,3,0,99,846,0,846
"همدان","رزن","سردرود",8,729,4,2,175,910,10,920
"همدان","رزن","سردرود",9,662,5,1,122,790,5,795
"همدان","رزن","سردرود",10,804,4,2,96,906,3,909
"همدان","رزن","سردرود",11,595,10,1,194,800,5,805
"همدان","رزن","سردرود",12,443,4,0,112,559,6,565
"همدان","رزن","سردرود",13,702,6,0,70,778,5,783
"همدان","رزن","سردرود",14,279,1,0,29,309,2,311
"همدان","رزن","سردرود",15,450,0,1,34,485,2,487
"همدان","رزن","سردرود",16,437,6,1,116,560,3,563
"همدان","رزن","سردرود",17,537,4,2,63,606,3,609
"همدان","رزن","سردرود",18,227,1,0,1,229,2,231
"همدان","رزن","سردرود",19,322,1,0,9,332,2,334
"همدان","رزن","سردرود",20,522,0,0,33,555,3,558
"همدان","رزن","سردرود",21,92,0,0,6,98,2,100
"همدان","رزن","سردرود",22,227,0,0,38,265,0,265
"همدان","رزن","سردرود",23,370,3,0,39,412,1,413
"همدان","رزن","سردرود",24,818,5,0,160,983,5,988
"همدان","رزن","سردرود",25,342,1,1,48,392,12,404
"همدان","رزن","سردرود",26,275,4,0,19,298,2,300
"همدان","رزن","سردرود",27,184,0,0,26,210,0,210
"همدان","رزن","سردرود",28,311,1,1,16,329,0,329
"همدان","رزن","سردرود",29,486,2,0,24,512,3,515
"همدان","رزن","سردرود",30,401,2,0,20,423,1,424
"همدان","رزن","سردرود",31,374,4,1,32,411,1,412
"همدان","رزن","سردرود",32,391,7,0,60,458,4,462
"همدان","رزن","سردرود",33,533,2,2,73,610,3,613
"همدان","رزن","سردرود",34,370,1,0,27,398,2,400
"همدان","رزن","سردرود",35,279,2,0,65,346,2,348
"همدان","رزن","سردرود",36,875,6,0,72,953,3,956
"همدان","رزن","سردرود",37,162,0,0,17,179,0,179
"همدان","رزن","سردرود",38,359,3,0,72,434,1,435
"همدان","رزن","سردرود",39,997,0,0,62,1059,2,1061
"همدان","رزن","سردرود",40,708,8,1,70,787,9,796
"همدان","رزن","سردرود",41,780,4,2,44,830,0,830
"همدان","رزن","سردرود",42,114,2,0,26,142,4,146
"همدان","رزن","قروه_درجزین",1,838,20,3,750,1611,15,1626
"همدان","رزن","قروه_درجزین",2,458,8,1,308,775,6,781
"همدان","رزن","قروه_درجزین",3,335,5,0,209,549,11,560
"همدان","رزن","قروه_درجزین",4,103,3,1,100,207,0,207
"همدان","رزن","قروه_درجزین",5,369,6,2,303,680,7,687
"همدان","رزن","قروه_درجزین",6,268,2,0,246,516,7,523
"همدان","رزن","قروه_درجزین",7,338,18,4,335,695,8,703
"همدان","رزن","قروه_درجزین",8,154,3,2,162,321,4,325
"همدان","رزن","قروه_درجزین",9,765,5,3,193,966,4,970
"همدان","رزن","قروه_درجزین",10,533,4,1,179,717,4,721
"همدان","رزن","قروه_درجزین",11,277,0,0,20,297,0,297
"همدان","رزن","قروه_درجزین",12,604,9,2,62,677,4,681
"همدان","رزن","قروه_درجزین",13,692,5,1,236,934,4,938
"همدان","رزن","قروه_درجزین",14,403,9,2,217,631,3,634
"همدان","رزن","قروه_درجزین",15,566,3,1,143,713,2,715
"همدان","رزن","قروه_درجزین",16,134,3,0,42,179,1,180
"همدان","رزن","قروه_درجزین",17,239,3,0,73,315,3,318
"همدان","رزن","قروه_درجزین",18,596,6,1,145,748,2,750
"همدان","رزن","قروه_درجزین",19,524,6,3,66,599,5,604
"همدان","رزن","قروه_درجزین",20,618,5,0,40,663,0,663
"همدان","رزن","قروه_درجزین",21,503,0,0,23,526,3,529
"همدان","رزن","قروه_درجزین",22,610,7,3,25,645,1,646
"همدان","رزن","قروه_درجزین",23,546,6,0,125,677,5,682
"همدان","رزن","قروه_درجزین",24,666,16,0,86,768,5,773
"همدان","رزن","قروه_درجزین",25,185,0,0,12,197,0,197
"همدان","رزن","قروه_درجزین",26,178,2,0,17,197,1,198
"همدان","رزن","قروه_درجزین",27,798,6,4,208,1016,6,1022
"همدان","رزن","قروه_درجزین",28,640,13,4,258,915,13,928
"همدان","رزن","قروه_درجزین",29,537,4,0,127,668,4,672
"همدان","رزن","قروه_درجزین",30,529,2,3,97,631,1,632
"همدان","رزن","قروه_درجزین",31,313,0,1,56,370,2,372
"همدان","رزن","قروه_درجزین",32,261,1,0,32,294,1,295
"همدان","رزن","قروه_درجزین",33,872,4,1,72,949,13,962
"همدان","رزن","قروه_درجزین",34,496,3,4,271,774,12,786
"همدان","رزن","قروه_درجزین",35,762,8,1,223,994,9,1003
"همدان","رزن","قروه_درجزین",36,435,6,2,136,579,9,588
"همدان","رزن","قروه_درجزین",37,291,1,0,23,315,2,317
"همدان","رزن","قروه_درجزین",38,440,0,0,34,474,2,476
"همدان","رزن","قروه_درجزین",39,504,3,1,51,559,0,559
"همدان","رزن","قروه_درجزین",40,364,0,0,20,384,0,384
"همدان","رزن","قروه_درجزین",41,552,1,0,49,602,2,604
"همدان","رزن","قروه_درجزین",42,120,2,2,96,220,2,222
"همدان","رزن","قروه_درجزین",43,72,0,1,58,131,2,133
"همدان","تویسرکان","مرکزی",1,584,8,10,315,917,18,935
"همدان","تویسرکان","مرکزی",2,997,14,3,288,1302,21,1323
"همدان","تویسرکان","مرکزی",3,714,13,4,293,1024,26,1050
"همدان","تویسرکان","مرکزی",4,666,5,2,266,939,19,958
"همدان","تویسرکان","مرکزی",5,448,24,9,602,1083,17,1100
"همدان","تویسرکان","مرکزی",6,655,25,13,701,1394,18,1412
"همدان","تویسرکان","مرکزی",7,473,6,13,282,774,15,789
"همدان","تویسرکان","مرکزی",8,511,16,2,353,882,13,895
"همدان","تویسرکان","مرکزی",9,219,3,0,135,357,4,361
"همدان","تویسرکان","مرکزی",10,930,11,2,288,1231,23,1254
"همدان","تویسرکان","مرکزی",11,887,17,6,298,1208,23,1231
"همدان","تویسرکان","مرکزی",12,527,9,1,198,735,7,742
"همدان","تویسرکان","مرکزی",13,547,19,3,276,845,10,855
"همدان","تویسرکان","مرکزی",14,517,7,7,226,757,7,764
"همدان","تویسرکان","مرکزی",15,1017,10,39,239,1305,14,1319
"همدان","تویسرکان","مرکزی",16,1082,6,33,114,1235,9,1244
"همدان","تویسرکان","مرکزی",17,729,7,8,242,986,12,998
"همدان","تویسرکان","مرکزی",18,511,14,14,295,834,16,850
"همدان","تویسرکان","مرکزی",19,1389,43,22,518,1972,33,2005
"همدان","تویسرکان","مرکزی",20,813,14,21,180,1028,10,1038
"همدان","تویسرکان","مرکزی",21,604,16,3,313,936,14,950
"همدان","تویسرکان","مرکزی",22,1076,16,16,429,1537,17,1554
"همدان","تویسرکان","مرکزی",23,434,7,11,208,660,7,667
"همدان","تویسرکان","مرکزی",24,777,18,7,227,1029,18,1047
"همدان","تویسرکان","مرکزی",25,330,1,4,145,480,7,487
"همدان","تویسرکان","مرکزی",26,919,9,8,122,1058,12,1070
"همدان","تویسرکان","مرکزی",27,1088,15,2,244,1349,15,1364
"همدان","تویسرکان","مرکزی",28,878,9,4,101,992,2,994
"همدان","تویسرکان","مرکزی",29,341,4,5,177,527,6,533
"همدان","تویسرکان","مرکزی",30,393,10,0,134,537,10,547
"همدان","تویسرکان","مرکزی",31,181,3,5,73,262,5,267
"همدان","تویسرکان","مرکزی",32,511,5,1,38,555,2,557
"همدان","تویسرکان","مرکزی",33,575,1,0,34,610,5,615
"همدان","تویسرکان","مرکزی",34,822,1,2,31,856,1,857
"همدان","تویسرکان","مرکزی",35,367,1,0,15,383,0,383
"همدان","تویسرکان","مرکزی",36,672,4,1,79,756,0,756
"همدان","تویسرکان","مرکزی",37,204,4,1,47,256,2,258
"همدان","تویسرکان","مرکزی",38,843,1,4,59,907,2,909
"همدان","تویسرکان","مرکزی",39,290,2,5,60,357,0,357
"همدان","تویسرکان","مرکزی",40,444,5,1,36,486,2,488
"همدان","تویسرکان","مرکزی",41,545,0,0,36,581,4,585
"همدان","تویسرکان","مرکزی",42,318,2,374,41,735,2,737
"همدان","تویسرکان","مرکزی",43,218,0,2,41,261,4,265
"همدان","تویسرکان","مرکزی",44,864,4,4,103,975,6,981
"همدان","تویسرکان","مرکزی",45,647,1,4,186,838,12,850
"همدان","تویسرکان","مرکزی",46,459,4,5,123,591,4,595
"همدان","تویسرکان","مرکزی",47,880,3,1,41,925,2,927
"همدان","تویسرکان","مرکزی",48,169,2,949,55,1175,7,1182
"همدان","تویسرکان","مرکزی",49,454,0,122,78,654,5,659
"همدان","تویسرکان","مرکزی",50,673,4,4,87,768,4,772
"همدان","تویسرکان","مرکزی",51,987,8,4,188,1187,7,1194
"همدان","تویسرکان","مرکزی",52,851,3,3,166,1023,10,1033
"همدان","تویسرکان","مرکزی",53,462,7,1,112,582,10,592
"همدان","تویسرکان","مرکزی",54,882,11,3,110,1006,9,1015
"همدان","تویسرکان","مرکزی",55,701,1,1,26,729,4,733
"همدان","تویسرکان","مرکزی",56,785,15,8,216,1024,7,1031
"همدان","تویسرکان","مرکزی",57,939,10,14,277,1240,18,1258
"همدان","تویسرکان","مرکزی",58,927,7,3,100,1037,7,1044
"همدان","تویسرکان","مرکزی",59,471,2,4,28,505,1,506
"همدان","تویسرکان","مرکزی",60,255,1,2,50,308,0,308
"همدان","تویسرکان","مرکزی",61,377,2,4,18,401,3,404
"همدان","تویسرکان","مرکزی",62,630,8,0,62,700,0,700
"همدان","تویسرکان","مرکزی",63,533,1,0,31,565,0,565
"همدان","تویسرکان","مرکزی",64,917,4,0,42,963,2,965
"همدان","تویسرکان","مرکزی",65,329,2,1,54,386,2,388
"همدان","تویسرکان","قلقلرود",1,401,1,3,73,478,11,489
"همدان","تویسرکان","قلقلرود",2,529,3,2,38,572,6,578
"همدان","تویسرکان","قلقلرود",3,248,2,2,28,280,1,281
"همدان","تویسرکان","قلقلرود",4,445,1,7,13,466,1,467
"همدان","تویسرکان","قلقلرود",5,193,1,0,23,217,1,218
"همدان","تویسرکان","قلقلرود",6,630,5,2,98,735,4,739
"همدان","تویسرکان","قلقلرود",7,468,0,9,52,529,0,529
"همدان","تویسرکان","قلقلرود",8,103,3,1,6,113,2,115
"همدان","تویسرکان","قلقلرود",9,760,7,5,44,816,1,817
"همدان","تویسرکان","قلقلرود",10,392,4,0,50,446,6,452
"همدان","تویسرکان","قلقلرود",11,686,3,0,15,704,5,709
"همدان","تویسرکان","قلقلرود",12,476,0,2,32,510,3,513
"همدان","تویسرکان","قلقلرود",13,338,1,0,15,354,1,355
"همدان","تویسرکان","قلقلرود",14,656,1,3,28,688,1,689
"همدان","تویسرکان","قلقلرود",15,687,0,1,18,706,1,707
"همدان","تویسرکان","قلقلرود",16,721,3,4,33,761,1,762
"همدان","تویسرکان","قلقلرود",17,488,3,3,47,541,2,543
"همدان","تویسرکان","قلقلرود",18,400,1,0,38,439,1,440
"همدان","تویسرکان","قلقلرود",19,410,2,1,66,479,3,482
"همدان","تویسرکان","قلقلرود",20,377,2,98,32,509,2,511
"همدان","تویسرکان","قلقلرود",21,341,5,307,17,670,2,672
"همدان","تویسرکان","قلقلرود",22,190,0,118,21,329,0,329
"همدان","تویسرکان","قلقلرود",23,141,1,277,9,428,2,430
"همدان","تویسرکان","قلقلرود",24,541,0,13,30,584,6,590
"همدان","تویسرکان","قلقلرود",25,372,2,2,221,597,3,600
"همدان","تویسرکان","قلقلرود",26,116,3,1,24,144,0,144
"همدان","کبودراهنگ","مرکزی",1,557,38,2,299,896,14,910
"همدان","کبودراهنگ","مرکزی",2,721,31,1,179,932,4,936
"همدان","کبودراهنگ","مرکزی",3,786,36,3,480,1305,22,1327
"همدان","کبودراهنگ","مرکزی",4,634,25,1,216,876,13,889
"همدان","کبودراهنگ","مرکزی",5,658,17,5,213,893,27,920
"همدان","کبودراهنگ","مرکزی",6,859,21,2,148,1030,9,1039
"همدان","کبودراهنگ","مرکزی",7,573,19,6,213,811,20,831
"همدان","کبودراهنگ","مرکزی",8,914,18,2,152,1086,19,1105
"همدان","کبودراهنگ","مرکزی",9,279,16,2,190,487,8,495
"همدان","کبودراهنگ","مرکزی",10,689,37,5,261,992,9,1001
"همدان","کبودراهنگ","مرکزی",11,408,18,1,333,760,11,771
"همدان","کبودراهنگ","مرکزی",12,243,12,1,90,346,2,348
"همدان","کبودراهنگ","مرکزی",13,483,22,4,236,745,28,773
"همدان","کبودراهنگ","مرکزی",14,149,9,1,73,232,3,235
"همدان","کبودراهنگ","مرکزی",15,746,26,7,288,1067,8,1075
"همدان","کبودراهنگ","مرکزی",16,529,25,10,283,847,11,858
"همدان","کبودراهنگ","مرکزی",17,354,16,3,198,571,11,582
"همدان","کبودراهنگ","مرکزی",18,680,18,4,365,1067,15,1082
"همدان","کبودراهنگ","مرکزی",19,450,13,7,183,653,10,663
"همدان","کبودراهنگ","مرکزی",20,358,6,0,12,376,0,376
"همدان","کبودراهنگ","مرکزی",21,769,10,2,27,808,7,815
"همدان","کبودراهنگ","مرکزی",22,538,4,1,67,610,13,623
"همدان","کبودراهنگ","مرکزی",23,658,5,1,24,688,1,689
"همدان","کبودراهنگ","مرکزی",24,593,9,0,59,661,6,667
"همدان","کبودراهنگ","مرکزی",25,774,9,0,46,829,4,833
"همدان","کبودراهنگ","مرکزی",26,474,0,1,40,515,2,517
"همدان","کبودراهنگ","مرکزی",27,449,6,0,82,537,3,540
"همدان","کبودراهنگ","مرکزی",28,485,0,0,46,531,2,533
"همدان","کبودراهنگ","مرکزی",29,249,1,0,16,266,0,266
"همدان","کبودراهنگ","مرکزی",30,454,3,3,118,578,10,588
"همدان","کبودراهنگ","مرکزی",31,507,3,0,72,582,2,584
"همدان","کبودراهنگ","مرکزی",32,905,14,3,227,1149,11,1160
"همدان","کبودراهنگ","مرکزی",33,907,9,2,80,998,3,1001
"همدان","کبودراهنگ","مرکزی",34,625,1,2,41,669,6,675
"همدان","کبودراهنگ","مرکزی",35,898,8,2,53,961,8,969
"همدان","کبودراهنگ","مرکزی",36,693,13,6,155,867,14,881
"همدان","کبودراهنگ","مرکزی",37,730,3,2,76,811,0,811
"همدان","کبودراهنگ","مرکزی",38,653,1,1,30,685,1,686
"همدان","کبودراهنگ","مرکزی",39,680,6,3,69,758,4,762
"همدان","کبودراهنگ","مرکزی",40,658,4,0,24,686,1,687
"همدان","کبودراهنگ","مرکزی",41,626,8,2,112,748,7,755
"همدان","کبودراهنگ","مرکزی",42,853,2,0,71,926,4,930
"همدان","کبودراهنگ","مرکزی",43,529,3,1,114,647,8,655
"همدان","کبودراهنگ","مرکزی",44,531,2,0,52,585,1,586
"همدان","کبودراهنگ","مرکزی",45,484,4,1,47,536,6,542
"همدان","کبودراهنگ","مرکزی",46,553,5,2,53,613,5,618
"همدان","کبودراهنگ","مرکزی",47,702,4,2,37,745,2,747
"همدان","کبودراهنگ","مرکزی",48,508,3,3,77,591,8,599
"همدان","کبودراهنگ","مرکزی",49,473,8,0,29,510,0,510
"همدان","کبودراهنگ","مرکزی",50,281,2,1,38,322,4,326
"همدان","کبودراهنگ","مرکزی",51,418,2,1,17,438,3,441
"همدان","کبودراهنگ","مرکزی",52,109,0,0,71,180,0,180
"همدان","کبودراهنگ","مرکزی",53,399,2,0,21,422,4,426
"همدان","کبودراهنگ","مرکزی",54,606,1,1,36,644,2,646
"همدان","کبودراهنگ","مرکزی",55,957,12,0,162,1131,11,1142
"همدان","کبودراهنگ","مرکزی",56,306,1,0,13,320,1,321
"همدان","کبودراهنگ","مرکزی",57,909,3,0,71,983,9,992
"همدان","کبودراهنگ","مرکزی",58,993,9,2,60,1064,0,1064
"همدان","کبودراهنگ","مرکزی",59,414,15,2,53,484,3,487
"همدان","کبودراهنگ","مرکزی",60,515,8,0,47,570,2,572
"همدان","کبودراهنگ","مرکزی",61,392,31,0,19,442,6,448
"همدان","کبودراهنگ","مرکزی",62,540,37,1,20,598,1,599
"همدان","کبودراهنگ","مرکزی",63,444,7,1,51,503,4,507
"همدان","کبودراهنگ","مرکزی",64,553,2,0,21,576,1,577
"همدان","کبودراهنگ","مرکزی",65,379,7,1,54,441,3,444
"همدان","کبودراهنگ","مرکزی",66,457,2,0,37,496,1,497
"همدان","کبودراهنگ","مرکزی",67,825,20,0,175,1020,9,1029
"همدان","کبودراهنگ","مرکزی",68,1037,21,1,136,1195,8,1203
"همدان","کبودراهنگ","مرکزی",69,557,3,0,37,597,6,603
"همدان","کبودراهنگ","مرکزی",70,584,2,0,18,604,1,605
"همدان","کبودراهنگ","مرکزی",71,678,1,0,90,769,2,771
"همدان","کبودراهنگ","مرکزی",72,528,2,1,56,587,0,587
"همدان","کبودراهنگ","مرکزی",73,559,3,3,23,588,3,591
"همدان","کبودراهنگ","مرکزی",74,249,1,0,8,258,0,258
"همدان","کبودراهنگ","مرکزی",75,491,4,1,23,519,4,523
"همدان","کبودراهنگ","مرکزی",76,458,1,0,20,479,4,483
"همدان","کبودراهنگ","مرکزی",77,328,0,1,23,352,4,356
"همدان","کبودراهنگ","مرکزی",78,514,2,5,26,547,14,561
"همدان","کبودراهنگ","مرکزی",79,498,2,0,22,522,0,522
"همدان","کبودراهنگ","مرکزی",80,122,6,1,49,178,0,178
"همدان","کبودراهنگ","گل_تپه",1,535,6,4,109,654,6,660
"همدان","کبودراهنگ","گل_تپه",2,573,9,2,71,655,2,657
"همدان","کبودراهنگ","گل_تپه",3,368,2,0,14,384,2,386
"همدان","کبودراهنگ","گل_تپه",4,445,2,0,6,453,1,454
"همدان","کبودراهنگ","گل_تپه",5,602,1,0,19,622,4,626
"همدان","کبودراهنگ","گل_تپه",6,509,4,3,27,543,3,546
"همدان","کبودراهنگ","گل_تپه",7,272,3,1,23,299,5,304
"همدان","کبودراهنگ","گل_تپه",8,530,2,0,30,562,0,562
"همدان","کبودراهنگ","گل_تپه",9,492,4,1,46,543,2,545
"همدان","کبودراهنگ","گل_تپه",10,501,3,1,34,539,4,543
"همدان","کبودراهنگ","گل_تپه",11,631,2,0,38,671,3,674
"همدان","کبودراهنگ","گل_تپه",12,355,2,0,9,366,2,368
"همدان","کبودراهنگ","گل_تپه",13,355,2,0,18,375,4,379
"همدان","کبودراهنگ","گل_تپه",14,712,5,0,10,727,3,730
"همدان","کبودراهنگ","گل_تپه",15,444,3,0,54,501,5,506
"همدان","کبودراهنگ","گل_تپه",16,407,2,0,17,426,1,427
"همدان","کبودراهنگ","گل_تپه",17,307,0,0,21,328,4,332
"همدان","کبودراهنگ","گل_تپه",18,267,0,0,30,297,0,297
"همدان","کبودراهنگ","گل_تپه",19,421,0,0,24,445,5,450
"همدان","کبودراهنگ","گل_تپه",20,534,2,0,20,556,2,558
"همدان","کبودراهنگ","گل_تپه",21,205,2,1,37,245,1,246
"همدان","کبودراهنگ","گل_تپه",22,492,1,0,11,504,11,515
"همدان","کبودراهنگ","گل_تپه",23,488,1,0,29,518,2,520
"همدان","کبودراهنگ","گل_تپه",24,395,0,3,28,426,3,429
"همدان","کبودراهنگ","گل_تپه",25,331,2,0,8,341,0,341
"همدان","کبودراهنگ","گل_تپه",26,296,0,0,13,309,5,314
"همدان","کبودراهنگ","گل_تپه",27,375,2,0,20,397,0,397
"همدان","کبودراهنگ","گل_تپه",28,478,0,0,14,492,1,493
"همدان","کبودراهنگ","گل_تپه",29,289,0,0,8,297,3,300
"همدان","کبودراهنگ","گل_تپه",30,277,8,0,10,295,0,295
"همدان","کبودراهنگ","گل_تپه",31,274,1,0,6,281,0,281
"همدان","کبودراهنگ","گل_تپه",32,150,2,1,26,179,1,180
"همدان","کبودراهنگ","گل_تپه",33,347,5,3,175,530,9,539
"همدان","کبودراهنگ","شیرین_سو",1,390,13,8,246,657,7,664
"همدان","کبودراهنگ","شیرین_سو",2,464,4,4,250,722,3,725
"همدان","کبودراهنگ","شیرین_سو",3,431,5,1,19,456,8,464
"همدان","کبودراهنگ","شیرین_سو",4,566,0,0,11,577,2,579
"همدان","کبودراهنگ","شیرین_سو",5,452,5,0,21,478,5,483
"همدان","کبودراهنگ","شیرین_سو",6,556,2,1,11,570,1,571
"همدان","کبودراهنگ","شیرین_سو",7,485,4,0,23,512,3,515
"همدان","کبودراهنگ","شیرین_سو",8,590,3,2,17,612,2,614
"همدان","کبودراهنگ","شیرین_سو",9,633,3,0,41,677,5,682
"همدان","کبودراهنگ","شیرین_سو",10,547,3,0,58,608,11,619
"همدان","کبودراهنگ","شیرین_سو",11,540,2,4,66,612,4,616
"همدان","کبودراهنگ","شیرین_سو",12,843,4,1,48,896,4,900
"همدان","کبودراهنگ","شیرین_سو",13,417,4,4,23,448,6,454
"همدان","کبودراهنگ","شیرین_سو",14,531,2,5,13,551,1,552
"همدان","کبودراهنگ","شیرین_سو",15,258,2,0,9,269,1,270
"همدان","کبودراهنگ","شیرین_سو",16,411,3,1,16,431,6,437
"همدان","کبودراهنگ","شیرین_سو",17,522,1,0,63,586,1,587
"همدان","کبودراهنگ","شیرین_سو",18,692,4,3,40,739,1,740
"همدان","کبودراهنگ","شیرین_سو",19,422,0,0,25,447,3,450
"همدان","کبودراهنگ","شیرین_سو",20,524,4,0,62,590,1,591
"همدان","کبودراهنگ","شیرین_سو",21,617,0,0,11,628,4,632
"همدان","کبودراهنگ","شیرین_سو",22,332,8,0,11,351,1,352
"همدان","کبودراهنگ","شیرین_سو",23,747,2,0,43,792,3,795
"همدان","ملایر","مرکزی",1,816,25,18,393,1252,20,1272
"همدان","ملایر","مرکزی",2,819,16,9,293,1137,12,1149
"همدان","ملایر","مرکزی",3,1285,32,6,538,1861,36,1897
"همدان","ملایر","مرکزی",4,819,17,12,351,1199,16,1215
"همدان","ملایر","مرکزی",5,1390,38,11,390,1829,19,1848
"همدان","ملایر","مرکزی",6,860,19,7,318,1204,16,1220
"همدان","ملایر","مرکزی",7,563,24,9,208,804,10,814
"همدان","ملایر","مرکزی",8,1276,44,12,560,1892,24,1916
"همدان","ملایر","مرکزی",9,1590,42,9,481,2122,35,2157
"همدان","ملایر","مرکزی",10,502,16,2,286,806,16,822
"همدان","ملایر","مرکزی",11,589,14,1,291,895,15,910
"همدان","ملایر","مرکزی",12,856,8,9,214,1087,14,1101
"همدان","ملایر","مرکزی",13,1626,26,10,486,2148,30,2178
"همدان","ملایر","مرکزی",14,1059,30,6,278,1373,30,1403
"همدان","ملایر","مرکزی",15,1066,38,6,309,1419,20,1439
"همدان","ملایر","مرکزی",16,919,14,6,196,1135,14,1149
"همدان","ملایر","مرکزی",17,1224,16,9,360,1609,24,1633
"همدان","ملایر","مرکزی",18,1222,31,8,281,1542,23,1565
"همدان","ملایر","مرکزی",19,1356,34,1,372,1763,32,1795
"همدان","ملایر","مرکزی",20,694,31,5,329,1059,11,1070
"همدان","ملایر","مرکزی",21,1208,33,17,402,1660,25,1685
"همدان","ملایر","مرکزی",22,851,40,40,949,1880,45,1925
"همدان","ملایر","مرکزی",23,543,21,21,807,1392,41,1433
"همدان","ملایر","مرکزی",24,357,12,15,455,839,9,848
"همدان","ملایر","مرکزی",25,881,34,18,756,1689,54,1743
"همدان","ملایر","مرکزی",26,399,20,4,534,957,8,965
"همدان","ملایر","مرکزی",27,933,42,42,948,1965,44,2009
"همدان","ملایر","مرکزی",28,273,10,18,379,680,14,694
"همدان","ملایر","مرکزی",29,880,15,3,222,1120,17,1137
"همدان","ملایر","مرکزی",30,1126,14,4,296,1440,20,1460
"همدان","ملایر","مرکزی",31,612,12,3,166,793,9,802
"همدان","ملایر","مرکزی",32,910,24,34,606,1574,19,1593
"همدان","ملایر","مرکزی",33,1012,19,16,331,1378,19,1397
"همدان","ملایر","مرکزی",34,684,18,7,418,1127,13,1140
"همدان","ملایر","مرکزی",35,815,18,21,525,1379,24,1403
"همدان","ملایر","مرکزی",36,305,15,7,346,673,12,685
"همدان","ملایر","مرکزی",37,423,16,3,303,745,4,749
"همدان","ملایر","مرکزی",38,683,17,19,467,1186,20,1206
"همدان","ملایر","مرکزی",39,732,32,30,798,1592,25,1617
"همدان","ملایر","مرکزی",40,444,15,15,408,882,18,900
"همدان","ملایر","مرکزی",41,891,37,13,452,1393,14,1407
"همدان","ملایر","مرکزی",42,854,20,10,367,1251,27,1278
"همدان","ملایر","مرکزی",43,1201,34,34,568,1837,31,1868
"همدان","ملایر","مرکزی",44,1113,16,2,153,1284,16,1300
"همدان","ملایر","مرکزی",45,993,22,13,310,1338,36,1374
"همدان","ملایر","مرکزی",46,1538,12,9,278,1837,16,1853
"همدان","ملایر","مرکزی",47,262,11,20,137,430,8,438
"همدان","ملایر","مرکزی",48,388,6,5,96,495,8,503
"همدان","ملایر","مرکزی",49,603,5,21,95,724,4,728
"همدان","ملایر","مرکزی",50,1481,7,17,131,1636,12,1648
"همدان","ملایر","مرکزی",51,988,15,12,291,1306,15,1321
"همدان","ملایر","مرکزی",52,1012,3,13,122,1150,5,1155
"همدان","ملایر","مرکزی",53,572,8,10,107,697,8,705
"همدان","ملایر","مرکزی",54,1086,11,6,136,1239,15,1254
"همدان","ملایر","مرکزی",55,261,5,8,97,371,6,377
"همدان","ملایر","مرکزی",56,1238,8,22,241,1509,16,1525
"همدان","ملایر","مرکزی",57,691,19,8,257,975,12,987
"همدان","ملایر","مرکزی",58,422,8,5,135,570,5,575
"همدان","ملایر","مرکزی",59,960,24,24,389,1397,29,1426
"همدان","ملایر","مرکزی",60,744,25,20,326,1115,17,1132
"همدان","ملایر","مرکزی",61,585,16,22,334,957,20,977
"همدان","ملایر","مرکزی",62,718,28,20,498,1264,18,1282
"همدان","ملایر","مرکزی",63,975,12,17,230,1234,22,1256
"همدان","ملایر","مرکزی",64,684,24,10,314,1032,12,1044
"همدان","ملایر","مرکزی",65,1053,7,8,200,1268,9,1277
"همدان","ملایر","مرکزی",66,1564,19,7,162,1752,15,1767
"همدان","ملایر","مرکزی",67,758,3,6,101,868,6,874
"همدان","ملایر","مرکزی",68,1157,9,2,131,1299,8,1307
"همدان","ملایر","مرکزی",69,945,8,8,197,1158,8,1166
"همدان","ملایر","مرکزی",70,380,13,11,358,762,17,779
"همدان","ملایر","مرکزی",71,280,12,2,140,434,9,443
"همدان","ملایر","مرکزی",72,200,8,5,118,331,6,337
"همدان","ملایر","مرکزی",73,492,4,3,134,633,12,645
"همدان","ملایر","مرکزی",74,1154,3,3,97,1257,11,1268
"همدان","ملایر","مرکزی",75,521,5,3,98,627,7,634
"همدان","ملایر","مرکزی",76,1015,7,3,105,1130,8,1138
"همدان","ملایر","مرکزی",77,107,2,1,30,140,0,140
"همدان","ملایر","مرکزی",78,398,4,3,26,431,3,434
"همدان","ملایر","مرکزی",79,434,4,1,54,493,5,498
"همدان","ملایر","مرکزی",80,396,8,4,40,448,3,451
"همدان","ملایر","مرکزی",81,964,5,2,71,1042,12,1054
"همدان","ملایر","مرکزی",82,825,6,1,94,926,8,934
"همدان","ملایر","مرکزی",83,696,7,1,99,803,12,815
"همدان","ملایر","مرکزی",84,911,6,0,86,1003,13,1016
"همدان","ملایر","مرکزی",85,548,0,0,76,624,8,632
"همدان","ملایر","مرکزی",86,227,1,0,68,296,4,300
"همدان","ملایر","مرکزی",87,578,1,1,28,608,2,610
"همدان","ملایر","مرکزی",88,994,3,1,94,1092,4,1096
"همدان","ملایر","مرکزی",89,834,0,0,50,884,3,887
"همدان","ملایر","مرکزی",90,586,4,0,47,637,4,641
"همدان","ملایر","مرکزی",91,461,3,1,78,543,0,543
"همدان","ملایر","مرکزی",92,635,2,5,58,700,12,712
"همدان","ملایر","مرکزی",93,288,8,1,42,339,3,342
"همدان","ملایر","مرکزی",94,260,2,0,23,285,4,289
"همدان","ملایر","مرکزی",95,535,2,1,24,562,4,566
"همدان","ملایر","مرکزی",96,735,8,3,218,964,16,980
"همدان","ملایر","مرکزی",97,1152,10,1,199,1362,12,1374
"همدان","ملایر","مرکزی",98,470,2,1,25,498,9,507
"همدان","ملایر","مرکزی",99,507,2,0,21,530,1,531
"همدان","ملایر","مرکزی",100,218,1,0,19,238,1,239
"همدان","ملایر","مرکزی",101,366,1,0,16,383,3,386
"همدان","ملایر","جوکار",1,461,5,2,99,567,5,572
"همدان","ملایر","جوکار",2,762,13,10,201,986,6,992
"همدان","ملایر","جوکار",3,1245,6,0,214,1465,18,1483
"همدان","ملایر","جوکار",4,860,7,0,115,982,3,985
"همدان","ملایر","جوکار",5,812,4,0,269,1085,5,1090
"همدان","ملایر","جوکار",6,1122,5,2,167,1296,5,1301
"همدان","ملایر","جوکار",7,296,1,1,13,311,1,312
"همدان","ملایر","جوکار",8,766,8,1,141,916,0,916
"همدان","ملایر","جوکار",9,669,2,0,50,721,3,724
"همدان","ملایر","جوکار",10,713,15,1,99,828,7,835
"همدان","ملایر","جوکار",11,242,0,2,22,266,1,267
"همدان","ملایر","جوکار",12,524,4,0,26,554,11,565
"همدان","ملایر","جوکار",13,787,7,3,108,905,3,908
"همدان","ملایر","جوکار",14,437,5,4,126,572,8,580
"همدان","ملایر","جوکار",15,1182,3,3,21,1209,6,1215
"همدان","ملایر","جوکار",16,543,2,0,32,577,2,579
"همدان","ملایر","جوکار",17,769,1,0,27,797,2,799
"همدان","ملایر","جوکار",18,1278,7,1,55,1341,5,1346
"همدان","ملایر","جوکار",19,854,3,3,44,904,6,910
"همدان","ملایر","جوکار",20,477,3,3,26,509,0,509
"همدان","ملایر","جوکار",21,338,2,0,19,359,2,361
"همدان","ملایر","جوکار",22,1200,1,0,29,1230,0,1230
"همدان","ملایر","جوکار",23,883,3,1,43,930,1,931
"همدان","ملایر","جوکار",24,712,0,0,19,731,3,734
"همدان","ملایر","جوکار",25,1159,1,0,36,1196,12,1208
"همدان","ملایر","جوکار",26,790,3,1,19,813,2,815
"همدان","ملایر","جوکار",27,840,3,2,65,910,0,910
"همدان","ملایر","جوکار",28,1259,3,0,45,1307,6,1313
"همدان","ملایر","جوکار",29,1085,5,3,48,1141,7,1148
"همدان","ملایر","جوکار",30,880,0,1,57,938,3,941
"همدان","ملایر","جوکار",31,1012,4,0,108,1124,2,1126
"همدان","ملایر","جوکار",32,672,3,2,44,721,7,728
"همدان","ملایر","جوکار",33,334,7,0,22,363,3,366
"همدان","ملایر","جوکار",34,270,0,2,19,291,0,291
"همدان","ملایر","جوکار",35,789,4,0,31,824,1,825
"همدان","ملایر","جوکار",36,77,1,0,23,101,2,103
"همدان","ملایر","سامن",1,741,9,7,239,996,16,1012
"همدان","ملایر","سامن",2,681,8,1,165,855,20,875
"همدان","ملایر","سامن",3,634,16,8,341,999,8,1007
"همدان","ملایر","سامن",4,580,4,3,38,625,8,633
"همدان","ملایر","سامن",5,265,2,1,51,319,2,321
"همدان","ملایر","سامن",6,567,2,1,110,680,3,683
"همدان","ملایر","سامن",7,582,2,1,47,632,3,635
"همدان","ملایر","سامن",8,472,0,1,66,539,0,539
"همدان","ملایر","سامن",9,798,1,0,39,838,4,842
"همدان","ملایر","سامن",10,575,5,4,110,694,7,701
"همدان","ملایر","سامن",11,130,0,0,10,140,1,141
"همدان","ملایر","سامن",12,1148,7,4,52,1211,7,1218
"همدان","ملایر","سامن",13,749,7,171,102,1029,0,1029
"همدان","ملایر","سامن",14,424,9,14,44,491,3,494
"همدان","ملایر","سامن",15,512,0,4,15,531,5,536
"همدان","ملایر","سامن",16,1029,9,24,105,1167,10,1177
"همدان","ملایر","سامن",17,841,3,19,58,921,12,933
"همدان","ملایر","سامن",18,1078,2,2,36,1118,2,1120
"همدان","ملایر","سامن",19,243,0,0,22,265,0,265
"همدان","ملایر","سامن",20,210,1,1,23,235,0,235
"همدان","ملایر","سامن",21,712,12,3,45,772,2,774
"همدان","ملایر","سامن",22,758,0,0,19,777,0,777
"همدان","ملایر","سامن",23,441,4,3,63,511,4,515
"همدان","ملایر","سامن",24,528,3,2,70,603,4,607
"همدان","ملایر","سامن",25,605,4,1,50,660,1,661
"همدان","ملایر","سامن",26,656,1,0,23,680,4,684
"همدان","ملایر","سامن",27,943,9,7,20,979,12,991
"همدان","ملایر","سامن",28,756,3,4,32,795,1,796
"همدان","ملایر","سامن",29,320,1,4,36,361,2,363
"همدان","ملایر","سامن",30,89,0,2,53,144,0,144
"همدان","ملایر","زند",1,513,7,2,90,612,4,616
"همدان","ملایر","زند",2,377,1,1,38,417,3,420
"همدان","ملایر","زند",3,555,2,2,66,625,0,625
"همدان","ملایر","زند",4,432,1,0,43,476,3,479
"همدان","ملایر","زند",5,401,1,3,43,448,5,453
"همدان","ملایر","زند",6,506,2,0,48,556,4,560
"همدان","ملایر","زند",7,710,3,1,61,775,3,778
"همدان","ملایر","زند",8,481,5,0,57,543,3,546
"همدان","ملایر","زند",9,686,1,0,51,738,0,738
"همدان","ملایر","زند",10,186,0,0,17,203,4,207
"همدان","ملایر","زند",11,261,1,0,32,294,1,295
"همدان","ملایر","زند",12,652,2,3,24,681,3,684
"همدان","ملایر","زند",13,277,1,1,4,283,1,284
"همدان","ملایر","زند",14,407,1,4,18,430,3,433
"همدان","ملایر","زند",15,321,3,0,35,359,1,360
"همدان","ملایر","زند",16,192,1,91,27,311,1,312
"همدان","ملایر","زند",17,168,0,0,16,184,0,184
"همدان","ملایر","زند",18,199,1,0,12,212,0,212
"همدان","ملایر","زند",19,252,0,13,26,291,0,291
"همدان","ملایر","زند",20,67,1,1,21,90,0,90
"همدان","ملایر","زند",21,72,4,2,34,112,0,112
"همدان","نهاوند","مرکزی",1,555,18,21,506,1100,27,1127
"همدان","نهاوند","مرکزی",2,584,23,12,338,957,10,967
"همدان","نهاوند","مرکزی",3,416,12,15,409,852,15,867
"همدان","نهاوند","مرکزی",4,447,14,9,335,805,12,817
"همدان","نهاوند","مرکزی",5,417,13,17,437,884,15,899
"همدان","نهاوند","مرکزی",6,184,13,2,251,450,14,464
"همدان","نهاوند","مرکزی",7,468,15,12,310,805,16,821
"همدان","نهاوند","مرکزی",8,735,10,12,231,988,16,1004
"همدان","نهاوند","مرکزی",9,828,1,5,228,1062,9,1071
"همدان","نهاوند","مرکزی",10,533,4,9,143,689,10,699
"همدان","نهاوند","مرکزی",11,691,3,10,106,810,4,814
"همدان","نهاوند","مرکزی",12,371,2,6,105,484,8,492
"همدان","نهاوند","مرکزی",13,520,2,13,66,601,3,604
"همدان","نهاوند","مرکزی",14,555,7,99,176,837,5,842
"همدان","نهاوند","مرکزی",15,437,9,22,224,692,6,698
"همدان","نهاوند","مرکزی",16,877,15,42,253,1187,9,1196
"همدان","نهاوند","مرکزی",17,519,4,11,223,757,10,767
"همدان","نهاوند","مرکزی",18,202,3,17,178,400,8,408
"همدان","نهاوند","مرکزی",19,437,10,25,357,829,10,839
"همدان","نهاوند","مرکزی",20,495,9,6,290,800,16,816
"همدان","نهاوند","مرکزی",21,817,9,85,269,1180,14,1194
"همدان","نهاوند","مرکزی",22,1010,23,62,319,1414,18,1432
"همدان","نهاوند","مرکزی",23,517,4,50,134,705,10,715
"همدان","نهاوند","مرکزی",24,789,21,36,232,1078,23,1101
"همدان","نهاوند","مرکزی",25,993,13,11,220,1237,8,1245
"همدان","نهاوند","مرکزی",26,741,11,27,289,1068,20,1088
"همدان","نهاوند","مرکزی",27,737,16,19,486,1258,22,1280
"همدان","نهاوند","مرکزی",28,586,15,12,484,1097,13,1110
"همدان","نهاوند","مرکزی",29,510,12,16,393,931,17,948
"همدان","نهاوند","مرکزی",30,625,8,11,332,976,18,994
"همدان","نهاوند","مرکزی",31,999,6,13,209,1227,10,1237
"همدان","نهاوند","مرکزی",32,551,7,12,107,677,6,683
"همدان","نهاوند","مرکزی",33,678,13,7,139,837,10,847
"همدان","نهاوند","مرکزی",34,635,11,5,137,788,9,797
"همدان","نهاوند","مرکزی",35,988,10,20,231,1249,7,1256
"همدان","نهاوند","مرکزی",36,779,23,23,507,1332,21,1353
"همدان","نهاوند","مرکزی",37,868,12,41,309,1230,13,1243
"همدان","نهاوند","مرکزی",38,154,0,6,56,216,3,219
"همدان","نهاوند","مرکزی",39,640,8,16,266,930,21,951
"همدان","نهاوند","مرکزی",40,838,16,26,638,1518,17,1535
"همدان","نهاوند","مرکزی",41,339,5,6,374,724,6,730
"همدان","نهاوند","مرکزی",42,438,8,19,459,924,18,942
"همدان","نهاوند","مرکزی",43,507,8,11,405,931,9,940
"همدان","نهاوند","مرکزی",44,600,15,7,223,845,11,856
"همدان","نهاوند","مرکزی",45,1167,19,12,492,1690,11,1701
"همدان","نهاوند","مرکزی",46,628,22,24,296,970,13,983
"همدان","نهاوند","مرکزی",47,299,7,1,79,386,6,392
"همدان","نهاوند","مرکزی",48,889,9,14,146,1058,8,1066
"همدان","نهاوند","مرکزی",49,518,5,7,133,663,8,671
"همدان","نهاوند","مرکزی",50,600,9,6,123,738,16,754
"همدان","نهاوند","مرکزی",51,694,4,3,107,808,4,812
"همدان","نهاوند","مرکزی",52,579,5,2,69,655,3,658
"همدان","نهاوند","مرکزی",53,559,5,4,80,648,0,648
"همدان","نهاوند","مرکزی",54,721,2,1,52,776,6,782
"همدان","نهاوند","مرکزی",55,800,3,3,45,851,3,854
"همدان","نهاوند","مرکزی",56,741,1,156,73,971,7,978
"همدان","نهاوند","مرکزی",57,519,5,15,71,610,6,616
"همدان","نهاوند","مرکزی",58,857,7,14,103,981,7,988
"همدان","نهاوند","مرکزی",59,927,4,10,67,1008,6,1014
"همدان","نهاوند","مرکزی",60,597,7,1,15,620,4,624
"همدان","نهاوند","مرکزی",61,895,7,4,83,989,6,995
"همدان","نهاوند","مرکزی",62,776,5,2,16,799,0,799
"همدان","نهاوند","مرکزی",63,697,11,12,123,843,8,851
"همدان","نهاوند","مرکزی",64,1034,0,11,55,1100,4,1104
"همدان","نهاوند","مرکزی",65,714,4,4,48,770,3,773
"همدان","نهاوند","مرکزی",66,769,5,2,41,817,2,819
"همدان","نهاوند","مرکزی",67,559,1,3,14,577,0,577
"همدان","نهاوند","مرکزی",68,348,2,1,20,371,2,373
"همدان","نهاوند","مرکزی",69,358,2,3,13,376,0,376
"همدان","نهاوند","مرکزی",70,879,9,3,52,943,5,948
"همدان","نهاوند","مرکزی",71,747,1,1,22,771,3,774
"همدان","نهاوند","مرکزی",72,63,0,24,22,109,0,109
"همدان","نهاوند","مرکزی",73,923,18,33,116,1090,7,1097
"همدان","نهاوند","مرکزی",74,792,4,2,93,891,1,892
"همدان","نهاوند","مرکزی",75,271,0,1,58,330,1,331
"همدان","نهاوند","مرکزی",76,1056,2,2,100,1160,8,1168
"همدان","نهاوند","مرکزی",77,546,6,1,58,611,3,614
"همدان","نهاوند","مرکزی",78,546,4,3,79,632,3,635
"همدان","نهاوند","مرکزی",79,417,1,11,52,481,0,481
"همدان","نهاوند","مرکزی",80,621,3,2,45,671,6,677
"همدان","نهاوند","مرکزی",81,574,1,138,47,760,2,762
"همدان","نهاوند","مرکزی",82,661,0,3,45,709,4,713
"همدان","نهاوند","مرکزی",83,444,4,1,51,500,0,500
"همدان","نهاوند","مرکزی",84,408,1,322,27,758,8,766
"همدان","نهاوند","مرکزی",85,783,3,1,58,845,2,847
"همدان","نهاوند","مرکزی",86,114,5,5,50,174,5,179
"همدان","نهاوند","مرکزی",87,153,6,2,45,206,5,211
"همدان","نهاوند","خرل",1,719,8,34,206,967,11,978
"همدان","نهاوند","خرل",2,459,13,14,177,663,3,666
"همدان","نهاوند","خرل",3,235,3,13,148,399,6,405
"همدان","نهاوند","خرل",4,469,3,16,179,667,8,675
"همدان","نهاوند","خرل",5,454,6,28,86,574,3,577
"همدان","نهاوند","خرل",6,461,8,9,64,542,1,543
"همدان","نهاوند","خرل",7,541,7,14,196,758,6,764
"همدان","نهاوند","خرل",8,559,4,3,59,625,0,625
"همدان","نهاوند","خرل",9,571,9,1,129,710,3,713
"همدان","نهاوند","خرل",10,487,0,1,30,518,1,519
"همدان","نهاوند","خرل",11,804,3,6,222,1035,21,1056
"همدان","نهاوند","خرل",12,302,1,11,92,406,5,411
"همدان","نهاوند","خرل",13,335,2,17,125,479,7,486
"همدان","نهاوند","خرل",14,693,3,4,103,803,4,807
"همدان","نهاوند","خرل",15,640,6,8,55,709,2,711
"همدان","نهاوند","خرل",16,600,6,9,120,735,8,743
"همدان","نهاوند","خرل",17,351,10,11,109,481,3,484
"همدان","نهاوند","خرل",18,728,9,11,50,798,4,802
"همدان","نهاوند","خرل",19,649,13,19,181,862,8,870
"همدان","نهاوند","خرل",20,168,0,117,17,302,1,303
"همدان","نهاوند","خرل",21,300,2,11,23,336,0,336
"همدان","نهاوند","خرل",22,925,3,47,51,1026,2,1028
"همدان","نهاوند","خرل",23,741,3,7,68,819,2,821
"همدان","نهاوند","خرل",24,349,1,0,42,392,0,392
"همدان","نهاوند","خرل",25,447,1,63,59,570,3,573
"همدان","نهاوند","خرل",26,521,3,1,55,580,3,583
"همدان","نهاوند","خرل",27,333,0,28,55,416,1,417
"همدان","نهاوند","خرل",28,345,3,4,35,387,1,388
"همدان","نهاوند","خرل",29,292,1,40,25,358,2,360
"همدان","نهاوند","خرل",30,836,6,0,42,884,2,886
"همدان","نهاوند","دشت_زرین",1,581,4,5,201,791,15,806
"همدان","نهاوند","دشت_زرین",2,730,7,10,191,938,7,945
"همدان","نهاوند","دشت_زرین",3,851,6,5,63,925,6,931
"همدان","نهاوند","دشت_زرین",4,544,4,1,82,631,8,639
"همدان","نهاوند","دشت_زرین",5,948,6,10,129,1093,4,1097
"همدان","نهاوند","دشت_زرین",6,523,4,1,38,566,4,570
"همدان","نهاوند","دشت_زرین",7,758,0,0,30,788,5,793
"همدان","نهاوند","دشت_زرین",8,1189,1,9,135,1334,0,1334
"همدان","نهاوند","دشت_زرین",9,758,6,4,39,807,3,810
"همدان","نهاوند","دشت_زرین",10,417,3,0,32,452,6,458
"همدان","نهاوند","دشت_زرین",11,612,1,0,29,642,2,644
"همدان","نهاوند","گیان",1,1096,21,12,161,1290,6,1296
"همدان","نهاوند","گیان",2,993,12,18,237,1260,10,1270
"همدان","نهاوند","گیان",3,654,12,4,133,803,0,803
"همدان","نهاوند","گیان",4,501,12,5,125,643,13,656
"همدان","نهاوند","گیان",5,270,1,1,90,362,3,365
"همدان","نهاوند","گیان",6,1109,12,3,74,1198,5,1203
"همدان","نهاوند","گیان",7,1057,5,7,124,1193,7,1200
"همدان","نهاوند","گیان",8,572,0,0,50,622,0,622
"همدان","نهاوند","گیان",9,801,0,1,34,836,2,838
"همدان","نهاوند","گیان",10,596,1,2,50,649,0,649
"همدان","نهاوند","گیان",11,492,11,3,69,575,1,576
"همدان","نهاوند","گیان",12,575,2,3,26,606,4,610
"همدان","همدان","مرکزی",1,1325,24,7,503,1859,13,1872
"همدان","همدان","مرکزی",2,885,18,7,335,1245,14,1259
"همدان","همدان","مرکزی",3,540,64,39,1277,1920,17,1937
"همدان","همدان","مرکزی",4,510,77,43,1498,2128,12,2140
"همدان","همدان","مرکزی",5,354,67,36,1079,1536,15,1551
"همدان","همدان","مرکزی",6,537,50,46,1382,2015,15,2030
"همدان","همدان","مرکزی",7,640,43,39,1188,1910,27,1937
"همدان","همدان","مرکزی",8,296,41,18,815,1170,21,1191
"همدان","همدان","مرکزی",9,545,53,45,1263,1906,20,1926
"همدان","همدان","مرکزی",10,507,82,41,1380,2010,24,2034
"همدان","همدان","مرکزی",11,751,87,47,1530,2415,28,2443
"همدان","همدان","مرکزی",12,621,51,31,894,1597,23,1620
"همدان","همدان","مرکزی",13,596,66,9,755,1426,20,1446
"همدان","همدان","مرکزی",14,678,59,102,840,1679,48,1727
"همدان","همدان","مرکزی",15,508,41,34,1165,1748,19,1767
"همدان","همدان","مرکزی",16,745,65,16,1073,1899,24,1923
"همدان","همدان","مرکزی",17,989,61,27,659,1736,29,1765
"همدان","همدان","مرکزی",18,502,37,16,556,1111,9,1120
"همدان","همدان","مرکزی",19,688,33,28,796,1545,32,1577
"همدان","همدان","مرکزی",20,646,66,26,967,1705,24,1729
"همدان","همدان","مرکزی",21,658,73,36,1327,2094,30,2124
"همدان","همدان","مرکزی",22,765,45,57,1057,1924,28,1952
"همدان","همدان","مرکزی",23,958,60,50,977,2045,47,2092
"همدان","همدان","مرکزی",24,675,41,31,719,1466,35,1501
"همدان","همدان","مرکزی",25,575,43,57,768,1443,21,1464
"همدان","همدان","مرکزی",26,521,48,40,973,1582,30,1612
"همدان","همدان","مرکزی",27,1122,49,30,932,2133,56,2189
"همدان","همدان","مرکزی",28,1123,54,21,550,1748,16,1764
"همدان","همدان","مرکزی",29,999,66,28,689,1782,33,1815
"همدان","همدان","مرکزی",30,548,36,24,642,1250,20,1270
"همدان","همدان","مرکزی",31,527,63,36,974,1600,20,1620
"همدان","همدان","مرکزی",32,669,34,25,922,1650,37,1687
"همدان","همدان","مرکزی",33,862,47,40,1216,2165,30,2195
"همدان","همدان","مرکزی",34,803,69,27,968,1867,29,1896
"همدان","همدان","مرکزی",35,502,33,28,540,1103,18,1121
"همدان","همدان","مرکزی",36,1086,58,18,729,1891,25,1916
"همدان","همدان","مرکزی",37,815,43,17,678,1553,25,1578
"همدان","همدان","مرکزی",38,692,39,17,492,1240,22,1262
"همدان","همدان","مرکزی",39,1288,65,23,642,2018,32,2050
"همدان","همدان","مرکزی",40,770,34,16,482,1302,16,1318
"همدان","همدان","مرکزی",41,975,62,13,527,1577,15,1592
"همدان","همدان","مرکزی",42,1282,60,29,1091,2462,39,2501
"همدان","همدان","مرکزی",43,1487,37,13,563,2100,26,2126
"همدان","همدان","مرکزی",44,842,43,17,673,1575,42,1617
"همدان","همدان","مرکزی",45,964,30,12,577,1583,20,1603
"همدان","همدان","مرکزی",46,1168,24,13,454,1659,26,1685
"همدان","همدان","مرکزی",47,1874,11,6,173,2064,15,2079
"همدان","همدان","مرکزی",48,1402,9,18,290,1719,20,1739
"همدان","همدان","مرکزی",49,1317,17,11,247,1592,9,1601
"همدان","همدان","مرکزی",50,981,30,23,476,1510,25,1535
"همدان","همدان","مرکزی",51,1049,44,7,521,1621,28,1649
"همدان","همدان","مرکزی",52,1390,49,9,469,1917,24,1941
"همدان","همدان","مرکزی",53,508,29,7,283,827,14,841
"همدان","همدان","مرکزی",54,903,31,27,652,1613,30,1643
"همدان","همدان","مرکزی",55,1089,28,19,578,1714,21,1735
"همدان","همدان","مرکزی",56,996,30,15,483,1524,19,1543
"همدان","همدان","مرکزی",57,918,34,10,508,1470,14,1484
"همدان","همدان","مرکزی",58,1013,31,19,620,1683,24,1707
"همدان","همدان","مرکزی",59,1034,30,7,518,1589,27,1616
"همدان","همدان","مرکزی",60,814,23,3,287,1127,9,1136
"همدان","همدان","مرکزی",61,1084,20,9,295,1408,19,1427
"همدان","همدان","مرکزی",62,885,17,6,183,1091,11,1102
"همدان","همدان","مرکزی",63,1041,11,4,183,1239,18,1257
"همدان","همدان","مرکزی",64,1308,23,6,191,1528,12,1540
"همدان","همدان","مرکزی",65,853,23,3,211,1090,9,1099
"همدان","همدان","مرکزی",66,1578,4,6,261,1849,11,1860
"همدان","همدان","مرکزی",67,1700,27,2,184,1913,15,1928
"همدان","همدان","مرکزی",68,1604,9,5,208,1826,18,1844
"همدان","همدان","مرکزی",69,857,6,0,132,995,4,999
"همدان","همدان","مرکزی",70,1192,15,4,162,1373,14,1387
"همدان","همدان","مرکزی",71,1216,24,5,316,1561,14,1575
"همدان","همدان","مرکزی",72,1154,23,4,229,1410,23,1433
"همدان","همدان","مرکزی",73,1536,21,1,189,1747,12,1759
"همدان","همدان","مرکزی",74,1611,52,6,623,2292,22,2314
"همدان","همدان","مرکزی",75,1294,44,9,427,1774,22,1796
"همدان","همدان","مرکزی",76,1277,42,4,329,1652,11,1663
"همدان","همدان","مرکزی",77,1193,17,4,146,1360,9,1369
"همدان","همدان","مرکزی",78,1397,10,2,174,1583,8,1591
"همدان","همدان","مرکزی",79,819,14,8,226,1067,7,1074
"همدان","همدان","مرکزی",80,1478,9,5,107,1599,19,1618
"همدان","همدان","مرکزی",81,1236,11,3,102,1352,12,1364
"همدان","همدان","مرکزی",82,1656,12,0,150,1818,12,1830
"همدان","همدان","مرکزی",83,1594,25,4,145,1768,13,1781
"همدان","همدان","مرکزی",84,1716,19,2,211,1948,0,1948
"همدان","همدان","مرکزی",85,964,28,11,527,1530,21,1551
"همدان","همدان","مرکزی",86,1105,51,11,711,1878,30,1908
"همدان","همدان","مرکزی",87,1024,51,29,711,1815,15,1830
"همدان","همدان","مرکزی",88,1538,48,19,729,2334,21,2355
"همدان","همدان","مرکزی",89,1218,51,16,708,1993,22,2015
"همدان","همدان","مرکزی",90,985,21,18,295,1319,25,1344
"همدان","همدان","مرکزی",91,1337,17,5,176,1535,8,1543
"همدان","همدان","مرکزی",92,1437,64,12,523,2036,23,2059
"همدان","همدان","مرکزی",93,1571,42,14,384,2011,26,2037
"همدان","همدان","مرکزی",94,1229,34,3,502,1768,21,1789
"همدان","همدان","مرکزی",95,1672,41,10,448,2171,13,2184
"همدان","همدان","مرکزی",96,1458,39,6,523,2026,33,2059
"همدان","همدان","مرکزی",97,1426,39,24,476,1965,35,2000
"همدان","همدان","مرکزی",98,1768,41,12,490,2311,30,2341
"همدان","همدان","مرکزی",99,630,21,12,374,1037,12,1049
"همدان","همدان","مرکزی",100,1172,28,7,487,1694,21,1715
"همدان","همدان","مرکزی",101,1238,22,10,315,1585,16,1601
"همدان","همدان","مرکزی",102,1523,23,6,313,1865,25,1890
"همدان","همدان","مرکزی",103,1413,21,9,260,1703,6,1709
"همدان","همدان","مرکزی",104,1205,9,6,139,1359,18,1377
"همدان","همدان","مرکزی",105,1570,21,5,166,1762,8,1770
"همدان","همدان","مرکزی",106,1537,12,1,198,1748,22,1770
"همدان","همدان","مرکزی",107,1671,27,4,225,1927,23,1950
"همدان","همدان","مرکزی",108,1117,21,5,236,1379,12,1391
"همدان","همدان","مرکزی",109,1525,19,2,166,1712,18,1730
"همدان","همدان","مرکزی",110,1083,13,4,218,1318,19,1337
"همدان","همدان","مرکزی",111,1509,26,4,207,1746,19,1765
"همدان","همدان","مرکزی",112,1187,19,6,281,1493,13,1506
"همدان","همدان","مرکزی",113,997,16,2,222,1237,19,1256
"همدان","همدان","مرکزی",114,1372,15,2,203,1592,10,1602
"همدان","همدان","مرکزی",115,729,17,3,117,866,12,878
"همدان","همدان","مرکزی",116,1271,13,3,208,1495,23,1518
"همدان","همدان","مرکزی",117,1383,29,4,275,1691,11,1702
"همدان","همدان","مرکزی",118,1311,18,5,194,1528,0,1528
"همدان","همدان","مرکزی",119,739,3,1,135,878,8,886
"همدان","همدان","مرکزی",120,1941,23,2,286,2252,33,2285
"همدان","همدان","مرکزی",121,1010,18,4,207,1239,9,1248
"همدان","همدان","مرکزی",122,972,24,22,510,1528,16,1544
"همدان","همدان","مرکزی",123,999,45,6,504,1554,15,1569
"همدان","همدان","مرکزی",124,1012,39,10,423,1484,36,1520
"همدان","همدان","مرکزی",125,393,16,7,144,560,6,566
"همدان","همدان","مرکزی",126,971,28,5,399,1403,20,1423
"همدان","همدان","مرکزی",127,960,37,11,505,1513,21,1534
"همدان","همدان","مرکزی",128,826,25,5,503,1359,17,1376
"همدان","همدان","مرکزی",129,601,33,4,260,898,7,905
"همدان","همدان","مرکزی",130,582,30,5,302,919,16,935
"همدان","همدان","مرکزی",131,524,22,3,293,842,10,852
"همدان","همدان","مرکزی",132,1277,36,4,416,1733,18,1751
"همدان","همدان","مرکزی",133,1064,32,15,429,1540,18,1558
"همدان","همدان","مرکزی",134,1011,24,9,430,1474,26,1500
"همدان","همدان","مرکزی",135,903,40,19,554,1516,28,1544
"همدان","همدان","مرکزی",136,531,18,27,492,1068,24,1092
"همدان","همدان","مرکزی",137,868,36,41,709,1654,37,1691
"همدان","همدان","مرکزی",138,576,36,24,612,1248,25,1273
"همدان","همدان","مرکزی",139,691,42,16,884,1633,32,1665
"همدان","همدان","مرکزی",140,494,38,32,764,1328,15,1343
"همدان","همدان","مرکزی",141,423,50,15,831,1319,22,1341
"همدان","همدان","مرکزی",142,810,51,25,1295,2181,30,2211
"همدان","همدان","مرکزی",143,713,38,18,701,1470,15,1485
"همدان","همدان","مرکزی",144,799,51,9,567,1426,22,1448
"همدان","همدان","مرکزی",145,1207,59,13,722,2001,26,2027
"همدان","همدان","مرکزی",146,1814,38,6,517,2375,18,2393
"همدان","همدان","مرکزی",147,433,22,15,298,768,12,780
"همدان","همدان","مرکزی",148,1016,48,36,708,1808,15,1823
"همدان","همدان","مرکزی",149,990,38,37,814,1879,21,1900
"همدان","همدان","مرکزی",150,920,26,30,755,1731,18,1749
"همدان","همدان","مرکزی",151,1145,17,59,659,1880,31,1911
"همدان","همدان","مرکزی",152,672,50,16,605,1343,27,1370
"همدان","همدان","مرکزی",153,728,70,17,747,1562,22,1584
"همدان","همدان","مرکزی",154,414,56,15,1019,1504,31,1535
"همدان","همدان","مرکزی",155,337,29,12,881,1259,39,1298
"همدان","همدان","مرکزی",156,952,49,22,855,1878,33,1911
"همدان","همدان","مرکزی",157,868,60,18,889,1835,22,1857
"همدان","همدان","مرکزی",158,1210,24,11,668,1913,27,1940
"همدان","همدان","مرکزی",159,924,53,14,725,1716,24,1740
"همدان","همدان","مرکزی",160,565,67,9,796,1437,13,1450
"همدان","همدان","مرکزی",161,511,64,11,686,1272,14,1286
"همدان","همدان","مرکزی",162,653,46,8,578,1285,11,1296
"همدان","همدان","مرکزی",163,875,26,8,512,1421,24,1445
"همدان","همدان","مرکزی",164,1065,37,9,506,1617,12,1629
"همدان","همدان","مرکزی",165,1254,47,22,538,1861,23,1884
"همدان","همدان","مرکزی",166,1055,17,2,243,1317,4,1321
"همدان","همدان","مرکزی",167,1153,15,30,399,1597,14,1611
"همدان","همدان","مرکزی",168,1347,12,26,424,1809,12,1821
"همدان","همدان","مرکزی",169,585,5,13,422,1025,7,1032
"همدان","همدان","مرکزی",170,1507,45,6,581,2139,23,2162
"همدان","همدان","مرکزی",171,928,34,16,353,1331,19,1350
"همدان","همدان","مرکزی",172,408,39,13,478,938,7,945
"همدان","همدان","مرکزی",173,296,28,11,249,584,7,591
"همدان","همدان","مرکزی",174,853,20,13,280,1166,20,1186
"همدان","همدان","مرکزی",175,358,9,5,160,532,4,536
"همدان","همدان","مرکزی",176,350,11,5,142,508,7,515
"همدان","همدان","مرکزی",177,379,23,6,337,745,13,758
"همدان","همدان","مرکزی",178,615,25,7,270,917,17,934
"همدان","همدان","مرکزی",179,331,20,12,182,545,11,556
"همدان","همدان","مرکزی",180,552,13,11,228,804,11,815
"همدان","همدان","مرکزی",181,252,17,8,229,506,4,510
"همدان","همدان","مرکزی",182,354,20,5,149,528,8,536
"همدان","همدان","مرکزی",183,375,16,3,234,628,7,635
"همدان","همدان","مرکزی",184,1740,16,1,121,1878,25,1903
"همدان","همدان","مرکزی",185,1419,18,5,183,1625,21,1646
"همدان","همدان","مرکزی",186,1270,21,1,152,1444,16,1460
"همدان","همدان","مرکزی",187,1197,61,1,202,1461,29,1490
"همدان","همدان","مرکزی",188,857,13,3,362,1235,15,1250
"همدان","همدان","مرکزی",189,833,2,3,238,1076,3,1079
"همدان","همدان","مرکزی",190,588,9,2,191,790,4,794
"همدان","همدان","مرکزی",191,1220,26,16,341,1603,15,1618
"همدان","همدان","مرکزی",192,589,9,2,167,767,9,776
"همدان","همدان","مرکزی",193,329,12,1,131,473,15,488
"همدان","همدان","مرکزی",194,449,5,1,16,471,2,473
"همدان","همدان","مرکزی",195,102,2,616,223,943,24,967
"همدان","همدان","مرکزی",196,1483,10,7,75,1575,8,1583
"همدان","همدان","مرکزی",197,657,9,2,41,709,1,710
"همدان","همدان","مرکزی",198,1158,11,2,171,1342,13,1355
"همدان","همدان","مرکزی",199,422,1,0,17,440,0,440
"همدان","همدان","مرکزی",200,357,1,0,45,403,1,404
"همدان","همدان","مرکزی",201,619,6,1,39,665,4,669
"همدان","همدان","مرکزی",202,533,8,0,36,577,5,582
"همدان","همدان","مرکزی",203,1050,4,1,32,1087,8,1095
"همدان","همدان","مرکزی",204,147,0,0,64,211,2,213
"همدان","همدان","مرکزی",205,451,5,4,36,496,3,499
"همدان","همدان","مرکزی",206,617,5,0,32,654,11,665
"همدان","همدان","مرکزی",207,296,4,3,20,323,0,323
"همدان","همدان","مرکزی",208,327,4,0,22,353,1,354
"همدان","همدان","مرکزی",209,378,4,0,21,403,1,404
"همدان","همدان","مرکزی",210,309,3,2,41,355,6,361
"همدان","همدان","مرکزی",211,793,15,1,217,1026,12,1038
"همدان","همدان","مرکزی",212,895,15,6,231,1147,13,1160
"همدان","همدان","مرکزی",213,1244,16,1,173,1434,10,1444
"همدان","همدان","مرکزی",214,801,2,5,51,859,1,860
"همدان","همدان","مرکزی",215,164,3,1,15,183,0,183
"همدان","همدان","مرکزی",216,703,16,2,193,914,5,919
"همدان","همدان","مرکزی",217,510,9,1,83,603,4,607
"همدان","همدان","مرکزی",218,404,6,0,75,485,8,493
"همدان","همدان","مرکزی",219,324,5,1,22,352,5,357
"همدان","همدان","مرکزی",220,405,5,0,21,431,0,431
"همدان","همدان","مرکزی",221,288,2,0,28,318,5,323
"همدان","همدان","مرکزی",222,201,1,3,26,231,0,231
"همدان","همدان","مرکزی",223,244,1,1,21,267,0,267
"همدان","همدان","مرکزی",224,248,0,1,5,254,2,256
"همدان","همدان","مرکزی",225,177,1,0,6,184,0,184
"همدان","همدان","مرکزی",226,861,3,3,83,950,6,956
"همدان","همدان","مرکزی",227,972,11,2,122,1107,10,1117
"همدان","همدان","مرکزی",228,880,0,2,74,956,4,960
"همدان","همدان","مرکزی",229,980,10,0,94,1084,11,1095
"همدان","همدان","مرکزی",230,934,10,1,86,1031,9,1040
"همدان","همدان","مرکزی",231,1078,11,1,55,1145,9,1154
"همدان","همدان","مرکزی",232,716,10,5,58,789,2,791
"همدان","همدان","مرکزی",233,1612,11,12,132,1767,10,1777
"همدان","همدان","مرکزی",234,895,8,3,107,1013,8,1021
"همدان","همدان","مرکزی",235,355,1,1,61,418,3,421
"همدان","همدان","مرکزی",236,758,7,20,192,977,5,982
"همدان","همدان","مرکزی",237,1626,7,3,96,1732,8,1740
"همدان","همدان","مرکزی",238,1131,19,3,313,1466,11,1477
"همدان","همدان","مرکزی",239,1355,4,1,90,1450,3,1453
"همدان","همدان","مرکزی",240,1043,3,0,46,1092,2,1094
"همدان","همدان","مرکزی",241,943,10,3,117,1073,14,1087
"همدان","همدان","مرکزی",242,768,3,2,70,843,5,848
"همدان","همدان","مرکزی",243,1053,14,3,228,1298,12,1310
"همدان","همدان","مرکزی",244,1057,17,2,308,1384,16,1400
"همدان","همدان","مرکزی",245,725,4,0,47,776,1,777
"همدان","همدان","مرکزی",246,723,8,4,201,936,5,941
"همدان","همدان","مرکزی",247,241,1,0,17,259,5,264
"همدان","همدان","فمنین",1,517,9,1,462,989,16,1005
"همدان","همدان","فمنین",2,375,1,0,104,480,2,482
"همدان","همدان","فمنین",3,599,13,1,543,1156,17,1173
"همدان","همدان","فمنین",4,295,24,3,241,563,8,571
"همدان","همدان","فمنین",5,591,8,0,266,865,5,870
"همدان","همدان","فمنین",6,395,4,0,189,588,6,594
"همدان","همدان","فمنین",7,322,5,0,149,476,6,482
"همدان","همدان","فمنین",8,359,2,1,199,561,5,566
"همدان","همدان","فمنین",9,316,8,0,84,408,3,411
"همدان","همدان","فمنین",10,491,8,4,152,655,6,661
"همدان","همدان","فمنین",11,637,6,3,86,732,4,736
"همدان","همدان","فمنین",12,441,2,2,73,518,5,523
"همدان","همدان","فمنین",13,380,2,0,59,441,6,447
"همدان","همدان","فمنین",14,330,3,1,93,427,0,427
"همدان","همدان","فمنین",15,636,6,0,44,686,2,688
"همدان","همدان","فمنین",16,597,1,1,91,690,5,695
"همدان","همدان","فمنین",17,536,1,1,86,624,15,639
"همدان","همدان","فمنین",18,463,9,1,113,586,6,592
"همدان","همدان","فمنین",19,162,3,4,10,179,0,179
"همدان","همدان","فمنین",20,625,5,1,53,684,8,692
"همدان","همدان","فمنین",21,151,0,0,31,182,0,182
"همدان","همدان","فمنین",22,410,4,1,81,496,3,499
"همدان","همدان","فمنین",23,513,4,1,114,632,3,635
"همدان","همدان","فمنین",24,478,2,0,43,523,1,524
"همدان","همدان","فمنین",25,347,3,0,35,385,0,385
"همدان","همدان","فمنین",26,280,1,0,72,353,1,354
"همدان","همدان","فمنین",27,642,2,4,117,765,6,771
"همدان","همدان","فمنین",28,409,1,0,86,496,2,498
"همدان","همدان","فمنین",29,631,1,1,51,684,0,684
"همدان","همدان","فمنین",30,568,5,1,91,665,8,673
"همدان","همدان","فمنین",31,251,4,1,34,290,2,292
"همدان","همدان","فمنین",32,277,2,0,41,320,2,322
"همدان","همدان","فمنین",33,94,0,0,37,131,3,134
"همدان","همدان","فمنین",34,569,3,0,11,583,1,584
"همدان","همدان","فمنین",35,420,6,1,101,528,1,529
"همدان","همدان","فمنین",36,150,1,0,29,180,2,182
"همدان","همدان","فمنین",37,163,1,0,21,185,0,185
"همدان","همدان","فمنین",38,195,0,0,26,221,0,221
"همدان","همدان","فمنین",39,429,1,0,140,570,4,574
"همدان","همدان","فمنین",40,170,1,0,43,214,1,215
"همدان","همدان","فمنین",41,187,3,2,21,213,1,214
"همدان","همدان","فمنین",42,216,0,0,34,250,2,252
"همدان","همدان","فمنین",43,242,2,0,20,264,2,266
"همدان","همدان","فمنین",44,82,1,0,14,97,0,97
"همدان","همدان","فمنین",45,157,2,2,14,175,1,176
"همدان","همدان","فمنین",46,493,2,1,38,534,0,534
"همدان","همدان","فمنین",47,131,2,1,24,158,0,158
"همدان","همدان","فمنین",48,136,0,4,28,168,2,170
"همدان","همدان","فمنین",49,173,0,1,10,184,0,184
"همدان","همدان","فمنین",50,274,1,0,13,288,2,290
"همدان","همدان","فمنین",51,116,1,0,9,126,0,126
"همدان","همدان","فمنین",52,65,1,0,53,119,3,122
"همدان","همدان","فمنین",53,108,0,1,34,143,1,144
"همدان","همدان","شراء",1,842,2,2,60,906,1,907
"همدان","همدان","شراء",2,668,3,0,16,687,2,689
"همدان","همدان","شراء",3,746,4,1,63,814,7,821
"همدان","همدان","شراء",4,267,5,1,20,293,3,296
"همدان","همدان","شراء",5,216,3,0,30,249,5,254
"همدان","همدان","شراء",6,473,2,0,63,538,5,543
"همدان","همدان","شراء",7,151,0,1,23,175,1,176
"همدان","همدان","شراء",8,359,1,0,20,380,0,380
"همدان","همدان","شراء",9,481,1,0,13,495,1,496
"همدان","همدان","شراء",10,559,2,2,58,621,2,623
"همدان","همدان","شراء",11,214,0,1,6,221,0,221
"همدان","همدان","شراء",12,577,2,3,42,624,6,630
"همدان","همدان","شراء",13,403,0,1,83,487,3,490
"همدان","همدان","شراء",14,604,4,3,99,710,5,715
"همدان","همدان","شراء",15,639,7,2,96,744,5,749
"همدان","همدان","شراء",16,739,0,0,44,783,0,783
"همدان","همدان","شراء",17,287,3,0,19,309,5,314
"همدان","همدان","شراء",18,400,0,0,15,415,0,415
"همدان","همدان","شراء",19,368,2,6,50,426,2,428
"همدان","همدان","شراء",20,424,1,0,43,468,5,473
"همدان","همدان","شراء",21,194,2,1,8,205,1,206
"همدان","همدان","شراء",22,78,1,0,7,86,0,86
"همدان","همدان","شراء",23,222,0,0,12,234,2,236
"همدان","همدان","شراء",24,571,1,4,18,594,2,596
"همدان","همدان","شراء",25,687,3,0,37,727,7,734
"همدان","همدان","شراء",26,561,3,2,34,600,5,605
"همدان","همدان","شراء",27,602,3,0,40,645,1,646
"همدان","همدان","شراء",28,519,2,1,50,572,4,576
"همدان","همدان","شراء",29,126,2,0,13,141,0,141
"همدان","همدان","شراء",30,104,2,0,20,126,2,128
"همدان","همدان","شراء",31,113,5,0,21,139,2,141
"یزد","ابرکوه","مرکزی",1,763,11,8,609,1391,21,1412
"یزد","ابرکوه","مرکزی",2,642,7,4,215,868,10,878
"یزد","ابرکوه","مرکزی",3,707,5,1,282,995,11,1006
"یزد","ابرکوه","مرکزی",4,240,6,0,199,445,9,454
"یزد","ابرکوه","مرکزی",5,915,4,1,196,1116,6,1122
"یزد","ابرکوه","مرکزی",6,499,10,0,229,738,4,742
"یزد","ابرکوه","مرکزی",7,734,11,3,357,1105,19,1124
"یزد","ابرکوه","مرکزی",8,403,5,3,161,572,10,582
"یزد","ابرکوه","مرکزی",9,946,10,3,411,1370,16,1386
"یزد","ابرکوه","مرکزی",10,520,9,6,415,950,11,961
"یزد","ابرکوه","مرکزی",11,681,5,3,242,931,8,939
"یزد","ابرکوه","مرکزی",12,556,13,2,265,836,6,842
"یزد","ابرکوه","مرکزی",13,463,5,1,222,691,9,700
"یزد","ابرکوه","مرکزی",14,375,10,2,182,569,4,573
"یزد","ابرکوه","مرکزی",15,370,9,0,252,631,6,637
"یزد","ابرکوه","مرکزی",16,192,2,2,61,257,2,259
"یزد","ابرکوه","مرکزی",17,102,6,0,74,182,1,183
"یزد","ابرکوه","مرکزی",18,673,3,1,155,832,2,834
"یزد","ابرکوه","مرکزی",19,572,2,0,115,689,3,692
"یزد","ابرکوه","مرکزی",20,476,2,2,90,570,3,573
"یزد","ابرکوه","مرکزی",21,239,0,0,48,287,2,289
"یزد","ابرکوه","مرکزی",22,826,4,0,62,892,1,893
"یزد","ابرکوه","مرکزی",23,426,4,1,97,528,2,530
"یزد","ابرکوه","مرکزی",24,315,1,0,31,347,1,348
"یزد","ابرکوه","مرکزی",25,482,5,0,40,527,3,530
"یزد","ابرکوه","مرکزی",26,488,3,0,42,533,5,538
"یزد","ابرکوه","مرکزی",27,483,1,0,34,518,0,518
"یزد","ابرکوه","مرکزی",28,389,4,0,78,471,2,473
"یزد","ابرکوه","مرکزی",1,245,0,0,37,282,3,285
"یزد","ابرکوه","بهمن",2,359,1,0,34,394,2,396
"یزد","ابرکوه","بهمن",3,594,3,1,61,659,0,659
"یزد","ابرکوه","بهمن",4,339,5,0,51,395,1,396
"یزد","ابرکوه","بهمن",5,397,3,0,60,460,0,460
"یزد","ابرکوه","بهمن",6,852,3,0,78,933,0,933
"یزد","ابرکوه","بهمن",7,467,0,0,31,498,0,498
"یزد","ابرکوه","بهمن",8,688,1,0,132,821,0,821
"یزد","ابرکوه","بهمن",9,519,4,2,212,737,3,740
"یزد","ابرکوه","بهمن",10,595,0,0,96,691,6,697
"یزد","ابرکوه","بهمن",11,441,1,1,74,517,0,517
"یزد","ابرکوه","بهمن",12,453,1,0,84,538,3,541
"یزد","ابرکوه","بهمن",13,440,1,1,88,530,3,533
"یزد","ابرکوه","بهمن",14,502,3,3,117,625,1,626
"یزد","ابرکوه","بهمن",15,291,4,0,57,352,1,353
"یزد","اردکان","مرکزی",1,677,35,7,1269,1988,31,2019
"یزد","اردکان","مرکزی",2,665,33,6,871,1575,25,1600
"یزد","اردکان","مرکزی",3,354,13,6,577,950,13,963
"یزد","اردکان","مرکزی",4,260,18,4,769,1051,15,1066
"یزد","اردکان","مرکزی",5,273,20,5,823,1121,10,1131
"یزد","اردکان","مرکزی",6,390,14,4,734,1142,18,1160
"یزد","اردکان","مرکزی",7,267,8,6,260,541,9,550
"یزد","اردکان","مرکزی",8,230,10,3,208,451,13,464
"یزد","اردکان","مرکزی",9,527,24,1,888,1440,30,1470
"یزد","اردکان","مرکزی",10,355,17,8,641,1021,17,1038
"یزد","اردکان","مرکزی",11,499,19,4,615,1137,18,1155
"یزد","اردکان","مرکزی",12,347,32,3,593,975,14,989
"یزد","اردکان","مرکزی",13,482,4,1,541,1028,16,1044
"یزد","اردکان","مرکزی",14,309,7,0,614,930,12,942
"یزد","اردکان","مرکزی",15,442,14,2,591,1049,14,1063
"یزد","اردکان","مرکزی",16,449,12,2,515,978,12,990
"یزد","اردکان","مرکزی",17,335,11,7,594,947,15,962
"یزد","اردکان","مرکزی",18,275,4,0,419,698,8,706
"یزد","اردکان","مرکزی",19,174,7,1,558,740,10,750
"یزد","اردکان","مرکزی",20,276,14,5,579,874,12,886
"یزد","اردکان","مرکزی",21,308,12,2,503,825,10,835
"یزد","اردکان","مرکزی",22,315,20,5,648,988,11,999
"یزد","اردکان","مرکزی",23,446,12,6,555,1019,8,1027
"یزد","اردکان","مرکزی",24,441,10,2,501,954,6,960
"یزد","اردکان","مرکزی",25,196,11,2,495,704,7,711
"یزد","اردکان","مرکزی",26,282,10,2,747,1041,8,1049
"یزد","اردکان","مرکزی",27,243,15,2,779,1039,13,1052
"یزد","اردکان","مرکزی",28,528,24,5,824,1381,20,1401
"یزد","اردکان","مرکزی",29,189,13,0,311,513,12,525
"یزد","اردکان","مرکزی",30,289,18,3,466,776,22,798
"یزد","اردکان","مرکزی",31,694,22,2,209,927,11,938
"یزد","اردکان","مرکزی",32,563,25,7,415,1010,34,1044
"یزد","اردکان","مرکزی",33,679,17,4,238,938,19,957
"یزد","اردکان","مرکزی",34,546,10,2,168,726,9,735
"یزد","اردکان","مرکزی",35,408,17,2,233,660,24,684
"یزد","اردکان","مرکزی",36,262,11,0,83,356,12,368
"یزد","اردکان","مرکزی",37,172,6,2,90,270,3,273
"یزد","اردکان","مرکزی",38,94,5,0,94,193,2,195
"یزد","اردکان","مرکزی",39,173,6,1,100,280,9,289
"یزد","اردکان","مرکزی",40,255,7,1,355,618,10,628
"یزد","اردکان","خرائق",1,215,2,0,159,376,1,377
"یزد","اردکان","خرائق",2,341,2,0,201,544,4,548
"یزد","اردکان","خرائق",3,140,1,0,179,320,1,321
"یزد","اردکان","خرائق",4,468,4,14,292,778,0,778
"یزد","اردکان","خرائق",5,90,4,0,193,287,1,288
"یزد","اردکان","خرائق",6,181,1,1,98,281,1,282
"یزد","اردکان","خرائق",7,70,2,1,116,189,1,190
"یزد","اردکان","خرائق",8,414,22,13,324,773,6,779
"یزد","اردکان","عقدا",1,389,23,1,318,731,6,737
"یزد","اردکان","عقدا",2,408,11,0,256,675,2,677
"یزد","اردکان","عقدا",3,466,7,1,248,722,12,734
"یزد","اردکان","عقدا",4,382,11,3,253,649,5,654
"یزد","اردکان","عقدا",5,336,3,3,261,603,8,611
"یزد","اردکان","عقدا",6,367,3,2,65,437,1,438
"یزد","اردکان","عقدا",7,228,1,0,91,320,1,321
"یزد","اردکان","عقدا",8,225,1,0,148,374,1,375
"یزد","بافق","مرکزی",1,1179,17,8,447,1651,21,1672
"یزد","بافق","مرکزی",2,1061,8,1,226,1296,1,1297
"یزد","بافق","مرکزی",3,846,8,4,155,1013,6,1019
"یزد","بافق","مرکزی",4,777,6,6,104,893,1,894
"یزد","بافق","مرکزی",5,758,5,0,99,862,2,864
"یزد","بافق","مرکزی",6,1049,8,4,214,1275,3,1278
"یزد","بافق","مرکزی",7,539,3,0,47,589,4,593
"یزد","بافق","مرکزی",8,310,1,0,59,370,0,370
"یزد","بافق","مرکزی",9,424,3,0,21,448,2,450
"یزد","بافق","مرکزی",10,590,2,0,61,653,2,655
"یزد","بافق","مرکزی",11,824,13,2,227,1066,10,1076
"یزد","بافق","مرکزی",12,934,3,6,128,1071,8,1079
"یزد","بافق","مرکزی",13,492,1,2,59,554,6,560
"یزد","بافق","مرکزی",14,555,10,3,190,758,4,762
"یزد","بافق","مرکزی",15,920,6,3,203,1132,11,1143
"یزد","بافق","مرکزی",16,378,5,0,104,487,0,487
"یزد","بافق","مرکزی",17,359,6,4,165,534,7,541
"یزد","بافق","مرکزی",18,429,10,1,107,547,1,548
"یزد","بافق","مرکزی",19,536,9,0,179,724,1,725
"یزد","بافق","مرکزی",20,1023,9,1,177,1210,7,1217
"یزد","بافق","مرکزی",21,559,3,0,136,698,5,703
"یزد","بافق","مرکزی",22,159,1,1,57,218,1,219
"یزد","بافق","مرکزی",23,200,0,2,32,234,0,234
"یزد","بافق","مرکزی",24,400,12,5,185,602,5,607
"یزد","بافق","مرکزی",25,664,4,0,82,750,2,752
"یزد","بافق","مرکزی",26,605,9,1,104,719,1,720
"یزد","بافق","مرکزی",27,171,0,0,21,192,0,192
"یزد","بافق","مرکزی",28,243,0,0,51,294,0,294
"یزد","بافق","مرکزی",29,264,2,0,47,313,1,314
"یزد","بافق","مرکزی",30,627,2,0,53,682,1,683
"یزد","بافق","مرکزی",31,253,2,2,77,334,3,337
"یزد","بافق","مرکزی",32,677,3,0,77,757,3,760
"یزد","بافق","مرکزی",33,418,5,0,57,480,0,480
"یزد","بافق","بهاباد",1,512,7,4,47,570,0,570
"یزد","بافق","بهاباد",2,641,4,1,95,741,2,743
"یزد","بافق","بهاباد",3,865,17,3,129,1014,4,1018
"یزد","بافق","بهاباد",4,1111,15,2,101,1229,6,1235
"یزد","بافق","بهاباد",5,419,14,1,57,491,1,492
"یزد","بافق","بهاباد",6,549,3,2,164,718,6,724
"یزد","بافق","بهاباد",7,494,1,0,54,549,3,552
"یزد","بافق","بهاباد",8,575,3,1,30,609,1,610
"یزد","بافق","بهاباد",9,386,2,2,102,492,3,495
"یزد","بافق","بهاباد",10,514,4,0,26,544,1,545
"یزد","بافق","بهاباد",11,312,1,0,36,349,1,350
"یزد","بافق","بهاباد",12,351,1,1,34,387,2,389
"یزد","بافق","بهاباد",13,407,6,1,55,469,0,469
"یزد","بافق","بهاباد",14,556,2,2,66,626,3,629
"یزد","بافق","بهاباد",15,517,3,0,51,571,3,574
"یزد","بافق","بهاباد",16,414,2,0,39,455,1,456
"یزد","بافق","بهاباد",17,90,0,1,11,102,0,102
"یزد","تفت","مرکزی",1,449,23,5,572,1049,13,1062
"یزد","تفت","مرکزی",2,502,8,2,418,930,16,946
"یزد","تفت","مرکزی",3,351,11,1,560,923,12,935
"یزد","تفت","مرکزی",4,493,19,2,677,1191,12,1203
"یزد","تفت","مرکزی",5,182,4,0,198,384,2,386
"یزد","تفت","مرکزی",6,147,10,0,154,311,4,315
"یزد","تفت","مرکزی",7,586,19,1,314,920,17,937
"یزد","تفت","مرکزی",8,254,12,3,137,406,3,409
"یزد","تفت","مرکزی",9,237,5,7,434,683,6,689
"یزد","تفت","مرکزی",10,457,21,4,377,859,10,869
"یزد","تفت","مرکزی",11,497,20,2,459,978,13,991
"یزد","تفت","مرکزی",12,427,20,2,588,1037,12,1049
"یزد","تفت","مرکزی",13,61,1,0,74,136,1,137
"یزد","تفت","مرکزی",14,460,10,0,403,873,11,884
"یزد","تفت","مرکزی",15,274,7,2,512,795,6,801
"یزد","تفت","مرکزی",16,90,1,0,59,150,,150
"یزد","تفت","مرکزی",17,127,1,0,137,265,1,266
"یزد","تفت","مرکزی",18,576,18,0,403,997,11,1008
"یزد","تفت","مرکزی",19,392,8,2,185,587,2,589
"یزد","تفت","مرکزی",20,332,3,1,331,667,3,670
"یزد","تفت","مرکزی",21,201,1,0,69,271,3,274
"یزد","تفت","مرکزی",22,274,1,0,220,495,5,500
"یزد","تفت","مرکزی",23,418,9,4,715,1146,9,1155
"یزد","تفت","مرکزی",24,318,2,1,216,537,2,539
"یزد","تفت","مرکزی",25,725,7,0,339,1071,15,1086
"یزد","تفت","مرکزی",26,963,19,1,703,1686,16,1702
"یزد","تفت","مرکزی",27,334,4,0,177,515,4,519
"یزد","تفت","مرکزی",28,399,4,0,176,579,4,583
"یزد","تفت","مرکزی",29,239,2,1,190,432,1,433
"یزد","تفت","مرکزی",30,413,5,0,178,596,4,600
"یزد","تفت","مرکزی",31,720,7,2,599,1328,7,1335
"یزد","تفت","مرکزی",32,311,2,0,195,508,4,512
"یزد","تفت","مرکزی",33,386,3,1,280,670,6,676
"یزد","تفت","مرکزی",34,313,3,0,132,448,2,450
"یزد","تفت","مرکزی",35,318,7,2,156,483,1,484
"یزد","تفت","مرکزی",36,456,7,2,101,566,1,567
"یزد","تفت","مرکزی",37,464,5,2,40,511,1,512
"یزد","تفت","مرکزی",38,217,5,0,103,325,,325
"یزد","تفت","مرکزی",39,483,1,2,99,585,2,587
"یزد","تفت","مرکزی",40,398,10,1,479,888,9,897
"یزد","تفت","مرکزی",41,601,24,6,822,1453,11,1464
"یزد","تفت","مرکزی",42,550,12,3,913,1478,6,1484
"یزد","تفت","مرکزی",43,434,8,3,609,1054,3,1057
"یزد","تفت","نیر",1,1426,13,0,337,1776,13,1789
"یزد","تفت","نیر",2,621,9,2,154,786,2,788
"یزد","تفت","نیر",3,511,6,0,310,827,1,828
"یزد","تفت","نیر",4,434,4,0,378,816,4,820
"یزد","تفت","نیر",5,664,6,3,360,1033,3,1036
"یزد","تفت","نیر",6,750,0,1,248,999,3,1002
"یزد","تفت","نیر",7,442,2,4,275,723,0,723
"یزد","تفت","نیر",8,484,13,2,460,959,4,963
"یزد","تفت","نیر",9,437,5,0,283,725,6,731
"یزد","تفت","نیر",10,330,2,1,159,492,3,495
"یزد","تفت","نیر",11,856,10,0,284,1150,2,1152
"یزد","تفت","نیر",12,468,3,1,145,617,2,619
"یزد","تفت","نیر",13,584,12,1,195,792,4,796
"یزد","تفت","نیر",14,385,7,0,118,510,5,515
"یزد","تفت","نیر",15,653,3,0,192,848,2,850
"یزد","تفت","نیر",16,340,1,0,176,517,5,522
"یزد","تفت","نیر",17,450,3,2,159,614,3,617
"یزد","خاتم","مرکزی",1,527,1,2,205,735,5,740
"یزد","خاتم","مرکزی",2,639,1,0,159,799,1,800
"یزد","خاتم","مرکزی",3,519,5,0,207,731,3,734
"یزد","خاتم","مرکزی",4,226,1,4,174,405,4,409
"یزد","خاتم","مرکزی",5,127,1,1,38,167,2,169
"یزد","خاتم","مرکزی",6,872,5,1,292,1170,6,1176
"یزد","خاتم","مرکزی",7,817,3,2,435,1257,0,1257
"یزد","خاتم","مرکزی",8,627,7,1,236,871,1,872
"یزد","خاتم","مرکزی",9,301,1,1,106,409,5,414
"یزد","خاتم","مرکزی",10,379,2,3,133,517,0,517
"یزد","خاتم","مرکزی",11,164,0,0,44,208,0,208
"یزد","خاتم","مرکزی",12,212,1,0,90,303,0,303
"یزد","خاتم","مرکزی",13,192,6,0,48,246,0,246
"یزد","خاتم","مرکزی",14,244,3,1,88,336,0,336
"یزد","خاتم","مرکزی",15,579,6,11,265,861,2,863
"یزد","خاتم","مرکزی",16,375,3,5,92,475,0,475
"یزد","خاتم","مرکزی",17,383,3,1,107,494,1,495
"یزد","خاتم","مرکزی",18,541,4,0,88,633,0,633
"یزد","خاتم","مرکزی",19,389,0,0,15,404,1,405
"یزد","خاتم","مرکزی",20,521,0,0,53,574,0,574
"یزد","خاتم","مروست",1,947,10,0,86,1043,4,1047
"یزد","خاتم","مروست",2,1014,4,1,111,1130,4,1134
"یزد","خاتم","مروست",3,371,4,7,42,424,2,426
"یزد","خاتم","مروست",4,512,6,1,155,674,2,676
"یزد","خاتم","مروست",5,472,3,0,82,557,2,559
"یزد","خاتم","مروست",6,200,2,0,34,236,1,237
"یزد","خاتم","مروست",7,372,1,0,76,449,3,452
"یزد","خاتم","مروست",8,592,1,2,90,685,3,688
"یزد","خاتم","مروست",9,433,1,2,60,496,1,497
"یزد","خاتم","مروست",10,521,4,1,66,592,5,597
"یزد","خاتم","مروست",11,229,3,1,44,277,0,277
"یزد","خاتم","مروست",12,185,1,0,19,205,0,205
"یزد","خاتم","مروست",13,363,2,0,18,383,2,385
"یزد","خاتم","مروست",14,249,1,0,36,286,3,289
"یزد","خاتم","مروست",15,121,1,1,26,149,0,149
"یزد","خاتم","مروست",16,165,2,0,37,204,0,204
"یزد","صدوق","مرکزی",1,270,7,2,338,617,8,625
"یزد","صدوق","مرکزی",2,788,23,5,882,1698,20,1718
"یزد","صدوق","مرکزی",3,286,4,0,270,560,7,567
"یزد","صدوق","مرکزی",4,405,23,1,427,856,14,870
"یزد","صدوق","مرکزی",5,575,16,12,341,944,6,950
"یزد","صدوق","مرکزی",6,302,11,2,325,640,4,644
"یزد","صدوق","مرکزی",7,418,10,6,886,1320,10,1330
"یزد","صدوق","مرکزی",8,187,0,4,757,948,2,950
"یزد","صدوق","مرکزی",9,123,1,7,326,457,7,464
"یزد","صدوق","مرکزی",10,110,1,0,288,399,4,403
"یزد","صدوق","مرکزی",11,173,11,0,199,383,4,387
"یزد","صدوق","مرکزی",12,162,5,0,207,374,4,378
"یزد","صدوق","مرکزی",13,62,1,0,52,115,1,116
"یزد","صدوق","مرکزی",14,289,4,3,237,533,6,539
"یزد","صدوق","مرکزی",15,360,7,1,703,1071,12,1083
"یزد","صدوق","مرکزی",16,384,6,0,493,883,3,886
"یزد","صدوق","مرکزی",17,506,4,2,351,863,6,869
"یزد","صدوق","مرکزی",18,379,5,0,287,671,7,678
"یزد","صدوق","مرکزی",19,379,5,3,309,696,4,700
"یزد","صدوق","مرکزی",20,532,2,1,201,736,8,744
"یزد","صدوق","مرکزی",21,175,3,1,211,390,2,392
"یزد","صدوق","مرکزی",22,120,0,0,96,216,0,216
"یزد","صدوق","مرکزی",23,269,5,1,164,439,2,441
"یزد","صدوق","مرکزی",24,89,2,0,91,182,0,182
"یزد","صدوق","خضرآباد",1,298,3,4,494,799,8,807
"یزد","صدوق","خضرآباد",2,276,2,4,387,669,5,674
"یزد","صدوق","خضرآباد",3,161,4,1,322,488,2,490
"یزد","صدوق","خضرآباد",4,293,11,1,273,578,4,582
"یزد","صدوق","خضرآباد",5,303,3,0,171,477,7,484
"یزد","صدوق","خضرآباد",6,240,6,8,182,436,10,446
"یزد","صدوق","خضرآباد",7,225,4,1,230,460,7,467
"یزد","صدوق","خضرآباد",8,522,11,2,251,786,0,786
"یزد","صدوق","خضرآباد",9,298,10,0,228,536,1,537
"یزد","صدوق","خضرآباد",10,444,9,3,328,784,5,789
"یزد","صدوق","خضرآباد",11,352,0,1,92,445,5,450
"یزد","طبس","مرکزی",402710001,682,17,9,522,1230,4,1234
"یزد","طبس","مرکزی",402710002,804,8,4,493,1309,10,1319
"یزد","طبس","مرکزی",402710003,737,26,2,741,1506,13,1519
"یزد","طبس","مرکزی",402710004,807,33,3,325,1168,8,1176
"یزد","طبس","مرکزی",402710005,524,22,5,558,1109,12,1121
"یزد","طبس","مرکزی",402710006,561,17,1,558,1137,9,1146
"یزد","طبس","مرکزی",402710007,774,22,10,739,1545,10,1555
"یزد","طبس","مرکزی",402710008,887,21,5,645,1558,12,1570
"یزد","طبس","مرکزی",402710009,353,14,1,308,676,3,679
"یزد","طبس","مرکزی",402710010,1026,5,2,315,1348,5,1353
"یزد","طبس","مرکزی",402710011,730,16,5,234,985,3,988
"یزد","طبس","مرکزی",402710012,1032,19,1,456,1508,8,1516
"یزد","طبس","مرکزی",402710013,648,25,2,537,1212,15,1227
"یزد","طبس","مرکزی",402710014,859,11,0,590,1460,8,1468
"یزد","طبس","مرکزی",402710015,741,11,1,218,971,9,980
"یزد","طبس","مرکزی",402710016,597,13,3,213,826,7,833
"یزد","طبس","مرکزی",402710017,328,9,5,151,493,2,495
"یزد","طبس","مرکزی",402710018,410,6,1,92,509,1,510
"یزد","طبس","مرکزی",402710019,756,12,0,154,922,0,922
"یزد","طبس","مرکزی",402710020,874,5,1,158,1038,4,1042
"یزد","طبس","مرکزی",402710021,957,11,1,161,1130,5,1135
"یزد","طبس","مرکزی",402710022,1101,6,0,191,1298,2,1300
"یزد","طبس","مرکزی",402710023,719,3,0,35,757,1,758
"یزد","طبس","مرکزی",402710024,1048,4,1,85,1138,4,1142
"یزد","طبس","مرکزی",402710025,261,2,0,44,307,0,307
"یزد","طبس","مرکزی",402710026,890,5,0,80,975,1,976
"یزد","طبس","مرکزی",402710027,651,1,0,131,783,6,789
"یزد","طبس","مرکزی",402710028,116,3,0,58,177,1,178
"یزد","طبس","دستگردان",402720029,972,14,2,280,1268,5,1273
"یزد","طبس","دستگردان",402720030,648,7,2,300,957,2,959
"یزد","طبس","دستگردان",402720031,531,8,0,81,620,2,622
"یزد","طبس","دستگردان",402720032,639,8,0,189,836,3,839
"یزد","طبس","دستگردان",402720033,291,0,0,65,356,0,356
"یزد","طبس","دستگردان",402720034,607,5,0,48,660,3,663
"یزد","طبس","دستگردان",402720035,456,3,0,98,557,1,558
"یزد","طبس","دستگردان",402720036,307,1,0,25,333,3,336
"یزد","طبس","دستگردان",402720037,435,1,0,101,537,3,540
"یزد","طبس","دستگردان",402720038,233,2,0,20,255,0,255
"یزد","طبس","دستگردان",402720039,133,1,2,41,177,0,177
"یزد","طبس","دستگردان",402720040,334,1,0,85,420,0,420
"یزد","طبس","دستگردان",402720041,122,0,2,31,155,0,155
"یزد","طبس","دستگردان",402730042,485,3,0,120,608,4,612
"یزد","طبس","دستگردان",402730043,552,3,1,103,659,6,665
"یزد","طبس","دستگردان",402730044,635,4,0,156,795,3,798
"یزد","طبس","دستگردان",402730045,205,3,0,27,235,3,238
"یزد","طبس","دستگردان",402730046,391,1,0,79,471,1,472
"یزد","طبس","دستگردان",402730047,572,3,0,100,675,2,677
"یزد","طبس","دستگردان",402730048,443,5,1,82,531,3,534
"یزد","طبس","دستگردان",402730049,831,2,1,18,852,2,854
"یزد","طبس","دستگردان",402730050,440,2,0,25,467,3,470
"یزد","طبس","دستگردان",402730051,643,2,0,53,698,2,700
"یزد","طبس","دستگردان",402730052,386,0,1,42,429,1,430
"یزد","مهریز","مرکزی",1,755,15,9,712,1491,27,1518
"یزد","مهریز","مرکزی",2,765,21,5,604,1395,21,1416
"یزد","مهریز","مرکزی",3,963,26,1,515,1505,22,1527
"یزد","مهریز","مرکزی",4,447,11,3,562,1023,7,1030
"یزد","مهریز","مرکزی",5,425,12,1,321,759,8,767
"یزد","مهریز","مرکزی",6,185,3,2,353,543,6,549
"یزد","مهریز","مرکزی",7,141,6,0,160,307,2,309
"یزد","مهریز","مرکزی",8,271,10,2,413,696,4,700
"یزد","مهریز","مرکزی",9,412,14,0,423,849,6,855
"یزد","مهریز","مرکزی",10,235,5,1,144,385,1,386
"یزد","مهریز","مرکزی",11,483,13,2,588,1086,14,1100
"یزد","مهریز","مرکزی",12,370,7,1,280,658,4,662
"یزد","مهریز","مرکزی",13,260,6,3,321,590,7,597
"یزد","مهریز","مرکزی",14,440,8,4,404,856,10,866
"یزد","مهریز","مرکزی",15,132,3,0,181,316,5,321
"یزد","مهریز","مرکزی",16,362,14,4,281,661,7,668
"یزد","مهریز","مرکزی",17,427,6,0,293,726,9,735
"یزد","مهریز","مرکزی",18,260,6,1,195,462,3,465
"یزد","مهریز","مرکزی",19,334,7,5,180,526,7,533
"یزد","مهریز","مرکزی",20,331,1,1,148,481,10,491
"یزد","مهریز","مرکزی",21,182,0,1,97,280,6,286
"یزد","مهریز","مرکزی",22,112,4,0,134,250,2,252
"یزد","مهریز","مرکزی",23,456,16,5,328,805,8,813
"یزد","مهریز","مرکزی",24,194,7,4,161,366,6,372
"یزد","مهریز","مرکزی",25,325,7,2,349,683,2,685
"یزد","مهریز","مرکزی",26,193,9,2,77,281,2,283
"یزد","مهریز","مرکزی",27,972,9,3,525,1509,7,1516
"یزد","مهریز","مرکزی",28,719,11,15,262,1007,9,1016
"یزد","مهریز","مرکزی",29,792,6,2,346,1146,7,1153
"یزد","مهریز","مرکزی",30,323,7,4,267,601,3,604
"یزد","مهریز","مرکزی",31,208,5,1,274,488,4,492
"یزد","مهریز","مرکزی",32,548,9,0,427,984,3,987
"یزد","مهریز","مرکزی",33,550,0,0,272,822,4,826
"یزد","مهریز","مرکزی",34,624,2,4,397,1027,10,1037
"یزد","مهریز","مرکزی",35,413,26,0,342,781,1,782
"یزد","مهریز","مرکزی",36,294,1,4,123,422,0,422
"یزد","مهریز","مرکزی",37,199,3,2,305,509,4,513
"یزد","مهریز","مرکزی",38,335,5,0,283,623,4,627
"یزد","مهریز","مرکزی",39,460,12,1,619,1092,11,1103
"یزد","مهریز","مرکزی",40,800,14,6,652,1472,11,1483
"یزد","مهریز","مرکزی",41,394,6,0,345,745,11,756
"یزد","مهریز","مرکزی",42,799,8,2,512,1321,3,1324
"یزد","مهریز","مرکزی",43,283,1,0,211,495,4,499
"یزد","مهریز","مرکزی",44,283,2,1,146,432,1,433
"یزد","مهریز","مرکزی",45,652,7,0,185,844,2,846
"یزد","مهریز","مرکزی",46,751,0,0,110,861,2,863
"یزد","میبد","مرکزی",1,831,32,3,483,1349,26,1375
"یزد","میبد","مرکزی",2,539,7,7,334,887,15,902
"یزد","میبد","مرکزی",3,363,6,3,129,501,9,510
"یزد","میبد","مرکزی",4,1353,25,8,445,1831,28,1859
"یزد","میبد","مرکزی",5,775,10,0,183,968,12,980
"یزد","میبد","مرکزی",6,299,7,0,98,404,12,416
"یزد","میبد","مرکزی",7,798,8,0,179,985,11,996
"یزد","میبد","مرکزی",8,733,21,4,383,1141,16,1157
"یزد","میبد","مرکزی",9,558,19,1,211,789,19,808
"یزد","میبد","مرکزی",10,789,19,5,181,994,8,1002
"یزد","میبد","مرکزی",11,1012,20,3,170,1205,24,1229
"یزد","میبد","مرکزی",12,829,6,0,91,926,7,933
"یزد","میبد","مرکزی",13,651,9,3,92,755,16,771
"یزد","میبد","مرکزی",14,510,11,3,137,661,16,677
"یزد","میبد","مرکزی",15,699,14,3,134,850,16,866
"یزد","میبد","مرکزی",16,668,19,1,82,770,12,782
"یزد","میبد","مرکزی",17,801,15,2,359,1177,15,1192
"یزد","میبد","مرکزی",18,721,8,0,231,960,13,973
"یزد","میبد","مرکزی",19,900,16,2,323,1241,20,1261
"یزد","میبد","مرکزی",20,779,28,2,469,1278,26,1304
"یزد","میبد","مرکزی",21,317,13,5,279,614,9,623
"یزد","میبد","مرکزی",22,623,7,4,317,951,20,971
"یزد","میبد","مرکزی",23,665,10,1,243,919,16,935
"یزد","میبد","مرکزی",24,591,17,4,393,1005,15,1020
"یزد","میبد","مرکزی",25,333,7,0,156,496,5,501
"یزد","میبد","مرکزی",26,790,10,3,179,982,13,995
"یزد","میبد","مرکزی",27,324,10,1,206,541,12,553
"یزد","میبد","مرکزی",28,984,19,2,411,1416,21,1437
"یزد","میبد","مرکزی",29,804,23,4,338,1169,8,1177
"یزد","میبد","مرکزی",30,414,14,12,369,809,9,818
"یزد","میبد","مرکزی",31,481,18,13,388,900,19,919
"یزد","میبد","مرکزی",32,565,13,1,226,805,2,807
"یزد","میبد","مرکزی",33,1041,5,1,232,1279,2,1281
"یزد","میبد","مرکزی",34,602,5,2,139,748,12,760
"یزد","میبد","مرکزی",35,844,20,2,499,1365,20,1385
"یزد","میبد","مرکزی",36,413,7,1,191,612,12,624
"یزد","میبد","مرکزی",37,726,18,2,265,1011,14,1025
"یزد","میبد","مرکزی",38,262,2,0,78,342,9,351
"یزد","میبد","مرکزی",39,255,4,2,108,369,3,372
"یزد","میبد","مرکزی",40,188,1,0,30,219,4,223
"یزد","میبد","مرکزی",41,121,0,0,21,142,1,143
"یزد","میبد","مرکزی",42,492,6,0,512,1010,17,1027
"یزد","میبد","مرکزی",43,606,7,1,604,1218,10,1228
"یزد","میبد","مرکزی",44,191,2,0,249,442,11,453
"یزد","میبد","مرکزی",45,248,5,1,341,595,10,605
"یزد","میبد","مرکزی",46,162,5,1,91,259,1,260
"یزد","میبد","مرکزی",47,440,12,2,174,628,3,631
"یزد","میبد","مرکزی",48,374,3,5,70,452,0,452
"یزد","میبد","مرکزی",49,140,1,1,10,152,2,154
"یزد","میبد","مرکزی",50,144,2,1,29,176,0,176
"یزد","میبد","مرکزی",51,82,2,1,22,107,2,109
"یزد","میبد","مرکزی",52,659,15,2,277,953,16,969
"یزد","میبد","مرکزی",53,188,5,1,65,259,6,265
"یزد","میبد","مرکزی",54,399,8,0,259,666,10,676
"یزد","میبد","مرکزی",55,335,3,1,137,476,10,486
"یزد","میبد","مرکزی",56,42,0,1,22,65,2,67
"یزد","میبد","مرکزی",57,102,5,2,123,232,11,243
"یزد","میبد","مرکزی",58,25,2,1,63,91,4,95
"یزد","یزد","مرکزی",1,1100,37,13,1264,2414,32,2446
"یزد","یزد","مرکزی",2,1104,27,4,811,1946,12,1958
"یزد","یزد","مرکزی",3,487,14,11,469,981,19,1000
"یزد","یزد","مرکزی",4,274,17,3,351,645,12,657
"یزد","یزد","مرکزی",5,632,19,6,714,1371,37,1408
"یزد","یزد","مرکزی",6,369,11,12,378,770,7,777
"یزد","یزد","مرکزی",7,597,22,6,757,1382,7,1389
"یزد","یزد","مرکزی",8,445,8,8,528,989,10,999
"یزد","یزد","مرکزی",9,556,13,3,431,1003,13,1016
"یزد","یزد","مرکزی",10,932,23,1,728,1684,16,1700
"یزد","یزد","مرکزی",11,784,17,7,529,1337,16,1353
"یزد","یزد","مرکزی",12,572,12,7,695,1286,13,1299
"یزد","یزد","مرکزی",13,567,18,4,465,1054,3,1057
"یزد","یزد","مرکزی",14,459,12,0,365,836,17,853
"یزد","یزد","مرکزی",15,750,19,3,565,1337,21,1358
"یزد","یزد","مرکزی",16,505,15,4,708,1232,6,1238
"یزد","یزد","مرکزی",17,134,3,1,209,347,6,353
"یزد","یزد","مرکزی",18,174,10,3,220,407,4,411
"یزد","یزد","مرکزی",19,203,5,7,409,624,10,634
"یزد","یزد","مرکزی",20,222,6,2,341,571,8,579
"یزد","یزد","مرکزی",21,258,12,2,204,476,3,479
"یزد","یزد","مرکزی",22,305,14,2,189,510,12,522
"یزد","یزد","مرکزی",23,230,8,0,114,352,2,354
"یزد","یزد","مرکزی",24,685,31,8,780,1504,18,1522
"یزد","یزد","مرکزی",25,195,5,3,199,402,7,409
"یزد","یزد","مرکزی",26,314,6,10,346,676,11,687
"یزد","یزد","مرکزی",27,602,23,5,734,1364,14,1378
"یزد","یزد","مرکزی",28,681,16,3,471,1171,15,1186
"یزد","یزد","مرکزی",29,816,27,3,836,1682,18,1700
"یزد","یزد","مرکزی",30,558,18,0,362,938,8,946
"یزد","یزد","مرکزی",31,1169,24,3,837,2033,17,2050
"یزد","یزد","مرکزی",32,518,25,3,748,1294,5,1299
"یزد","یزد","مرکزی",33,708,24,6,739,1477,23,1500
"یزد","یزد","مرکزی",34,268,6,1,319,594,12,606
"یزد","یزد","مرکزی",35,781,29,7,806,1623,20,1643
"یزد","یزد","مرکزی",36,395,13,2,615,1025,9,1034
"یزد","یزد","مرکزی",37,233,3,7,400,643,10,653
"یزد","یزد","مرکزی",38,408,18,6,540,972,24,996
"یزد","یزد","مرکزی",39,551,13,0,702,1266,16,1282
"یزد","یزد","مرکزی",40,386,11,2,697,1096,12,1108
"یزد","یزد","مرکزی",41,595,13,10,625,1243,12,1255
"یزد","یزد","مرکزی",42,352,12,6,314,684,2,686
"یزد","یزد","مرکزی",43,554,26,1,554,1135,14,1149
"یزد","یزد","مرکزی",44,228,7,10,333,578,4,582
"یزد","یزد","مرکزی",45,404,35,15,991,1445,19,1464
"یزد","یزد","مرکزی",46,422,25,20,864,1331,17,1348
"یزد","یزد","مرکزی",47,546,26,16,888,1476,20,1496
"یزد","یزد","مرکزی",48,235,25,1,470,731,4,735
"یزد","یزد","مرکزی",49,495,47,11,1365,1918,26,1944
"یزد","یزد","مرکزی",50,526,30,13,976,1545,11,1556
"یزد","یزد","مرکزی",51,502,21,12,840,1375,13,1388
"یزد","یزد","مرکزی",52,909,51,10,1231,2201,21,2222
"یزد","یزد","مرکزی",53,314,26,8,961,1309,16,1325
"یزد","یزد","مرکزی",54,503,48,19,1437,2007,27,2034
"یزد","یزد","مرکزی",55,157,25,2,481,665,2,667
"یزد","یزد","مرکزی",56,314,17,6,594,931,9,940
"یزد","یزد","مرکزی",57,520,28,10,822,1380,16,1396
"یزد","یزد","مرکزی",58,595,17,6,726,1344,13,1357
"یزد","یزد","مرکزی",59,327,20,3,706,1056,11,1067
"یزد","یزد","مرکزی",60,291,24,11,591,917,13,930
"یزد","یزد","مرکزی",61,380,22,9,517,928,10,938
"یزد","یزد","مرکزی",62,656,29,11,896,1592,13,1605
"یزد","یزد","مرکزی",63,249,10,0,348,607,11,618
"یزد","یزد","مرکزی",64,294,12,2,480,788,12,800
"یزد","یزد","مرکزی",65,489,23,6,755,1273,15,1288
"یزد","یزد","مرکزی",66,475,36,10,926,1447,11,1458
"یزد","یزد","مرکزی",67,438,21,8,711,1178,21,1199
"یزد","یزد","مرکزی",68,387,21,7,765,1180,19,1199
"یزد","یزد","مرکزی",69,380,14,10,528,932,13,945
"یزد","یزد","مرکزی",70,617,35,13,1027,1692,18,1710
"یزد","یزد","مرکزی",71,628,24,9,690,1351,9,1360
"یزد","یزد","مرکزی",72,483,14,1,534,1032,14,1046
"یزد","یزد","مرکزی",73,335,14,2,642,993,7,1000
"یزد","یزد","مرکزی",74,759,47,10,995,1811,12,1823
"یزد","یزد","مرکزی",75,870,45,12,779,1706,19,1725
"یزد","یزد","مرکزی",76,388,18,3,525,934,16,950
"یزد","یزد","مرکزی",77,634,24,10,815,1483,20,1503
"یزد","یزد","مرکزی",78,784,23,7,606,1420,0,1420
"یزد","یزد","مرکزی",79,364,25,7,530,926,13,939
"یزد","یزد","مرکزی",80,774,28,6,757,1565,19,1584
"یزد","یزد","مرکزی",81,612,23,10,518,1163,5,1168
"یزد","یزد","مرکزی",82,772,25,8,370,1175,19,1194
"یزد","یزد","مرکزی",83,514,19,5,681,1219,10,1229
"یزد","یزد","مرکزی",84,775,28,9,681,1493,7,1500
"یزد","یزد","مرکزی",85,405,19,14,463,901,7,908
"یزد","یزد","مرکزی",86,642,40,11,882,1575,19,1594
"یزد","یزد","مرکزی",87,811,34,9,818,1672,26,1698
"یزد","یزد","مرکزی",88,658,21,1,735,1415,15,1430
"یزد","یزد","مرکزی",89,764,22,7,784,1577,13,1590
"یزد","یزد","مرکزی",90,964,18,6,594,1582,17,1599
"یزد","یزد","مرکزی",91,224,4,0,127,355,2,357
"یزد","یزد","مرکزی",92,677,13,4,442,1136,18,1154
"یزد","یزد","مرکزی",93,1426,31,5,921,2383,16,2399
"یزد","یزد","مرکزی",94,984,15,3,437,1439,8,1447
"یزد","یزد","مرکزی",95,686,30,6,466,1188,12,1200
"یزد","یزد","مرکزی",96,1136,22,8,811,1977,20,1997
"یزد","یزد","مرکزی",97,793,16,13,558,1380,12,1392
"یزد","یزد","مرکزی",98,597,18,10,527,1152,4,1156
"یزد","یزد","مرکزی",99,524,13,1,375,913,8,921
"یزد","یزد","مرکزی",100,416,6,4,413,839,11,850
"یزد","یزد","مرکزی",101,688,19,8,755,1470,7,1477
"یزد","یزد","مرکزی",102,597,19,9,523,1148,9,1157
"یزد","یزد","مرکزی",103,700,34,11,870,1615,15,1630
"یزد","یزد","مرکزی",104,660,20,4,512,1196,17,1213
"یزد","یزد","مرکزی",105,735,24,13,742,1514,18,1532
"یزد","یزد","مرکزی",106,745,22,5,566,1338,20,1358
"یزد","یزد","مرکزی",107,675,20,2,639,1336,21,1357
"یزد","یزد","مرکزی",108,1265,44,13,600,1922,14,1936
"یزد","یزد","مرکزی",109,709,23,4,405,1141,17,1158
"یزد","یزد","مرکزی",110,769,18,1,696,1484,15,1499
"یزد","یزد","مرکزی",111,373,11,3,271,658,5,663
"یزد","یزد","مرکزی",112,309,18,7,303,637,8,645
"یزد","یزد","مرکزی",113,311,11,1,471,794,13,807
"یزد","یزد","مرکزی",114,430,26,5,367,828,4,832
"یزد","یزد","مرکزی",115,658,42,20,717,1437,34,1471
"یزد","یزد","مرکزی",116,680,28,6,577,1291,9,1300
"یزد","یزد","مرکزی",117,334,9,3,333,679,12,691
"یزد","یزد","مرکزی",118,592,15,8,560,1175,15,1190
"یزد","یزد","مرکزی",119,600,25,7,735,1367,17,1384
"یزد","یزد","مرکزی",120,751,15,3,547,1316,12,1328
"یزد","یزد","مرکزی",121,795,18,9,650,1472,17,1489
"یزد","یزد","مرکزی",122,249,8,16,744,1017,21,1038
"یزد","یزد","مرکزی",123,312,17,5,649,983,17,1000
"یزد","یزد","مرکزی",124,353,19,10,713,1095,7,1102
"یزد","یزد","مرکزی",125,630,33,10,1033,1706,14,1720
"یزد","یزد","مرکزی",126,220,6,6,226,458,8,466
"یزد","یزد","مرکزی",127,152,2,1,224,379,3,382
"یزد","یزد","مرکزی",128,344,13,8,554,919,11,930
"یزد","یزد","مرکزی",129,173,12,5,245,435,13,448
"یزد","یزد","مرکزی",130,470,34,17,1150,1671,14,1685
"یزد","یزد","مرکزی",131,520,30,7,811,1368,12,1380
"یزد","یزد","مرکزی",132,235,11,6,264,516,4,520
"یزد","یزد","مرکزی",133,367,19,8,447,841,10,851
"یزد","یزد","مرکزی",134,709,21,8,766,1504,21,1525
"یزد","یزد","مرکزی",135,874,21,4,578,1477,10,1487
"یزد","یزد","مرکزی",136,343,14,4,312,673,8,681
"یزد","یزد","مرکزی",137,478,10,6,270,764,4,768
"یزد","یزد","مرکزی",138,640,21,9,736,1406,24,1430
"یزد","یزد","مرکزی",139,456,13,3,444,916,14,930
"یزد","یزد","مرکزی",140,530,19,8,509,1066,15,1081
"یزد","یزد","مرکزی",141,733,21,6,595,1355,22,1377
"یزد","یزد","مرکزی",142,551,11,2,579,1143,8,1151
"یزد","یزد","مرکزی",143,914,17,10,654,1595,27,1622
"یزد","یزد","مرکزی",144,955,14,5,651,1625,25,1650
"یزد","یزد","مرکزی",145,928,8,1,640,1577,17,1594
"یزد","یزد","مرکزی",146,537,10,5,226,778,10,788
"یزد","یزد","مرکزی",147,535,24,2,401,962,12,974
"یزد","یزد","مرکزی",148,708,8,9,235,960,7,967
"یزد","یزد","مرکزی",149,764,14,1,444,1223,18,1241
"یزد","یزد","مرکزی",150,694,9,2,272,977,10,987
"یزد","یزد","مرکزی",151,1272,19,5,489,1785,12,1797
"یزد","یزد","مرکزی",152,525,3,2,151,681,3,684
"یزد","یزد","مرکزی",153,1428,17,4,578,2027,22,2049
"یزد","یزد","مرکزی",154,1350,15,5,268,1638,12,1650
"یزد","یزد","مرکزی",155,1039,21,4,440,1504,10,1514
"یزد","یزد","مرکزی",156,702,30,10,867,1609,21,1630
"یزد","یزد","مرکزی",157,543,33,5,1015,1596,18,1614
"یزد","یزد","مرکزی",158,366,32,15,634,1047,10,1057
"یزد","یزد","مرکزی",159,172,18,16,1120,1326,7,1333
"یزد","یزد","مرکزی",160,256,34,6,1046,1342,9,1351
"یزد","یزد","مرکزی",161,494,55,10,983,1542,29,1571
"یزد","یزد","مرکزی",162,116,24,8,427,575,4,579
"یزد","یزد","مرکزی",163,252,28,11,757,1048,4,1052
"یزد","یزد","مرکزی",164,236,16,5,309,566,7,573
"یزد","یزد","مرکزی",165,241,27,2,666,936,4,940
"یزد","یزد","مرکزی",166,346,38,7,1155,1546,34,1580
"یزد","یزد","مرکزی",167,400,36,9,886,1331,16,1347
"یزد","یزد","مرکزی",168,435,36,9,722,1202,12,1214
"یزد","یزد","مرکزی",169,349,25,8,641,1023,17,1040
"یزد","یزد","مرکزی",170,443,36,10,850,1339,25,1364
"یزد","یزد","مرکزی",171,395,15,2,320,732,14,746
"یزد","یزد","مرکزی",172,418,20,5,766,1209,16,1225
"یزد","یزد","مرکزی",173,773,12,5,455,1245,7,1252
"یزد","یزد","مرکزی",174,471,15,2,563,1051,14,1065
"یزد","یزد","مرکزی",175,315,21,10,644,990,19,1009
"یزد","یزد","مرکزی",176,389,31,23,1686,2129,15,2144
"یزد","یزد","مرکزی",177,958,64,24,1471,2517,28,2545
"یزد","یزد","مرکزی",178,277,26,11,678,992,8,1000
"یزد","یزد","مرکزی",179,260,27,2,628,917,4,921
"یزد","یزد","مرکزی",180,872,38,13,1184,2107,18,2125
"یزد","یزد","مرکزی",181,538,60,29,1759,2386,21,2407
"یزد","یزد","مرکزی",182,334,46,26,1376,1782,18,1800
"یزد","یزد","مرکزی",183,828,65,30,1010,1933,18,1951
"یزد","یزد","مرکزی",184,135,16,2,327,480,4,484
"یزد","یزد","مرکزی",185,502,30,33,1483,2048,16,2064
"یزد","یزد","مرکزی",186,429,27,12,687,1155,13,1168
"یزد","یزد","مرکزی",187,314,32,9,1085,1440,16,1456
"یزد","یزد","مرکزی",188,241,33,8,894,1176,9,1185
"یزد","یزد","مرکزی",189,520,59,28,1393,2000,22,2022
"یزد","یزد","مرکزی",190,406,32,18,976,1432,21,1453
"یزد","یزد","مرکزی",191,671,102,102,1379,2254,36,2290
"یزد","یزد","مرکزی",192,543,38,4,411,996,28,1024
"یزد","یزد","مرکزی",193,548,42,28,1010,1628,38,1666
"یزد","یزد","مرکزی",194,771,45,11,771,1598,22,1620
"یزد","یزد","مرکزی",195,1022,39,13,1437,2511,22,2533
"یزد","یزد","مرکزی",196,717,14,0,552,1283,11,1294
"یزد","یزد","مرکزی",197,275,15,6,316,612,14,626
"یزد","یزد","مرکزی",198,775,43,20,625,1463,24,1487
"یزد","یزد","مرکزی",199,176,13,1,201,391,4,395
"یزد","یزد","مرکزی",200,123,9,0,61,193,2,195
"یزد","یزد","مرکزی",201,563,17,9,334,923,12,935
"یزد","یزد","مرکزی",202,139,3,0,106,248,2,250
"یزد","یزد","مرکزی",203,85,1,0,78,164,1,165
"یزد","یزد","مرکزی",204,275,7,3,200,485,5,490
"یزد","یزد","مرکزی",205,123,2,0,63,188,5,193
"یزد","یزد","مرکزی",206,106,5,0,65,176,4,180
"یزد","یزد","مرکزی",207,229,4,2,197,432,4,436
"یزد","یزد","مرکزی",208,703,29,4,674,1410,24,1434
"یزد","یزد","مرکزی",209,392,16,4,495,907,17,924
"یزد","یزد","مرکزی",210,460,15,1,402,878,9,887
"یزد","یزد","مرکزی",211,280,7,1,309,597,9,606
"یزد","یزد","مرکزی",212,319,8,24,550,901,8,909
"یزد","یزد","مرکزی",213,484,14,7,391,896,8,904
"یزد","یزد","مرکزی",214,364,4,17,375,760,8,768
"یزد","یزد","مرکزی",215,406,10,4,572,992,8,1000
"یزد","یزد","مرکزی",216,316,7,1,219,543,6,549
"یزد","یزد","مرکزی",217,811,32,2,543,1388,12,1400
"یزد","یزد","مرکزی",218,885,13,3,378,1279,5,1284
"یزد","یزد","مرکزی",219,685,7,0,302,994,5,999
"یزد","یزد","مرکزی",220,1242,15,2,629,1888,11,1899
"یزد","یزد","مرکزی",221,943,6,8,562,1519,6,1525
"یزد","یزد","مرکزی",222,878,32,5,750,1665,10,1675
"یزد","یزد","مرکزی",223,399,9,4,264,676,4,680
"یزد","یزد","مرکزی",224,861,22,14,603,1500,12,1512
"یزد","یزد","مرکزی",225,498,11,1,165,675,5,680
"یزد","یزد","مرکزی",226,769,15,5,518,1307,18,1325
"یزد","یزد","مرکزی",227,630,12,1,619,1262,14,1276
"یزد","یزد","مرکزی",228,460,14,0,374,848,5,853
"یزد","یزد","مرکزی",229,461,5,3,326,795,5,800
"یزد","یزد","مرکزی",230,664,13,0,177,854,5,859
"یزد","یزد","مرکزی",231,706,9,1,316,1032,10,1042
"یزد","یزد","مرکزی",232,362,0,0,389,751,5,756
"یزد","یزد","مرکزی",233,1131,9,7,348,1495,4,1499
"یزد","یزد","مرکزی",234,682,12,0,441,1135,8,1143
"یزد","یزد","مرکزی",235,342,4,0,174,520,3,523
"یزد","یزد","مرکزی",236,261,8,3,213,485,7,492
"یزد","یزد","مرکزی",237,219,12,0,198,429,4,433
"یزد","یزد","مرکزی",238,364,28,0,228,620,18,638
"یزد","یزد","زارچ",1,297,5,0,353,655,2,657
"یزد","یزد","زارچ",2,227,7,3,352,589,4,593
"یزد","یزد","زارچ",3,293,6,2,383,684,4,688
"یزد","یزد","زارچ",4,250,7,2,257,516,4,520
"یزد","یزد","زارچ",5,210,3,1,193,407,1,408
"یزد","یزد","زارچ",6,481,11,0,338,830,8,838
"یزد","یزد","زارچ",7,405,10,5,252,672,6,678
"یزد","یزد","زارچ",8,338,3,2,263,606,6,612
"یزد","یزد","زارچ",9,366,6,0,249,621,8,629
"یزد","یزد","زارچ",10,244,3,2,195,444,3,447
"یزد","یزد","زارچ",11,418,13,2,265,698,4,702
"یزد","یزد","زارچ",12,429,5,0,247,681,9,690
"یزد","یزد","زارچ",13,342,6,0,310,658,7,665
"یزد","یزد","زارچ",14,274,2,1,189,466,4,470
"یزد","یزد","زارچ",15,231,4,0,204,439,2,441
"یزد","یزد","زارچ",16,182,0,1,275,458,5,463
"یزد","یزد","زارچ",17,117,5,0,82,204,2,206
"چهارمحال_و_بختیاری","اردل","مرکزی",1,280,32,3,95,410,5,415
"چهارمحال_و_بختیاری","اردل","مرکزی",2,567,63,5,213,848,4,852
"چهارمحال_و_بختیاری","اردل","مرکزی",3,602,84,17,282,985,8,993
"چهارمحال_و_بختیاری","اردل","مرکزی",4,145,19,8,87,259,2,261
"چهارمحال_و_بختیاری","اردل","مرکزی",5,489,23,1,101,614,11,625
"چهارمحال_و_بختیاری","اردل","مرکزی",6,556,47,8,186,797,3,800
"چهارمحال_و_بختیاری","اردل","مرکزی",7,113,15,2,92,222,0,222
"چهارمحال_و_بختیاری","اردل","مرکزی",8,989,9,0,26,1024,6,1030
"چهارمحال_و_بختیاری","اردل","مرکزی",9,792,24,2,79,897,2,899
"چهارمحال_و_بختیاری","اردل","مرکزی",10,869,5,1,25,900,0,900
"چهارمحال_و_بختیاری","اردل","مرکزی",11,288,2,0,6,296,1,297
"چهارمحال_و_بختیاری","اردل","مرکزی",12,796,18,1,80,895,3,898
"چهارمحال_و_بختیاری","اردل","مرکزی",13,319,12,1,31,363,0,363
"چهارمحال_و_بختیاری","اردل","مرکزی",14,271,34,2,56,363,1,364
"چهارمحال_و_بختیاری","اردل","مرکزی",15,283,6,1,22,312,2,314
"چهارمحال_و_بختیاری","اردل","مرکزی",16,227,33,0,39,299,1,300
"چهارمحال_و_بختیاری","اردل","مرکزی",17,591,91,0,53,735,2,737
"چهارمحال_و_بختیاری","اردل","مرکزی",18,537,84,0,123,744,6,750
"چهارمحال_و_بختیاری","اردل","مرکزی",19,331,35,6,28,400,0,400
"چهارمحال_و_بختیاری","اردل","مرکزی",20,570,38,0,157,765,0,765
"چهارمحال_و_بختیاری","اردل","مرکزی",21,347,23,0,125,495,3,498
"چهارمحال_و_بختیاری","اردل","مرکزی",22,409,31,1,271,712,5,717
"چهارمحال_و_بختیاری","اردل","مرکزی",23,312,8,5,17,342,11,353
"چهارمحال_و_بختیاری","اردل","مرکزی",24,291,19,0,187,497,2,499
"چهارمحال_و_بختیاری","اردل","مرکزی",25,299,9,1,251,560,3,563
"چهارمحال_و_بختیاری","اردل","مرکزی",26,210,3,0,67,280,0,280
"چهارمحال_و_بختیاری","اردل","مرکزی",27,448,7,0,70,525,1,526
"چهارمحال_و_بختیاری","اردل","مرکزی",28,312,0,0,76,388,2,390
"چهارمحال_و_بختیاری","اردل","مرکزی",29,229,5,0,155,389,0,389
"چهارمحال_و_بختیاری","اردل","مرکزی",30,382,3,0,26,411,0,411
"چهارمحال_و_بختیاری","اردل","مرکزی",31,314,9,1,129,453,0,453
"چهارمحال_و_بختیاری","اردل","مرکزی",32,284,14,0,61,359,0,359
"چهارمحال_و_بختیاری","اردل","مرکزی",33,460,10,3,66,539,3,542
"چهارمحال_و_بختیاری","اردل","مرکزی",34,429,5,9,57,500,0,500
"چهارمحال_و_بختیاری","اردل","مرکزی",35,401,3,4,37,445,0,445
"چهارمحال_و_بختیاری","اردل","مرکزی",36,334,15,18,104,471,2,473
"چهارمحال_و_بختیاری","اردل","مرکزی",37,270,12,3,45,330,0,330
"چهارمحال_و_بختیاری","اردل","مرکزی",38,382,14,0,4,400,0,400
"چهارمحال_و_بختیاری","اردل","مرکزی",39,607,3,0,14,624,0,624
"چهارمحال_و_بختیاری","اردل","مرکزی",40,343,16,0,5,364,0,364
"چهارمحال_و_بختیاری","اردل","مرکزی",41,475,19,1,21,516,0,516
"چهارمحال_و_بختیاری","اردل","مرکزی",42,330,41,1,46,418,4,422
"چهارمحال_و_بختیاری","اردل","مرکزی",43,260,14,3,17,294,1,295
"چهارمحال_و_بختیاری","اردل","مرکزی",44,156,3,1,4,164,0,164
"چهارمحال_و_بختیاری","اردل","مرکزی",45,391,9,0,0,400,0,400
"چهارمحال_و_بختیاری","اردل","میانکوه",1,847,35,4,114,1000,0,1000
"چهارمحال_و_بختیاری","اردل","میانکوه",2,437,22,0,143,602,0,602
"چهارمحال_و_بختیاری","اردل","میانکوه",3,547,79,0,101,727,5,732
"چهارمحال_و_بختیاری","اردل","میانکوه",4,463,2,0,139,604,3,607
"چهارمحال_و_بختیاری","اردل","میانکوه",5,447,10,0,34,491,1,492
"چهارمحال_و_بختیاری","اردل","میانکوه",6,307,17,0,56,380,3,383
"چهارمحال_و_بختیاری","اردل","میانکوه",7,403,26,0,131,560,5,565
"چهارمحال_و_بختیاری","اردل","میانکوه",8,388,17,0,59,464,1,465
"چهارمحال_و_بختیاری","اردل","میانکوه",9,461,5,0,13,479,0,479
"چهارمحال_و_بختیاری","اردل","میانکوه",10,501,26,0,173,700,0,700
"چهارمحال_و_بختیاری","اردل","میانکوه",11,273,42,2,128,445,0,445
"چهارمحال_و_بختیاری","اردل","میانکوه",12,305,17,1,70,393,0,393
"چهارمحال_و_بختیاری","اردل","میانکوه",13,292,23,0,53,368,0,368
"چهارمحال_و_بختیاری","اردل","میانکوه",14,554,60,2,112,728,0,728
"چهارمحال_و_بختیاری","اردل","میانکوه",15,674,11,0,9,694,0,694
"چهارمحال_و_بختیاری","اردل","میانکوه",16,504,24,4,25,557,1,558
"چهارمحال_و_بختیاری","اردل","میانکوه",17,151,3,0,12,166,0,166
"چهارمحال_و_بختیاری","اردل","میانکوه",18,223,7,0,75,305,6,311
"چهارمحال_و_بختیاری","اردل","میانکوه",19,123,51,0,93,267,0,267
"چهارمحال_و_بختیاری","بروجن","مرکزی",1,949,45,9,520,1523,13,1536
"چهارمحال_و_بختیاری","بروجن","مرکزی",2,170,1,2,113,286,1,287
"چهارمحال_و_بختیاری","بروجن","مرکزی",3,466,39,5,556,1066,9,1075
"چهارمحال_و_بختیاری","بروجن","مرکزی",4,685,31,9,561,1286,9,1295
"چهارمحال_و_بختیاری","بروجن","مرکزی",5,759,19,6,320,1104,12,1116
"چهارمحال_و_بختیاری","بروجن","مرکزی",6,835,23,2,190,1050,5,1055
"چهارمحال_و_بختیاری","بروجن","مرکزی",7,531,3,2,111,647,5,652
"چهارمحال_و_بختیاری","بروجن","مرکزی",8,851,32,7,520,1410,16,1426
"چهارمحال_و_بختیاری","بروجن","مرکزی",9,756,36,12,625,1429,14,1443
"چهارمحال_و_بختیاری","بروجن","مرکزی",10,432,14,8,422,876,4,880
"چهارمحال_و_بختیاری","بروجن","مرکزی",11,1101,33,6,431,1571,11,1582
"چهارمحال_و_بختیاری","بروجن","مرکزی",12,671,33,11,641,1356,16,1372
"چهارمحال_و_بختیاری","بروجن","مرکزی",13,597,43,5,500,1145,19,1164
"چهارمحال_و_بختیاری","بروجن","مرکزی",14,438,26,6,370,840,11,851
"چهارمحال_و_بختیاری","بروجن","مرکزی",15,613,26,11,537,1187,14,1201
"چهارمحال_و_بختیاری","بروجن","مرکزی",16,484,30,5,479,998,10,1008
"چهارمحال_و_بختیاری","بروجن","مرکزی",17,200,6,6,402,614,2,616
"چهارمحال_و_بختیاری","بروجن","مرکزی",18,694,20,6,423,1143,7,1150
"چهارمحال_و_بختیاری","بروجن","مرکزی",19,358,6,8,201,573,8,581
"چهارمحال_و_بختیاری","بروجن","مرکزی",20,1082,29,7,365,1483,8,1491
"چهارمحال_و_بختیاری","بروجن","مرکزی",21,834,25,2,164,1025,5,1030
"چهارمحال_و_بختیاری","بروجن","مرکزی",22,1475,45,10,460,1990,6,1996
"چهارمحال_و_بختیاری","بروجن","مرکزی",23,317,13,2,322,654,3,657
"چهارمحال_و_بختیاری","بروجن","مرکزی",24,521,34,17,499,1071,8,1079
"چهارمحال_و_بختیاری","بروجن","مرکزی",25,727,26,21,814,1588,30,1618
"چهارمحال_و_بختیاری","بروجن","مرکزی",26,581,16,3,172,772,11,783
"چهارمحال_و_بختیاری","بروجن","مرکزی",27,204,5,1,104,314,7,321
"چهارمحال_و_بختیاری","بروجن","مرکزی",28,598,16,2,135,751,7,758
"چهارمحال_و_بختیاری","بروجن","مرکزی",29,811,9,1,151,972,13,985
"چهارمحال_و_بختیاری","بروجن","مرکزی",30,795,9,6,129,939,12,951
"چهارمحال_و_بختیاری","بروجن","مرکزی",31,859,9,7,186,1061,10,1071
"چهارمحال_و_بختیاری","بروجن","مرکزی",32,945,15,3,212,1175,6,1181
"چهارمحال_و_بختیاری","بروجن","مرکزی",33,856,23,9,238,1126,13,1139
"چهارمحال_و_بختیاری","بروجن","مرکزی",34,490,6,1,58,555,1,556
"چهارمحال_و_بختیاری","بروجن","مرکزی",35,575,6,3,115,699,1,700
"چهارمحال_و_بختیاری","بروجن","مرکزی",36,859,12,0,130,1001,5,1006
"چهارمحال_و_بختیاری","بروجن","مرکزی",37,578,3,2,88,671,3,674
"چهارمحال_و_بختیاری","بروجن","مرکزی",38,310,4,2,120,436,1,437
"چهارمحال_و_بختیاری","بروجن","مرکزی",39,252,6,0,73,331,2,333
"چهارمحال_و_بختیاری","بروجن","مرکزی",40,1137,11,3,116,1267,5,1272
"چهارمحال_و_بختیاری","بروجن","مرکزی",41,450,5,0,78,533,2,535
"چهارمحال_و_بختیاری","بروجن","مرکزی",42,1188,6,0,127,1321,3,1324
"چهارمحال_و_بختیاری","بروجن","مرکزی",43,1092,16,0,156,1264,3,1267
"چهارمحال_و_بختیاری","بروجن","مرکزی",44,544,1,0,44,589,3,592
"چهارمحال_و_بختیاری","بروجن","مرکزی",45,314,6,0,37,357,2,359
"چهارمحال_و_بختیاری","بروجن","مرکزی",46,399,4,1,16,420,2,422
"چهارمحال_و_بختیاری","بروجن","مرکزی",47,463,2,0,28,493,3,496
"چهارمحال_و_بختیاری","بروجن","مرکزی",48,438,2,2,142,584,0,584
"چهارمحال_و_بختیاری","بروجن","گندمان",1,385,2,1,86,474,5,479
"چهارمحال_و_بختیاری","بروجن","گندمان",2,766,17,3,231,1017,15,1032
"چهارمحال_و_بختیاری","بروجن","گندمان",3,686,19,3,186,894,13,907
"چهارمحال_و_بختیاری","بروجن","گندمان",4,444,9,1,96,550,3,553
"چهارمحال_و_بختیاری","بروجن","گندمان",5,412,15,7,102,536,4,540
"چهارمحال_و_بختیاری","بروجن","گندمان",6,409,4,0,33,446,2,448
"چهارمحال_و_بختیاری","بروجن","گندمان",7,390,4,0,56,450,1,451
"چهارمحال_و_بختیاری","بروجن","گندمان",8,563,4,0,33,600,7,607
"چهارمحال_و_بختیاری","بروجن","گندمان",9,454,4,3,66,527,0,527
"چهارمحال_و_بختیاری","بروجن","گندمان",10,385,5,1,40,431,0,431
"چهارمحال_و_بختیاری","بروجن","گندمان",11,305,2,1,41,349,0,349
"چهارمحال_و_بختیاری","بروجن","گندمان",12,516,13,3,29,561,2,563
"چهارمحال_و_بختیاری","بروجن","گندمان",13,187,22,0,56,265,2,267
"چهارمحال_و_بختیاری","بروجن","گندمان",14,349,3,1,66,419,5,424
"چهارمحال_و_بختیاری","بروجن","گندمان",15,628,30,0,202,860,10,870
"چهارمحال_و_بختیاری","بروجن","گندمان",16,440,20,4,123,587,4,591
"چهارمحال_و_بختیاری","بروجن","گندمان",17,421,26,1,52,500,1,501
"چهارمحال_و_بختیاری","بروجن","گندمان",18,182,11,3,23,219,2,221
"چهارمحال_و_بختیاری","بروجن","گندمان",19,532,34,0,116,682,2,684
"چهارمحال_و_بختیاری","بروجن","بلداچی",1,447,15,2,260,724,11,735
"چهارمحال_و_بختیاری","بروجن","بلداچی",2,394,18,4,222,638,7,645
"چهارمحال_و_بختیاری","بروجن","بلداچی",3,479,7,0,293,779,3,782
"چهارمحال_و_بختیاری","بروجن","بلداچی",4,523,9,0,193,725,8,733
"چهارمحال_و_بختیاری","بروجن","بلداچی",5,768,12,1,339,1120,9,1129
"چهارمحال_و_بختیاری","بروجن","بلداچی",6,559,8,0,220,787,11,798
"چهارمحال_و_بختیاری","بروجن","بلداچی",7,349,11,5,177,542,15,557
"چهارمحال_و_بختیاری","بروجن","بلداچی",8,317,3,0,152,472,1,473
"چهارمحال_و_بختیاری","بروجن","بلداچی",9,397,0,0,26,423,1,424
"چهارمحال_و_بختیاری","بروجن","بلداچی",10,844,12,1,104,961,7,968
"چهارمحال_و_بختیاری","بروجن","بلداچی",11,631,11,1,84,727,3,730
"چهارمحال_و_بختیاری","بروجن","بلداچی",12,696,17,0,58,771,5,776
"چهارمحال_و_بختیاری","بروجن","بلداچی",13,703,67,0,53,823,2,825
"چهارمحال_و_بختیاری","بروجن","بلداچی",14,246,16,0,31,293,2,295
"چهارمحال_و_بختیاری","بروجن","بلداچی",15,386,16,1,72,475,3,478
"چهارمحال_و_بختیاری","بروجن","بلداچی",16,192,100,0,97,389,1,390
"چهارمحال_و_بختیاری","بروجن","بلداچی",17,418,145,0,113,676,8,684
"چهارمحال_و_بختیاری","بروجن","بلداچی",18,137,65,0,24,226,0,226
"چهارمحال_و_بختیاری","شهرکرد","مرکزی",1,582,75,30,501,1188,12,1200
"چهارمحال_و_بختیاری","شهرکرد","مرکزی",2,1318,154,31,728,2231,18,2249
"چهارمحال_و_بختیاری","شهرکرد","مرکزی",3,1019,98,61,617,1795,12,1807
"چهارمحال_و_بختیاری","شهرکرد","مرکزی",4,861,75,53,466,1455,14,1469
"چهارمحال_و_بختیاری","شهرکرد","مرکزی",5,815,80,55,572,1522,20,1542
"چهارمحال_و_بختیاری","شهرکرد","مرکزی",6,820,83,81,596,1580,20,1600
"چهارمحال_و_بختیاری","شهرکرد","مرکزی",7,385,32,102,305,824,11,835
"چهارمحال_و_بختیاری","شهرکرد","مرکزی",8,541,67,48,488,1144,13,1157
"چهارمحال_و_بختیاری","شهرکرد","مرکزی",9,1477,55,53,420,2005,22,2027
"چهارمحال_و_بختیاری","شهرکرد","مرکزی",10,834,76,45,458,1413,16,1429
"چهارمحال_و_بختیاری","شهرکرد","مرکزی",11,712,72,80,686,1550,26,1576
"چهارمحال_و_بختیاری","شهرکرد","مرکزی",12,447,85,55,639,1226,11,1237
"چهارمحال_و_بختیاری","شهرکرد","مرکزی",13,1141,112,49,708,2010,25,2035
"چهارمحال_و_بختیاری","شهرکرد","مرکزی",14,502,65,21,542,1130,6,1136
"چهارمحال_و_بختیاری","شهرکرد","مرکزی",15,295,39,29,369,732,9,741
"چهارمحال_و_بختیاری","شهرکرد","مرکزی",16,973,100,61,831,1965,10,1975
"چهارمحال_و_بختیاری","شهرکرد","مرکزی",17,725,83,21,438,1267,10,1277
"چهارمحال_و_بختیاری","شهرکرد","مرکزی",18,946,126,49,608,1729,11,1740
"چهارمحال_و_بختیاری","شهرکرد","مرکزی",19,1128,46,40,443,1657,12,1669
"چهارمحال_و_بختیاری","شهرکرد","مرکزی",20,541,32,18,394,985,15,1000
"چهارمحال_و_بختیاری","شهرکرد","مرکزی",21,469,36,22,520,1047,13,1060
"چهارمحال_و_بختیاری","شهرکرد","مرکزی",22,479,51,29,482,1041,25,1066
"چهارمحال_و_بختیاری","شهرکرد","مرکزی",23,526,91,48,1019,1684,13,1697
"چهارمحال_و_بختیاری","شهرکرد","مرکزی",24,1077,122,34,451,1684,16,1700
"چهارمحال_و_بختیاری","شهرکرد","مرکزی",25,778,82,15,358,1233,14,1247
"چهارمحال_و_بختیاری","شهرکرد","مرکزی",26,431,25,41,365,862,8,870
"چهارمحال_و_بختیاری","شهرکرد","مرکزی",27,440,44,28,659,1171,11,1182
"چهارمحال_و_بختیاری","شهرکرد","مرکزی",28,858,57,37,320,1272,20,1292
"چهارمحال_و_بختیاری","شهرکرد","مرکزی",29,875,48,36,428,1387,17,1404
"چهارمحال_و_بختیاری","شهرکرد","مرکزی",30,881,59,36,361,1337,13,1350
"چهارمحال_و_بختیاری","شهرکرد","مرکزی",31,658,54,27,503,1242,10,1252
"چهارمحال_و_بختیاری","شهرکرد","مرکزی",32,797,82,50,869,1798,15,1813
"چهارمحال_و_بختیاری","شهرکرد","مرکزی",33,997,42,25,321,1385,9,1394
"چهارمحال_و_بختیاری","شهرکرد","مرکزی",34,905,43,35,267,1250,13,1263
"چهارمحال_و_بختیاری","شهرکرد","مرکزی",35,907,44,69,563,1583,16,1599
"چهارمحال_و_بختیاری","شهرکرد","مرکزی",36,922,67,35,663,1687,13,1700
"چهارمحال_و_بختیاری","شهرکرد","مرکزی",37,556,67,20,469,1112,15,1127
"چهارمحال_و_بختیاری","شهرکرد","مرکزی",38,1172,136,33,776,2117,16,2133
"چهارمحال_و_بختیاری","شهرکرد","مرکزی",39,1280,172,32,436,1920,27,1947
"چهارمحال_و_بختیاری","شهرکرد","مرکزی",40,882,164,18,545,1609,16,1625
"چهارمحال_و_بختیاری","شهرکرد","مرکزی",41,1256,60,33,286,1635,19,1654
"چهارمحال_و_بختیاری","شهرکرد","مرکزی",42,1267,63,34,285,1649,21,1670
"چهارمحال_و_بختیاری","شهرکرد","مرکزی",43,655,36,38,453,1182,18,1200
"چهارمحال_و_بختیاری","شهرکرد","مرکزی",44,865,45,33,636,1579,25,1604
"چهارمحال_و_بختیاری","شهرکرد","مرکزی",45,1087,38,37,524,1686,15,1701
"چهارمحال_و_بختیاری","شهرکرد","مرکزی",46,1103,28,23,438,1592,8,1600
"چهارمحال_و_بختیاری","شهرکرد","مرکزی",47,906,43,40,301,1290,9,1299
"چهارمحال_و_بختیاری","شهرکرد","مرکزی",48,1083,85,22,643,1833,26,1859
"چهارمحال_و_بختیاری","شهرکرد","مرکزی",49,504,27,6,83,620,6,626
"چهارمحال_و_بختیاری","شهرکرد","مرکزی",50,562,23,6,155,746,13,759
"چهارمحال_و_بختیاری","شهرکرد","مرکزی",51,338,53,11,254,656,24,680
"چهارمحال_و_بختیاری","شهرکرد","مرکزی",52,1129,18,7,138,1292,7,1299
"چهارمحال_و_بختیاری","شهرکرد","مرکزی",53,1424,39,9,197,1669,4,1673
"چهارمحال_و_بختیاری","شهرکرد","مرکزی",54,1128,23,4,140,1295,10,1305
"چهارمحال_و_بختیاری","شهرکرد","مرکزی",55,1214,21,15,218,1468,7,1475
"چهارمحال_و_بختیاری","شهرکرد","مرکزی",56,1108,29,10,242,1389,6,1395
"چهارمحال_و_بختیاری","شهرکرد","مرکزی",57,1191,34,19,335,1579,19,1598
"چهارمحال_و_بختیاری","شهرکرد","مرکزی",58,737,18,6,222,983,17,1000
"چهارمحال_و_بختیاری","شهرکرد","مرکزی",59,1008,56,8,344,1416,14,1430
"چهارمحال_و_بختیاری","شهرکرد","مرکزی",60,396,24,2,296,718,7,725
"چهارمحال_و_بختیاری","شهرکرد","مرکزی",61,633,13,3,193,842,17,859
"چهارمحال_و_بختیاری","شهرکرد","مرکزی",62,991,54,9,491,1545,14,1559
"چهارمحال_و_بختیاری","شهرکرد","مرکزی",63,809,57,9,489,1364,18,1382
"چهارمحال_و_بختیاری","شهرکرد","مرکزی",64,412,15,4,237,668,12,680
"چهارمحال_و_بختیاری","شهرکرد","مرکزی",65,967,22,11,239,1239,10,1249
"چهارمحال_و_بختیاری","شهرکرد","مرکزی",66,566,25,7,218,816,10,826
"چهارمحال_و_بختیاری","شهرکرد","مرکزی",67,857,24,2,306,1189,10,1199
"چهارمحال_و_بختیاری","شهرکرد","مرکزی",68,752,42,14,653,1461,19,1480
"چهارمحال_و_بختیاری","شهرکرد","مرکزی",69,1150,68,9,430,1657,8,1665
"چهارمحال_و_بختیاری","شهرکرد","مرکزی",70,721,25,6,428,1180,19,1199
"چهارمحال_و_بختیاری","شهرکرد","مرکزی",71,254,8,2,126,390,5,395
"چهارمحال_و_بختیاری","شهرکرد","مرکزی",72,466,28,7,302,803,5,808
"چهارمحال_و_بختیاری","شهرکرد","مرکزی",73,142,8,4,49,203,1,204
"چهارمحال_و_بختیاری","شهرکرد","مرکزی",74,753,18,2,245,1018,10,1028
"چهارمحال_و_بختیاری","شهرکرد","مرکزی",75,747,17,27,335,1126,12,1138
"چهارمحال_و_بختیاری","شهرکرد","مرکزی",76,756,33,18,425,1232,14,1246
"چهارمحال_و_بختیاری","شهرکرد","مرکزی",77,1152,28,22,500,1702,14,1716
"چهارمحال_و_بختیاری","شهرکرد","مرکزی",78,712,23,9,345,1089,15,1104
"چهارمحال_و_بختیاری","شهرکرد","مرکزی",79,308,5,5,113,431,2,433
"چهارمحال_و_بختیاری","شهرکرد","مرکزی",80,765,26,16,403,1210,20,1230
"چهارمحال_و_بختیاری","شهرکرد","مرکزی",81,471,13,20,257,761,12,773
"چهارمحال_و_بختیاری","شهرکرد","مرکزی",82,589,17,6,275,887,16,903
"چهارمحال_و_بختیاری","شهرکرد","مرکزی",83,635,15,21,320,991,14,1005
"چهارمحال_و_بختیاری","شهرکرد","مرکزی",84,114,8,2,63,187,1,188
"چهارمحال_و_بختیاری","شهرکرد","مرکزی",85,1297,19,5,131,1452,5,1457
"چهارمحال_و_بختیاری","شهرکرد","مرکزی",86,1251,22,7,112,1392,7,1399
"چهارمحال_و_بختیاری","شهرکرد","مرکزی",87,1037,12,4,104,1157,8,1165
"چهارمحال_و_بختیاری","شهرکرد","مرکزی",88,1454,33,6,183,1676,11,1687
"چهارمحال_و_بختیاری","شهرکرد","مرکزی",89,953,19,5,129,1106,7,1113
"چهارمحال_و_بختیاری","شهرکرد","مرکزی",90,703,1,0,38,742,5,747
"چهارمحال_و_بختیاری","شهرکرد","مرکزی",91,1248,5,6,76,1335,8,1343
"چهارمحال_و_بختیاری","شهرکرد","مرکزی",92,1206,7,5,77,1295,5,1300
"چهارمحال_و_بختیاری","شهرکرد","مرکزی",93,850,28,17,154,1049,2,1051
"چهارمحال_و_بختیاری","شهرکرد","مرکزی",94,487,17,3,120,627,2,629
"چهارمحال_و_بختیاری","شهرکرد","مرکزی",95,432,53,4,129,618,3,621
"چهارمحال_و_بختیاری","شهرکرد","مرکزی",96,1270,18,3,158,1449,4,1453
"چهارمحال_و_بختیاری","شهرکرد","مرکزی",97,209,2,1,50,262,5,267
"چهارمحال_و_بختیاری","شهرکرد","مرکزی",98,346,6,4,45,401,2,403
"چهارمحال_و_بختیاری","شهرکرد","مرکزی",99,681,17,4,48,750,2,752
"چهارمحال_و_بختیاری","شهرکرد","مرکزی",100,460,6,7,57,530,1,531
"چهارمحال_و_بختیاری","شهرکرد","مرکزی",101,759,2,0,51,812,3,815
"چهارمحال_و_بختیاری","شهرکرد","مرکزی",102,547,3,0,24,574,1,575
"چهارمحال_و_بختیاری","شهرکرد","مرکزی",103,795,4,6,53,858,1,859
"چهارمحال_و_بختیاری","شهرکرد","مرکزی",104,730,10,0,51,791,9,800
"چهارمحال_و_بختیاری","شهرکرد","مرکزی",105,688,6,0,47,741,8,749
"چهارمحال_و_بختیاری","شهرکرد","بن",1,688,4,7,53,752,3,755
"چهارمحال_و_بختیاری","شهرکرد","بن",2,1206,17,9,81,1313,4,1317
"چهارمحال_و_بختیاری","شهرکرد","بن",3,1320,4,0,92,1416,5,1421
"چهارمحال_و_بختیاری","شهرکرد","بن",4,833,7,0,56,896,6,902
"چهارمحال_و_بختیاری","شهرکرد","بن",5,635,2,2,18,657,5,662
"چهارمحال_و_بختیاری","شهرکرد","بن",6,699,0,1,35,735,4,739
"چهارمحال_و_بختیاری","شهرکرد","بن",7,1288,11,1,69,1369,9,1378
"چهارمحال_و_بختیاری","شهرکرد","بن",8,450,2,1,41,494,6,500
"چهارمحال_و_بختیاری","شهرکرد","بن",9,895,10,4,89,998,10,1008
"چهارمحال_و_بختیاری","شهرکرد","بن",10,917,7,4,73,1001,8,1009
"چهارمحال_و_بختیاری","شهرکرد","بن",11,593,7,3,41,644,3,647
"چهارمحال_و_بختیاری","شهرکرد","بن",12,416,1,2,27,446,3,449
"چهارمحال_و_بختیاری","شهرکرد","بن",13,649,11,1,29,690,7,697
"چهارمحال_و_بختیاری","شهرکرد","بن",14,1128,4,0,41,1173,2,1175
"چهارمحال_و_بختیاری","شهرکرد","بن",15,913,0,1,24,938,6,944
"چهارمحال_و_بختیاری","شهرکرد","بن",16,1048,5,3,26,1082,2,1084
"چهارمحال_و_بختیاری","شهرکرد","بن",17,372,2,0,10,384,0,384
"چهارمحال_و_بختیاری","شهرکرد","بن",18,755,0,0,21,776,2,778
"چهارمحال_و_بختیاری","شهرکرد","بن",19,263,0,0,22,285,0,285
"چهارمحال_و_بختیاری","شهرکرد","بن",20,899,7,1,116,1023,8,1031
"چهارمحال_و_بختیاری","شهرکرد","بن",21,491,4,1,30,526,0,526
"چهارمحال_و_بختیاری","شهرکرد","بن",22,233,0,0,7,240,0,240
"چهارمحال_و_بختیاری","شهرکرد","بن",23,435,8,4,18,465,1,466
"چهارمحال_و_بختیاری","شهرکرد","بن",24,315,14,8,25,362,0,362
"چهارمحال_و_بختیاری","شهرکرد","بن",25,219,3,1,34,257,2,259
"چهارمحال_و_بختیاری","شهرکرد","سامان",1,444,5,13,133,595,4,599
"چهارمحال_و_بختیاری","شهرکرد","سامان",2,981,12,15,173,1181,12,1193
"چهارمحال_و_بختیاری","شهرکرد","سامان",3,1056,24,13,428,1521,6,1527
"چهارمحال_و_بختیاری","شهرکرد","سامان",4,699,10,7,184,900,7,907
"چهارمحال_و_بختیاری","شهرکرد","سامان",5,866,17,4,150,1037,13,1050
"چهارمحال_و_بختیاری","شهرکرد","سامان",6,965,8,12,458,1443,11,1454
"چهارمحال_و_بختیاری","شهرکرد","سامان",7,627,7,14,292,940,5,945
"چهارمحال_و_بختیاری","شهرکرد","سامان",8,447,7,13,162,629,9,638
"چهارمحال_و_بختیاری","شهرکرد","سامان",9,596,5,10,173,784,7,791
"چهارمحال_و_بختیاری","شهرکرد","سامان",10,149,2,3,57,211,0,211
"چهارمحال_و_بختیاری","شهرکرد","سامان",11,559,5,1,125,690,4,694
"چهارمحال_و_بختیاری","شهرکرد","سامان",12,771,10,2,222,1005,4,1009
"چهارمحال_و_بختیاری","شهرکرد","سامان",13,539,1,2,87,629,3,632
"چهارمحال_و_بختیاری","شهرکرد","سامان",14,429,1,1,36,467,1,468
"چهارمحال_و_بختیاری","شهرکرد","سامان",15,729,5,5,126,865,0,865
"چهارمحال_و_بختیاری","شهرکرد","سامان",16,279,7,5,213,504,5,509
"چهارمحال_و_بختیاری","شهرکرد","سامان",17,450,0,1,56,507,1,508
"چهارمحال_و_بختیاری","شهرکرد","سامان",18,496,4,3,39,542,2,544
"چهارمحال_و_بختیاری","شهرکرد","سامان",19,367,7,2,73,449,1,450
"چهارمحال_و_بختیاری","شهرکرد","سامان",20,182,1,0,16,199,1,200
"چهارمحال_و_بختیاری","شهرکرد","سامان",21,348,3,1,146,498,2,500
"چهارمحال_و_بختیاری","شهرکرد","سامان",22,711,5,4,121,841,4,845
"چهارمحال_و_بختیاری","شهرکرد","سامان",23,649,0,2,136,787,0,787
"چهارمحال_و_بختیاری","شهرکرد","سامان",24,781,1,5,123,910,2,912
"چهارمحال_و_بختیاری","شهرکرد","سامان",25,328,2,0,49,379,1,380
"چهارمحال_و_بختیاری","شهرکرد","سامان",26,545,5,1,66,617,4,621
"چهارمحال_و_بختیاری","شهرکرد","سامان",27,950,11,3,125,1089,6,1095
"چهارمحال_و_بختیاری","شهرکرد","سامان",28,377,8,0,84,469,2,471
"چهارمحال_و_بختیاری","شهرکرد","سامان",29,285,4,1,117,407,7,414
"چهارمحال_و_بختیاری","شهرکرد","سامان",30,143,1,1,56,201,3,204
"چهارمحال_و_بختیاری","شهرکرد","سامان",31,658,5,1,176,840,3,843
"چهارمحال_و_بختیاری","شهرکرد","سامان",32,171,0,0,9,180,0,180
"چهارمحال_و_بختیاری","شهرکرد","سامان",33,112,5,1,18,136,0,136
"چهارمحال_و_بختیاری","شهرکرد","سامان",34,366,5,5,192,568,2,570
"چهارمحال_و_بختیاری","شهرکرد","لاران",1,752,36,11,176,975,2,977
"چهارمحال_و_بختیاری","شهرکرد","لاران",2,384,18,15,113,530,1,531
"چهارمحال_و_بختیاری","شهرکرد","لاران",3,1279,65,16,241,1601,7,1608
"چهارمحال_و_بختیاری","شهرکرد","لاران",4,827,64,9,241,1141,3,1144
"چهارمحال_و_بختیاری","شهرکرد","لاران",5,787,11,3,122,923,6,929
"چهارمحال_و_بختیاری","شهرکرد","لاران",6,433,26,5,228,692,8,700
"چهارمحال_و_بختیاری","شهرکرد","لاران",7,427,8,1,112,548,0,548
"چهارمحال_و_بختیاری","شهرکرد","لاران",8,787,4,4,188,983,4,987
"چهارمحال_و_بختیاری","شهرکرد","لاران",9,783,7,7,83,880,2,882
"چهارمحال_و_بختیاری","شهرکرد","لاران",10,905,10,1,50,966,3,969
"چهارمحال_و_بختیاری","شهرکرد","لاران",11,694,14,3,97,808,4,812
"چهارمحال_و_بختیاری","شهرکرد","لاران",12,1136,6,0,39,1181,7,1188
"چهارمحال_و_بختیاری","شهرکرد","لاران",13,384,2,1,16,403,4,407
"چهارمحال_و_بختیاری","شهرکرد","لاران",14,707,3,0,34,744,1,745
"چهارمحال_و_بختیاری","شهرکرد","لاران",15,570,4,1,33,608,1,609
"چهارمحال_و_بختیاری","شهرکرد","لاران",16,1382,11,0,60,1453,4,1457
"چهارمحال_و_بختیاری","شهرکرد","لاران",17,1392,4,3,60,1459,3,1462
"چهارمحال_و_بختیاری","شهرکرد","لاران",18,330,6,0,35,371,1,372
"چهارمحال_و_بختیاری","شهرکرد","لاران",19,627,2,0,39,668,2,670
"چهارمحال_و_بختیاری","شهرکرد","لاران",20,625,10,5,47,687,4,691
"چهارمحال_و_بختیاری","شهرکرد","لاران",21,480,6,4,43,533,0,533
"چهارمحال_و_بختیاری","شهرکرد","لاران",22,197,2,0,13,212,0,212
"چهارمحال_و_بختیاری","شهرکرد","لاران",23,180,2,2,18,202,3,205
"چهارمحال_و_بختیاری","شهرکرد","لاران",24,147,2,1,16,166,0,166
"چهارمحال_و_بختیاری","فارسان","مرکزی",1,522,97,8,208,835,3,838
"چهارمحال_و_بختیاری","فارسان","مرکزی",2,706,53,4,651,1414,16,1430
"چهارمحال_و_بختیاری","فارسان","مرکزی",3,684,41,5,359,1089,8,1097
"چهارمحال_و_بختیاری","فارسان","مرکزی",4,512,37,4,269,822,9,831
"چهارمحال_و_بختیاری","فارسان","مرکزی",5,550,69,17,426,1062,7,1069
"چهارمحال_و_بختیاری","فارسان","مرکزی",6,696,155,6,358,1215,8,1223
"چهارمحال_و_بختیاری","فارسان","مرکزی",7,701,49,10,504,1264,13,1277
"چهارمحال_و_بختیاری","فارسان","مرکزی",8,695,188,21,369,1273,14,1287
"چهارمحال_و_بختیاری","فارسان","مرکزی",9,664,195,7,287,1153,10,1163
"چهارمحال_و_بختیاری","فارسان","مرکزی",10,706,62,11,598,1377,19,1396
"چهارمحال_و_بختیاری","فارسان","مرکزی",11,460,73,8,321,862,7,869
"چهارمحال_و_بختیاری","فارسان","مرکزی",12,457,73,21,419,970,8,978
"چهارمحال_و_بختیاری","فارسان","مرکزی",13,298,64,6,230,598,4,602
"چهارمحال_و_بختیاری","فارسان","مرکزی",14,557,18,0,101,676,1,677
"چهارمحال_و_بختیاری","فارسان","مرکزی",15,391,8,1,101,501,0,501
"چهارمحال_و_بختیاری","فارسان","مرکزی",16,246,13,0,45,304,1,305
"چهارمحال_و_بختیاری","فارسان","مرکزی",17,597,32,2,169,800,5,805
"چهارمحال_و_بختیاری","فارسان","مرکزی",18,477,34,9,139,659,4,663
"چهارمحال_و_بختیاری","فارسان","مرکزی",19,599,21,0,174,794,1,795
"چهارمحال_و_بختیاری","فارسان","مرکزی",20,666,25,2,207,900,2,902
"چهارمحال_و_بختیاری","فارسان","مرکزی",21,265,12,2,96,375,6,381
"چهارمحال_و_بختیاری","فارسان","مرکزی",22,549,14,5,264,832,3,835
"چهارمحال_و_بختیاری","فارسان","مرکزی",23,501,14,1,186,702,5,707
"چهارمحال_و_بختیاری","فارسان","مرکزی",24,295,12,1,123,431,0,431
"چهارمحال_و_بختیاری","فارسان","مرکزی",25,388,43,1,330,762,4,766
"چهارمحال_و_بختیاری","فارسان","مرکزی",26,711,10,0,170,891,0,891
"چهارمحال_و_بختیاری","فارسان","مرکزی",27,239,22,0,207,468,3,471
"چهارمحال_و_بختیاری","فارسان","مرکزی",28,390,24,8,361,783,8,791
"چهارمحال_و_بختیاری","فارسان","مرکزی",29,462,10,9,319,800,8,808
"چهارمحال_و_بختیاری","فارسان","مرکزی",30,529,28,2,321,880,11,891
"چهارمحال_و_بختیاری","فارسان","مرکزی",31,798,39,2,176,1015,0,1015
"چهارمحال_و_بختیاری","فارسان","مرکزی",32,504,30,4,111,649,4,653
"چهارمحال_و_بختیاری","فارسان","مرکزی",33,656,24,2,116,798,2,800
"چهارمحال_و_بختیاری","فارسان","مرکزی",34,484,3,0,93,580,4,584
"چهارمحال_و_بختیاری","فارسان","مرکزی",35,455,17,1,99,572,0,572
"چهارمحال_و_بختیاری","فارسان","مرکزی",36,752,13,1,111,877,6,883
"چهارمحال_و_بختیاری","فارسان","مرکزی",37,665,15,2,309,991,7,998
"چهارمحال_و_بختیاری","فارسان","مرکزی",38,603,11,2,210,826,5,831
"چهارمحال_و_بختیاری","فارسان","مرکزی",39,367,10,6,276,659,5,664
"چهارمحال_و_بختیاری","فارسان","مرکزی",40,590,16,6,257,869,5,874
"چهارمحال_و_بختیاری","فارسان","مرکزی",41,655,17,9,310,991,8,999
"چهارمحال_و_بختیاری","فارسان","مرکزی",42,658,13,3,130,804,7,811
"چهارمحال_و_بختیاری","فارسان","مرکزی",43,521,24,6,63,614,3,617
"چهارمحال_و_بختیاری","فارسان","مرکزی",44,728,18,3,186,935,7,942
"چهارمحال_و_بختیاری","فارسان","مرکزی",45,178,95,3,47,323,1,324
"چهارمحال_و_بختیاری","فارسان","مرکزی",46,568,9,0,101,678,0,678
"چهارمحال_و_بختیاری","فارسان","مرکزی",47,154,9,0,41,204,0,204
"چهارمحال_و_بختیاری","فارسان","مرکزی",48,511,13,0,89,613,3,616
"چهارمحال_و_بختیاری","فارسان","مرکزی",49,699,25,4,262,990,6,996
"چهارمحال_و_بختیاری","فارسان","مرکزی",50,448,25,2,285,760,0,760
"چهارمحال_و_بختیاری","فارسان","مرکزی",51,479,9,2,76,566,4,570
"چهارمحال_و_بختیاری","فارسان","مرکزی",52,248,3,0,67,318,1,319
"چهارمحال_و_بختیاری","فارسان","مرکزی",53,676,13,2,202,893,5,898
"چهارمحال_و_بختیاری","فارسان","مرکزی",54,812,21,6,113,952,4,956
"چهارمحال_و_بختیاری","فارسان","مرکزی",55,674,29,1,160,864,6,870
"چهارمحال_و_بختیاری","فارسان","مرکزی",56,186,4,0,30,220,0,220
"چهارمحال_و_بختیاری","فارسان","مرکزی",57,500,20,0,30,550,1,551
"چهارمحال_و_بختیاری","فارسان","مرکزی",58,300,53,2,45,400,6,406
"چهارمحال_و_بختیاری","فارسان","مرکزی",59,151,39,0,37,227,2,229
"چهارمحال_و_بختیاری","فارسان","مرکزی",60,254,30,0,39,323,0,323
"چهارمحال_و_بختیاری","کوهرنگ","مرکزی",1,273,434,3,123,833,3,836
"چهارمحال_و_بختیاری","کوهرنگ","مرکزی",2,110,354,0,30,494,6,500
"چهارمحال_و_بختیاری","کوهرنگ","مرکزی",3,141,312,2,56,511,7,518
"چهارمحال_و_بختیاری","کوهرنگ","مرکزی",4,36,284,0,8,328,0,328
"چهارمحال_و_بختیاری","کوهرنگ","مرکزی",5,34,117,0,12,163,0,163
"چهارمحال_و_بختیاری","کوهرنگ","مرکزی",6,102,301,1,26,430,1,431
"چهارمحال_و_بختیاری","کوهرنگ","مرکزی",7,74,232,0,5,311,1,312
"چهارمحال_و_بختیاری","کوهرنگ","مرکزی",8,169,283,1,19,472,1,473
"چهارمحال_و_بختیاری","کوهرنگ","مرکزی",9,198,324,0,25,547,1,548
"چهارمحال_و_بختیاری","کوهرنگ","مرکزی",10,89,313,0,2,404,3,407
"چهارمحال_و_بختیاری","کوهرنگ","مرکزی",11,102,33,0,56,191,0,191
"چهارمحال_و_بختیاری","کوهرنگ","مرکزی",12,85,16,2,16,119,0,119
"چهارمحال_و_بختیاری","کوهرنگ","مرکزی",13,43,188,0,13,244,4,248
"چهارمحال_و_بختیاری","کوهرنگ","مرکزی",14,98,241,0,38,377,0,377
"چهارمحال_و_بختیاری","کوهرنگ","مرکزی",15,187,190,0,65,442,1,443
"چهارمحال_و_بختیاری","کوهرنگ","مرکزی",16,65,295,0,25,385,0,385
"چهارمحال_و_بختیاری","کوهرنگ","مرکزی",17,34,616,0,21,671,0,671
"چهارمحال_و_بختیاری","کوهرنگ","مرکزی",18,224,143,1,66,434,3,437
"چهارمحال_و_بختیاری","کوهرنگ","مرکزی",19,155,103,1,11,270,5,275
"چهارمحال_و_بختیاری","کوهرنگ","مرکزی",20,130,243,0,59,432,0,432
"چهارمحال_و_بختیاری","کوهرنگ","مرکزی",21,144,81,0,57,282,0,282
"چهارمحال_و_بختیاری","کوهرنگ","مرکزی",22,316,53,0,35,404,9,413
"چهارمحال_و_بختیاری","کوهرنگ","مرکزی",23,218,55,0,56,329,0,329
"چهارمحال_و_بختیاری","کوهرنگ","مرکزی",24,99,30,0,11,140,0,140
"چهارمحال_و_بختیاری","کوهرنگ","مرکزی",25,115,52,3,29,199,1,200
"چهارمحال_و_بختیاری","کوهرنگ","مرکزی",26,184,144,3,86,417,8,425
"چهارمحال_و_بختیاری","کوهرنگ","مرکزی",27,175,105,0,40,320,2,322
"چهارمحال_و_بختیاری","کوهرنگ","مرکزی",28,303,73,1,75,452,3,455
"چهارمحال_و_بختیاری","کوهرنگ","مرکزی",29,239,162,1,39,441,0,441
"چهارمحال_و_بختیاری","کوهرنگ","مرکزی",30,129,107,0,47,283,1,284
"چهارمحال_و_بختیاری","کوهرنگ","مرکزی",31,170,211,0,62,443,4,447
"چهارمحال_و_بختیاری","کوهرنگ","مرکزی",32,84,220,2,183,489,4,493
"چهارمحال_و_بختیاری","کوهرنگ","مرکزی",33,389,221,8,79,697,7,704
"چهارمحال_و_بختیاری","کوهرنگ","مرکزی",34,107,208,11,15,341,0,341
"چهارمحال_و_بختیاری","کوهرنگ","مرکزی",35,101,166,0,22,289,3,292
"چهارمحال_و_بختیاری","کوهرنگ","مرکزی",36,482,29,1,8,520,5,525
"چهارمحال_و_بختیاری","کوهرنگ","مرکزی",37,119,11,0,0,130,0,130
"چهارمحال_و_بختیاری","کوهرنگ","مرکزی",38,128,2,2,0,132,0,132
"چهارمحال_و_بختیاری","کوهرنگ","مرکزی",39,74,16,1,4,95,0,95
"چهارمحال_و_بختیاری","کوهرنگ","مرکزی",40,227,9,0,1,237,1,238
"چهارمحال_و_بختیاری","کوهرنگ","مرکزی",41,455,32,0,8,495,4,499
"چهارمحال_و_بختیاری","کوهرنگ","مرکزی",42,109,15,23,0,147,1,148
"چهارمحال_و_بختیاری","کوهرنگ","بازفت",1,365,29,2,44,440,3,443
"چهارمحال_و_بختیاری","کوهرنگ","بازفت",2,225,19,0,74,318,1,319
"چهارمحال_و_بختیاری","کوهرنگ","بازفت",3,304,28,4,59,395,1,396
"چهارمحال_و_بختیاری","کوهرنگ","بازفت",4,383,16,0,32,431,3,434
"چهارمحال_و_بختیاری","کوهرنگ","بازفت",5,338,5,0,58,401,0,401
"چهارمحال_و_بختیاری","کوهرنگ","بازفت",6,335,5,2,19,361,0,361
"چهارمحال_و_بختیاری","کوهرنگ","بازفت",7,144,1,0,60,205,1,206
"چهارمحال_و_بختیاری","کوهرنگ","بازفت",8,213,7,0,49,269,1,270
"چهارمحال_و_بختیاری","کوهرنگ","بازفت",9,94,4,1,32,131,0,131
"چهارمحال_و_بختیاری","کوهرنگ","بازفت",10,280,26,0,79,385,14,399
"چهارمحال_و_بختیاری","کوهرنگ","بازفت",11,190,25,1,35,251,0,251
"چهارمحال_و_بختیاری","کوهرنگ","بازفت",12,380,18,0,194,592,2,594
"چهارمحال_و_بختیاری","کوهرنگ","بازفت",13,417,65,11,200,693,5,698
"چهارمحال_و_بختیاری","کوهرنگ","بازفت",14,390,17,2,270,679,1,680
"چهارمحال_و_بختیاری","کوهرنگ","بازفت",15,525,3,0,11,539,0,539
"چهارمحال_و_بختیاری","کوهرنگ","بازفت",16,154,0,0,4,158,0,158
"چهارمحال_و_بختیاری","کوهرنگ","بازفت",17,264,15,0,63,342,0,342
"چهارمحال_و_بختیاری","کوهرنگ","بازفت",18,195,3,0,39,237,7,244
"چهارمحال_و_بختیاری","کوهرنگ","بازفت",19,261,1,0,6,268,4,272
"چهارمحال_و_بختیاری","کوهرنگ","بازفت",20,469,25,2,61,557,2,559
"چهارمحال_و_بختیاری","کوهرنگ","بازفت",21,375,2,0,4,381,0,381
"چهارمحال_و_بختیاری","کوهرنگ","بازفت",22,243,10,0,5,258,0,258
"چهارمحال_و_بختیاری","کوهرنگ","بازفت",23,242,15,1,42,300,0,300
"چهارمحال_و_بختیاری","کوهرنگ","بازفت",24,462,41,3,33,539,9,548
"چهارمحال_و_بختیاری","کوهرنگ","بازفت",25,224,17,2,38,281,0,281
"چهارمحال_و_بختیاری","کیار","مرکزی",2,587,8,0,141,736,6,742
"چهارمحال_و_بختیاری","کیار","مرکزی",3,850,11,3,198,1062,6,1068
"چهارمحال_و_بختیاری","کیار","مرکزی",4,430,11,0,90,531,4,535
"چهارمحال_و_بختیاری","کیار","مرکزی",5,1001,29,6,119,1155,0,1155
"چهارمحال_و_بختیاری","کیار","مرکزی",6,1004,10,8,81,1103,6,1109
"چهارمحال_و_بختیاری","کیار","مرکزی",7,1000,18,3,139,1160,5,1165
"چهارمحال_و_بختیاری","کیار","مرکزی",8,485,1,0,59,545,6,551
"چهارمحال_و_بختیاری","کیار","مرکزی",9,1092,52,20,173,1337,6,1343
"چهارمحال_و_بختیاری","کیار","مرکزی",10,1005,11,3,110,1129,5,1134
"چهارمحال_و_بختیاری","کیار","مرکزی",11,503,14,4,61,582,6,588
"چهارمحال_و_بختیاری","کیار","مرکزی",12,643,9,2,97,751,4,755
"چهارمحال_و_بختیاری","کیار","مرکزی",13,976,7,4,124,1111,4,1115
"چهارمحال_و_بختیاری","کیار","مرکزی",14,1120,20,4,147,1291,9,1300
"چهارمحال_و_بختیاری","کیار","مرکزی",15,378,8,1,31,418,2,420
"چهارمحال_و_بختیاری","کیار","مرکزی",16,422,15,0,109,546,3,549
"چهارمحال_و_بختیاری","کیار","مرکزی",17,1180,20,5,209,1414,8,1422
"چهارمحال_و_بختیاری","کیار","مرکزی",18,899,9,3,69,980,9,989
"چهارمحال_و_بختیاری","کیار","مرکزی",19,820,23,2,218,1063,12,1075
"چهارمحال_و_بختیاری","کیار","مرکزی",20,863,7,3,34,907,0,907
"چهارمحال_و_بختیاری","کیار","مرکزی",21,330,11,0,66,407,3,410
"چهارمحال_و_بختیاری","کیار","مرکزی",22,230,3,2,27,262,1,263
"چهارمحال_و_بختیاری","کیار","مرکزی",23,561,10,0,155,726,5,731
"چهارمحال_و_بختیاری","کیار","مرکزی",24,534,8,0,78,620,10,630
"چهارمحال_و_بختیاری","کیار","مرکزی",25,333,10,0,32,375,5,380
"چهارمحال_و_بختیاری","کیار","مرکزی",26,399,2,1,31,433,2,435
"چهارمحال_و_بختیاری","کیار","مرکزی",27,397,6,9,37,449,2,451
"چهارمحال_و_بختیاری","کیار","مرکزی",28,267,3,2,35,307,2,309
"چهارمحال_و_بختیاری","کیار","مرکزی",29,758,12,6,187,963,13,976
"چهارمحال_و_بختیاری","کیار","مرکزی",30,747,13,0,90,850,7,857
"چهارمحال_و_بختیاری","کیار","مرکزی",31,385,4,2,65,456,3,459
"چهارمحال_و_بختیاری","کیار","مرکزی",32,461,18,0,28,507,1,508
"چهارمحال_و_بختیاری","کیار","مرکزی",33,269,42,4,59,374,4,378
"چهارمحال_و_بختیاری","کیار","مرکزی",34,154,5,1,51,211,3,214
"چهارمحال_و_بختیاری","کیار","ناغان",1,177,4,0,33,214,0,214
"چهارمحال_و_بختیاری","کیار","ناغان",2,82,5,1,16,104,0,104
"چهارمحال_و_بختیاری","کیار","ناغان",3,444,15,0,14,473,0,473
"چهارمحال_و_بختیاری","کیار","ناغان",4,259,2,1,16,278,2,280
"چهارمحال_و_بختیاری","کیار","ناغان",5,204,26,0,18,248,2,250
"چهارمحال_و_بختیاری","کیار","ناغان",6,328,11,1,55,395,2,397
"چهارمحال_و_بختیاری","کیار","ناغان",7,284,5,0,64,353,4,357
"چهارمحال_و_بختیاری","کیار","ناغان",8,490,26,1,86,603,3,606
"چهارمحال_و_بختیاری","کیار","ناغان",9,779,19,4,77,879,10,889
"چهارمحال_و_بختیاری","کیار","ناغان",10,460,4,0,20,484,1,485
"چهارمحال_و_بختیاری","کیار","ناغان",11,308,11,9,40,368,3,371
"چهارمحال_و_بختیاری","کیار","ناغان",12,30,0,0,7,37,0,37
"چهارمحال_و_بختیاری","کیار","ناغان",13,233,22,0,70,325,0,325
"چهارمحال_و_بختیاری","کیار","ناغان",14,218,18,3,33,272,0,272
"چهارمحال_و_بختیاری","کیار","ناغان",15,196,17,1,45,259,0,259
"چهارمحال_و_بختیاری","کیار","ناغان",16,245,28,1,41,315,0,315
"چهارمحال_و_بختیاری","کیار","ناغان",17,312,30,2,31,375,0,375
"چهارمحال_و_بختیاری","کیار","ناغان",18,181,7,1,11,200,0,200
"چهارمحال_و_بختیاری","کیار","ناغان",19,310,4,4,32,350,0,350
"چهارمحال_و_بختیاری","کیار","ناغان",20,350,4,0,18,372,0,372
"چهارمحال_و_بختیاری","کیار","ناغان",21,211,6,0,19,236,0,236
"چهارمحال_و_بختیاری","کیار","ناغان",22,334,9,1,111,455,3,458
"چهارمحال_و_بختیاری","کیار","ناغان",23,261,8,0,37,306,2,308
"چهارمحال_و_بختیاری","کیار","ناغان",24,216,2,0,37,255,0,255
"چهارمحال_و_بختیاری","کیار","ناغان",25,286,15,0,18,319,0,319
"چهارمحال_و_بختیاری","کیار","ناغان",26,139,11,1,37,188,0,188
"چهارمحال_و_بختیاری","کیار","ناغان",27,368,22,3,43,436,2,438
"چهارمحال_و_بختیاری","لردگان","مرکزی",1,820,17,2,261,1100,0,1100
"چهارمحال_و_بختیاری","لردگان","مرکزی",2,624,18,0,239,881,0,881
"چهارمحال_و_بختیاری","لردگان","مرکزی",3,242,15,3,400,660,6,666
"چهارمحال_و_بختیاری","لردگان","مرکزی",4,470,13,2,437,922,3,925
"چهارمحال_و_بختیاری","لردگان","مرکزی",5,810,34,6,230,1080,5,1085
"چهارمحال_و_بختیاری","لردگان","مرکزی",6,594,22,4,202,822,2,824
"چهارمحال_و_بختیاری","لردگان","مرکزی",7,535,33,10,522,1100,0,1100
"چهارمحال_و_بختیاری","لردگان","مرکزی",8,977,16,2,93,1088,2,1090
"چهارمحال_و_بختیاری","لردگان","مرکزی",9,968,14,2,112,1096,1,1097
"چهارمحال_و_بختیاری","لردگان","مرکزی",10,744,34,6,232,1016,4,1020
"چهارمحال_و_بختیاری","لردگان","مرکزی",11,522,51,3,301,877,3,880
"چهارمحال_و_بختیاری","لردگان","مرکزی",12,574,76,11,426,1087,4,1091
"چهارمحال_و_بختیاری","لردگان","مرکزی",13,757,22,2,147,928,12,940
"چهارمحال_و_بختیاری","لردگان","مرکزی",14,583,44,10,327,964,4,968
"چهارمحال_و_بختیاری","لردگان","مرکزی",15,368,23,1,96,488,1,489
"چهارمحال_و_بختیاری","لردگان","مرکزی",16,808,10,1,95,914,0,914
"چهارمحال_و_بختیاری","لردگان","مرکزی",17,743,31,0,179,953,3,956
"چهارمحال_و_بختیاری","لردگان","مرکزی",18,689,14,2,563,1268,0,1268
"چهارمحال_و_بختیاری","لردگان","مرکزی",19,675,13,6,106,800,0,800
"چهارمحال_و_بختیاری","لردگان","مرکزی",20,567,20,0,208,795,2,797
"چهارمحال_و_بختیاری","لردگان","مرکزی",21,818,38,6,170,1032,2,1034
"چهارمحال_و_بختیاری","لردگان","مرکزی",22,608,37,195,147,987,2,989
"چهارمحال_و_بختیاری","لردگان","مرکزی",23,605,13,10,118,746,1,747
"چهارمحال_و_بختیاری","لردگان","مرکزی",24,535,36,35,137,743,3,746
"چهارمحال_و_بختیاری","لردگان","مرکزی",25,417,22,0,42,481,3,484
"چهارمحال_و_بختیاری","لردگان","مرکزی",26,526,15,2,151,694,3,697
"چهارمحال_و_بختیاری","لردگان","مرکزی",27,553,10,3,29,595,1,596
"چهارمحال_و_بختیاری","لردگان","مرکزی",28,638,45,6,248,937,2,939
"چهارمحال_و_بختیاری","لردگان","مرکزی",29,318,4,0,178,500,0,500
"چهارمحال_و_بختیاری","لردگان","مرکزی",30,467,23,3,194,687,3,690
"چهارمحال_و_بختیاری","لردگان","مرکزی",31,328,14,6,394,742,2,744
"چهارمحال_و_بختیاری","لردگان","مرکزی",32,238,35,4,166,443,3,446
"چهارمحال_و_بختیاری","لردگان","مرکزی",33,460,44,8,291,803,2,805
"چهارمحال_و_بختیاری","لردگان","مرکزی",34,775,26,0,192,993,1,994
"چهارمحال_و_بختیاری","لردگان","مرکزی",35,626,7,0,207,840,3,843
"چهارمحال_و_بختیاری","لردگان","مرکزی",36,897,17,3,133,1050,0,1050
"چهارمحال_و_بختیاری","لردگان","مرکزی",37,204,2,0,45,251,1,252
"چهارمحال_و_بختیاری","لردگان","مرکزی",38,569,23,3,109,704,2,706
"چهارمحال_و_بختیاری","لردگان","مرکزی",39,533,27,4,286,850,0,850
"چهارمحال_و_بختیاری","لردگان","مرکزی",40,525,8,7,160,700,0,700
"چهارمحال_و_بختیاری","لردگان","مرکزی",41,499,12,4,173,688,2,690
"چهارمحال_و_بختیاری","لردگان","مرکزی",42,686,33,3,199,921,2,923
"چهارمحال_و_بختیاری","لردگان","مرکزی",43,682,18,3,140,843,3,846
"چهارمحال_و_بختیاری","لردگان","مرکزی",44,36,1,0,3,40,2,42
"چهارمحال_و_بختیاری","لردگان","مرکزی",45,830,13,3,142,988,2,990
"چهارمحال_و_بختیاری","لردگان","مرکزی",46,613,1,0,17,631,2,633
"چهارمحال_و_بختیاری","لردگان","مرکزی",47,451,6,0,83,540,1,541
"چهارمحال_و_بختیاری","لردگان","مرکزی",48,792,5,0,49,846,1,847
"چهارمحال_و_بختیاری","لردگان","مرکزی",49,571,12,4,109,696,1,697
"چهارمحال_و_بختیاری","لردگان","مرکزی",50,88,0,0,2,90,1,91
"چهارمحال_و_بختیاری","لردگان","مرکزی",51,998,1,0,1,1000,0,1000
"چهارمحال_و_بختیاری","لردگان","مرکزی",52,103,9,0,19,131,0,131
"چهارمحال_و_بختیاری","لردگان","مرکزی",53,128,2,0,19,149,0,149
"چهارمحال_و_بختیاری","لردگان","مرکزی",54,559,40,1,146,746,2,748
"چهارمحال_و_بختیاری","لردگان","مرکزی",55,834,13,6,308,1161,1,1162
"چهارمحال_و_بختیاری","لردگان","مرکزی",56,961,20,4,185,1170,2,1172
"چهارمحال_و_بختیاری","لردگان","مرکزی",57,443,19,10,71,543,2,545
"چهارمحال_و_بختیاری","لردگان","مرکزی",58,450,33,4,295,782,2,784
"چهارمحال_و_بختیاری","لردگان","مرکزی",59,600,7,0,270,877,0,877
"چهارمحال_و_بختیاری","لردگان","مرکزی",60,541,23,3,123,690,1,691
"چهارمحال_و_بختیاری","لردگان","مرکزی",61,511,11,1,35,558,1,559
"چهارمحال_و_بختیاری","لردگان","مرکزی",62,405,13,0,122,540,1,541
"چهارمحال_و_بختیاری","لردگان","مرکزی",63,513,28,3,185,729,2,731
"چهارمحال_و_بختیاری","لردگان","مرکزی",64,443,34,1,82,560,0,560
"چهارمحال_و_بختیاری","لردگان","مرکزی",65,818,24,0,124,966,2,968
"چهارمحال_و_بختیاری","لردگان","مرکزی",66,535,37,1,76,649,1,650
"چهارمحال_و_بختیاری","لردگان","مرکزی",67,213,8,0,65,286,3,289
"چهارمحال_و_بختیاری","لردگان","مرکزی",68,544,54,1,69,668,1,669
"چهارمحال_و_بختیاری","لردگان","مرکزی",69,969,11,20,150,1150,0,1150
"چهارمحال_و_بختیاری","لردگان","مرکزی",70,963,6,0,252,1221,1,1222
"چهارمحال_و_بختیاری","لردگان","خانمیرزا",1,360,30,12,92,494,2,496
"چهارمحال_و_بختیاری","لردگان","خانمیرزا",2,254,111,13,271,649,0,649
"چهارمحال_و_بختیاری","لردگان","خانمیرزا",3,380,65,4,237,686,0,686
"چهارمحال_و_بختیاری","لردگان","خانمیرزا",4,422,17,2,96,537,2,539
"چهارمحال_و_بختیاری","لردگان","خانمیرزا",5,266,84,1,262,613,2,615
"چهارمحال_و_بختیاری","لردگان","خانمیرزا",6,501,35,3,80,619,1,620
"چهارمحال_و_بختیاری","لردگان","خانمیرزا",7,679,27,58,225,989,3,992
"چهارمحال_و_بختیاری","لردگان","خانمیرزا",8,208,38,0,121,367,13,380
"چهارمحال_و_بختیاری","لردگان","خانمیرزا",9,838,71,3,442,1354,0,1354
"چهارمحال_و_بختیاری","لردگان","خانمیرزا",10,401,32,0,117,550,0,550
"چهارمحال_و_بختیاری","لردگان","خانمیرزا",11,296,260,0,55,611,5,616
"چهارمحال_و_بختیاری","لردگان","خانمیرزا",12,731,166,0,99,996,0,996
"چهارمحال_و_بختیاری","لردگان","خانمیرزا",13,149,58,0,34,241,4,245
"چهارمحال_و_بختیاری","لردگان","خانمیرزا",14,338,74,1,95,508,0,508
"چهارمحال_و_بختیاری","لردگان","خانمیرزا",15,175,80,0,68,323,2,325
"چهارمحال_و_بختیاری","لردگان","خانمیرزا",16,287,44,1,131,463,1,464
"چهارمحال_و_بختیاری","لردگان","خانمیرزا",17,717,86,13,309,1125,0,1125
"چهارمحال_و_بختیاری","لردگان","خانمیرزا",18,332,65,0,146,543,0,543
"چهارمحال_و_بختیاری","لردگان","خانمیرزا",19,463,3,0,44,510,0,510
"چهارمحال_و_بختیاری","لردگان","خانمیرزا",20,633,35,0,199,867,2,869
"چهارمحال_و_بختیاری","لردگان","خانمیرزا",21,201,47,0,99,347,5,352
"چهارمحال_و_بختیاری","لردگان","خانمیرزا",22,279,163,0,133,575,0,575
"چهارمحال_و_بختیاری","لردگان","خانمیرزا",23,344,83,3,179,609,4,613
"چهارمحال_و_بختیاری","لردگان","خانمیرزا",24,159,30,0,243,432,3,435
"چهارمحال_و_بختیاری","لردگان","خانمیرزا",25,525,47,2,145,719,4,723
"چهارمحال_و_بختیاری","لردگان","فلارد",1,852,31,0,110,993,3,996
"چهارمحال_و_بختیاری","لردگان","فلارد",2,657,44,1,187,889,0,889
"چهارمحال_و_بختیاری","لردگان","فلارد",3,575,38,2,85,700,0,700
"چهارمحال_و_بختیاری","لردگان","فلارد",4,510,6,3,75,594,3,597
"چهارمحال_و_بختیاری","لردگان","فلارد",5,819,39,0,92,950,0,950
"چهارمحال_و_بختیاری","لردگان","فلارد",6,641,37,1,114,793,2,795
"چهارمحال_و_بختیاری","لردگان","فلارد",7,1113,12,1,74,1200,0,1200
"چهارمحال_و_بختیاری","لردگان","فلارد",8,891,24,3,74,992,0,992
"چهارمحال_و_بختیاری","لردگان","فلارد",9,770,4,0,76,850,0,850
"چهارمحال_و_بختیاری","لردگان","فلارد",10,571,4,0,25,600,0,600
"چهارمحال_و_بختیاری","لردگان","فلارد",11,618,5,0,125,748,2,750
"چهارمحال_و_بختیاری","لردگان","فلارد",12,493,6,2,43,544,0,544
"چهارمحال_و_بختیاری","لردگان","فلارد",13,585,7,0,72,664,2,666
"چهارمحال_و_بختیاری","لردگان","فلارد",14,537,35,5,108,685,2,687
"چهارمحال_و_بختیاری","لردگان","فلارد",15,1081,19,0,133,1233,3,1236
"چهارمحال_و_بختیاری","لردگان","فلارد",16,596,28,0,71,695,2,697
"چهارمحال_و_بختیاری","لردگان","فلارد",17,620,14,4,59,697,0,697
"چهارمحال_و_بختیاری","لردگان","فلارد",18,805,6,0,84,895,0,895
"چهارمحال_و_بختیاری","لردگان","فلارد",19,682,32,0,34,748,0,748
"چهارمحال_و_بختیاری","لردگان","فلارد",20,749,13,0,18,780,0,780
"چهارمحال_و_بختیاری","لردگان","فلارد",21,609,17,1,87,714,0,714
"چهارمحال_و_بختیاری","لردگان","فلارد",22,692,8,1,77,778,0,778
"چهارمحال_و_بختیاری","لردگان","فلارد",23,436,6,1,12,455,0,455
"چهارمحال_و_بختیاری","لردگان","فلارد",24,576,3,2,37,618,0,618
"چهارمحال_و_بختیاری","لردگان","فلارد",25,559,21,2,38,620,0,620
"چهارمحال_و_بختیاری","لردگان","منج",1,322,24,1,190,537,0,537
"چهارمحال_و_بختیاری","لردگان","منج",2,356,1,1,134,492,1,493
"چهارمحال_و_بختیاری","لردگان","منج",3,262,31,1,102,396,1,397
"چهارمحال_و_بختیاری","لردگان","منج",4,910,35,0,55,1000,0,1000
"چهارمحال_و_بختیاری","لردگان","منج",5,70,31,0,70,171,0,171
"چهارمحال_و_بختیاری","لردگان","منج",6,216,27,0,57,300,0,300
"چهارمحال_و_بختیاری","لردگان","منج",7,402,19,0,42,463,0,463
"چهارمحال_و_بختیاری","لردگان","منج",8,620,22,2,56,700,0,700
"چهارمحال_و_بختیاری","لردگان","منج",9,462,11,0,125,598,2,600
"چهارمحال_و_بختیاری","لردگان","منج",10,322,3,4,86,415,1,416
"چهارمحال_و_بختیاری","لردگان","منج",11,242,7,12,173,434,3,437
"چهارمحال_و_بختیاری","لردگان","منج",12,274,3,2,63,342,0,342
"چهارمحال_و_بختیاری","لردگان","منج",13,163,8,1,2,174,0,174
"چهارمحال_و_بختیاری","لردگان","منج",14,428,4,4,56,492,0,492
"چهارمحال_و_بختیاری","لردگان","منج",15,310,6,0,48,364,0,364
"چهارمحال_و_بختیاری","لردگان","منج",16,116,4,1,127,248,0,248
"چهارمحال_و_بختیاری","لردگان","منج",17,217,8,4,38,267,0,267
"چهارمحال_و_بختیاری","لردگان","منج",18,232,2,0,29,263,0,263
"چهارمحال_و_بختیاری","لردگان","منج",19,334,16,2,86,438,2,440
"چهارمحال_و_بختیاری","لردگان","منج",20,230,19,0,68,317,3,320
"چهارمحال_و_بختیاری","لردگان","منج",21,278,12,2,72,364,2,366
"چهارمحال_و_بختیاری","لردگان","منج",22,28,1,0,7,36,0,36
"کرمان","بافت","مرکزی",1,537,4,0,153,694,2,696
"کرمان","بافت","مرکزی",2,456,2,1,221,680,7,687
"کرمان","بافت","مرکزی",3,364,1,2,120,487,2,489
"کرمان","بافت","مرکزی",4,776,9,0,385,1170,0,1170
"کرمان","بافت","مرکزی",5,687,14,6,540,1247,5,1252
"کرمان","بافت","مرکزی",6,652,7,0,236,895,2,897
"کرمان","بافت","مرکزی",7,1214,11,3,308,1536,4,1540
"کرمان","بافت","مرکزی",8,984,6,5,345,1340,5,1345
"کرمان","بافت","مرکزی",9,836,7,2,159,1004,0,1004
"کرمان","بافت","مرکزی",10,680,11,9,401,1101,12,1113
"کرمان","بافت","مرکزی",11,1028,7,4,537,1576,9,1585
"کرمان","بافت","مرکزی",12,1004,11,6,369,1390,12,1402
"کرمان","بافت","مرکزی",13,737,15,3,482,1237,11,1248
"کرمان","بافت","مرکزی",14,1224,5,1,189,1419,9,1428
"کرمان","بافت","مرکزی",15,1001,9,3,413,1426,13,1439
"کرمان","بافت","مرکزی",16,776,20,2,479,1277,13,1290
"کرمان","بافت","مرکزی",17,353,2,3,160,518,2,520
"کرمان","بافت","مرکزی",18,881,18,6,352,1257,8,1265
"کرمان","بافت","مرکزی",19,382,0,0,66,448,5,453
"کرمان","بافت","مرکزی",20,212,0,0,43,255,2,257
"کرمان","بافت","مرکزی",21,604,3,0,182,789,4,793
"کرمان","بافت","مرکزی",22,252,0,0,86,338,0,338
"کرمان","بافت","مرکزی",23,244,0,0,66,310,0,310
"کرمان","بافت","مرکزی",24,314,2,1,44,361,0,361
"کرمان","بافت","مرکزی",25,273,1,0,25,299,0,299
"کرمان","بافت","مرکزی",26,411,1,1,24,437,0,437
"کرمان","بافت","مرکزی",27,315,3,0,115,433,0,433
"کرمان","بافت","مرکزی",28,472,1,2,64,539,1,540
"کرمان","بافت","مرکزی",29,339,0,0,57,396,0,396
"کرمان","بافت","مرکزی",30,157,1,0,99,257,0,257
"کرمان","بافت","مرکزی",31,1240,2,0,103,1345,2,1347
"کرمان","بافت","مرکزی",32,346,0,1,77,424,0,424
"کرمان","بافت","مرکزی",33,549,2,0,148,699,1,700
"کرمان","بافت","مرکزی",34,797,2,0,320,1119,13,1132
"کرمان","بافت","مرکزی",35,455,4,3,61,523,2,525
"کرمان","بافت","مرکزی",36,632,0,1,108,741,0,741
"کرمان","بافت","مرکزی",37,322,0,1,30,353,1,354
"کرمان","بافت","مرکزی",38,109,0,1,52,162,2,164
"کرمان","بافت","مرکزی",39,199,0,0,24,223,2,225
"کرمان","بافت","مرکزی",40,687,4,1,198,890,2,892
"کرمان","بافت","مرکزی",41,452,1,0,27,480,0,480
"کرمان","بافت","مرکزی",42,486,1,0,85,572,3,575
"کرمان","بافت","مرکزی",43,850,8,1,292,1151,4,1155
"کرمان","بافت","مرکزی",44,202,0,0,47,249,1,250
"کرمان","بافت","مرکزی",45,404,4,0,89,497,2,499
"کرمان","بافت","مرکزی",46,488,0,0,102,590,0,590
"کرمان","بافت","مرکزی",47,410,0,0,56,466,1,467
"کرمان","بافت","مرکزی",48,390,1,0,193,584,2,586
"کرمان","بافت","مرکزی",49,262,1,0,19,282,0,282
"کرمان","بافت","مرکزی",50,557,1,3,122,683,4,687
"کرمان","بافت","مرکزی",51,419,5,0,61,485,0,485
"کرمان","بافت","مرکزی",52,284,1,0,45,330,5,335
"کرمان","بافت","مرکزی",53,718,5,3,114,840,2,842
"کرمان","بافت","مرکزی",54,274,1,3,210,488,2,490
"کرمان","بافت","مرکزی",55,318,4,1,206,529,4,533
"کرمان","بافت","مرکزی",56,515,3,0,139,657,0,657
"کرمان","بافت","مرکزی",57,1006,7,1,183,1197,0,1197
"کرمان","بافت","مرکزی",58,575,5,2,175,757,6,763
"کرمان","بافت","مرکزی",59,901,6,2,140,1049,3,1052
"کرمان","بافت","مرکزی",60,660,5,4,90,759,5,764
"کرمان","بافت","مرکزی",61,273,0,0,25,298,2,300
"کرمان","بافت","مرکزی",62,492,0,0,28,520,0,520
"کرمان","بافت","مرکزی",63,282,0,0,30,312,2,314
"کرمان","بافت","مرکزی",64,232,0,0,8,240,1,241
"کرمان","بافت","مرکزی",65,186,0,0,6,192,0,192
"کرمان","بافت","مرکزی",66,356,0,1,43,400,0,400
"کرمان","بافت","رابر",67,298,1,0,8,307,3,310
"کرمان","بافت","رابر",68,529,1,2,58,590,0,590
"کرمان","بافت","رابر",69,236,1,3,26,266,0,266
"کرمان","بافت","رابر",70,820,1,0,145,966,0,966
"کرمان","بافت","رابر",71,480,0,0,8,488,0,488
"کرمان","بافت","رابر",72,971,1,0,13,985,2,987
"کرمان","بافت","رابر",73,307,2,1,7,317,2,319
"کرمان","بافت","رابر",74,459,6,0,116,581,1,582
"کرمان","بافت","رابر",75,240,2,0,23,265,0,265
"کرمان","بافت","رابر",76,350,2,0,27,379,0,379
"کرمان","بافت","رابر",77,385,0,0,21,406,1,407
"کرمان","بافت","رابر",78,392,3,0,3,398,2,400
"کرمان","بافت","رابر",79,299,0,0,1,300,0,300
"کرمان","بافت","رابر",80,291,1,1,3,296,0,296
"کرمان","بافت","رابر",81,575,1,2,85,663,0,663
"کرمان","بافت","رابر",82,524,1,0,78,603,0,603
"کرمان","بافت","رابر",83,447,0,0,47,494,0,494
"کرمان","بافت","رابر",84,541,4,10,116,671,0,671
"کرمان","بافت","رابر",85,302,1,1,16,320,3,323
"کرمان","بافت","رابر",86,536,1,1,16,554,0,554
"کرمان","بافت","رابر",87,742,2,0,6,750,0,750
"کرمان","بافت","رابر",88,300,0,0,21,321,0,321
"کرمان","بافت","رابر",89,789,7,0,26,822,6,828
"کرمان","بافت","رابر",90,575,5,0,45,625,2,627
"کرمان","بافت","رابر",91,900,1,0,76,977,0,977
"کرمان","بافت","رابر",92,355,0,2,67,424,1,425
"کرمان","بافت","رابر",93,221,0,0,10,231,0,231
"کرمان","بافت","رابر",94,448,0,2,98,548,3,551
"کرمان","بافت","رابر",95,297,1,1,100,399,1,400
"کرمان","بافت","رابر",96,301,0,1,132,434,6,440
"کرمان","بافت","رابر",97,413,4,0,160,577,2,579
"کرمان","بافت","رابر",98,413,1,0,107,521,3,524
"کرمان","بافت","رابر",99,411,2,0,281,694,4,698
"کرمان","بافت","رابر",100,351,1,0,203,555,2,557
"کرمان","بافت","رابر",101,740,8,1,323,1072,4,1076
"کرمان","بافت","رابر",102,528,7,0,133,668,8,676
"کرمان","بافت","رابر",103,927,2,2,128,1059,0,1059
"کرمان","بافت","رابر",104,1638,4,2,141,1785,0,1785
"کرمان","بافت","رابر",105,197,1,0,57,255,2,257
"کرمان","بافت","ارزوئیه",106,517,3,1,66,587,0,587
"کرمان","بافت","ارزوئیه",107,475,2,0,97,574,1,575
"کرمان","بافت","ارزوئیه",108,875,3,1,119,998,2,1000
"کرمان","بافت","ارزوئیه",109,302,0,0,24,326,3,329
"کرمان","بافت","ارزوئیه",110,325,2,0,102,429,4,433
"کرمان","بافت","ارزوئیه",111,531,0,1,149,681,0,681
"کرمان","بافت","ارزوئیه",112,571,1,0,75,647,2,649
"کرمان","بافت","ارزوئیه",113,437,1,0,77,515,2,517
"کرمان","بافت","ارزوئیه",114,400,1,0,225,626,4,630
"کرمان","بافت","ارزوئیه",115,595,2,1,105,703,6,709
"کرمان","بافت","ارزوئیه",116,985,4,1,104,1094,3,1097
"کرمان","بافت","ارزوئیه",117,356,1,0,43,400,3,403
"کرمان","بافت","ارزوئیه",118,717,3,2,198,920,0,920
"کرمان","بافت","ارزوئیه",119,790,13,1,178,982,14,996
"کرمان","بافت","ارزوئیه",120,119,0,0,24,143,1,144
"کرمان","بافت","ارزوئیه",121,958,3,5,271,1237,5,1242
"کرمان","بافت","ارزوئیه",122,673,4,1,243,921,5,926
"کرمان","بافت","ارزوئیه",123,657,7,4,354,1022,7,1029
"کرمان","بافت","ارزوئیه",124,308,1,0,60,369,0,369
"کرمان","بافت","ارزوئیه",125,878,2,0,80,960,10,970
"کرمان","بافت","ارزوئیه",126,423,0,0,126,549,0,549
"کرمان","بافت","ارزوئیه",127,701,0,0,102,803,2,805
"کرمان","بافت","ارزوئیه",128,502,0,1,93,596,3,599
"کرمان","بافت","ارزوئیه",129,375,1,0,57,433,2,435
"کرمان","بافت","ارزوئیه",130,555,0,0,87,642,0,642
"کرمان","بافت","ارزوئیه",131,445,0,1,49,495,4,499
"کرمان","بافت","ارزوئیه",132,1101,2,1,90,1194,0,1194
"کرمان","بافت","ارزوئیه",133,624,0,0,45,669,1,670
"کرمان","بافت","ارزوئیه",134,559,1,0,42,602,2,604
"کرمان","بافت","ارزوئیه",135,397,0,0,70,467,1,468
"کرمان","بردسیر","مرکزی",1,881,15,2,261,1159,9,1168
"کرمان","بردسیر","مرکزی",2,882,7,0,151,1040,5,1045
"کرمان","بردسیر","مرکزی",3,888,9,7,181,1085,4,1089
"کرمان","بردسیر","مرکزی",4,205,2,0,57,264,1,265
"کرمان","بردسیر","مرکزی",5,922,5,0,157,1084,4,1088
"کرمان","بردسیر","مرکزی",6,751,13,4,157,925,11,936
"کرمان","بردسیر","مرکزی",7,1010,1,2,131,1144,6,1150
"کرمان","بردسیر","مرکزی",8,704,9,4,242,959,14,973
"کرمان","بردسیر","مرکزی",9,807,11,5,142,965,9,974
"کرمان","بردسیر","مرکزی",10,625,17,1,170,813,12,825
"کرمان","بردسیر","مرکزی",11,964,13,1,241,1219,10,1229
"کرمان","بردسیر","مرکزی",12,979,10,0,291,1280,9,1289
"کرمان","بردسیر","مرکزی",13,989,21,3,372,1385,11,1396
"کرمان","بردسیر","مرکزی",14,425,6,3,215,649,8,657
"کرمان","بردسیر","مرکزی",15,712,12,1,131,856,7,863
"کرمان","بردسیر","مرکزی",16,495,5,0,135,635,11,646
"کرمان","بردسیر","مرکزی",17,575,8,1,170,754,3,757
"کرمان","بردسیر","مرکزی",18,443,1,2,78,524,2,526
"کرمان","بردسیر","مرکزی",19,519,0,0,42,561,2,563
"کرمان","بردسیر","مرکزی",20,678,9,2,98,787,2,789
"کرمان","بردسیر","مرکزی",21,469,0,2,43,514,2,516
"کرمان","بردسیر","مرکزی",22,1111,9,3,86,1209,7,1216
"کرمان","بردسیر","مرکزی",23,547,2,0,54,603,2,605
"کرمان","بردسیر","مرکزی",24,595,5,3,36,639,0,639
"کرمان","بردسیر","مرکزی",25,431,2,0,56,489,4,493
"کرمان","بردسیر","مرکزی",26,482,3,0,43,528,2,530
"کرمان","بردسیر","مرکزی",27,235,0,0,24,259,1,260
"کرمان","بردسیر","مرکزی",28,238,2,0,18,258,0,258
"کرمان","بردسیر","مرکزی",29,354,2,0,5,361,1,362
"کرمان","بردسیر","مرکزی",30,433,1,0,25,459,0,459
"کرمان","بردسیر","مرکزی",31,394,0,0,29,423,4,427
"کرمان","بردسیر","مرکزی",32,425,0,0,51,476,2,478
"کرمان","بردسیر","مرکزی",33,666,5,0,86,757,2,759
"کرمان","بردسیر","مرکزی",34,718,3,0,74,795,17,812
"کرمان","بردسیر","مرکزی",35,1010,4,1,150,1165,5,1170
"کرمان","بردسیر","مرکزی",36,985,7,0,143,1135,14,1149
"کرمان","بردسیر","مرکزی",37,619,4,0,174,797,6,803
"کرمان","بردسیر","مرکزی",38,382,1,6,43,432,4,436
"کرمان","بردسیر","مرکزی",39,677,0,0,55,732,3,735
"کرمان","بردسیر","مرکزی",40,985,3,0,89,1077,0,1077
"کرمان","بردسیر","مرکزی",41,1384,5,0,134,1523,2,1525
"کرمان","بردسیر","مرکزی",42,219,0,1,23,243,0,243
"کرمان","بردسیر","مرکزی",43,414,0,1,17,432,3,435
"کرمان","بردسیر","مرکزی",44,457,2,0,31,490,4,494
"کرمان","بردسیر","مرکزی",45,227,1,0,11,239,3,242
"کرمان","بردسیر","لاله_زار",1,1045,7,2,77,1131,3,1134
"کرمان","بردسیر","لاله_زار",2,545,0,0,59,604,2,606
"کرمان","بردسیر","لاله_زار",3,772,3,0,59,834,4,838
"کرمان","بردسیر","لاله_زار",4,674,5,0,28,707,4,711
"کرمان","بردسیر","لاله_زار",5,286,0,0,14,300,0,300
"کرمان","بردسیر","لاله_زار",6,165,0,0,15,180,1,181
"کرمان","بردسیر","لاله_زار",7,530,1,0,14,545,0,545
"کرمان","بردسیر","لاله_زار",8,725,1,0,77,803,5,808
"کرمان","بردسیر","لاله_زار",9,763,5,0,61,829,1,830
"کرمان","بردسیر","لاله_زار",10,293,9,0,36,338,2,340
"کرمان","بم","مرکزی",1,594,19,1,336,950,8,958
"کرمان","بم","مرکزی",2,417,3,1,169,590,5,595
"کرمان","بم","مرکزی",3,156,5,2,96,259,3,262
"کرمان","بم","مرکزی",4,394,6,1,195,596,4,600
"کرمان","بم","مرکزی",5,264,10,1,224,499,8,507
"کرمان","بم","مرکزی",6,749,15,9,317,1090,10,1100
"کرمان","بم","مرکزی",7,801,12,0,325,1138,23,1161
"کرمان","بم","مرکزی",8,885,12,2,237,1136,9,1145
"کرمان","بم","مرکزی",9,782,5,1,107,895,5,900
"کرمان","بم","مرکزی",10,1014,3,1,197,1215,3,1218
"کرمان","بم","مرکزی",11,236,2,2,116,356,4,360
"کرمان","بم","مرکزی",12,294,3,3,221,521,0,521
"کرمان","بم","مرکزی",13,542,12,0,217,771,5,776
"کرمان","بم","مرکزی",14,596,1,3,128,728,2,730
"کرمان","بم","مرکزی",15,447,10,1,374,832,1,833
"کرمان","بم","مرکزی",16,441,2,0,135,578,8,586
"کرمان","بم","مرکزی",17,190,3,0,93,286,1,287
"کرمان","بم","مرکزی",18,432,9,0,164,605,9,614
"کرمان","بم","مرکزی",19,828,15,1,538,1382,15,1397
"کرمان","بم","مرکزی",20,467,3,0,260,730,14,744
"کرمان","بم","مرکزی",21,289,1,1,158,449,7,456
"کرمان","بم","مرکزی",22,265,7,5,204,481,8,489
"کرمان","بم","مرکزی",23,252,5,0,216,473,7,480
"کرمان","بم","مرکزی",24,155,3,1,118,277,5,282
"کرمان","بم","مرکزی",25,195,2,0,71,268,4,272
"کرمان","بم","مرکزی",26,374,5,0,237,616,8,624
"کرمان","بم","مرکزی",27,695,6,2,396,1099,8,1107
"کرمان","بم","مرکزی",28,393,8,6,350,757,6,763
"کرمان","بم","مرکزی",29,473,3,1,64,541,3,544
"کرمان","بم","مرکزی",30,430,8,3,388,829,11,840
"کرمان","بم","مرکزی",31,413,3,1,79,496,4,500
"کرمان","بم","مرکزی",32,224,2,4,199,429,5,434
"کرمان","بم","مرکزی",33,198,3,1,212,414,1,415
"کرمان","بم","مرکزی",34,613,7,1,342,963,13,976
"کرمان","بم","مرکزی",35,728,24,3,433,1188,13,1201
"کرمان","بم","مرکزی",36,383,6,5,239,633,11,644
"کرمان","بم","مرکزی",37,603,10,1,146,760,10,770
"کرمان","بم","مرکزی",38,914,29,6,419,1368,14,1382
"کرمان","بم","مرکزی",39,516,6,4,266,792,7,799
"کرمان","بم","مرکزی",40,207,4,1,170,382,5,387
"کرمان","بم","مرکزی",41,120,2,0,84,206,2,208
"کرمان","بم","مرکزی",42,734,11,0,396,1141,4,1145
"کرمان","بم","مرکزی",43,499,10,1,326,836,4,840
"کرمان","بم","مرکزی",44,454,2,0,187,643,0,643
"کرمان","بم","مرکزی",45,178,5,1,212,396,6,402
"کرمان","بم","مرکزی",46,222,5,4,190,421,,421
"کرمان","بم","مرکزی",47,646,13,7,166,832,3,835
"کرمان","بم","مرکزی",48,482,0,6,229,717,8,725
"کرمان","بم","مرکزی",49,108,1,2,106,217,3,220
"کرمان","بم","مرکزی",50,175,1,2,126,304,3,307
"کرمان","بم","مرکزی",51,335,3,3,152,493,5,498
"کرمان","بم","مرکزی",52,576,11,2,267,856,9,865
"کرمان","بم","مرکزی",53,82,1,0,77,160,4,164
"کرمان","بم","مرکزی",54,174,5,5,99,283,7,290
"کرمان","بم","مرکزی",55,326,15,1,195,537,4,541
"کرمان","بم","مرکزی",56,221,1,0,46,268,4,272
"کرمان","بم","مرکزی",57,279,2,0,23,304,0,304
"کرمان","بم","مرکزی",58,1093,8,0,93,1194,4,1198
"کرمان","بم","مرکزی",59,1516,4,6,90,1616,0,1616
"کرمان","بم","مرکزی",60,467,5,2,107,581,0,581
"کرمان","بم","مرکزی",61,698,5,2,141,846,0,846
"کرمان","بم","مرکزی",62,799,4,5,141,949,4,953
"کرمان","بم","مرکزی",63,732,10,1,229,972,6,978
"کرمان","بم","مرکزی",64,706,12,1,186,905,4,909
"کرمان","بم","مرکزی",65,1638,0,0,58,1696,4,1700
"کرمان","بم","مرکزی",66,913,3,0,227,1143,7,1150
"کرمان","بم","مرکزی",67,418,0,0,180,598,1,599
"کرمان","بم","مرکزی",68,599,3,1,84,687,0,687
"کرمان","بم","مرکزی",69,398,4,1,98,501,0,501
"کرمان","بم","مرکزی",70,157,5,3,363,528,3,531
"کرمان","بم","مرکزی",71,403,1,0,31,435,1,436
"کرمان","بم","مرکزی",72,566,3,1,44,614,8,622
"کرمان","بم","مرکزی",73,300,0,2,14,316,1,317
"کرمان","بم","مرکزی",74,457,1,2,62,522,0,522
"کرمان","بم","مرکزی",75,531,1,3,84,619,4,623
"کرمان","بم","مرکزی",76,880,5,3,224,1112,5,1117
"کرمان","بم","مرکزی",77,442,2,1,108,553,1,554
"کرمان","بم","مرکزی",78,371,2,1,98,472,2,474
"کرمان","بم","مرکزی",79,516,2,0,20,538,1,539
"کرمان","بم","مرکزی",80,57,0,0,35,92,0,92
"کرمان","بم","مرکزی",81,839,2,0,47,888,0,888
"کرمان","بم","مرکزی",82,925,3,2,109,1039,6,1045
"کرمان","بم","مرکزی",83,525,3,0,78,606,5,611
"کرمان","بم","مرکزی",84,1024,1,0,97,1122,0,1122
"کرمان","بم","مرکزی",85,396,1,1,15,413,0,413
"کرمان","بم","مرکزی",86,420,4,0,107,531,0,531
"کرمان","بم","مرکزی",87,1901,8,1,276,2186,14,2200
"کرمان","بم","مرکزی",88,700,12,3,173,888,12,900
"کرمان","بم","مرکزی",89,350,2,0,112,464,2,466
"کرمان","بم","مرکزی",90,615,10,0,64,689,3,692
"کرمان","بم","مرکزی",91,795,2,2,56,855,3,858
"کرمان","بم","مرکزی",92,374,1,0,53,428,2,430
"کرمان","بم","مرکزی",93,517,0,0,22,539,0,539
"کرمان","بم","مرکزی",94,407,2,0,68,477,3,480
"کرمان","بم","مرکزی",95,271,1,0,18,290,1,291
"کرمان","بم","روداب",96,514,2,1,82,599,,599
"کرمان","بم","روداب",97,615,2,0,58,675,,675
"کرمان","بم","روداب",98,1025,0,2,62,1089,4,1093
"کرمان","بم","روداب",99,533,8,1,86,628,,628
"کرمان","بم","روداب",100,488,3,3,94,588,7,595
"کرمان","بم","روداب",101,654,0,0,213,867,1,868
"کرمان","بم","روداب",102,552,0,1,17,570,1,571
"کرمان","بم","روداب",103,804,0,0,25,829,,829
"کرمان","بم","روداب",104,1193,3,3,101,1300,,1300
"کرمان","بم","روداب",105,537,0,1,57,595,1,596
"کرمان","بم","روداب",106,530,1,12,50,593,2,595
"کرمان","بم","روداب",107,998,0,0,1,999,1,1000
"کرمان","بم","روداب",108,414,2,0,162,578,,578
"کرمان","بم","روداب",109,371,1,0,28,400,1,401
"کرمان","بم","روداب",110,287,2,0,65,354,3,357
"کرمان","بم","روداب",111,738,0,0,62,800,,800
"کرمان","بم","روداب",112,557,4,0,147,708,,708
"کرمان","بم","روداب",113,292,0,0,8,300,,300
"کرمان","بم","روداب",114,792,3,1,61,857,,857
"کرمان","بم","روداب",115,839,2,0,5,846,4,850
"کرمان","بم","روداب",116,510,0,0,46,556,2,558
"کرمان","بم","روداب",117,647,1,0,21,669,1,670
"کرمان","بم","روداب",118,662,0,0,78,740,,740
"کرمان","بم","روداب",119,439,0,1,34,474,,474
"کرمان","بم","روداب",120,481,0,0,42,523,2,525
"کرمان","بم","روداب",121,435,0,0,1,436,,436
"کرمان","بم","روداب",122,604,6,4,40,654,,654
"کرمان","بم","روداب",123,181,2,0,37,220,,220
"کرمان","بم","نرماشیر",124,1755,3,1,131,1890,2,1892
"کرمان","بم","نرماشیر",125,1005,6,5,163,1179,3,1182
"کرمان","بم","نرماشیر",126,1155,0,0,24,1179,1,1180
"کرمان","بم","نرماشیر",127,970,2,0,28,1000,,1000
"کرمان","بم","نرماشیر",128,984,0,0,16,1000,,1000
"کرمان","بم","نرماشیر",129,892,3,0,101,996,,996
"کرمان","بم","نرماشیر",130,616,2,5,24,647,1,648
"کرمان","بم","نرماشیر",131,952,2,0,46,1000,,1000
"کرمان","بم","نرماشیر",132,981,0,0,19,1000,,1000
"کرمان","بم","نرماشیر",133,867,2,0,81,950,,950
"کرمان","بم","نرماشیر",134,686,0,0,55,741,3,744
"کرمان","بم","نرماشیر",135,1108,0,0,4,1112,4,1116
"کرمان","بم","نرماشیر",136,929,1,4,36,970,,970
"کرمان","بم","نرماشیر",137,888,1,0,20,909,,909
"کرمان","بم","نرماشیر",138,781,0,0,18,799,1,800
"کرمان","بم","نرماشیر",139,692,3,4,7,706,,706
"کرمان","بم","نرماشیر",140,725,2,0,52,779,2,781
"کرمان","بم","نرماشیر",141,1090,0,0,10,1100,,1100
"کرمان","بم","نرماشیر",142,767,4,0,59,830,,830
"کرمان","بم","نرماشیر",143,912,2,4,32,950,,950
"کرمان","بم","نرماشیر",144,485,0,0,13,498,1,499
"کرمان","بم","نرماشیر",145,1267,0,3,30,1300,,1300
"کرمان","بم","نرماشیر",146,448,3,0,94,545,3,548
"کرمان","بم","نرماشیر",147,983,0,0,15,998,,998
"کرمان","بم","نرماشیر",148,1240,0,0,10,1250,1,1251
"کرمان","بم","نرماشیر",149,877,0,0,22,899,1,900
"کرمان","بم","نرماشیر",150,1014,5,1,68,1088,,1088
"کرمان","بم","نرماشیر",151,941,1,0,61,1003,48,1051
"کرمان","بم","فهرج",152,1136,2,3,158,1299,1,1300
"کرمان","بم","فهرج",153,1039,5,0,81,1125,2,1127
"کرمان","بم","فهرج",154,308,4,0,51,363,3,366
"کرمان","بم","فهرج",155,476,0,0,23,499,1,500
"کرمان","بم","فهرج",156,941,0,0,18,959,,959
"کرمان","بم","فهرج",157,860,1,1,25,887,2,889
"کرمان","بم","فهرج",158,868,0,2,41,911,,911
"کرمان","بم","فهرج",159,800,0,0,20,820,,820
"کرمان","بم","فهرج",160,765,0,0,35,800,2,802
"کرمان","بم","فهرج",161,798,1,0,44,843,,843
"کرمان","بم","فهرج",162,490,0,0,21,511,2,513
"کرمان","بم","فهرج",163,1224,1,0,33,1258,,1258
"کرمان","بم","فهرج",164,1146,0,0,46,1192,,1192
"کرمان","بم","فهرج",165,705,1,0,28,734,2,736
"کرمان","بم","فهرج",166,952,0,0,126,1078,2,1080
"کرمان","جیرفت","شهر_جیرفت",1,353,2,3,224,582,2,584
"کرمان","جیرفت","شهر_جیرفت",2,402,3,14,130,549,0,549
"کرمان","جیرفت","شهر_جیرفت",3,689,0,4,145,838,0,838
"کرمان","جیرفت","شهر_جیرفت",4,453,2,24,137,616,4,620
"کرمان","جیرفت","شهر_جیرفت",5,419,6,6,235,666,8,674
"کرمان","جیرفت","شهر_جیرفت",6,342,1,7,240,590,6,596
"کرمان","جیرفت","شهر_جیرفت",7,641,2,10,104,757,0,757
"کرمان","جیرفت","شهر_جیرفت",8,583,8,0,221,812,4,816
"کرمان","جیرفت","شهر_جیرفت",9,722,4,5,95,826,10,836
"کرمان","جیرفت","شهر_جیرفت",10,403,5,1,155,564,1,565
"کرمان","جیرفت","شهر_جیرفت",11,357,11,3,266,637,4,641
"کرمان","جیرفت","شهر_جیرفت",12,255,1,0,74,330,0,330
"کرمان","جیرفت","شهر_جیرفت",13,433,4,1,128,566,9,575
"کرمان","جیرفت","شهر_جیرفت",14,611,4,1,331,947,4,951
"کرمان","جیرفت","شهر_جیرفت",15,527,16,0,349,892,8,900
"کرمان","جیرفت","شهر_جیرفت",16,571,9,0,235,815,3,818
"کرمان","جیرفت","شهر_جیرفت",17,461,9,5,232,707,7,714
"کرمان","جیرفت","شهر_جیرفت",18,460,9,0,147,616,1,617
"کرمان","جیرفت","شهر_جیرفت",19,742,9,4,250,1005,6,1011
"کرمان","جیرفت","شهر_جیرفت",20,922,13,5,414,1354,7,1361
"کرمان","جیرفت","شهر_جیرفت",21,178,5,0,132,315,0,315
"کرمان","جیرفت","شهر_جیرفت",22,1042,13,4,333,1392,2,1394
"کرمان","جیرفت","شهر_جیرفت",23,904,7,5,151,1067,3,1070
"کرمان","جیرفت","شهر_جیرفت",24,328,4,0,106,438,9,447
"کرمان","جیرفت","شهر_جیرفت",25,867,14,4,369,1254,11,1265
"کرمان","جیرفت","شهر_جیرفت",26,806,5,1,174,986,0,986
"کرمان","جیرفت","شهر_جیرفت",27,410,10,0,162,582,5,587
"کرمان","جیرفت","شهر_جیرفت",28,689,2,6,142,839,9,848
"کرمان","جیرفت","شهر_جیرفت",29,298,3,1,156,458,3,461
"کرمان","جیرفت","شهر_جیرفت",30,570,10,3,203,786,4,790
"کرمان","جیرفت","شهر_جیرفت",31,762,8,2,190,962,2,964
"کرمان","جیرفت","شهر_جیرفت",32,345,3,0,155,503,6,509
"کرمان","جیرفت","شهر_جیرفت",33,375,2,1,177,555,3,558
"کرمان","جیرفت","شهر_جیرفت",34,751,13,0,234,998,0,998
"کرمان","جیرفت","شهر_جیرفت",35,139,2,4,66,211,2,213
"کرمان","جیرفت","شهر_جیرفت",36,403,3,1,203,610,8,618
"کرمان","جیرفت","شهر_جیرفت",37,460,7,3,278,748,9,757
"کرمان","جیرفت","شهر_جیرفت",38,419,4,3,165,591,9,600
"کرمان","جیرفت","شهر_جیرفت",39,258,5,1,137,401,6,407
"کرمان","جیرفت","شهر_جیرفت",40,478,6,2,312,798,2,800
"کرمان","جیرفت","شهر_جیرفت",41,153,0,1,62,216,0,216
"کرمان","جیرفت","شهر_جیرفت",42,445,4,0,141,590,4,594
"کرمان","جیرفت","شهر_جیرفت",43,840,7,2,243,1092,5,1097
"کرمان","جیرفت","شهر_جیرفت",44,182,1,0,122,305,0,305
"کرمان","جیرفت","شهر_جیرفت",45,577,10,2,237,826,4,830
"کرمان","جیرفت","شهر_جیرفت",46,416,2,0,104,522,1,523
"کرمان","جیرفت","شهر_جیرفت",47,430,3,1,74,508,5,513
"کرمان","جیرفت","شهر_جیرفت",48,488,2,4,81,575,3,578
"کرمان","جیرفت","شهر_جیرفت",49,378,3,1,29,411,12,423
"کرمان","جیرفت","شهر_جیرفت",50,883,3,2,151,1039,1,1040
"کرمان","جیرفت","شهر_جیرفت",51,197,3,2,162,364,1,365
"کرمان","جیرفت","شهر_جیرفت",52,247,2,2,83,334,2,336
"کرمان","جیرفت","شهر_جیرفت",53,1032,2,2,169,1205,3,1208
"کرمان","جیرفت","شهر_جیرفت",54,823,1,1,101,926,0,926
"کرمان","جیرفت","شهر_جیرفت",55,1094,2,0,12,1108,0,1108
"کرمان","جیرفت","شهر_جیرفت",56,681,7,0,158,846,3,849
"کرمان","جیرفت","شهر_جیرفت",57,1065,2,1,38,1106,3,1109
"کرمان","جیرفت","شهر_جیرفت",58,526,3,0,97,626,0,626
"کرمان","جیرفت","شهر_جیرفت",59,506,1,0,36,543,0,543
"کرمان","جیرفت","شهر_جیرفت",60,447,0,3,29,479,2,481
"کرمان","جیرفت","شهر_جیرفت",61,314,3,0,22,339,2,341
"کرمان","جیرفت","شهر_جیرفت",62,694,1,2,20,717,0,717
"کرمان","جیرفت","شهر_جیرفت",63,1112,2,1,33,1148,0,1148
"کرمان","جیرفت","شهر_جیرفت",64,431,1,0,53,485,0,485
"کرمان","جیرفت","شهر_جیرفت",65,758,4,0,101,863,2,865
"کرمان","جیرفت","شهر_جیرفت",66,876,4,0,82,962,0,962
"کرمان","جیرفت","شهر_جیرفت",67,393,1,0,38,432,3,435
"کرمان","جیرفت","شهر_جیرفت",68,283,2,0,28,313,1,314
"کرمان","جیرفت","شهر_جیرفت",69,379,4,0,51,434,7,441
"کرمان","جیرفت","شهر_جیرفت",70,705,1,0,35,741,0,741
"کرمان","جیرفت","شهر_جیرفت",71,370,0,0,38,408,2,410
"کرمان","جیرفت","مرکزی",105,348,2,0,30,380,1,381
"کرمان","جیرفت","مرکزی",106,509,2,0,91,602,6,608
"کرمان","جیرفت","مرکزی",107,1228,2,0,32,1262,7,1269
"کرمان","جیرفت","مرکزی",108,610,0,0,51,661,1,662
"کرمان","جیرفت","مرکزی",109,979,5,5,23,1012,0,1012
"کرمان","جیرفت","مرکزی",110,533,3,1,15,552,0,552
"کرمان","جیرفت","مرکزی",111,801,1,0,20,822,0,822
"کرمان","جیرفت","مرکزی",112,584,1,0,29,614,2,616
"کرمان","جیرفت","مرکزی",113,425,0,0,46,471,1,472
"کرمان","جیرفت","مرکزی",114,515,0,0,35,550,1,551
"کرمان","جیرفت","مرکزی",115,440,0,0,9,449,2,451
"کرمان","جیرفت","مرکزی",116,776,1,0,7,784,0,784
"کرمان","جیرفت","مرکزی",117,1134,1,0,76,1211,2,1213
"کرمان","جیرفت","مرکزی",118,870,0,0,96,966,3,969
"کرمان","جیرفت","مرکزی",119,519,1,1,110,631,0,631
"کرمان","جیرفت","مرکزی",120,911,1,0,90,1002,0,1002
"کرمان","جیرفت","مرکزی",121,976,1,0,13,990,0,990
"کرمان","جیرفت","مرکزی",122,1026,0,0,59,1085,0,1085
"کرمان","جیرفت","مرکزی",123,942,10,0,26,978,0,978
"کرمان","جیرفت","مرکزی",124,767,1,0,10,778,1,779
"کرمان","جیرفت","مرکزی",125,872,2,2,22,898,4,902
"کرمان","جیرفت","مرکزی",126,237,0,0,11,248,1,249
"کرمان","جیرفت","مرکزی",127,719,2,0,37,758,0,758
"کرمان","جیرفت","مرکزی",128,485,0,0,15,500,0,500
"کرمان","جیرفت","مرکزی",129,638,7,1,83,729,5,734
"کرمان","جیرفت","مرکزی",130,821,0,0,21,842,1,843
"کرمان","جیرفت","مرکزی",131,1164,0,1,83,1248,0,1248
"کرمان","جیرفت","مرکزی",132,1008,3,2,192,1205,4,1209
"کرمان","جیرفت","مرکزی",133,822,1,0,66,889,1,890
"کرمان","جیرفت","مرکزی",134,937,0,0,3,940,0,940
"کرمان","جیرفت","مرکزی",135,910,2,0,22,934,4,938
"کرمان","جیرفت","مرکزی",136,726,0,1,65,792,2,794
"کرمان","جیرفت","مرکزی",137,1267,3,0,32,1302,2,1304
"کرمان","جیرفت","مرکزی",138,724,3,0,70,797,8,805
"کرمان","جیرفت","مرکزی",139,1024,0,1,95,1120,2,1122
"کرمان","جیرفت","مرکزی",140,874,2,0,41,917,4,921
"کرمان","جیرفت","مرکزی",141,773,2,0,24,799,1,800
"کرمان","جیرفت","مرکزی",142,349,2,0,32,383,0,383
"کرمان","جیرفت","مرکزی",143,542,1,0,24,567,0,567
"کرمان","جیرفت","مرکزی",144,323,2,0,10,335,0,335
"کرمان","جیرفت","مرکزی",145,389,0,0,9,398,0,398
"کرمان","جیرفت","مرکزی",146,386,0,0,21,407,1,408
"کرمان","جیرفت","مرکزی",147,400,0,0,40,440,0,440
"کرمان","جیرفت","مرکزی",148,704,2,4,26,736,0,736
"کرمان","جیرفت","مرکزی",149,285,0,0,8,293,0,293
"کرمان","جیرفت","چبالبارز",1,641,3,0,89,733,0,733
"کرمان","جیرفت","چبالبارز",2,771,1,1,24,797,1,798
"کرمان","جیرفت","چبالبارز",3,306,1,1,92,400,0,400
"کرمان","جیرفت","چبالبارز",4,408,0,1,95,504,2,506
"کرمان","جیرفت","چبالبارز",5,593,7,1,223,824,3,827
"کرمان","جیرفت","چبالبارز",6,235,6,1,57,299,1,300
"کرمان","جیرفت","چبالبارز",7,251,4,0,12,267,0,267
"کرمان","جیرفت","چبالبارز",8,322,2,1,170,495,2,497
"کرمان","جیرفت","چبالبارز",9,1011,1,0,63,1075,0,1075
"کرمان","جیرفت","چبالبارز",10,148,1,0,24,173,1,174
"کرمان","جیرفت","چبالبارز",11,319,3,3,67,392,0,392
"کرمان","جیرفت","چبالبارز",12,387,0,0,38,425,1,426
"کرمان","جیرفت","چبالبارز",13,359,1,1,61,422,0,422
"کرمان","جیرفت","چبالبارز",14,487,0,1,65,553,0,553
"کرمان","جیرفت","چبالبارز",15,330,0,0,60,390,1,391
"کرمان","جیرفت","چبالبارز",16,315,0,0,29,344,1,345
"کرمان","جیرفت","چبالبارز",17,44,0,0,7,51,0,51
"کرمان","جیرفت","چبالبارز",18,149,0,0,3,152,1,153
"کرمان","جیرفت","چبالبارز",19,90,1,0,11,102,0,102
"کرمان","جیرفت","چبالبارز",20,218,0,0,3,221,0,221
"کرمان","جیرفت","چبالبارز",21,447,0,0,5,452,0,452
"کرمان","جیرفت","ساردوئیه",1,883,7,3,216,1109,7,1116
"کرمان","جیرفت","ساردوئیه",2,597,1,2,188,788,4,792
"کرمان","جیرفت","ساردوئیه",3,307,6,3,134,450,3,453
"کرمان","جیرفت","ساردوئیه",4,593,1,1,29,624,0,624
"کرمان","جیرفت","ساردوئیه",5,331,0,0,9,340,0,340
"کرمان","جیرفت","ساردوئیه",6,287,1,0,41,329,1,330
"کرمان","جیرفت","ساردوئیه",7,654,5,5,69,733,6,739
"کرمان","جیرفت","ساردوئیه",8,592,1,0,37,630,0,630
"کرمان","جیرفت","ساردوئیه",9,440,1,0,12,453,1,454
"کرمان","جیرفت","ساردوئیه",10,454,2,3,40,499,1,500
"کرمان","جیرفت","ساردوئیه",11,421,1,0,10,432,8,440
"کرمان","جیرفت","ساردوئیه",12,608,0,0,26,634,1,635
"کرمان","جیرفت","ساردوئیه",13,221,1,0,15,237,1,238
"کرمان","جیرفت","ساردوئیه",14,468,2,1,38,509,0,509
"کرمان","جیرفت","ساردوئیه",15,829,1,0,35,865,0,865
"کرمان","جیرفت","ساردوئیه",16,256,2,5,90,353,0,353
"کرمان","جیرفت","ساردوئیه",17,266,0,0,24,290,0,290
"کرمان","جیرفت","ساردوئیه",18,301,0,1,13,315,0,315
"کرمان","جیرفت","ساردوئیه",19,646,0,0,18,664,0,664
"کرمان","جیرفت","ساردوئیه",20,622,0,0,23,645,0,645
"کرمان","جیرفت","ساردوئیه",21,879,0,0,21,900,0,900
"کرمان","جیرفت","ساردوئیه",22,418,0,0,57,475,0,475
"کرمان","جیرفت","ساردوئیه",23,821,7,3,169,1000,0,1000
"کرمان","جیرفت","ساردوئیه",24,512,2,1,113,628,0,628
"کرمان","جیرفت","ساردوئیه",25,711,1,0,88,800,0,800
"کرمان","جیرفت","ساردوئیه",26,907,0,1,116,1024,2,1026
"کرمان","جیرفت","ساردوئیه",27,776,0,0,103,879,0,879
"کرمان","جیرفت","ساردوئیه",28,541,0,0,15,556,1,557
"کرمان","جیرفت","ساردوئیه",29,196,2,1,3,202,0,202
"کرمان","جیرفت","ساردوئیه",30,718,0,0,30,748,0,748
"کرمان","جیرفت","ساردوئیه",31,593,0,0,14,607,0,607
"کرمان","جیرفت","ساردوئیه",32,669,0,0,16,685,0,685
"کرمان","جیرفت","ساردوئیه",33,893,0,0,7,900,0,900
"کرمان","جیرفت","ساردوئیه",34,225,1,0,14,240,1,241
"کرمان","راور","مرکزی",1,1196,8,4,354,1562,17,1579
"کرمان","راور","مرکزی",2,336,3,3,55,397,8,405
"کرمان","راور","مرکزی",3,649,11,0,150,810,5,815
"کرمان","راور","مرکزی",4,827,10,0,104,941,0,941
"کرمان","راور","مرکزی",5,830,5,3,148,986,9,995
"کرمان","راور","مرکزی",6,672,6,4,173,855,6,861
"کرمان","راور","مرکزی",7,533,3,0,129,665,5,670
"کرمان","راور","مرکزی",8,838,5,1,243,1087,12,1099
"کرمان","راور","مرکزی",9,692,6,0,131,829,5,834
"کرمان","راور","مرکزی",10,345,1,2,92,440,6,446
"کرمان","راور","مرکزی",11,629,5,3,154,791,9,800
"کرمان","راور","مرکزی",12,1048,13,0,303,1364,11,1375
"کرمان","راور","مرکزی",13,929,14,1,163,1107,12,1119
"کرمان","راور","مرکزی",14,597,16,2,188,803,6,809
"کرمان","راور","مرکزی",15,559,1,0,97,657,7,664
"کرمان","راور","مرکزی",16,588,5,0,138,731,6,737
"کرمان","راور","مرکزی",17,409,2,2,67,480,1,481
"کرمان","راور","مرکزی",18,663,0,0,55,718,0,718
"کرمان","راور","مرکزی",19,707,0,0,75,782,5,787
"کرمان","راور","مرکزی",20,434,0,0,64,498,3,501
"کرمان","راور","مرکزی",21,523,0,0,92,615,2,617
"کرمان","راور","مرکزی",22,395,2,0,97,494,5,499
"کرمان","راور","مرکزی",23,426,0,0,67,493,0,493
"کرمان","راور","مرکزی",24,505,3,0,22,530,5,535
"کرمان","راور","مرکزی",25,490,0,1,29,520,0,520
"کرمان","راور","مرکزی",26,556,1,0,39,596,0,596
"کرمان","راور","کوهساران",1,408,2,1,86,497,3,500
"کرمان","راور","کوهساران",2,377,0,0,33,410,2,412
"کرمان","راور","کوهساران",3,305,0,0,67,372,2,374
"کرمان","راور","کوهساران",4,231,3,0,39,273,4,277
"کرمان","راور","کوهساران",5,334,2,1,80,417,7,424
"کرمان","راور","کوهساران",6,371,2,2,62,437,4,441
"کرمان","راور","کوهساران",7,378,1,0,39,418,2,420
"کرمان","راور","کوهساران",8,281,2,0,15,298,0,298
"کرمان","رفسنجان","مرکزی",1,768,33,9,657,1467,25,1492
"کرمان","رفسنجان","مرکزی",2,527,22,5,504,1058,13,1071
"کرمان","رفسنجان","مرکزی",3,753,21,3,466,1243,12,1255
"کرمان","رفسنجان","مرکزی",4,187,11,1,227,426,10,436
"کرمان","رفسنجان","مرکزی",5,646,20,5,574,1245,23,1268
"کرمان","رفسنجان","مرکزی",6,615,26,5,489,1135,15,1150
"کرمان","رفسنجان","مرکزی",7,510,8,5,436,959,5,964
"کرمان","رفسنجان","مرکزی",8,172,4,2,190,368,3,371
"کرمان","رفسنجان","مرکزی",9,92,1,1,77,171,4,175
"کرمان","رفسنجان","مرکزی",10,399,9,8,339,755,12,767
"کرمان","رفسنجان","مرکزی",11,436,15,14,497,962,13,975
"کرمان","رفسنجان","مرکزی",12,702,21,9,658,1390,11,1401
"کرمان","رفسنجان","مرکزی",13,413,14,5,329,761,2,763
"کرمان","رفسنجان","مرکزی",14,474,16,4,600,1094,14,1108
"کرمان","رفسنجان","مرکزی",15,714,21,2,588,1325,12,1337
"کرمان","رفسنجان","مرکزی",16,915,20,1,734,1670,15,1685
"کرمان","رفسنجان","مرکزی",17,258,5,2,208,473,2,475
"کرمان","رفسنجان","مرکزی",18,750,16,2,351,1119,14,1133
"کرمان","رفسنجان","مرکزی",19,916,3,4,346,1269,11,1280
"کرمان","رفسنجان","مرکزی",20,420,4,3,315,742,4,746
"کرمان","رفسنجان","مرکزی",21,433,21,1,471,926,13,939
"کرمان","رفسنجان","مرکزی",22,546,18,5,467,1036,14,1050
"کرمان","رفسنجان","مرکزی",23,676,13,2,365,1056,6,1062
"کرمان","رفسنجان","مرکزی",24,338,7,7,386,738,8,746
"کرمان","رفسنجان","مرکزی",25,585,12,2,262,861,10,871
"کرمان","رفسنجان","مرکزی",26,495,15,2,375,887,13,900
"کرمان","رفسنجان","مرکزی",27,1009,16,1,466,1492,12,1504
"کرمان","رفسنجان","مرکزی",28,588,4,0,360,952,8,960
"کرمان","رفسنجان","مرکزی",29,536,18,5,479,1038,8,1046
"کرمان","رفسنجان","مرکزی",30,954,8,2,255,1219,3,1222
"کرمان","رفسنجان","مرکزی",31,494,29,2,591,1116,8,1124
"کرمان","رفسنجان","مرکزی",32,531,6,2,392,931,13,944
"کرمان","رفسنجان","مرکزی",33,835,27,1,438,1301,12,1313
"کرمان","رفسنجان","مرکزی",34,481,11,4,301,797,9,806
"کرمان","رفسنجان","مرکزی",35,852,14,1,351,1218,19,1237
"کرمان","رفسنجان","مرکزی",36,519,16,7,261,803,10,813
"کرمان","رفسنجان","مرکزی",37,981,13,8,366,1368,16,1384
"کرمان","رفسنجان","مرکزی",38,315,12,3,249,579,8,587
"کرمان","رفسنجان","مرکزی",39,442,10,1,258,711,6,717
"کرمان","رفسنجان","مرکزی",40,721,22,8,686,1437,12,1449
"کرمان","رفسنجان","مرکزی",41,640,17,1,461,1119,13,1132
"کرمان","رفسنجان","مرکزی",42,203,13,1,180,397,9,406
"کرمان","رفسنجان","مرکزی",43,573,9,2,253,837,12,849
"کرمان","رفسنجان","مرکزی",44,302,3,2,188,495,4,499
"کرمان","رفسنجان","مرکزی",45,860,7,1,332,1200,8,1208
"کرمان","رفسنجان","مرکزی",46,301,14,5,298,618,2,620
"کرمان","رفسنجان","مرکزی",47,362,4,0,244,610,6,616
"کرمان","رفسنجان","مرکزی",48,260,1,0,96,357,2,359
"کرمان","رفسنجان","مرکزی",49,677,4,1,226,908,7,915
"کرمان","رفسنجان","مرکزی",50,572,7,2,372,953,9,962
"کرمان","رفسنجان","مرکزی",51,374,13,3,236,626,7,633
"کرمان","رفسنجان","مرکزی",52,397,17,4,356,774,12,786
"کرمان","رفسنجان","مرکزی",53,499,26,2,426,953,12,965
"کرمان","رفسنجان","مرکزی",54,481,18,10,633,1142,9,1151
"کرمان","رفسنجان","مرکزی",55,565,26,4,831,1426,17,1443
"کرمان","رفسنجان","مرکزی",56,216,14,3,404,637,11,648
"کرمان","رفسنجان","مرکزی",57,272,10,4,342,628,10,638
"کرمان","رفسنجان","مرکزی",58,272,15,3,502,792,12,804
"کرمان","رفسنجان","مرکزی",59,682,9,1,252,944,9,953
"کرمان","رفسنجان","مرکزی",60,718,9,2,203,932,10,942
"کرمان","رفسنجان","مرکزی",61,883,28,6,641,1558,23,1581
"کرمان","رفسنجان","مرکزی",62,411,10,0,290,711,13,724
"کرمان","رفسنجان","مرکزی",63,652,17,4,382,1055,18,1073
"کرمان","رفسنجان","مرکزی",64,604,16,2,374,996,22,1018
"کرمان","رفسنجان","مرکزی",65,999,8,6,405,1418,15,1433
"کرمان","رفسنجان","مرکزی",66,372,14,5,216,607,6,613
"کرمان","رفسنجان","مرکزی",67,730,12,0,304,1046,13,1059
"کرمان","رفسنجان","مرکزی",68,155,5,2,70,232,4,236
"کرمان","رفسنجان","مرکزی",69,812,12,4,260,1088,12,1100
"کرمان","رفسنجان","مرکزی",70,235,7,0,90,332,1,333
"کرمان","رفسنجان","مرکزی",71,357,5,0,111,473,2,475
"کرمان","رفسنجان","مرکزی",72,844,12,10,388,1254,14,1268
"کرمان","رفسنجان","مرکزی",73,234,9,0,151,394,3,397
"کرمان","رفسنجان","مرکزی",74,834,17,8,396,1255,10,1265
"کرمان","رفسنجان","مرکزی",75,952,22,3,332,1309,19,1328
"کرمان","رفسنجان","مرکزی",76,920,34,2,521,1477,12,1489
"کرمان","رفسنجان","مرکزی",77,249,13,0,217,479,12,491
"کرمان","رفسنجان","مرکزی",78,608,13,2,443,1066,14,1080
"کرمان","رفسنجان","مرکزی",79,706,15,2,579,1302,14,1316
"کرمان","رفسنجان","مرکزی",80,269,14,0,240,523,7,530
"کرمان","رفسنجان","مرکزی",81,732,16,2,328,1078,12,1090
"کرمان","رفسنجان","مرکزی",82,555,29,1,339,924,9,933
"کرمان","رفسنجان","مرکزی",83,405,15,0,155,575,10,585
"کرمان","رفسنجان","مرکزی",84,617,22,6,361,1006,34,1040
"کرمان","رفسنجان","مرکزی",85,880,5,5,169,1059,0,1059
"کرمان","رفسنجان","مرکزی",86,435,2,0,92,529,3,532
"کرمان","رفسنجان","مرکزی",87,542,16,2,152,712,0,712
"کرمان","رفسنجان","مرکزی",88,800,8,0,234,1042,3,1045
"کرمان","رفسنجان","مرکزی",89,430,3,0,66,499,1,500
"کرمان","رفسنجان","مرکزی",90,436,5,0,117,558,1,559
"کرمان","رفسنجان","مرکزی",91,733,6,0,140,879,4,883
"کرمان","رفسنجان","مرکزی",92,793,9,2,131,935,4,939
"کرمان","رفسنجان","مرکزی",93,1201,8,0,281,1490,10,1500
"کرمان","رفسنجان","مرکزی",94,561,3,1,112,677,5,682
"کرمان","رفسنجان","مرکزی",95,692,8,0,217,917,5,922
"کرمان","رفسنجان","مرکزی",96,473,7,0,137,617,4,621
"کرمان","رفسنجان","مرکزی",97,1163,10,1,171,1345,11,1356
"کرمان","رفسنجان","مرکزی",98,467,5,2,78,552,4,556
"کرمان","رفسنجان","مرکزی",99,927,14,2,299,1242,12,1254
"کرمان","رفسنجان","مرکزی",100,565,3,0,137,705,3,708
"کرمان","رفسنجان","مرکزی",101,601,2,1,189,793,1,794
"کرمان","رفسنجان","مرکزی",102,863,11,1,185,1060,4,1064
"کرمان","رفسنجان","مرکزی",103,835,14,4,386,1239,2,1241
"کرمان","رفسنجان","مرکزی",104,940,9,0,355,1304,11,1315
"کرمان","رفسنجان","مرکزی",105,488,6,1,178,673,0,673
"کرمان","رفسنجان","مرکزی",106,941,4,0,102,1047,3,1050
"کرمان","رفسنجان","مرکزی",107,523,12,1,232,768,5,773
"کرمان","رفسنجان","مرکزی",108,703,4,2,186,895,6,901
"کرمان","رفسنجان","مرکزی",109,420,7,0,294,721,1,722
"کرمان","رفسنجان","مرکزی",110,607,4,0,140,751,3,754
"کرمان","رفسنجان","مرکزی",111,563,9,1,266,839,9,848
"کرمان","رفسنجان","مرکزی",112,498,2,2,176,678,3,681
"کرمان","رفسنجان","مرکزی",113,531,5,0,185,721,0,721
"کرمان","رفسنجان","مرکزی",114,635,1,1,227,864,4,868
"کرمان","رفسنجان","مرکزی",115,499,4,0,149,652,9,661
"کرمان","رفسنجان","مرکزی",116,509,2,1,214,726,4,730
"کرمان","رفسنجان","مرکزی",117,773,21,3,353,1150,10,1160
"کرمان","رفسنجان","مرکزی",118,820,12,2,201,1035,8,1043
"کرمان","رفسنجان","مرکزی",119,377,7,0,300,684,10,694
"کرمان","رفسنجان","مرکزی",120,905,10,1,264,1180,10,1190
"کرمان","رفسنجان","مرکزی",121,704,12,1,369,1086,7,1093
"کرمان","رفسنجان","مرکزی",122,806,11,1,256,1074,9,1083
"کرمان","رفسنجان","مرکزی",123,795,5,1,193,994,6,1000
"کرمان","رفسنجان","مرکزی",124,994,25,1,326,1346,4,1350
"کرمان","رفسنجان","مرکزی",125,838,6,0,202,1046,2,1048
"کرمان","رفسنجان","مرکزی",126,126,3,3,79,211,0,211
"کرمان","رفسنجان","مرکزی",127,1049,22,8,522,1601,9,1610
"کرمان","رفسنجان","مرکزی",128,815,24,12,471,1322,11,1333
"کرمان","رفسنجان","مرکزی",129,294,8,4,174,480,3,483
"کرمان","رفسنجان","مرکزی",130,137,7,1,90,235,2,237
"کرمان","رفسنجان","مرکزی",131,305,5,3,81,394,4,398
"کرمان","رفسنجان","مرکزی",132,539,7,2,177,725,3,728
"کرمان","رفسنجان","مرکزی",133,457,7,0,134,598,1,599
"کرمان","رفسنجان","مرکزی",134,693,11,4,345,1053,1,1054
"کرمان","رفسنجان","مرکزی",135,766,11,1,214,992,7,999
"کرمان","رفسنجان","مرکزی",136,720,20,3,259,1002,4,1006
"کرمان","رفسنجان","انار",1,1100,18,7,465,1590,15,1605
"کرمان","رفسنجان","انار",2,382,2,2,171,557,2,559
"کرمان","رفسنجان","انار",3,1049,12,5,525,1591,9,1600
"کرمان","رفسنجان","انار",4,787,13,3,379,1182,14,1196
"کرمان","رفسنجان","انار",5,751,9,1,348,1109,4,1113
"کرمان","رفسنجان","انار",6,702,9,1,323,1035,4,1039
"کرمان","رفسنجان","انار",7,550,7,8,275,840,2,842
"کرمان","رفسنجان","انار",8,1115,13,1,350,1479,10,1489
"کرمان","رفسنجان","انار",9,264,6,0,111,381,0,381
"کرمان","رفسنجان","انار",10,360,3,0,97,460,2,462
"کرمان","رفسنجان","انار",11,174,7,0,181,362,3,365
"کرمان","رفسنجان","انار",12,1022,12,1,336,1371,10,1381
"کرمان","رفسنجان","انار",13,964,16,1,203,1184,2,1186
"کرمان","رفسنجان","انار",14,494,6,0,121,621,2,623
"کرمان","رفسنجان","انار",15,695,7,1,177,880,5,885
"کرمان","رفسنجان","انار",16,696,2,0,236,934,10,944
"کرمان","رفسنجان","انار",17,586,11,0,119,716,8,724
"کرمان","رفسنجان","انار",18,508,7,1,116,632,7,639
"کرمان","رفسنجان","انار",19,309,6,1,114,430,4,434
"کرمان","رفسنجان","انار",20,394,4,1,31,430,1,431
"کرمان","رفسنجان","انار",21,588,1,0,105,694,1,695
"کرمان","رفسنجان","کشکوئیه",1,1024,22,4,494,1544,18,1562
"کرمان","رفسنجان","کشکوئیه",2,1109,8,0,222,1339,5,1344
"کرمان","رفسنجان","کشکوئیه",3,410,15,2,279,706,11,717
"کرمان","رفسنجان","کشکوئیه",4,605,5,1,302,913,8,921
"کرمان","رفسنجان","کشکوئیه",5,482,3,0,412,897,10,907
"کرمان","رفسنجان","کشکوئیه",6,746,10,1,278,1035,6,1041
"کرمان","رفسنجان","کشکوئیه",7,663,7,1,194,865,5,870
"کرمان","رفسنجان","کشکوئیه",8,552,8,4,149,713,6,719
"کرمان","رفسنجان","کشکوئیه",9,566,11,0,201,778,3,781
"کرمان","رفسنجان","کشکوئیه",10,645,8,4,213,870,5,875
"کرمان","رفسنجان","کشکوئیه",11,756,11,2,205,974,1,975
"کرمان","رفسنجان","کشکوئیه",12,166,1,0,169,336,1,337
"کرمان","رفسنجان","کشکوئیه",13,374,6,0,110,490,6,496
"کرمان","رفسنجان","کشکوئیه",14,353,0,0,150,503,1,504
"کرمان","رفسنجان","کشکوئیه",15,290,2,0,45,337,3,340
"کرمان","رفسنجان","نوق",1,248,19,1,573,841,7,848
"کرمان","رفسنجان","نوق",2,237,24,1,799,1061,8,1069
"کرمان","رفسنجان","نوق",3,172,9,0,420,601,4,605
"کرمان","رفسنجان","نوق",4,362,16,0,399,777,4,781
"کرمان","رفسنجان","نوق",5,243,5,0,215,463,2,465
"کرمان","رفسنجان","نوق",6,312,20,0,131,463,1,464
"کرمان","رفسنجان","نوق",7,677,26,1,174,878,1,879
"کرمان","رفسنجان","نوق",8,649,24,0,243,916,10,926
"کرمان","رفسنجان","نوق",9,273,7,0,136,416,1,417
"کرمان","رفسنجان","فردوس",1,656,3,0,315,974,10,984
"کرمان","رفسنجان","فردوس",2,600,2,1,240,843,3,846
"کرمان","رفسنجان","فردوس",3,723,3,0,183,909,8,917
"کرمان","رفسنجان","فردوس",4,858,12,0,216,1086,4,1090
"کرمان","رفسنجان","فردوس",5,322,5,0,108,435,4,439
"کرمان","رفسنجان","فردوس",6,522,4,2,137,665,2,667
"کرمان","رودبار_جنوب","مرکزی",1,738,1,0,13,752,0,752
"کرمان","رودبار_جنوب","مرکزی",2,668,2,1,23,694,3,697
"کرمان","رودبار_جنوب","مرکزی",3,562,1,0,9,572,2,574
"کرمان","رودبار_جنوب","مرکزی",4,1473,6,0,101,1580,0,1580
"کرمان","رودبار_جنوب","مرکزی",5,429,0,2,106,537,11,548
"کرمان","رودبار_جنوب","مرکزی",6,301,0,0,65,366,0,366
"کرمان","رودبار_جنوب","مرکزی",7,488,2,0,18,508,2,510
"کرمان","رودبار_جنوب","مرکزی",8,605,0,0,3,608,0,608
"کرمان","رودبار_جنوب","مرکزی",9,902,1,0,3,906,0,906
"کرمان","رودبار_جنوب","مرکزی",10,787,0,0,10,797,0,797
"کرمان","رودبار_جنوب","مرکزی",11,622,0,0,36,658,0,658
"کرمان","رودبار_جنوب","مرکزی",12,649,1,0,5,655,1,656
"کرمان","رودبار_جنوب","مرکزی",13,721,0,0,17,738,0,738
"کرمان","رودبار_جنوب","مرکزی",14,368,1,1,2,372,1,373
"کرمان","رودبار_جنوب","مرکزی",15,532,1,0,4,537,2,539
"کرمان","رودبار_جنوب","مرکزی",16,1048,2,0,14,1064,1,1065
"کرمان","رودبار_جنوب","مرکزی",17,744,0,0,53,797,3,800
"کرمان","رودبار_جنوب","مرکزی",18,381,0,0,5,386,0,386
"کرمان","رودبار_جنوب","مرکزی",19,405,1,0,2,408,0,408
"کرمان","رودبار_جنوب","مرکزی",20,372,1,2,6,381,0,381
"کرمان","رودبار_جنوب","مرکزی",21,1180,0,0,13,1193,0,1193
"کرمان","رودبار_جنوب","مرکزی",22,1065,0,0,15,1080,0,1080
"کرمان","رودبار_جنوب","مرکزی",23,539,0,0,2,541,0,541
"کرمان","رودبار_جنوب","مرکزی",24,891,0,0,12,903,0,903
"کرمان","رودبار_جنوب","مرکزی",25,1050,0,1,5,1056,0,1056
"کرمان","رودبار_جنوب","مرکزی",26,890,0,0,8,898,0,898
"کرمان","رودبار_جنوب","مرکزی",27,347,1,0,1,349,0,349
"کرمان","رودبار_جنوب","مرکزی",28,598,0,0,5,603,3,606
"کرمان","رودبار_جنوب","مرکزی",29,303,0,0,0,303,0,303
"کرمان","رودبار_جنوب","مرکزی",30,286,0,0,1,287,0,287
"کرمان","رودبار_جنوب","مرکزی",31,184,0,0,0,184,3,187
"کرمان","رودبار_جنوب","مرکزی",32,1347,0,0,3,1350,1,1351
"کرمان","رودبار_جنوب","مرکزی",33,171,0,0,36,207,5,212
"کرمان","رودبار_جنوب","مرکزی",34,550,0,0,5,555,0,555
"کرمان","رودبار_جنوب","مرکزی",35,309,1,0,42,352,2,354
"کرمان","رودبار_جنوب","مرکزی",36,595,0,1,0,596,0,596
"کرمان","رودبار_جنوب","مرکزی",37,841,0,0,7,848,0,848
"کرمان","رودبار_جنوب","مرکزی",38,682,0,0,10,692,2,694
"کرمان","رودبار_جنوب","مرکزی",39,1285,1,0,11,1297,0,1297
"کرمان","رودبار_جنوب","مرکزی",40,745,0,0,8,753,2,755
"کرمان","رودبار_جنوب","مرکزی",41,824,0,0,0,824,0,824
"کرمان","رودبار_جنوب","مرکزی",42,536,0,0,2,538,0,538
"کرمان","رودبار_جنوب","مرکزی",43,872,0,0,5,877,0,877
"کرمان","رودبار_جنوب","مرکزی",44,603,0,0,0,603,0,603
"کرمان","رودبار_جنوب","مرکزی",45,752,0,0,0,752,0,752
"کرمان","رودبار_جنوب","جازموریان",1,1170,1,1,5,1177,0,1177
"کرمان","رودبار_جنوب","جازموریان",2,1686,0,0,3,1689,11,1700
"کرمان","رودبار_جنوب","جازموریان",3,395,0,0,3,398,0,398
"کرمان","رودبار_جنوب","جازموریان",4,906,2,0,8,916,0,916
"کرمان","رودبار_جنوب","جازموریان",5,1202,3,0,30,1235,11,1246
"کرمان","رودبار_جنوب","جازموریان",6,517,0,0,99,616,1,617
"کرمان","رودبار_جنوب","جازموریان",7,436,0,0,11,447,0,447
"کرمان","رودبار_جنوب","جازموریان",8,832,0,1,11,844,3,847
"کرمان","رودبار_جنوب","جازموریان",9,498,0,0,1,499,0,499
"کرمان","رودبار_جنوب","جازموریان",10,931,0,0,7,938,7,945
"کرمان","رودبار_جنوب","جازموریان",11,841,0,0,9,850,0,850
"کرمان","رودبار_جنوب","جازموریان",12,698,0,0,2,700,0,700
"کرمان","رودبار_جنوب","جازموریان",13,565,2,0,0,567,0,567
"کرمان","رودبار_جنوب","جازموریان",14,832,1,4,7,844,1,845
"کرمان","رودبار_جنوب","جازموریان",15,676,0,0,0,676,1,677
"کرمان","رودبار_جنوب","جازموریان",16,559,0,1,12,572,1,573
"کرمان","رودبار_جنوب","جازموریان",17,552,0,0,2,554,3,557
"کرمان","رودبار_جنوب","جازموریان",18,1012,0,0,3,1015,1,1016
"کرمان","رودبار_جنوب","جازموریان",19,521,2,4,16,543,1,544
"کرمان","رودبار_جنوب","جازموریان",20,979,0,0,4,983,1,984
"کرمان","رودبار_جنوب","جازموریان",21,1231,0,0,1,1232,10,1242
"کرمان","رودبار_جنوب","جازموریان",22,798,0,0,0,798,0,798
"کرمان","رودبار_جنوب","جازموریان",23,226,0,0,28,254,0,254
"کرمان","رودبار_جنوب","جازموریان",24,393,0,0,5,398,2,400
"کرمان","رودبار_جنوب","جازموریان",25,430,0,0,26,456,0,456
"کرمان","رودبار_جنوب","جازموریان",26,276,0,0,0,276,0,276
"کرمان","رودبار_جنوب","جازموریان",27,385,0,0,0,385,0,385
"کرمان","رودبار_جنوب","جازموریان",28,482,0,0,0,482,0,482
"کرمان","رودبار_جنوب","جازموریان",29,251,0,0,0,251,0,251
"کرمان","رودبار_جنوب","جازموریان",30,200,0,0,0,200,0,200
"کرمان","ریگان","مرکزی",1,194,0,0,0,194,0,194
"کرمان","ریگان","مرکزی",2,170,0,0,0,170,0,170
"کرمان","ریگان","مرکزی",3,270,0,0,0,270,0,270
"کرمان","ریگان","مرکزی",4,297,0,0,2,299,1,300
"کرمان","ریگان","مرکزی",5,300,0,0,0,300,0,300
"کرمان","ریگان","مرکزی",6,453,6,0,49,508,0,508
"کرمان","ریگان","مرکزی",7,400,0,0,0,400,0,400
"کرمان","ریگان","مرکزی",8,888,0,0,0,888,0,888
"کرمان","ریگان","مرکزی",9,516,0,0,94,610,22,632
"کرمان","ریگان","مرکزی",10,495,2,1,16,514,1,515
"کرمان","ریگان","مرکزی",11,565,1,0,33,599,0,599
"کرمان","ریگان","مرکزی",12,778,0,0,22,800,0,800
"کرمان","ریگان","مرکزی",13,676,0,0,3,679,1,680
"کرمان","ریگان","مرکزی",14,762,4,2,115,883,0,883
"کرمان","ریگان","مرکزی",15,345,1,2,23,371,0,371
"کرمان","ریگان","مرکزی",16,751,0,0,83,834,5,839
"کرمان","ریگان","مرکزی",17,972,1,0,27,1000,0,1000
"کرمان","ریگان","مرکزی",18,589,0,0,21,610,2,612
"کرمان","ریگان","مرکزی",19,723,2,0,8,733,0,733
"کرمان","ریگان","مرکزی",20,1085,0,0,3,1088,1,1089
"کرمان","ریگان","مرکزی",21,475,0,0,16,491,0,491
"کرمان","ریگان","مرکزی",22,1204,0,0,77,1281,8,1289
"کرمان","ریگان","مرکزی",23,564,0,0,1,565,2,567
"کرمان","ریگان","مرکزی",24,562,0,0,0,562,2,564
"کرمان","ریگان","مرکزی",25,316,0,2,81,399,0,399
"کرمان","ریگان","مرکزی",26,880,0,0,0,880,0,880
"کرمان","ریگان","مرکزی",27,717,1,0,10,728,0,728
"کرمان","ریگان","مرکزی",28,970,0,0,30,1000,0,1000
"کرمان","ریگان","مرکزی",29,905,0,0,41,946,0,946
"کرمان","ریگان","مرکزی",30,462,0,0,10,472,13,485
"کرمان","ریگان","مرکزی",31,674,0,0,15,689,13,702
"کرمان","ریگان","مرکزی",32,844,0,0,17,861,0,861
"کرمان","ریگان","مرکزی",33,846,0,2,23,871,0,871
"کرمان","ریگان","مرکزی",34,791,0,0,1,792,2,794
"کرمان","ریگان","مرکزی",35,585,2,0,48,635,6,641
"کرمان","ریگان","مرکزی",36,517,0,0,36,553,0,553
"کرمان","ریگان","گنبکی",37,530,1,2,6,539,1,540
"کرمان","ریگان","گنبکی",38,661,0,0,9,670,0,670
"کرمان","ریگان","گنبکی",39,917,3,0,14,934,0,934
"کرمان","ریگان","گنبکی",40,542,1,1,48,592,0,592
"کرمان","ریگان","گنبکی",41,790,0,0,9,799,1,800
"کرمان","ریگان","گنبکی",42,601,0,0,7,608,0,608
"کرمان","ریگان","گنبکی",43,407,1,0,6,414,1,415
"کرمان","ریگان","گنبکی",44,694,0,0,6,700,0,700
"کرمان","ریگان","گنبکی",45,600,0,0,8,608,0,608
"کرمان","ریگان","گنبکی",46,490,1,0,4,495,0,495
"کرمان","ریگان","گنبکی",47,690,2,0,9,701,0,701
"کرمان","ریگان","گنبکی",48,201,0,0,0,201,1,202
"کرمان","ریگان","گنبکی",49,599,0,0,0,599,0,599
"کرمان","ریگان","گنبکی",50,427,0,0,0,427,0,427
"کرمان","زرند","مرکزی",1,631,19,1,345,996,11,1007
"کرمان","زرند","مرکزی",2,573,11,2,383,969,8,977
"کرمان","زرند","مرکزی",3,284,5,4,152,445,6,451
"کرمان","زرند","مرکزی",4,528,1,1,141,671,3,674
"کرمان","زرند","مرکزی",5,211,3,0,177,391,3,394
"کرمان","زرند","مرکزی",6,489,12,2,308,811,7,818
"کرمان","زرند","مرکزی",7,621,13,4,429,1067,13,1080
"کرمان","زرند","مرکزی",8,834,6,2,310,1152,12,1164
"کرمان","زرند","مرکزی",9,428,4,2,233,667,8,675
"کرمان","زرند","مرکزی",10,443,13,0,224,680,7,687
"کرمان","زرند","مرکزی",11,481,12,1,251,745,8,753
"کرمان","زرند","مرکزی",12,688,10,0,365,1063,21,1084
"کرمان","زرند","مرکزی",13,254,3,0,102,359,7,366
"کرمان","زرند","مرکزی",14,552,5,1,300,858,7,865
"کرمان","زرند","مرکزی",15,387,6,0,214,607,5,612
"کرمان","زرند","مرکزی",16,968,29,0,589,1586,16,1602
"کرمان","زرند","مرکزی",17,534,9,0,285,828,16,844
"کرمان","زرند","مرکزی",18,904,15,2,410,1331,23,1354
"کرمان","زرند","مرکزی",19,582,15,0,288,885,15,900
"کرمان","زرند","مرکزی",20,365,8,1,207,581,12,593
"کرمان","زرند","مرکزی",21,545,9,0,373,927,15,942
"کرمان","زرند","مرکزی",22,999,8,3,449,1459,17,1476
"کرمان","زرند","مرکزی",23,367,4,1,206,578,10,588
"کرمان","زرند","مرکزی",24,295,11,0,160,466,6,472
"کرمان","زرند","مرکزی",25,542,5,3,220,770,10,780
"کرمان","زرند","مرکزی",26,708,6,3,237,954,12,966
"کرمان","زرند","مرکزی",27,259,2,0,89,350,1,351
"کرمان","زرند","مرکزی",28,282,8,0,126,416,1,417
"کرمان","زرند","مرکزی",29,445,6,2,275,728,5,733
"کرمان","زرند","مرکزی",30,615,13,3,411,1042,17,1059
"کرمان","زرند","مرکزی",31,261,5,1,152,419,3,422
"کرمان","زرند","مرکزی",32,816,12,3,442,1273,17,1290
"کرمان","زرند","مرکزی",33,415,17,1,337,770,7,777
"کرمان","زرند","مرکزی",34,304,8,0,110,422,4,426
"کرمان","زرند","مرکزی",35,401,9,0,242,652,7,659
"کرمان","زرند","مرکزی",36,895,21,1,659,1576,22,1598
"کرمان","زرند","مرکزی",37,475,6,0,247,728,13,741
"کرمان","زرند","مرکزی",38,343,12,0,204,559,5,564
"کرمان","زرند","مرکزی",39,344,4,0,210,558,6,564
"کرمان","زرند","مرکزی",40,681,6,0,170,857,10,867
"کرمان","زرند","مرکزی",41,907,4,0,143,1054,1,1055
"کرمان","زرند","مرکزی",42,771,6,0,123,900,6,906
"کرمان","زرند","مرکزی",43,463,6,0,192,661,7,668
"کرمان","زرند","مرکزی",44,984,6,1,127,1118,9,1127
"کرمان","زرند","مرکزی",45,508,6,0,134,648,5,653
"کرمان","زرند","مرکزی",46,375,2,0,95,472,3,475
"کرمان","زرند","مرکزی",47,416,1,1,76,494,1,495
"کرمان","زرند","مرکزی",48,975,8,0,124,1107,4,1111
"کرمان","زرند","مرکزی",49,497,5,0,164,666,5,671
"کرمان","زرند","مرکزی",50,305,1,0,53,359,2,361
"کرمان","زرند","مرکزی",51,402,1,0,76,479,1,480
"کرمان","زرند","مرکزی",52,474,3,0,103,580,6,586
"کرمان","زرند","مرکزی",53,577,1,0,95,673,4,677
"کرمان","زرند","مرکزی",54,528,2,0,129,659,2,661
"کرمان","زرند","مرکزی",55,897,12,3,177,1089,9,1098
"کرمان","زرند","مرکزی",56,1078,6,1,141,1226,5,1231
"کرمان","زرند","مرکزی",57,505,6,0,103,614,1,615
"کرمان","زرند","مرکزی",58,610,2,1,57,670,1,671
"کرمان","زرند","مرکزی",59,463,2,0,123,588,1,589
"کرمان","زرند","مرکزی",60,245,2,0,28,275,1,276
"کرمان","زرند","مرکزی",61,388,0,0,43,431,1,432
"کرمان","زرند","مرکزی",62,983,9,0,283,1275,3,1278
"کرمان","زرند","مرکزی",63,864,1,1,144,1010,0,1010
"کرمان","زرند","مرکزی",64,242,2,0,86,330,2,332
"کرمان","زرند","مرکزی",65,141,1,0,42,184,2,186
"کرمان","زرند","مرکزی",66,603,2,0,207,812,11,823
"کرمان","زرند","مرکزی",67,985,2,0,140,1127,6,1133
"کرمان","زرند","مرکزی",68,474,4,0,85,563,2,565
"کرمان","زرند","مرکزی",69,712,6,0,396,1114,3,1117
"کرمان","زرند","مرکزی",70,881,5,1,169,1056,2,1058
"کرمان","زرند","مرکزی",71,1019,4,0,129,1152,6,1158
"کرمان","زرند","مرکزی",72,863,1,1,148,1013,6,1019
"کرمان","زرند","مرکزی",73,309,4,0,131,444,1,445
"کرمان","زرند","مرکزی",74,220,9,2,160,391,4,395
"کرمان","زرند","مرکزی",75,738,3,0,257,998,4,1002
"کرمان","زرند","مرکزی",76,502,5,0,229,736,0,736
"کرمان","زرند","مرکزی",77,611,5,0,185,801,2,803
"کرمان","زرند","مرکزی",78,1101,11,3,189,1304,11,1315
"کرمان","زرند","مرکزی",79,967,14,2,338,1321,8,1329
"کرمان","زرند","مرکزی",80,430,3,1,133,567,9,576
"کرمان","زرند","مرکزی",81,511,7,0,78,596,3,599
"کرمان","زرند","مرکزی",82,526,7,0,94,627,5,632
"کرمان","زرند","مرکزی",83,632,3,0,211,846,1,847
"کرمان","زرند","یزدان_آباد",1,468,2,0,97,567,3,570
"کرمان","زرند","یزدان_آباد",2,399,0,0,57,456,0,456
"کرمان","زرند","یزدان_آباد",3,425,4,0,80,509,5,514
"کرمان","زرند","یزدان_آباد",4,449,4,0,75,528,7,535
"کرمان","زرند","یزدان_آباد",5,481,0,0,51,532,2,534
"کرمان","زرند","یزدان_آباد",6,324,1,0,56,381,2,383
"کرمان","زرند","یزدان_آباد",7,410,1,1,101,513,6,519
"کرمان","زرند","یزدان_آباد",8,827,6,0,140,973,3,976
"کرمان","زرند","یزدان_آباد",9,1109,1,0,240,1350,5,1355
"کرمان","زرند","یزدان_آباد",10,343,0,0,36,379,0,379
"کرمان","زرند","یزدان_آباد",11,558,3,0,108,669,2,671
"کرمان","زرند","یزدان_آباد",12,377,1,0,214,592,0,592
"کرمان","زرند","یزدان_آباد",13,681,7,0,329,1017,5,1022
"کرمان","زرند","یزدان_آباد",14,291,8,2,102,403,3,406
"کرمان","زرند","یزدان_آباد",15,775,9,0,154,938,4,942
"کرمان","سیرجان","مرکزی",1,101,4,2,71,178,5,183
"کرمان","سیرجان","مرکزی",2,603,7,2,433,1045,17,1062
"کرمان","سیرجان","مرکزی",3,588,13,6,240,847,7,854
"کرمان","سیرجان","مرکزی",4,825,11,6,343,1185,14,1199
"کرمان","سیرجان","مرکزی",5,587,16,10,418,1031,12,1043
"کرمان","سیرجان","مرکزی",6,612,13,13,480,1118,14,1132
"کرمان","سیرجان","مرکزی",7,804,5,5,227,1041,9,1050
"کرمان","سیرجان","مرکزی",8,786,20,15,785,1606,22,1628
"کرمان","سیرجان","مرکزی",9,612,20,10,484,1126,10,1136
"کرمان","سیرجان","مرکزی",10,887,10,4,361,1262,15,1277
"کرمان","سیرجان","مرکزی",11,619,19,19,859,1516,11,1527
"کرمان","سیرجان","مرکزی",12,774,20,13,858,1665,19,1684
"کرمان","سیرجان","مرکزی",13,560,20,19,714,1313,29,1342
"کرمان","سیرجان","مرکزی",14,596,19,38,821,1474,21,1495
"کرمان","سیرجان","مرکزی",15,547,13,11,573,1144,20,1164
"کرمان","سیرجان","مرکزی",16,560,20,13,546,1139,20,1159
"کرمان","سیرجان","مرکزی",17,841,19,17,632,1509,12,1521
"کرمان","سیرجان","مرکزی",18,694,12,13,360,1079,14,1093
"کرمان","سیرجان","مرکزی",19,299,0,5,243,547,5,552
"کرمان","سیرجان","مرکزی",20,473,6,3,374,856,11,867
"کرمان","سیرجان","مرکزی",21,1039,5,5,220,1269,5,1274
"کرمان","سیرجان","مرکزی",22,861,8,6,243,1118,12,1130
"کرمان","سیرجان","مرکزی",23,1061,5,2,112,1180,12,1192
"کرمان","سیرجان","مرکزی",24,728,5,1,115,849,7,856
"کرمان","سیرجان","مرکزی",25,1142,8,13,288,1451,13,1464
"کرمان","سیرجان","مرکزی",26,581,7,10,589,1187,19,1206
"کرمان","سیرجان","مرکزی",27,1195,8,7,267,1477,14,1491
"کرمان","سیرجان","مرکزی",28,766,5,10,328,1109,11,1120
"کرمان","سیرجان","مرکزی",29,620,5,4,324,953,8,961
"کرمان","سیرجان","مرکزی",30,794,8,6,375,1183,11,1194
"کرمان","سیرجان","مرکزی",31,1389,9,8,387,1793,27,1820
"کرمان","سیرجان","مرکزی",32,926,14,11,204,1155,7,1162
"کرمان","سیرجان","مرکزی",33,689,8,5,340,1042,6,1048
"کرمان","سیرجان","مرکزی",34,396,11,16,503,926,19,945
"کرمان","سیرجان","مرکزی",35,788,15,16,435,1254,19,1273
"کرمان","سیرجان","مرکزی",36,840,6,3,333,1182,26,1208
"کرمان","سیرجان","مرکزی",37,1130,7,21,511,1669,7,1676
"کرمان","سیرجان","مرکزی",38,1353,3,7,335,1698,13,1711
"کرمان","سیرجان","مرکزی",39,1268,7,3,245,1523,12,1535
"کرمان","سیرجان","مرکزی",40,1027,4,1,100,1132,8,1140
"کرمان","سیرجان","مرکزی",41,762,4,2,178,946,4,950
"کرمان","سیرجان","مرکزی",42,885,14,16,197,1112,11,1123
"کرمان","سیرجان","مرکزی",43,949,4,7,211,1171,9,1180
"کرمان","سیرجان","مرکزی",44,1140,7,1,156,1304,4,1308
"کرمان","سیرجان","مرکزی",45,1104,10,11,273,1398,14,1412
"کرمان","سیرجان","مرکزی",46,804,8,4,189,1005,9,1014
"کرمان","سیرجان","مرکزی",47,766,7,31,202,1006,5,1011
"کرمان","سیرجان","مرکزی",48,986,7,64,185,1242,7,1249
"کرمان","سیرجان","مرکزی",49,964,5,6,212,1187,11,1198
"کرمان","سیرجان","مرکزی",50,406,4,12,328,750,5,755
"کرمان","سیرجان","مرکزی",51,1022,16,11,596,1645,11,1656
"کرمان","سیرجان","مرکزی",52,305,5,3,186,499,4,503
"کرمان","سیرجان","مرکزی",53,621,9,12,683,1325,0,1325
"کرمان","سیرجان","مرکزی",54,765,24,20,1024,1833,24,1857
"کرمان","سیرجان","مرکزی",55,780,3,13,722,1518,11,1529
"کرمان","سیرجان","مرکزی",56,549,18,15,462,1044,11,1055
"کرمان","سیرجان","مرکزی",57,648,12,6,344,1010,18,1028
"کرمان","سیرجان","مرکزی",58,313,8,8,280,609,8,617
"کرمان","سیرجان","مرکزی",59,442,10,2,393,847,11,858
"کرمان","سیرجان","مرکزی",60,610,28,0,375,1013,5,1018
"کرمان","سیرجان","مرکزی",61,1083,13,4,482,1582,0,1582
"کرمان","سیرجان","مرکزی",62,610,15,14,492,1131,21,1152
"کرمان","سیرجان","مرکزی",63,298,3,4,230,535,10,545
"کرمان","سیرجان","مرکزی",64,891,18,5,686,1600,18,1618
"کرمان","سیرجان","مرکزی",65,1329,28,8,455,1820,16,1836
"کرمان","سیرجان","مرکزی",66,1037,23,2,427,1489,11,1500
"کرمان","سیرجان","مرکزی",67,826,11,6,363,1206,5,1211
"کرمان","سیرجان","مرکزی",68,478,18,9,435,940,9,949
"کرمان","سیرجان","مرکزی",69,1027,32,17,982,2058,21,2079
"کرمان","سیرجان","مرکزی",70,742,18,7,726,1493,21,1514
"کرمان","سیرجان","مرکزی",71,373,9,2,214,598,9,607
"کرمان","سیرجان","مرکزی",72,935,24,3,448,1410,15,1425
"کرمان","سیرجان","مرکزی",73,901,23,1,515,1440,12,1452
"کرمان","سیرجان","مرکزی",74,416,5,8,335,764,16,780
"کرمان","سیرجان","مرکزی",75,729,7,9,253,998,7,1005
"کرمان","سیرجان","مرکزی",76,832,10,11,361,1214,13,1227
"کرمان","سیرجان","مرکزی",77,1174,20,7,581,1782,14,1796
"کرمان","سیرجان","مرکزی",78,563,13,2,256,834,7,841
"کرمان","سیرجان","مرکزی",79,563,9,16,284,872,13,885
"کرمان","سیرجان","مرکزی",80,305,3,2,236,546,15,561
"کرمان","سیرجان","مرکزی",81,179,2,8,72,261,5,266
"کرمان","سیرجان","مرکزی",82,217,3,3,107,330,3,333
"کرمان","سیرجان","مرکزی",83,116,1,1,115,233,5,238
"کرمان","سیرجان","مرکزی",84,381,9,3,129,522,7,529
"کرمان","سیرجان","مرکزی",85,214,3,3,109,329,6,335
"کرمان","سیرجان","مرکزی",86,916,10,17,315,1258,11,1269
"کرمان","سیرجان","مرکزی",87,604,1,15,238,858,16,874
"کرمان","سیرجان","مرکزی",88,185,1,1,92,279,1,280
"کرمان","سیرجان","مرکزی",89,455,2,6,178,641,9,650
"کرمان","سیرجان","مرکزی",90,748,5,6,137,896,5,901
"کرمان","سیرجان","مرکزی",91,716,1,4,125,846,4,850
"کرمان","سیرجان","مرکزی",92,1026,3,4,191,1224,7,1231
"کرمان","سیرجان","مرکزی",93,1083,5,5,210,1303,10,1313
"کرمان","سیرجان","مرکزی",94,873,6,6,60,945,0,945
"کرمان","سیرجان","مرکزی",95,202,1,0,166,369,0,369
"کرمان","سیرجان","مرکزی",96,321,1,1,126,449,6,455
"کرمان","سیرجان","مرکزی",97,237,0,2,63,302,0,302
"کرمان","سیرجان","مرکزی",98,403,2,1,118,524,1,525
"کرمان","سیرجان","مرکزی",99,577,1,0,169,747,9,756
"کرمان","سیرجان","مرکزی",100,291,0,1,53,345,2,347
"کرمان","سیرجان","مرکزی",101,1420,3,14,329,1766,2,1768
"کرمان","سیرجان","مرکزی",102,413,2,2,129,546,3,549
"کرمان","سیرجان","مرکزی",103,186,0,1,56,243,0,243
"کرمان","سیرجان","مرکزی",104,374,2,0,67,443,0,443
"کرمان","سیرجان","مرکزی",105,380,3,3,202,588,2,590
"کرمان","سیرجان","مرکزی",106,191,0,0,21,212,1,213
"کرمان","سیرجان","مرکزی",107,1072,3,0,116,1191,2,1193
"کرمان","سیرجان","مرکزی",108,447,1,3,115,566,0,566
"کرمان","سیرجان","مرکزی",109,339,2,1,114,456,8,464
"کرمان","سیرجان","مرکزی",110,637,1,4,109,751,1,752
"کرمان","سیرجان","مرکزی",111,248,4,1,51,304,0,304
"کرمان","سیرجان","مرکزی",112,477,10,0,109,596,0,596
"کرمان","سیرجان","مرکزی",113,731,0,2,127,860,2,862
"کرمان","سیرجان","مرکزی",114,929,3,9,140,1081,3,1084
"کرمان","سیرجان","مرکزی",115,308,3,2,22,335,5,340
"کرمان","سیرجان","مرکزی",116,833,6,0,124,963,4,967
"کرمان","سیرجان","مرکزی",117,831,7,7,168,1013,6,1019
"کرمان","سیرجان","مرکزی",118,1011,9,6,137,1163,4,1167
"کرمان","سیرجان","مرکزی",119,575,2,3,107,687,4,691
"کرمان","سیرجان","مرکزی",120,719,5,0,102,826,6,832
"کرمان","سیرجان","مرکزی",121,772,0,2,145,919,3,922
"کرمان","سیرجان","مرکزی",122,382,3,0,68,453,0,453
"کرمان","سیرجان","مرکزی",123,180,8,3,73,264,3,267
"کرمان","سیرجان","مرکزی",124,282,2,4,21,309,3,312
"کرمان","سیرجان","مرکزی",125,207,0,0,14,221,3,224
"کرمان","سیرجان","مرکزی",126,253,0,4,55,312,0,312
"کرمان","سیرجان","مرکزی",127,389,1,0,35,425,0,425
"کرمان","سیرجان","مرکزی",128,340,1,0,31,372,3,375
"کرمان","سیرجان","مرکزی",129,143,0,0,11,154,0,154
"کرمان","سیرجان","مرکزی",130,1110,8,1,165,1284,5,1289
"کرمان","سیرجان","مرکزی",131,399,1,1,124,525,1,526
"کرمان","سیرجان","مرکزی",132,532,4,1,135,672,1,673
"کرمان","سیرجان","مرکزی",133,469,3,1,105,578,3,581
"کرمان","سیرجان","پاریز",1,877,2,1,170,1050,17,1067
"کرمان","سیرجان","پاریز",2,348,9,3,112,472,8,480
"کرمان","سیرجان","پاریز",3,800,9,4,234,1047,11,1058
"کرمان","سیرجان","پاریز",4,433,5,1,176,615,4,619
"کرمان","سیرجان","پاریز",5,591,2,1,84,678,5,683
"کرمان","سیرجان","پاریز",6,550,2,3,112,667,6,673
"کرمان","سیرجان","پاریز",7,274,1,0,42,317,3,320
"کرمان","سیرجان","پاریز",8,130,1,0,26,157,0,157
"کرمان","سیرجان","پاریز",9,216,3,2,99,320,2,322
"کرمان","سیرجان","پاریز",10,349,0,1,26,376,2,378
"کرمان","سیرجان","پاریز",11,497,3,4,89,593,5,598
"کرمان","سیرجان","پاریز",12,573,5,2,206,786,18,804
"کرمان","سیرجان","پاریز",13,945,4,0,135,1084,10,1094
"کرمان","سیرجان","پاریز",14,635,0,2,63,700,2,702
"کرمان","سیرجان","پاریز",15,466,1,0,48,515,1,516
"کرمان","شهربابک","مرکزی",1,816,11,3,390,1220,16,1236
"کرمان","شهربابک","مرکزی",2,497,1,3,265,766,11,777
"کرمان","شهربابک","مرکزی",3,1073,11,7,535,1626,22,1648
"کرمان","شهربابک","مرکزی",4,262,4,1,158,425,7,432
"کرمان","شهربابک","مرکزی",5,738,7,8,367,1120,6,1126
"کرمان","شهربابک","مرکزی",6,679,13,5,451,1148,11,1159
"کرمان","شهربابک","مرکزی",7,984,9,2,532,1527,13,1540
"کرمان","شهربابک","مرکزی",8,393,1,0,134,528,5,533
"کرمان","شهربابک","مرکزی",9,448,2,1,151,602,2,604
"کرمان","شهربابک","مرکزی",10,920,3,4,272,1199,11,1210
"کرمان","شهربابک","مرکزی",11,791,5,0,157,953,4,957
"کرمان","شهربابک","مرکزی",12,768,4,0,99,871,11,882
"کرمان","شهربابک","مرکزی",13,1251,18,2,492,1763,22,1785
"کرمان","شهربابک","مرکزی",14,553,6,5,123,687,17,704
"کرمان","شهربابک","مرکزی",15,748,4,1,124,877,13,890
"کرمان","شهربابک","مرکزی",16,803,10,1,161,975,5,980
"کرمان","شهربابک","مرکزی",17,908,14,3,184,1109,10,1119
"کرمان","شهربابک","مرکزی",18,1235,8,3,159,1405,9,1414
"کرمان","شهربابک","مرکزی",19,406,12,0,146,564,4,568
"کرمان","شهربابک","مرکزی",20,364,3,0,38,405,0,405
"کرمان","شهربابک","مرکزی",21,432,0,1,76,509,5,514
"کرمان","شهربابک","مرکزی",22,1156,19,4,360,1539,17,1556
"کرمان","شهربابک","مرکزی",23,636,4,0,78,718,3,721
"کرمان","شهربابک","مرکزی",24,648,2,0,33,683,5,688
"کرمان","شهربابک","مرکزی",25,210,1,1,43,255,2,257
"کرمان","شهربابک","مرکزی",26,253,4,0,31,288,4,292
"کرمان","شهربابک","مرکزی",27,834,1,4,151,990,7,997
"کرمان","شهربابک","مرکزی",28,725,4,1,55,785,3,788
"کرمان","شهربابک","مرکزی",29,495,2,0,76,573,1,574
"کرمان","شهربابک","مرکزی",30,414,0,1,46,461,1,462
"کرمان","شهربابک","مرکزی",31,418,6,0,78,502,6,508
"کرمان","شهربابک","مرکزی",32,868,1,0,199,1068,5,1073
"کرمان","شهربابک","مرکزی",33,91,0,0,15,106,1,107
"کرمان","شهربابک","مرکزی",34,273,0,0,116,389,3,392
"کرمان","شهربابک","مرکزی",35,445,1,1,86,533,3,536
"کرمان","شهربابک","مرکزی",36,364,0,0,80,444,3,447
"کرمان","شهربابک","مرکزی",37,594,2,0,129,725,9,734
"کرمان","شهربابک","مرکزی",38,1032,10,0,119,1161,3,1164
"کرمان","شهربابک","مرکزی",39,592,4,1,119,716,8,724
"کرمان","شهربابک","مرکزی",40,102,0,0,34,136,3,139
"کرمان","شهربابک","مرکزی",41,110,0,1,19,130,3,133
"کرمان","شهربابک","مرکزی",42,313,0,1,40,354,3,357
"کرمان","شهربابک","مرکزی",43,196,0,1,82,279,2,281
"کرمان","شهربابک","مرکزی",44,267,0,1,32,300,0,300
"کرمان","شهربابک","مرکزی",45,369,0,0,35,404,0,404
"کرمان","شهربابک","مرکزی",46,413,2,0,20,435,0,435
"کرمان","شهربابک","مرکزی",47,339,2,0,24,365,4,369
"کرمان","شهربابک","مرکزی",48,422,1,1,30,454,1,455
"کرمان","شهربابک","مرکزی",49,287,0,0,16,303,0,303
"کرمان","شهربابک","مرکزی",50,377,0,0,44,421,4,425
"کرمان","شهربابک","مرکزی",51,272,0,0,27,299,2,301
"کرمان","شهربابک","مرکزی",52,227,1,0,33,261,0,261
"کرمان","شهربابک","مرکزی",53,221,2,0,28,251,2,253
"کرمان","شهربابک","مرکزی",54,281,0,0,22,303,6,309
"کرمان","شهربابک","مرکزی",55,163,1,0,19,183,4,187
"کرمان","شهربابک","مرکزی",56,177,1,1,29,208,2,210
"کرمان","شهربابک","مرکزی",57,240,0,0,4,244,1,245
"کرمان","شهربابک","مرکزی",58,231,0,0,11,242,0,242
"کرمان","شهربابک","مرکزی",59,305,3,0,29,337,1,338
"کرمان","شهربابک","مرکزی",60,805,3,0,136,944,2,946
"کرمان","شهربابک","مرکزی",61,417,1,0,34,452,3,455
"کرمان","شهربابک","مرکزی",62,294,0,0,12,306,2,308
"کرمان","شهربابک","دهج",1,675,1,0,125,801,0,801
"کرمان","شهربابک","دهج",2,571,0,1,78,650,0,650
"کرمان","شهربابک","دهج",3,204,0,0,72,276,1,277
"کرمان","شهربابک","دهج",4,267,1,3,44,315,0,315
"کرمان","شهربابک","دهج",5,514,3,4,29,550,0,550
"کرمان","شهربابک","دهج",6,395,0,0,7,402,0,402
"کرمان","شهربابک","دهج",7,198,1,0,7,206,0,206
"کرمان","شهربابک","دهج",8,338,0,0,12,350,0,350
"کرمان","عنبرآباد","مرکزی",1,811,1,1,66,879,3,882
"کرمان","عنبرآباد","مرکزی",2,1101,17,1,151,1270,2,1272
"کرمان","عنبرآباد","مرکزی",3,1410,5,1,83,1499,1,1500
"کرمان","عنبرآباد","مرکزی",4,950,4,0,80,1034,0,1034
"کرمان","عنبرآباد","مرکزی",5,1211,3,3,61,1278,3,1281
"کرمان","عنبرآباد","مرکزی",6,773,5,0,244,1022,3,1025
"کرمان","عنبرآباد","مرکزی",7,1380,5,2,229,1616,0,1616
"کرمان","عنبرآباد","مرکزی",8,542,3,0,173,718,0,718
"کرمان","عنبرآباد","مرکزی",9,1223,2,0,175,1400,0,1400
"کرمان","عنبرآباد","مرکزی",10,925,0,0,61,986,2,988
"کرمان","عنبرآباد","مرکزی",11,1087,0,0,59,1146,0,1146
"کرمان","عنبرآباد","مرکزی",12,735,1,0,50,786,1,787
"کرمان","عنبرآباد","مرکزی",13,429,0,0,9,438,1,439
"کرمان","عنبرآباد","مرکزی",14,1661,0,0,38,1699,0,1699
"کرمان","عنبرآباد","مرکزی",15,1764,3,0,33,1800,0,1800
"کرمان","عنبرآباد","مرکزی",16,892,0,0,7,899,1,900
"کرمان","عنبرآباد","مرکزی",17,885,0,0,35,920,1,921
"کرمان","عنبرآباد","مرکزی",18,1109,4,0,30,1143,1,1144
"کرمان","عنبرآباد","مرکزی",19,882,1,0,10,893,0,893
"کرمان","عنبرآباد","مرکزی",20,530,1,0,8,539,0,539
"کرمان","عنبرآباد","مرکزی",21,699,0,0,12,711,0,711
"کرمان","عنبرآباد","مرکزی",22,757,1,0,50,808,3,811
"کرمان","عنبرآباد","مرکزی",23,1076,0,0,37,1113,0,1113
"کرمان","عنبرآباد","مرکزی",24,1887,0,0,13,1900,0,1900
"کرمان","عنبرآباد","مرکزی",25,648,1,0,44,693,1,694
"کرمان","عنبرآباد","مرکزی",26,933,2,1,22,958,1,959
"کرمان","عنبرآباد","مرکزی",27,1185,2,0,15,1202,2,1204
"کرمان","عنبرآباد","مرکزی",28,443,1,1,28,473,1,474
"کرمان","عنبرآباد","مرکزی",29,736,3,1,103,843,0,843
"کرمان","عنبرآباد","مرکزی",30,789,1,0,6,796,3,799
"کرمان","عنبرآباد","جبالبارز_جنوبی",1,816,0,0,54,870,1,871
"کرمان","عنبرآباد","جبالبارز_جنوبی",2,361,2,1,168,532,0,532
"کرمان","عنبرآباد","جبالبارز_جنوبی",3,536,0,0,7,543,0,543
"کرمان","عنبرآباد","جبالبارز_جنوبی",4,795,0,0,5,800,0,800
"کرمان","عنبرآباد","جبالبارز_جنوبی",5,870,0,1,28,899,17,916
"کرمان","عنبرآباد","جبالبارز_جنوبی",6,975,2,0,26,1003,1,1004
"کرمان","عنبرآباد","جبالبارز_جنوبی",7,678,0,0,2,680,0,680
"کرمان","عنبرآباد","جبالبارز_جنوبی",8,251,0,0,11,262,0,262
"کرمان","عنبرآباد","جبالبارز_جنوبی",9,695,2,0,39,736,25,761
"کرمان","عنبرآباد","جبالبارز_جنوبی",10,407,0,0,29,436,0,436
"کرمان","عنبرآباد","جبالبارز_جنوبی",11,525,0,0,2,527,0,527
"کرمان","عنبرآباد","جبالبارز_جنوبی",12,765,0,0,12,777,3,780
"کرمان","عنبرآباد","جبالبارز_جنوبی",13,307,0,0,0,307,0,307
"کرمان","عنبرآباد","جبالبارز_جنوبی",14,700,0,0,0,700,0,700
"کرمان","عنبرآباد","جبالبارز_جنوبی",15,644,1,3,24,672,1,673
"کرمان","عنبرآباد","جبالبارز_جنوبی",16,335,0,0,0,335,0,335
"کرمان","عنبرآباد","جبالبارز_جنوبی",17,1100,1,0,80,1181,0,1181
"کرمان","عنبرآباد","جبالبارز_جنوبی",18,600,0,0,0,600,0,600
"کرمان","عنبرآباد","جبالبارز_جنوبی",19,545,0,0,3,548,0,548
"کرمان","عنبرآباد","جبالبارز_جنوبی",20,233,0,0,167,400,0,400
"کرمان","عنبرآباد","جبالبارز_جنوبی",21,1000,0,0,0,1000,0,1000
"کرمان","عنبرآباد","جبالبارز_جنوبی",22,599,0,0,1,600,0,600
"کرمان","عنبرآباد","جبالبارز_جنوبی",23,447,0,0,20,467,0,467
"کرمان","عنبرآباد","جبالبارز_جنوبی",24,562,0,0,9,571,0,571
"کرمان","عنبرآباد","جبالبارز_جنوبی",25,373,0,0,4,377,0,377
"کرمان","عنبرآباد","جبالبارز_جنوبی",26,612,0,0,13,625,0,625
"کرمان","عنبرآباد","اسمائیلی",1,403,1,1,39,444,3,447
"کرمان","عنبرآباد","اسمائیلی",2,607,1,0,54,662,3,665
"کرمان","عنبرآباد","اسمائیلی",3,665,0,0,1,666,0,666
"کرمان","عنبرآباد","اسمائیلی",4,259,0,0,22,281,2,283
"کرمان","عنبرآباد","اسمائیلی",5,870,0,0,47,917,0,917
"کرمان","عنبرآباد","اسمائیلی",6,517,0,1,4,522,3,525
"کرمان","عنبرآباد","اسمائیلی",7,616,1,0,27,644,0,644
"کرمان","عنبرآباد","اسمائیلی",8,792,2,0,55,849,1,850
"کرمان","عنبرآباد","اسمائیلی",9,548,0,0,51,599,0,599
"کرمان","عنبرآباد","اسمائیلی",10,538,0,0,57,595,2,597
"کرمان","عنبرآباد","اسمائیلی",11,1253,3,0,19,1275,0,1275
"کرمان","عنبرآباد","اسمائیلی",12,915,0,0,22,937,0,937
"کرمان","عنبرآباد","اسمائیلی",13,960,0,0,16,976,0,976
"کرمان","عنبرآباد","اسمائیلی",14,1092,1,1,6,1100,0,1100
"کرمان","عنبرآباد","اسمائیلی",15,470,0,0,51,521,0,521
"کرمان","عنبرآباد","اسمائیلی",16,400,0,1,19,420,0,420
"کرمان","عنبرآباد","اسمائیلی",17,420,0,0,8,428,0,428
"کرمان","عنبرآباد","اسمائیلی",18,676,1,0,5,682,5,687
"کرمان","عنبرآباد","اسمائیلی",19,730,1,1,3,735,0,735
"کرمان","عنبرآباد","اسمائیلی",20,663,1,0,115,779,1,780
"کرمان","عنبرآباد","اسمائیلی",21,687,0,1,26,714,1,715
"کرمان","عنبرآباد","اسمائیلی",22,447,0,0,3,450,0,450
"کرمان","عنبرآباد","اسمائیلی",23,1260,2,1,195,1458,2,1460
"کرمان","عنبرآباد","اسمائیلی",24,658,3,0,29,690,0,690
"کرمان","عنبرآباد","اسمائیلی",25,641,0,0,9,650,0,650
"کرمان","عنبرآباد","اسمائیلی",26,748,0,0,1,749,1,750
"کرمان","عنبرآباد","اسمائیلی",27,503,8,5,123,639,0,639
"کرمان","عنبرآباد","اسمائیلی",28,967,0,0,59,1026,0,1026
"کرمان","عنبرآباد","اسمائیلی",29,1025,0,1,24,1050,0,1050
"کرمان","عنبرآباد","اسمائیلی",30,754,2,1,16,773,0,773
"کرمان","عنبرآباد","اسمائیلی",31,547,5,0,41,593,0,593
"کرمان","قلعه_گنج","مرکزی",1,589,5,5,243,842,8,850
"کرمان","قلعه_گنج","مرکزی",2,419,4,0,132,555,5,560
"کرمان","قلعه_گنج","مرکزی",3,1068,0,0,32,1100,0,1100
"کرمان","قلعه_گنج","مرکزی",4,706,1,0,11,718,12,730
"کرمان","قلعه_گنج","مرکزی",5,765,4,2,51,822,4,826
"کرمان","قلعه_گنج","مرکزی",6,1116,4,0,52,1172,3,1175
"کرمان","قلعه_گنج","مرکزی",7,1399,2,0,2,1403,0,1403
"کرمان","قلعه_گنج","مرکزی",8,700,0,0,15,715,0,715
"کرمان","قلعه_گنج","مرکزی",9,643,2,0,14,659,0,659
"کرمان","قلعه_گنج","مرکزی",10,295,0,0,5,300,0,300
"کرمان","قلعه_گنج","مرکزی",11,723,0,0,7,730,0,730
"کرمان","قلعه_گنج","مرکزی",12,732,2,0,12,746,2,748
"کرمان","قلعه_گنج","مرکزی",13,696,0,1,42,739,0,739
"کرمان","قلعه_گنج","مرکزی",14,366,1,1,21,389,3,392
"کرمان","قلعه_گنج","مرکزی",15,471,1,0,50,522,7,529
"کرمان","قلعه_گنج","مرکزی",16,281,2,1,0,284,0,284
"کرمان","قلعه_گنج","مرکزی",17,366,1,0,32,399,0,399
"کرمان","قلعه_گنج","مرکزی",18,725,1,0,23,749,1,750
"کرمان","قلعه_گنج","مرکزی",19,664,1,0,16,681,3,684
"کرمان","قلعه_گنج","مرکزی",20,581,0,0,16,597,2,599
"کرمان","قلعه_گنج","مرکزی",21,592,0,0,7,599,1,600
"کرمان","قلعه_گنج","مرکزی",22,759,0,0,8,767,0,767
"کرمان","قلعه_گنج","مرکزی",23,371,0,0,2,373,0,373
"کرمان","قلعه_گنج","مرکزی",24,569,0,0,1,570,1,571
"کرمان","قلعه_گنج","مرکزی",25,584,0,0,2,586,0,586
"کرمان","قلعه_گنج","مرکزی",26,389,0,0,1,390,0,390
"کرمان","قلعه_گنج","مرکزی",27,655,1,0,1,657,1,658
"کرمان","قلعه_گنج","مرکزی",28,644,0,0,6,650,2,652
"کرمان","قلعه_گنج","مرکزی",29,411,3,0,3,417,0,417
"کرمان","قلعه_گنج","مرکزی",30,406,0,0,9,415,1,416
"کرمان","قلعه_گنج","مرکزی",31,785,0,0,2,787,1,788
"کرمان","قلعه_گنج","مرکزی",32,606,0,1,0,607,2,609
"کرمان","قلعه_گنج","مرکزی",33,497,1,0,5,503,0,503
"کرمان","قلعه_گنج","مرکزی",34,640,0,0,7,647,1,648
"کرمان","قلعه_گنج","مرکزی",35,638,0,0,0,638,0,638
"کرمان","قلعه_گنج","مرکزی",36,943,0,0,2,945,1,946
"کرمان","قلعه_گنج","مرکزی",37,472,0,0,7,479,3,482
"کرمان","قلعه_گنج","مرکزی",38,754,0,0,13,767,12,779
"کرمان","قلعه_گنج","مرکزی",39,557,0,0,3,560,0,560
"کرمان","قلعه_گنج","مرکزی",40,371,3,0,5,379,3,382
"کرمان","قلعه_گنج","مرکزی",41,555,0,0,9,564,0,564
"کرمان","قلعه_گنج","مرکزی",42,598,0,0,6,604,2,606
"کرمان","قلعه_گنج","مرکزی",43,447,0,0,2,449,1,450
"کرمان","قلعه_گنج","چاه_دادخدا",44,587,0,0,2,589,0,589
"کرمان","قلعه_گنج","چاه_دادخدا",45,447,2,0,18,467,0,467
"کرمان","قلعه_گنج","چاه_دادخدا",46,563,1,0,62,626,4,630
"کرمان","قلعه_گنج","چاه_دادخدا",47,609,1,0,3,613,0,613
"کرمان","قلعه_گنج","چاه_دادخدا",48,603,0,1,5,609,0,609
"کرمان","قلعه_گنج","چاه_دادخدا",49,679,0,3,79,761,5,766
"کرمان","قلعه_گنج","چاه_دادخدا",50,696,0,0,4,700,0,700
"کرمان","قلعه_گنج","چاه_دادخدا",51,192,0,1,0,193,2,195
"کرمان","قلعه_گنج","چاه_دادخدا",52,922,1,0,6,929,1,930
"کرمان","قلعه_گنج","چاه_دادخدا",53,696,0,0,1,697,3,700
"کرمان","قلعه_گنج","چاه_دادخدا",54,285,2,0,5,292,1,293
"کرمان","قلعه_گنج","چاه_دادخدا",55,537,2,4,352,895,5,900
"کرمان","قلعه_گنج","چاه_دادخدا",56,157,0,1,61,219,3,222
"کرمان","قلعه_گنج","چاه_دادخدا",57,725,1,0,10,736,1,737
"کرمان","قلعه_گنج","چاه_دادخدا",58,678,2,0,25,705,2,707
"کرمان","قلعه_گنج","چاه_دادخدا",59,311,1,1,0,313,0,313
"کرمان","قلعه_گنج","چاه_دادخدا",60,567,1,2,28,598,0,598
"کرمان","قلعه_گنج","چاه_دادخدا",61,396,2,0,138,536,2,538
"کرمان","قلعه_گنج","چاه_دادخدا",62,335,0,1,37,373,3,376
"کرمان","قلعه_گنج","چاه_دادخدا",63,779,0,0,0,779,0,779
"کرمان","قلعه_گنج","چاه_دادخدا",64,468,0,0,0,468,0,468
"کرمان","قلعه_گنج","چاه_دادخدا",65,483,0,1,0,484,1,485
"کرمان","قلعه_گنج","چاه_دادخدا",66,274,2,1,8,285,0,285
"کرمان","قلعه_گنج","چاه_دادخدا",67,591,1,0,0,592,1,593
"کرمان","کرمان","مرکزی",1,300,16,11,317,644,5,649
"کرمان","کرمان","مرکزی",2,919,35,19,802,1775,13,1788
"کرمان","کرمان","مرکزی",3,614,8,5,305,932,9,941
"کرمان","کرمان","مرکزی",4,894,21,9,242,1166,7,1173
"کرمان","کرمان","مرکزی",5,974,23,2,193,1192,11,1203
"کرمان","کرمان","مرکزی",6,281,6,4,63,354,2,356
"کرمان","کرمان","مرکزی",7,332,10,1,144,487,3,490
"کرمان","کرمان","مرکزی",8,478,20,17,431,946,9,955
"کرمان","کرمان","مرکزی",9,794,38,28,1185,2045,16,2061
"کرمان","کرمان","مرکزی",10,446,26,19,704,1195,19,1214
"کرمان","کرمان","مرکزی",11,961,40,36,1192,2229,69,2298
"کرمان","کرمان","مرکزی",12,897,26,12,550,1485,0,1485
"کرمان","کرمان","مرکزی",13,439,44,23,898,1404,11,1415
"کرمان","کرمان","مرکزی",14,288,28,21,742,1079,11,1090
"کرمان","کرمان","مرکزی",15,902,27,5,495,1429,14,1443
"کرمان","کرمان","مرکزی",16,679,21,10,572,1282,3,1285
"کرمان","کرمان","مرکزی",17,233,4,2,140,379,2,381
"کرمان","کرمان","مرکزی",18,207,11,23,312,553,9,562
"کرمان","کرمان","مرکزی",19,436,40,50,1308,1834,21,1855
"کرمان","کرمان","مرکزی",20,691,72,46,1312,2121,0,2121
"کرمان","کرمان","مرکزی",21,335,21,21,667,1044,12,1056
"کرمان","کرمان","مرکزی",22,263,32,45,988,1328,7,1335
"کرمان","کرمان","مرکزی",23,409,31,40,253,733,11,744
"کرمان","کرمان","مرکزی",24,318,27,30,1288,1663,15,1678
"کرمان","کرمان","مرکزی",25,368,40,37,1212,1657,14,1671
"کرمان","کرمان","مرکزی",26,373,34,32,1217,1656,15,1671
"کرمان","کرمان","مرکزی",27,554,35,26,1552,2167,9,2176
"کرمان","کرمان","مرکزی",28,553,49,44,1436,2082,25,2107
"کرمان","کرمان","مرکزی",29,245,28,32,891,1196,9,1205
"کرمان","کرمان","مرکزی",30,1030,25,8,760,1823,13,1836
"کرمان","کرمان","مرکزی",31,988,40,30,1109,2167,24,2191
"کرمان","کرمان","مرکزی",32,820,26,7,497,1350,11,1361
"کرمان","کرمان","مرکزی",33,310,26,30,956,1322,17,1339
"کرمان","کرمان","مرکزی",34,350,28,24,860,1262,16,1278
"کرمان","کرمان","مرکزی",35,682,48,22,1031,1783,27,1810
"کرمان","کرمان","مرکزی",36,843,40,7,679,1569,15,1584
"کرمان","کرمان","مرکزی",37,1023,40,13,870,1946,27,1973
"کرمان","کرمان","مرکزی",38,954,27,9,458,1448,11,1459
"کرمان","کرمان","مرکزی",39,236,16,29,563,844,12,856
"کرمان","کرمان","مرکزی",40,161,13,19,336,529,7,536
"کرمان","کرمان","مرکزی",41,628,46,22,781,1477,16,1493
"کرمان","کرمان","مرکزی",42,524,41,19,1142,1726,15,1741
"کرمان","کرمان","مرکزی",43,402,17,8,512,939,11,950
"کرمان","کرمان","مرکزی",44,879,20,27,705,1631,16,1647
"کرمان","کرمان","مرکزی",45,819,35,40,887,1781,16,1797
"کرمان","کرمان","مرکزی",46,1118,11,11,363,1503,13,1516
"کرمان","کرمان","مرکزی",47,752,20,4,538,1314,13,1327
"کرمان","کرمان","مرکزی",48,796,29,13,455,1293,19,1312
"کرمان","کرمان","مرکزی",49,1204,23,6,476,1709,18,1727
"کرمان","کرمان","مرکزی",50,823,22,6,533,1384,24,1408
"کرمان","کرمان","مرکزی",51,1187,16,8,399,1610,20,1630
"کرمان","کرمان","مرکزی",52,728,18,3,357,1106,12,1118
"کرمان","کرمان","مرکزی",53,863,23,7,530,1423,21,1444
"کرمان","کرمان","مرکزی",54,954,20,3,432,1409,7,1416
"کرمان","کرمان","مرکزی",55,747,21,9,666,1443,15,1458
"کرمان","کرمان","مرکزی",56,981,22,10,651,1664,20,1684
"کرمان","کرمان","مرکزی",57,1392,34,9,639,2074,26,2100
"کرمان","کرمان","مرکزی",58,741,7,10,461,1219,15,1234
"کرمان","کرمان","مرکزی",59,457,19,1,208,685,13,698
"کرمان","کرمان","مرکزی",60,927,26,8,452,1413,19,1432
"کرمان","کرمان","مرکزی",61,1081,22,10,327,1440,3,1443
"کرمان","کرمان","مرکزی",62,1469,10,2,262,1743,14,1757
"کرمان","کرمان","مرکزی",63,1138,19,4,340,1501,15,1516
"کرمان","کرمان","مرکزی",64,892,9,6,257,1164,5,1169
"کرمان","کرمان","مرکزی",65,1137,14,4,360,1515,13,1528
"کرمان","کرمان","مرکزی",66,1510,19,4,256,1789,7,1796
"کرمان","کرمان","مرکزی",67,1204,27,3,505,1739,17,1756
"کرمان","کرمان","مرکزی",68,1421,7,5,307,1740,14,1754
"کرمان","کرمان","مرکزی",69,1189,5,6,225,1425,13,1438
"کرمان","کرمان","مرکزی",70,1142,20,1,460,1623,6,1629
"کرمان","کرمان","مرکزی",71,978,37,15,485,1515,10,1525
"کرمان","کرمان","مرکزی",72,915,24,9,341,1289,8,1297
"کرمان","کرمان","مرکزی",73,1454,19,2,349,1824,14,1838
"کرمان","کرمان","مرکزی",74,725,12,1,271,1009,4,1013
"کرمان","کرمان","مرکزی",75,1091,27,14,678,1810,15,1825
"کرمان","کرمان","مرکزی",76,1236,20,9,393,1658,17,1675
"کرمان","کرمان","مرکزی",77,817,26,4,438,1285,9,1294
"کرمان","کرمان","مرکزی",78,1035,19,13,522,1589,20,1609
"کرمان","کرمان","مرکزی",79,1261,25,9,460,1755,9,1764
"کرمان","کرمان","مرکزی",80,629,24,14,330,997,1,998
"کرمان","کرمان","مرکزی",81,670,27,4,534,1235,15,1250
"کرمان","کرمان","مرکزی",82,540,24,12,594,1170,3,1173
"کرمان","کرمان","مرکزی",83,1115,23,9,400,1547,18,1565
"کرمان","کرمان","مرکزی",84,892,43,5,637,1577,22,1599
"کرمان","کرمان","مرکزی",85,586,23,2,445,1056,19,1075
"کرمان","کرمان","مرکزی",86,1181,50,11,698,1940,21,1961
"کرمان","کرمان","مرکزی",87,683,20,5,572,1280,18,1298
"کرمان","کرمان","مرکزی",88,393,23,22,780,1218,21,1239
"کرمان","کرمان","مرکزی",89,707,52,32,1089,1880,20,1900
"کرمان","کرمان","مرکزی",90,283,15,13,384,695,5,700
"کرمان","کرمان","مرکزی",91,654,39,20,784,1497,27,1524
"کرمان","کرمان","مرکزی",92,749,25,17,443,1234,15,1249
"کرمان","کرمان","مرکزی",93,1115,56,47,1130,2348,36,2384
"کرمان","کرمان","مرکزی",94,596,30,24,598,1248,26,1274
"کرمان","کرمان","مرکزی",95,885,26,14,545,1470,18,1488
"کرمان","کرمان","مرکزی",96,795,38,14,515,1362,25,1387
"کرمان","کرمان","مرکزی",97,959,24,8,446,1437,19,1456
"کرمان","کرمان","مرکزی",98,972,22,3,577,1574,25,1599
"کرمان","کرمان","مرکزی",99,435,12,21,266,734,2,736
"کرمان","کرمان","مرکزی",100,1041,20,5,380,1446,15,1461
"کرمان","کرمان","مرکزی",101,731,18,4,211,964,10,974
"کرمان","کرمان","مرکزی",102,866,14,9,396,1285,21,1306
"کرمان","کرمان","مرکزی",103,475,5,5,228,713,5,718
"کرمان","کرمان","مرکزی",104,1083,38,10,472,1603,26,1629
"کرمان","کرمان","مرکزی",105,731,31,16,738,1516,7,1523
"کرمان","کرمان","مرکزی",106,758,60,16,731,1565,28,1593
"کرمان","کرمان","مرکزی",107,259,26,23,620,928,13,941
"کرمان","کرمان","مرکزی",108,913,45,11,614,1583,20,1603
"کرمان","کرمان","مرکزی",109,772,33,20,836,1661,21,1682
"کرمان","کرمان","مرکزی",110,910,29,2,536,1477,13,1490
"کرمان","کرمان","مرکزی",111,361,20,17,728,1126,23,1149
"کرمان","کرمان","مرکزی",112,866,28,11,623,1528,19,1547
"کرمان","کرمان","مرکزی",113,686,25,14,745,1470,13,1483
"کرمان","کرمان","مرکزی",114,1022,35,20,718,1795,17,1812
"کرمان","کرمان","مرکزی",115,778,20,8,462,1268,9,1277
"کرمان","کرمان","مرکزی",116,495,15,6,375,891,7,898
"کرمان","کرمان","مرکزی",117,107,4,0,71,182,0,182
"کرمان","کرمان","مرکزی",118,1172,11,6,266,1455,11,1466
"کرمان","کرمان","مرکزی",119,1167,16,10,451,1644,11,1655
"کرمان","کرمان","مرکزی",120,881,23,13,535,1452,10,1462
"کرمان","کرمان","مرکزی",121,1068,28,7,652,1755,18,1773
"کرمان","کرمان","مرکزی",122,1317,33,5,536,1891,19,1910
"کرمان","کرمان","مرکزی",123,1259,26,2,491,1778,9,1787
"کرمان","کرمان","مرکزی",124,916,38,5,458,1417,28,1445
"کرمان","کرمان","مرکزی",125,936,36,25,608,1605,17,1622
"کرمان","کرمان","مرکزی",126,739,30,6,525,1300,10,1310
"کرمان","کرمان","مرکزی",127,663,20,13,429,1125,9,1134
"کرمان","کرمان","مرکزی",128,244,5,3,159,411,4,415
"کرمان","کرمان","مرکزی",129,770,35,11,584,1400,16,1416
"کرمان","کرمان","مرکزی",130,900,36,11,608,1555,12,1567
"کرمان","کرمان","مرکزی",131,688,20,5,475,1188,12,1200
"کرمان","کرمان","مرکزی",132,392,18,1,224,635,9,644
"کرمان","کرمان","مرکزی",133,740,32,5,572,1349,13,1362
"کرمان","کرمان","مرکزی",134,1457,51,11,660,2179,0,2179
"کرمان","کرمان","مرکزی",135,181,16,0,106,303,3,306
"کرمان","کرمان","مرکزی",136,1160,53,16,575,1804,26,1830
"کرمان","کرمان","مرکزی",137,409,21,10,364,804,11,815
"کرمان","کرمان","مرکزی",138,805,49,19,909,1782,18,1800
"کرمان","کرمان","مرکزی",139,964,28,14,578,1584,24,1608
"کرمان","کرمان","مرکزی",140,881,12,19,375,1287,10,1297
"کرمان","کرمان","مرکزی",141,926,16,4,418,1364,12,1376
"کرمان","کرمان","مرکزی",142,1017,13,12,447,1489,18,1507
"کرمان","کرمان","مرکزی",143,688,11,6,310,1015,10,1025
"کرمان","کرمان","مرکزی",144,416,4,3,254,677,9,686
"کرمان","کرمان","مرکزی",145,910,19,10,358,1297,15,1312
"کرمان","کرمان","مرکزی",146,1097,13,7,306,1423,7,1430
"کرمان","کرمان","مرکزی",147,889,16,10,366,1281,18,1299
"کرمان","کرمان","مرکزی",148,1397,14,5,277,1693,14,1707
"کرمان","کرمان","مرکزی",149,1298,18,2,227,1545,4,1549
"کرمان","کرمان","مرکزی",150,983,14,6,317,1320,14,1334
"کرمان","کرمان","مرکزی",151,1670,8,2,350,2030,70,2100
"کرمان","کرمان","مرکزی",152,1569,8,2,172,1751,16,1767
"کرمان","کرمان","مرکزی",153,818,59,73,687,1637,38,1675
"کرمان","کرمان","مرکزی",154,1156,13,3,127,1299,0,1299
"کرمان","کرمان","مرکزی",155,1064,8,5,184,1261,7,1268
"کرمان","کرمان","مرکزی",156,877,12,4,279,1172,18,1190
"کرمان","کرمان","مرکزی",157,1630,9,5,270,1914,17,1931
"کرمان","کرمان","مرکزی",158,896,5,8,138,1047,3,1050
"کرمان","کرمان","مرکزی",159,1049,13,4,388,1454,20,1474
"کرمان","کرمان","مرکزی",160,1017,12,5,303,1337,15,1352
"کرمان","کرمان","مرکزی",161,1160,16,2,221,1399,11,1410
"کرمان","کرمان","مرکزی",162,1111,25,6,364,1506,3,1509
"کرمان","کرمان","مرکزی",163,375,8,3,149,535,6,541
"کرمان","کرمان","مرکزی",164,735,27,12,423,1197,12,1209
"کرمان","کرمان","مرکزی",165,1141,25,7,449,1622,8,1630
"کرمان","کرمان","مرکزی",166,325,6,3,282,616,3,619
"کرمان","کرمان","مرکزی",167,734,36,12,698,1480,16,1496
"کرمان","کرمان","مرکزی",168,340,26,16,590,972,9,981
"کرمان","کرمان","مرکزی",169,1017,17,4,383,1421,16,1437
"کرمان","کرمان","مرکزی",170,1460,34,15,549,2058,22,2080
"کرمان","کرمان","مرکزی",171,446,14,1,194,655,7,662
"کرمان","کرمان","مرکزی",172,307,13,5,307,632,7,639
"کرمان","کرمان","مرکزی",173,1170,14,6,302,1492,11,1503
"کرمان","کرمان","مرکزی",174,1428,9,2,258,1697,11,1708
"کرمان","کرمان","مرکزی",175,331,10,1,168,510,8,518
"کرمان","کرمان","مرکزی",176,573,16,8,287,884,14,898
"کرمان","کرمان","مرکزی",177,1333,28,8,420,1789,11,1800
"کرمان","کرمان","مرکزی",178,1008,30,20,557,1615,17,1632
"کرمان","کرمان","مرکزی",179,1205,14,2,296,1517,0,1517
"کرمان","کرمان","مرکزی",180,1462,6,1,142,1611,12,1623
"کرمان","کرمان","مرکزی",181,1548,18,3,158,1727,18,1745
"کرمان","کرمان","مرکزی",182,1254,8,10,132,1404,0,1404
"کرمان","کرمان","مرکزی",183,1095,22,3,259,1379,11,1390
"کرمان","کرمان","مرکزی",184,1277,24,3,270,1574,18,1592
"کرمان","کرمان","مرکزی",185,917,12,2,324,1255,18,1273
"کرمان","کرمان","مرکزی",186,1420,14,2,239,1675,17,1692
"کرمان","کرمان","مرکزی",187,1219,13,1,139,1372,16,1388
"کرمان","کرمان","مرکزی",188,632,16,4,413,1065,14,1079
"کرمان","کرمان","مرکزی",189,1049,36,6,409,1500,13,1513
"کرمان","کرمان","مرکزی",190,1207,22,8,270,1507,20,1527
"کرمان","کرمان","مرکزی",191,909,21,3,615,1548,19,1567
"کرمان","کرمان","مرکزی",192,1273,28,3,509,1813,9,1822
"کرمان","کرمان","مرکزی",193,1110,16,4,256,1386,14,1400
"کرمان","کرمان","مرکزی",194,1143,23,5,314,1485,14,1499
"کرمان","کرمان","مرکزی",195,1119,9,4,204,1336,17,1353
"کرمان","کرمان","مرکزی",196,1671,11,2,222,1906,19,1925
"کرمان","کرمان","مرکزی",197,818,4,0,117,939,12,951
"کرمان","کرمان","مرکزی",198,1606,17,1,252,1876,25,1901
"کرمان","کرمان","مرکزی",199,737,2,1,119,859,7,866
"کرمان","کرمان","مرکزی",200,1324,21,1,270,1616,16,1632
"کرمان","کرمان","مرکزی",201,711,10,4,254,979,3,982
"کرمان","کرمان","مرکزی",202,214,3,6,153,376,9,385
"کرمان","کرمان","مرکزی",203,392,7,1,131,531,3,534
"کرمان","کرمان","مرکزی",204,237,2,1,114,354,5,359
"کرمان","کرمان","مرکزی",205,515,9,3,173,700,7,707
"کرمان","کرمان","مرکزی",206,1161,15,16,495,1687,28,1715
"کرمان","کرمان","مرکزی",207,341,10,1,82,434,4,438
"کرمان","کرمان","مرکزی",208,370,3,3,99,475,3,478
"کرمان","کرمان","مرکزی",209,464,8,6,263,741,20,761
"کرمان","کرمان","مرکزی",210,730,14,2,160,906,8,914
"کرمان","کرمان","مرکزی",211,305,12,6,120,443,10,453
"کرمان","کرمان","مرکزی",212,311,8,1,106,426,7,433
"کرمان","کرمان","مرکزی",213,226,13,2,213,454,6,460
"کرمان","کرمان","مرکزی",214,272,17,3,217,509,8,517
"کرمان","کرمان","مرکزی",215,405,13,13,276,707,8,715
"کرمان","کرمان","مرکزی",216,378,18,5,279,680,9,689
"کرمان","کرمان","مرکزی",217,239,24,30,813,1106,15,1121
"کرمان","کرمان","مرکزی",218,172,11,3,83,269,3,272
"کرمان","کرمان","مرکزی",219,510,29,38,346,923,18,941
"کرمان","کرمان","مرکزی",220,585,15,3,188,791,7,798
"کرمان","کرمان","مرکزی",221,1353,4,7,230,1594,7,1601
"کرمان","کرمان","مرکزی",222,1600,7,1,192,1800,8,1808
"کرمان","کرمان","مرکزی",223,1165,12,1,176,1354,12,1366
"کرمان","کرمان","مرکزی",224,1155,9,4,254,1422,13,1435
"کرمان","کرمان","مرکزی",225,1510,3,2,176,1691,6,1697
"کرمان","کرمان","مرکزی",226,1055,15,2,263,1335,0,1335
"کرمان","کرمان","مرکزی",227,358,7,1,103,469,7,476
"کرمان","کرمان","مرکزی",228,1671,11,1,223,1906,12,1918
"کرمان","کرمان","مرکزی",229,911,10,5,95,1021,7,1028
"کرمان","کرمان","مرکزی",230,504,3,0,42,549,2,551
"کرمان","کرمان","مرکزی",231,1069,1,0,50,1120,2,1122
"کرمان","کرمان","مرکزی",232,980,6,1,221,1208,17,1225
"کرمان","کرمان","مرکزی",233,919,23,4,265,1211,7,1218
"کرمان","کرمان","مرکزی",234,545,3,1,116,665,3,668
"کرمان","کرمان","مرکزی",235,546,9,3,86,644,5,649
"کرمان","کرمان","مرکزی",236,1073,3,0,84,1160,3,1163
"کرمان","کرمان","مرکزی",237,229,5,0,29,263,2,265
"کرمان","کرمان","مرکزی",238,1554,7,3,230,1794,12,1806
"کرمان","کرمان","مرکزی",239,1015,15,0,113,1143,6,1149
"کرمان","کرمان","مرکزی",240,1118,1,1,92,1212,4,1216
"کرمان","کرمان","مرکزی",241,473,2,0,42,517,0,517
"کرمان","کرمان","مرکزی",242,300,1,0,13,314,1,315
"کرمان","کرمان","مرکزی",243,730,5,1,121,857,8,865
"کرمان","کرمان","مرکزی",244,884,9,1,133,1027,5,1032
"کرمان","کرمان","مرکزی",245,403,4,1,61,469,2,471
"کرمان","کرمان","مرکزی",246,591,6,2,153,752,4,756
"کرمان","کرمان","مرکزی",247,1227,1,1,183,1412,13,1425
"کرمان","کرمان","مرکزی",248,789,19,2,483,1293,6,1299
"کرمان","کرمان","مرکزی",249,510,5,0,159,674,4,678
"کرمان","کرمان","مرکزی",250,773,6,1,165,945,7,952
"کرمان","کرمان","مرکزی",251,381,4,1,44,430,5,435
"کرمان","کرمان","مرکزی",252,445,2,5,80,532,1,533
"کرمان","کرمان","مرکزی",253,406,3,0,45,454,0,454
"کرمان","کرمان","مرکزی",254,312,1,0,70,383,4,387
"کرمان","کرمان","چترود",1,810,6,0,114,930,6,936
"کرمان","کرمان","چترود",2,782,5,0,149,936,2,938
"کرمان","کرمان","چترود",3,1086,11,4,129,1230,6,1236
"کرمان","کرمان","چترود",4,462,1,0,89,552,8,560
"کرمان","کرمان","چترود",5,801,7,0,106,914,11,925
"کرمان","کرمان","چترود",6,801,6,0,37,844,2,846
"کرمان","کرمان","چترود",7,1133,6,2,130,1271,10,1281
"کرمان","کرمان","چترود",8,816,5,0,46,867,2,869
"کرمان","کرمان","چترود",9,672,5,0,98,775,6,781
"کرمان","کرمان","چترود",10,558,1,0,61,620,2,622
"کرمان","کرمان","چترود",11,488,0,0,40,528,4,532
"کرمان","کرمان","چترود",12,665,4,2,54,725,7,732
"کرمان","کرمان","چترود",13,826,4,0,112,942,2,944
"کرمان","کرمان","چترود",14,572,0,0,100,672,2,674
"کرمان","کرمان","چترود",15,579,2,3,58,642,1,643
"کرمان","کرمان","چترود",16,547,1,1,18,567,2,569
"کرمان","کرمان","چترود",17,556,5,2,121,684,1,685
"کرمان","کرمان","چترود",18,742,2,0,97,841,2,843
"کرمان","کرمان","چترود",19,486,8,0,106,600,5,605
"کرمان","کرمان","چترود",20,227,0,0,18,245,1,246
"کرمان","کرمان","گلباف",1,788,10,1,88,887,5,892
"کرمان","کرمان","گلباف",2,1118,7,1,80,1206,6,1212
"کرمان","کرمان","گلباف",3,717,3,1,83,804,6,810
"کرمان","کرمان","گلباف",4,873,1,1,139,1014,4,1018
"کرمان","کرمان","گلباف",5,583,5,0,124,712,10,722
"کرمان","کرمان","گلباف",6,724,1,0,35,760,0,760
"کرمان","کرمان","گلباف",7,514,2,0,15,531,2,533
"کرمان","کرمان","گلباف",8,917,6,2,61,986,3,989
"کرمان","کرمان","گلباف",9,237,0,0,7,244,0,244
"کرمان","کرمان","گلباف",10,374,0,0,12,386,0,386
"کرمان","کرمان","گلباف",11,250,2,0,32,284,0,284
"کرمان","کرمان","گلباف",12,447,1,0,47,495,2,497
"کرمان","کرمان","گلباف",13,440,0,0,21,461,1,462
"کرمان","کرمان","گلباف",14,232,2,2,59,295,2,297
"کرمان","کرمان","راین",1,1022,5,0,209,1236,10,1246
"کرمان","کرمان","راین",2,803,9,3,376,1191,8,1199
"کرمان","کرمان","راین",3,894,6,0,188,1088,7,1095
"کرمان","کرمان","راین",4,645,7,3,178,833,5,838
"کرمان","کرمان","راین",5,567,8,0,186,761,3,764
"کرمان","کرمان","راین",6,668,1,0,167,836,6,842
"کرمان","کرمان","راین",7,934,9,3,200,1146,9,1155
"کرمان","کرمان","راین",8,702,1,0,43,746,5,751
"کرمان","کرمان","راین",9,348,0,1,35,384,0,384
"کرمان","کرمان","راین",10,314,4,1,51,370,0,370
"کرمان","کرمان","راین",11,427,7,1,71,506,2,508
"کرمان","کرمان","راین",12,299,0,0,27,326,1,327
"کرمان","کرمان","راین",13,300,5,0,42,347,2,349
"کرمان","کرمان","راین",14,381,1,0,18,400,1,401
"کرمان","کرمان","راین",15,259,0,0,25,284,0,284
"کرمان","کرمان","راین",16,67,0,0,13,80,0,80
"کرمان","کرمان","ماهان",1,481,3,0,57,541,3,544
"کرمان","کرمان","ماهان",2,762,1,0,110,873,4,877
"کرمان","کرمان","ماهان",3,844,8,0,165,1017,2,1019
"کرمان","کرمان","ماهان",4,817,14,11,439,1281,19,1300
"کرمان","کرمان","ماهان",5,984,14,10,250,1258,1,1259
"کرمان","کرمان","ماهان",6,716,7,2,183,908,8,916
"کرمان","کرمان","ماهان",7,730,9,2,227,968,9,977
"کرمان","کرمان","ماهان",8,578,3,1,88,670,10,680
"کرمان","کرمان","ماهان",9,617,2,1,72,692,7,699
"کرمان","کرمان","ماهان",10,780,6,0,231,1017,16,1033
"کرمان","کرمان","ماهان",11,758,10,2,274,1044,10,1054
"کرمان","کرمان","ماهان",12,841,4,0,132,977,11,988
"کرمان","کرمان","ماهان",13,386,1,2,90,479,3,482
"کرمان","کرمان","ماهان",14,252,6,1,113,372,8,380
"کرمان","کرمان","ماهان",15,243,1,0,74,318,1,319
"کرمان","کرمان","ماهان",16,753,3,1,139,896,0,896
"کرمان","کرمان","ماهان",17,317,1,0,76,394,0,394
"کرمان","کرمان","ماهان",18,510,4,3,453,970,10,980
"کرمان","کرمان","ماهان",19,333,6,2,253,594,16,610
"کرمان","کرمان","ماهان",20,859,0,0,90,949,7,956
"کرمان","کرمان","ماهان",21,1359,11,1,104,1475,0,1475
"کرمان","کرمان","ماهان",22,728,10,0,62,800,3,803
"کرمان","کرمان","ماهان",23,206,2,0,42,250,1,251
"کرمان","کرمان","ماهان",24,623,3,3,96,725,11,736
"کرمان","کرمان","ماهان",25,777,9,19,274,1079,7,1086
"کرمان","کرمان","ماهان",26,979,9,14,187,1189,9,1198
"کرمان","کرمان","ماهان",27,547,5,8,128,688,8,696
"کرمان","کرمان","ماهان",28,359,0,5,113,477,5,482
"کرمان","کرمان","ماهان",29,369,4,0,51,424,4,428
"کرمان","کرمان","ماهان",30,384,5,0,42,431,2,433
"کرمان","کرمان","شهداد",1,579,1,2,80,662,2,664
"کرمان","کرمان","شهداد",2,280,3,0,91,374,1,375
"کرمان","کرمان","شهداد",3,190,1,0,18,209,7,216
"کرمان","کرمان","شهداد",4,423,3,0,81,507,1,508
"کرمان","کرمان","شهداد",5,362,1,0,30,393,1,394
"کرمان","کرمان","شهداد",6,526,2,1,16,545,4,549
"کرمان","کرمان","شهداد",7,1031,15,0,267,1313,12,1325
"کرمان","کرمان","شهداد",8,797,10,0,86,893,5,898
"کرمان","کرمان","شهداد",9,439,3,0,14,456,3,459
"کرمان","کرمان","شهداد",10,1071,3,0,55,1129,0,1129
"کرمان","کرمان","شهداد",11,476,0,0,33,509,0,509
"کرمان","کرمان","شهداد",12,572,1,0,9,582,0,582
"کرمان","کرمان","شهداد",13,842,0,0,6,848,6,854
"کرمان","کرمان","شهداد",14,495,0,0,10,505,2,507
"کرمان","کرمان","شهداد",15,636,0,0,4,640,2,642
"کرمان","کرمان","شهداد",16,557,1,2,34,594,3,597
"کرمان","کهنوج","مرکزی",1,726,9,6,336,1077,7,1084
"کرمان","کهنوج","مرکزی",2,553,7,4,156,720,7,727
"کرمان","کهنوج","مرکزی",3,251,4,0,118,373,8,381
"کرمان","کهنوج","مرکزی",4,621,6,1,260,888,4,892
"کرمان","کهنوج","مرکزی",5,548,3,1,207,759,4,763
"کرمان","کهنوج","مرکزی",6,267,7,1,139,414,3,417
"کرمان","کهنوج","مرکزی",7,636,3,2,254,895,2,897
"کرمان","کهنوج","مرکزی",8,513,8,2,211,734,1,735
"کرمان","کهنوج","مرکزی",9,711,4,0,118,833,3,836
"کرمان","کهنوج","مرکزی",10,517,4,2,112,635,1,636
"کرمان","کهنوج","مرکزی",11,573,9,0,153,735,0,735
"کرمان","کهنوج","مرکزی",12,525,6,1,80,612,6,618
"کرمان","کهنوج","مرکزی",13,635,2,0,123,760,0,760
"کرمان","کهنوج","مرکزی",14,480,15,1,104,600,0,600
"کرمان","کهنوج","مرکزی",15,701,2,0,172,875,0,875
"کرمان","کهنوج","مرکزی",16,813,9,4,253,1079,5,1084
"کرمان","کهنوج","مرکزی",17,527,3,1,91,622,2,624
"کرمان","کهنوج","مرکزی",18,757,8,0,152,917,0,917
"کرمان","کهنوج","مرکزی",19,321,6,1,36,364,1,365
"کرمان","کهنوج","مرکزی",20,715,1,2,164,882,2,884
"کرمان","کهنوج","مرکزی",21,560,6,4,436,1006,3,1009
"کرمان","کهنوج","مرکزی",22,587,1,2,60,650,0,650
"کرمان","کهنوج","مرکزی",23,1084,3,2,104,1193,2,1195
"کرمان","کهنوج","مرکزی",24,387,2,0,44,433,4,437
"کرمان","کهنوج","مرکزی",25,221,5,2,109,337,2,339
"کرمان","کهنوج","مرکزی",26,480,10,2,227,719,1,720
"کرمان","کهنوج","مرکزی",27,185,1,0,37,223,1,224
"کرمان","کهنوج","مرکزی",28,681,6,1,190,878,8,886
"کرمان","کهنوج","مرکزی",29,690,2,0,41,733,0,733
"کرمان","کهنوج","مرکزی",30,651,1,2,102,756,2,758
"کرمان","کهنوج","مرکزی",31,539,0,0,48,587,2,589
"کرمان","کهنوج","مرکزی",32,548,0,0,17,565,0,565
"کرمان","کهنوج","مرکزی",33,848,1,1,64,914,0,914
"کرمان","کهنوج","مرکزی",34,376,0,0,33,409,3,412
"کرمان","کهنوج","مرکزی",35,379,1,0,36,416,0,416
"کرمان","کهنوج","مرکزی",36,706,1,0,25,732,1,733
"کرمان","کهنوج","مرکزی",37,862,3,1,26,892,1,893
"کرمان","کهنوج","مرکزی",38,814,0,0,79,893,5,898
"کرمان","کهنوج","مرکزی",39,932,2,1,126,1061,5,1066
"کرمان","کهنوج","مرکزی",40,603,0,0,128,731,8,739
"کرمان","کهنوج","مرکزی",41,223,0,0,14,237,2,239
"کرمان","کهنوج","مرکزی",42,587,3,1,66,657,0,657
"کرمان","کهنوج","مرکزی",43,536,1,1,8,546,1,547
"کرمان","کهنوج","مرکزی",44,449,0,0,22,471,0,471
"کرمان","کهنوج","مرکزی",45,356,0,0,12,368,4,372
"کرمان","کهنوج","مرکزی",46,496,0,0,22,518,0,518
"کرمان","کهنوج","مرکزی",47,414,4,0,13,431,0,431
"کرمان","کهنوج","مرکزی",48,564,0,0,20,584,0,584
"کرمان","کهنوج","مرکزی",49,248,1,0,13,262,0,262
"کرمان","کهنوج","مرکزی",50,249,0,0,2,251,0,251
"کرمان","کهنوج","مرکزی",51,259,0,0,2,261,0,261
"کرمان","کهنوج","مرکزی",52,217,1,0,8,226,4,230
"کرمان","کهنوج","مرکزی",53,689,1,0,13,703,0,703
"کرمان","کهنوج","مرکزی",54,634,2,0,11,647,2,649
"کرمان","کهنوج","مرکزی",55,460,1,0,13,474,1,475
"کرمان","کهنوج","مرکزی",56,948,3,2,16,969,1,970
"کرمان","کهنوج","مرکزی",57,629,4,0,15,648,2,650
"کرمان","کهنوج","مرکزی",58,440,1,0,94,535,3,538
"کرمان","کهنوج","فاریاب",1,377,7,1,136,521,0,521
"کرمان","کهنوج","فاریاب",2,572,7,1,120,700,0,700
"کرمان","کهنوج","فاریاب",3,387,2,0,72,461,0,461
"کرمان","کهنوج","فاریاب",4,677,1,1,24,703,1,704
"کرمان","کهنوج","فاریاب",5,451,2,1,75,529,0,529
"کرمان","کهنوج","فاریاب",6,339,0,0,4,343,3,346
"کرمان","کهنوج","فاریاب",7,431,0,0,9,440,0,440
"کرمان","کهنوج","فاریاب",8,490,0,0,53,543,0,543
"کرمان","کهنوج","فاریاب",9,429,0,0,9,438,0,438
"کرمان","کهنوج","فاریاب",10,414,0,0,10,424,0,424
"کرمان","کهنوج","فاریاب",11,651,4,1,22,678,4,682
"کرمان","کهنوج","فاریاب",12,589,2,0,10,601,0,601
"کرمان","کهنوج","فاریاب",13,372,0,0,42,414,3,417
"کرمان","کهنوج","فاریاب",14,306,0,0,7,313,5,318
"کرمان","کهنوج","فاریاب",15,400,1,0,1,402,0,402
"کرمان","کهنوج","فاریاب",16,652,1,1,16,670,4,674
"کرمان","کهنوج","فاریاب",17,626,0,0,4,630,5,635
"کرمان","کهنوج","فاریاب",18,502,0,0,5,507,0,507
"کرمان","کهنوج","فاریاب",19,511,0,0,30,541,4,545
"کرمان","کهنوج","فاریاب",20,403,0,1,56,460,1,461
"کرمان","کهنوج","فاریاب",21,524,3,0,64,591,0,591
"کرمان","کهنوج","فاریاب",22,320,1,0,39,360,6,366
"کرمان","کهنوج","فاریاب",23,608,0,0,2,610,4,614
"کرمان","کهنوج","فاریاب",24,779,1,0,11,791,1,792
"کرمان","کهنوج","فاریاب",25,565,0,0,10,575,3,578
"کرمان","کهنوج","فاریاب",26,733,1,0,30,764,0,764
"کرمان","کهنوج","فاریاب",27,639,1,0,29,669,0,669
"کرمان","کهنوج","فاریاب",28,336,1,0,26,363,1,364
"کرمان","کهنوج","فاریاب",29,509,0,0,23,532,0,532
"کرمان","کهنوج","فاریاب",30,351,1,0,6,358,0,358
"کرمان","کهنوج","فاریاب",31,472,0,0,0,472,0,472
"کرمان","کهنوج","فاریاب",32,188,0,0,3,191,0,191
"کرمان","کهنوج","فاریاب",33,316,2,0,31,349,2,351
"کرمان","کهنوج","فاریاب",34,79,0,0,47,126,0,126
"کرمان","کهنوج","فاریاب",35,451,1,0,17,469,0,469
"کرمان","کهنوج","فاریاب",36,212,2,0,22,236,0,236
"کرمان","کوهبنان","مرکزی",1,799,8,5,396,1208,3,1211
"کرمان","کوهبنان","مرکزی",2,416,5,0,172,593,4,597
"کرمان","کوهبنان","مرکزی",3,280,1,1,87,369,1,370
"کرمان","کوهبنان","مرکزی",4,992,14,1,249,1256,6,1262
"کرمان","کوهبنان","مرکزی",5,694,4,3,183,884,7,891
"کرمان","کوهبنان","مرکزی",6,797,4,2,257,1060,5,1065
"کرمان","کوهبنان","مرکزی",7,1224,14,2,307,1547,4,1551
"کرمان","کوهبنان","مرکزی",8,494,1,0,70,565,1,566
"کرمان","کوهبنان","مرکزی",9,522,1,2,50,575,1,576
"کرمان","کوهبنان","مرکزی",10,256,3,0,103,362,3,365
"کرمان","کوهبنان","مرکزی",11,263,0,0,24,287,2,289
"کرمان","کوهبنان","مرکزی",12,329,2,1,47,379,4,383
"کرمان","کوهبنان","مرکزی",13,273,0,0,24,297,0,297
"کرمان","کوهبنان","طغرلجرد",1,563,8,1,121,693,8,701
"کرمان","کوهبنان","طغرلجرد",2,401,5,0,89,495,8,503
"کرمان","کوهبنان","طغرلجرد",3,437,5,1,87,530,1,531
"کرمان","کوهبنان","طغرلجرد",4,375,3,2,192,572,8,580
"کرمان","کوهبنان","طغرلجرد",5,423,3,0,184,610,6,616
"کرمان","کوهبنان","طغرلجرد",6,258,3,1,115,377,2,379
"کرمان","کوهبنان","طغرلجرد",7,655,2,0,41,698,0,698
"کرمان","کوهبنان","طغرلجرد",8,390,2,0,42,434,1,435
"کرمان","کوهبنان","طغرلجرد",9,303,0,0,37,340,3,343
"کرمان","کوهبنان","طغرلجرد",10,314,1,0,86,401,0,401
"کرمان","کوهبنان","طغرلجرد",11,350,0,0,81,431,4,435
"کرمان","منوجان","مرکزی",1,522,0,4,195,721,3,724
"کرمان","منوجان","مرکزی",2,479,3,0,70,552,3,555
"کرمان","منوجان","مرکزی",3,548,2,0,32,582,0,582
"کرمان","منوجان","مرکزی",4,173,0,0,15,188,0,188
"کرمان","منوجان","مرکزی",5,636,2,0,58,696,3,699
"کرمان","منوجان","مرکزی",6,450,1,0,4,455,0,455
"کرمان","منوجان","مرکزی",7,457,5,1,64,527,0,527
"کرمان","منوجان","مرکزی",8,674,5,0,54,733,1,734
"کرمان","منوجان","مرکزی",9,705,4,2,24,735,1,736
"کرمان","منوجان","مرکزی",10,125,2,2,46,175,0,175
"کرمان","منوجان","مرکزی",11,1029,1,0,18,1048,1,1049
"کرمان","منوجان","مرکزی",12,691,10,2,31,734,2,736
"کرمان","منوجان","مرکزی",13,481,5,2,196,684,3,687
"کرمان","منوجان","مرکزی",14,345,3,0,55,403,0,403
"کرمان","منوجان","مرکزی",15,1050,2,4,156,1212,2,1214
"کرمان","منوجان","مرکزی",16,725,0,1,28,754,2,756
"کرمان","منوجان","مرکزی",17,946,12,7,99,1064,7,1071
"کرمان","منوجان","مرکزی",18,383,1,0,1,385,0,385
"کرمان","منوجان","مرکزی",19,641,0,0,12,653,0,653
"کرمان","منوجان","مرکزی",20,749,0,2,7,758,0,758
"کرمان","منوجان","مرکزی",21,844,1,2,12,859,0,859
"کرمان","منوجان","مرکزی",22,671,1,0,17,689,1,690
"کرمان","منوجان","مرکزی",23,540,0,0,9,549,0,549
"کرمان","منوجان","مرکزی",24,661,3,1,31,696,0,696
"کرمان","منوجان","مرکزی",25,752,0,0,38,790,1,791
"کرمان","منوجان","مرکزی",26,440,1,1,20,462,2,464
"کرمان","منوجان","مرکزی",27,679,0,0,3,682,0,682
"کرمان","منوجان","مرکزی",28,644,1,0,20,665,2,667
"کرمان","منوجان","مرکزی",29,488,0,0,11,499,1,500
"کرمان","منوجان","مرکزی",30,234,2,0,0,236,0,236
"کرمان","منوجان","مرکزی",31,399,2,0,2,403,0,403
"کرمان","منوجان","مرکزی",32,467,0,0,6,473,4,477
"کرمان","منوجان","مرکزی",33,771,2,1,42,816,0,816
"کرمان","منوجان","مرکزی",34,415,0,0,1,416,0,416
"کرمان","منوجان","مرکزی",35,488,0,0,8,496,1,497
"کرمان","منوجان","مرکزی",36,646,2,1,26,675,4,679
"کرمان","منوجان","مرکزی",37,687,0,0,9,696,4,700
"کرمان","منوجان","مرکزی",38,307,1,2,6,316,3,319
"کرمان","منوجان","آسمینون",1,854,6,5,56,921,0,921
"کرمان","منوجان","آسمینون",2,474,2,0,42,518,1,519
"کرمان","منوجان","آسمینون",3,535,0,0,12,547,3,550
"کرمان","منوجان","آسمینون",4,361,0,1,20,382,2,384
"کرمان","منوجان","آسمینون",5,266,1,0,9,276,5,281
"کرمان","منوجان","آسمینون",6,291,2,0,33,326,1,327
"کرمان","منوجان","آسمینون",7,304,4,1,44,353,3,356
"کرمان","منوجان","آسمینون",8,408,0,0,24,432,0,432
"کرمان","منوجان","آسمینون",9,380,4,1,37,422,1,423
"کرمان","منوجان","آسمینون",10,337,0,0,22,359,1,360
"کرمان","منوجان","آسمینون",11,402,1,0,41,444,2,446
"کرمان","منوجان","آسمینون",12,429,1,0,7,437,0,437
"کرمان","منوجان","آسمینون",13,646,1,0,19,666,3,669
"کرمان","منوجان","آسمینون",14,437,0,0,13,450,0,450
"کرمان","منوجان","آسمینون",15,650,4,4,96,754,0,754
"کرمان","منوجان","آسمینون",16,401,1,1,23,426,0,426
"کرمان","منوجان","آسمینون",17,606,0,0,19,625,2,627
"کرمان","منوجان","آسمینون",18,162,2,0,5,169,0,169
"کرمان","منوجان","آسمینون",19,420,2,0,46,468,2,470
"کرمان","منوجان","آسمینون",20,221,1,0,1,223,0,223
"کرمان","منوجان","آسمینون",21,275,1,0,8,284,0,284
"کرمان","منوجان","آسمینون",22,946,3,0,30,979,2,981
"کرمان","منوجان","آسمینون",23,485,1,0,2,488,2,490
"کرمان","منوجان","آسمینون",24,434,1,0,10,445,0,445
"کرمان","منوجان","آسمینون",25,307,0,0,2,309,0,309
"کرمان","منوجان","آسمینون",26,480,0,0,0,480,0,480
"کرمان","منوجان","آسمینون",27,448,0,0,18,466,3,469
"کرمان","منوجان","آسمینون",28,639,0,0,58,697,0,697
"کرمان","منوجان","آسمینون",29,665,2,1,43,711,3,714
"کرمان","منوجان","آسمینون",30,676,5,4,33,718,10,728
"کهکیلویه_و_بویراحمد","بهمئی","مرکزی",1,258,8,10,106,382,5,387
"کهکیلویه_و_بویراحمد","بهمئی","مرکزی",2,149,1,15,69,234,7,241
"کهکیلویه_و_بویراحمد","بهمئی","مرکزی",3,176,2,2,82,262,0,262
"کهکیلویه_و_بویراحمد","بهمئی","مرکزی",4,264,2,2,68,336,2,338
"کهکیلویه_و_بویراحمد","بهمئی","مرکزی",5,292,27,1,129,449,1,450
"کهکیلویه_و_بویراحمد","بهمئی","مرکزی",6,296,10,8,67,381,1,382
"کهکیلویه_و_بویراحمد","بهمئی","مرکزی",7,280,3,2,110,395,0,395
"کهکیلویه_و_بویراحمد","بهمئی","مرکزی",8,210,5,5,102,322,0,322
"کهکیلویه_و_بویراحمد","بهمئی","مرکزی",9,306,10,8,143,467,8,475
"کهکیلویه_و_بویراحمد","بهمئی","مرکزی",10,313,13,9,215,550,0,550
"کهکیلویه_و_بویراحمد","بهمئی","مرکزی",11,166,8,0,87,261,0,261
"کهکیلویه_و_بویراحمد","بهمئی","مرکزی",12,208,5,1,77,291,11,302
"کهکیلویه_و_بویراحمد","بهمئی","مرکزی",13,347,10,3,140,500,0,500
"کهکیلویه_و_بویراحمد","بهمئی","مرکزی",14,348,10,14,145,517,3,520
"کهکیلویه_و_بویراحمد","بهمئی","مرکزی",15,146,1,2,103,252,4,256
"کهکیلویه_و_بویراحمد","بهمئی","مرکزی",16,205,15,12,130,362,0,362
"کهکیلویه_و_بویراحمد","بهمئی","مرکزی",17,177,4,10,56,247,1,248
"کهکیلویه_و_بویراحمد","بهمئی","مرکزی",18,123,4,3,71,201,1,202
"کهکیلویه_و_بویراحمد","بهمئی","مرکزی",19,216,3,10,75,304,0,304
"کهکیلویه_و_بویراحمد","بهمئی","مرکزی",20,200,2,1,75,278,2,280
"کهکیلویه_و_بویراحمد","بهمئی","مرکزی",21,196,11,47,96,350,0,350
"کهکیلویه_و_بویراحمد","بهمئی","مرکزی",22,256,19,25,143,443,1,444
"کهکیلویه_و_بویراحمد","بهمئی","مرکزی",23,159,27,1,67,254,1,255
"کهکیلویه_و_بویراحمد","بهمئی","مرکزی",24,226,4,7,102,339,1,340
"کهکیلویه_و_بویراحمد","بهمئی","مرکزی",25,129,4,1,88,222,3,225
"کهکیلویه_و_بویراحمد","بهمئی","مرکزی",26,368,5,1,132,506,0,506
"کهکیلویه_و_بویراحمد","بهمئی","مرکزی",27,311,9,6,68,394,0,394
"کهکیلویه_و_بویراحمد","بهمئی","مرکزی",28,152,3,2,38,195,0,195
"کهکیلویه_و_بویراحمد","بهمئی","مرکزی",29,170,3,3,125,301,3,304
"کهکیلویه_و_بویراحمد","بهمئی","مرکزی",30,233,10,2,106,351,0,351
"کهکیلویه_و_بویراحمد","بهمئی","مرکزی",31,215,2,49,104,370,3,373
"کهکیلویه_و_بویراحمد","بهمئی","مرکزی",32,137,19,16,39,211,1,212
"کهکیلویه_و_بویراحمد","بهمئی","مرکزی",33,138,0,2,66,206,0,206
"کهکیلویه_و_بویراحمد","بهمئی","مرکزی",34,51,0,24,68,143,0,143
"کهکیلویه_و_بویراحمد","بهمئی","مرکزی",35,177,2,29,86,294,2,296
"کهکیلویه_و_بویراحمد","بهمئی","مرکزی",36,244,8,12,118,382,0,382
"کهکیلویه_و_بویراحمد","بهمئی","مرکزی",37,254,4,4,53,315,2,317
"کهکیلویه_و_بویراحمد","بهمئی","مرکزی",38,108,1,1,43,153,0,153
"کهکیلویه_و_بویراحمد","بهمئی","مرکزی",39,142,3,17,73,235,1,236
"کهکیلویه_و_بویراحمد","بهمئی","مرکزی",40,152,6,0,8,166,0,166
"کهکیلویه_و_بویراحمد","بهمئی","مرکزی",41,259,1,1,70,331,1,332
"کهکیلویه_و_بویراحمد","بهمئی","مرکزی",42,119,2,0,36,157,0,157
"کهکیلویه_و_بویراحمد","بهمئی","مرکزی",43,51,1,0,19,71,2,73
"کهکیلویه_و_بویراحمد","بهمئی","مرکزی",44,450,1,8,108,567,5,572
"کهکیلویه_و_بویراحمد","بهمئی","مرکزی",45,358,2,4,54,418,0,418
"کهکیلویه_و_بویراحمد","بهمئی","مرکزی",46,261,0,0,15,276,0,276
"کهکیلویه_و_بویراحمد","بهمئی","مرکزی",47,209,6,2,31,248,0,248
"کهکیلویه_و_بویراحمد","بهمئی","مرکزی",48,254,12,1,41,308,0,308
"کهکیلویه_و_بویراحمد","بهمئی","مرکزی",49,163,10,0,60,233,0,233
"کهکیلویه_و_بویراحمد","بهمئی","مرکزی",50,177,1,0,48,226,0,226
"کهکیلویه_و_بویراحمد","بهمئی","مرکزی",51,206,7,0,34,247,15,262
"کهکیلویه_و_بویراحمد","بهمئی","مرکزی",52,276,6,3,63,348,0,348
"کهکیلویه_و_بویراحمد","بهمئی","مرکزی",53,175,4,1,50,230,0,230
"کهکیلویه_و_بویراحمد","بهمئی","مرکزی",54,263,12,1,42,318,0,318
"کهکیلویه_و_بویراحمد","بهمئی","مرکزی",55,301,7,7,51,366,0,366
"کهکیلویه_و_بویراحمد","بهمئی","مرکزی",56,115,0,0,16,131,2,133
"کهکیلویه_و_بویراحمد","بهمئی","مرکزی",57,293,2,2,69,366,1,367
"کهکیلویه_و_بویراحمد","بهمئی","مرکزی",58,208,5,1,81,295,1,296
"کهکیلویه_و_بویراحمد","بهمئی","مرکزی",59,148,1,1,9,159,0,159
"کهکیلویه_و_بویراحمد","بهمئی","مرکزی",60,134,4,2,59,199,1,200
"کهکیلویه_و_بویراحمد","بهمئی","مرکزی",61,171,3,22,104,300,0,300
"کهکیلویه_و_بویراحمد","بهمئی","مرکزی",62,136,3,9,23,171,1,172
"کهکیلویه_و_بویراحمد","بهمئی","مرکزی",63,172,2,3,44,221,0,221
"کهکیلویه_و_بویراحمد","بهمئی","مرکزی",64,119,1,2,54,176,0,176
"کهکیلویه_و_بویراحمد","بهمئی","مرکزی",65,141,1,0,9,151,0,151
"کهکیلویه_و_بویراحمد","بهمئی","مرکزی",66,312,2,0,17,331,0,331
"کهکیلویه_و_بویراحمد","بهمئی","مرکزی",67,126,1,0,2,129,0,129
"کهکیلویه_و_بویراحمد","بهمئی","مرکزی",68,484,13,32,161,690,4,694
"کهکیلویه_و_بویراحمد","بهمئی","مرکزی",69,210,14,2,60,286,6,292
"کهکیلویه_و_بویراحمد","بهمئی","مرکزی",70,51,2,1,9,63,2,65
"کهکیلویه_و_بویراحمد","بویراحمد","مرکزی",1,735,64,33,557,1389,10,1399
"کهکیلویه_و_بویراحمد","بویراحمد","مرکزی",2,669,70,53,793,1585,10,1595
"کهکیلویه_و_بویراحمد","بویراحمد","مرکزی",3,810,48,33,697,1588,12,1600
"کهکیلویه_و_بویراحمد","بویراحمد","مرکزی",4,487,49,54,599,1189,11,1200
"کهکیلویه_و_بویراحمد","بویراحمد","مرکزی",5,575,47,36,649,1307,14,1321
"کهکیلویه_و_بویراحمد","بویراحمد","مرکزی",6,492,43,22,421,978,7,985
"کهکیلویه_و_بویراحمد","بویراحمد","مرکزی",7,607,22,14,306,949,6,955
"کهکیلویه_و_بویراحمد","بویراحمد","مرکزی",8,417,23,11,299,750,3,753
"کهکیلویه_و_بویراحمد","بویراحمد","مرکزی",9,752,46,27,525,1350,11,1361
"کهکیلویه_و_بویراحمد","بویراحمد","مرکزی",10,521,41,34,571,1167,11,1178
"کهکیلویه_و_بویراحمد","بویراحمد","مرکزی",11,603,33,25,468,1129,10,1139
"کهکیلویه_و_بویراحمد","بویراحمد","مرکزی",12,475,25,18,376,894,10,904
"کهکیلویه_و_بویراحمد","بویراحمد","مرکزی",13,549,25,23,560,1157,7,1164
"کهکیلویه_و_بویراحمد","بویراحمد","مرکزی",14,620,50,28,447,1145,3,1148
"کهکیلویه_و_بویراحمد","بویراحمد","مرکزی",15,646,48,15,444,1153,7,1160
"کهکیلویه_و_بویراحمد","بویراحمد","مرکزی",16,594,48,16,444,1102,2,1104
"کهکیلویه_و_بویراحمد","بویراحمد","مرکزی",17,884,45,18,463,1410,11,1421
"کهکیلویه_و_بویراحمد","بویراحمد","مرکزی",18,834,22,25,559,1440,7,1447
"کهکیلویه_و_بویراحمد","بویراحمد","مرکزی",19,808,36,25,502,1371,14,1385
"کهکیلویه_و_بویراحمد","بویراحمد","مرکزی",20,779,45,52,687,1563,12,1575
"کهکیلویه_و_بویراحمد","بویراحمد","مرکزی",21,665,24,25,569,1283,4,1287
"کهکیلویه_و_بویراحمد","بویراحمد","مرکزی",22,676,29,26,451,1182,6,1188
"کهکیلویه_و_بویراحمد","بویراحمد","مرکزی",23,743,55,16,378,1192,10,1202
"کهکیلویه_و_بویراحمد","بویراحمد","مرکزی",24,840,33,12,408,1293,9,1302
"کهکیلویه_و_بویراحمد","بویراحمد","مرکزی",25,890,28,39,428,1385,4,1389
"کهکیلویه_و_بویراحمد","بویراحمد","مرکزی",26,806,56,25,567,1454,10,1464
"کهکیلویه_و_بویراحمد","بویراحمد","مرکزی",27,732,27,6,350,1115,8,1123
"کهکیلویه_و_بویراحمد","بویراحمد","مرکزی",28,973,44,15,558,1590,20,1610
"کهکیلویه_و_بویراحمد","بویراحمد","مرکزی",29,816,71,17,381,1285,7,1292
"کهکیلویه_و_بویراحمد","بویراحمد","مرکزی",30,716,43,21,407,1187,10,1197
"کهکیلویه_و_بویراحمد","بویراحمد","مرکزی",31,880,40,18,284,1222,4,1226
"کهکیلویه_و_بویراحمد","بویراحمد","مرکزی",32,1202,64,25,555,1846,12,1858
"کهکیلویه_و_بویراحمد","بویراحمد","مرکزی",33,904,51,15,350,1320,10,1330
"کهکیلویه_و_بویراحمد","بویراحمد","مرکزی",34,924,52,31,568,1575,4,1579
"کهکیلویه_و_بویراحمد","بویراحمد","مرکزی",35,1237,46,20,429,1732,14,1746
"کهکیلویه_و_بویراحمد","بویراحمد","مرکزی",36,727,20,6,205,958,4,962
"کهکیلویه_و_بویراحمد","بویراحمد","مرکزی",37,622,36,17,226,901,10,911
"کهکیلویه_و_بویراحمد","بویراحمد","مرکزی",38,900,30,17,308,1255,8,1263
"کهکیلویه_و_بویراحمد","بویراحمد","مرکزی",39,1065,27,18,295,1405,6,1411
"کهکیلویه_و_بویراحمد","بویراحمد","مرکزی",40,911,47,8,447,1413,12,1425
"کهکیلویه_و_بویراحمد","بویراحمد","مرکزی",41,801,22,10,283,1116,3,1119
"کهکیلویه_و_بویراحمد","بویراحمد","مرکزی",42,784,37,16,325,1162,6,1168
"کهکیلویه_و_بویراحمد","بویراحمد","مرکزی",43,815,29,18,275,1137,8,1145
"کهکیلویه_و_بویراحمد","بویراحمد","مرکزی",44,748,36,14,400,1198,7,1205
"کهکیلویه_و_بویراحمد","بویراحمد","مرکزی",45,684,35,23,422,1164,7,1171
"کهکیلویه_و_بویراحمد","بویراحمد","مرکزی",46,1024,14,51,365,1454,10,1464
"کهکیلویه_و_بویراحمد","بویراحمد","مرکزی",47,960,19,6,154,1139,4,1143
"کهکیلویه_و_بویراحمد","بویراحمد","مرکزی",48,1189,36,6,210,1441,4,1445
"کهکیلویه_و_بویراحمد","بویراحمد","مرکزی",49,1039,34,7,215,1295,5,1300
"کهکیلویه_و_بویراحمد","بویراحمد","مرکزی",50,1517,20,4,157,1698,2,1700
"کهکیلویه_و_بویراحمد","بویراحمد","مرکزی",51,1150,6,7,233,1396,3,1399
"کهکیلویه_و_بویراحمد","بویراحمد","مرکزی",52,644,33,7,148,832,6,838
"کهکیلویه_و_بویراحمد","بویراحمد","مرکزی",53,430,29,11,207,677,4,681
"کهکیلویه_و_بویراحمد","بویراحمد","مرکزی",54,507,22,8,208,745,9,754
"کهکیلویه_و_بویراحمد","بویراحمد","مرکزی",55,558,63,13,111,745,1,746
"کهکیلویه_و_بویراحمد","بویراحمد","مرکزی",56,1003,18,35,245,1301,5,1306
"کهکیلویه_و_بویراحمد","بویراحمد","مرکزی",57,788,125,17,132,1062,7,1069
"کهکیلویه_و_بویراحمد","بویراحمد","مرکزی",58,818,19,14,237,1088,8,1096
"کهکیلویه_و_بویراحمد","بویراحمد","مرکزی",59,1117,1,1,13,1132,1,1133
"کهکیلویه_و_بویراحمد","بویراحمد","مرکزی",60,250,15,5,110,380,28,408
"کهکیلویه_و_بویراحمد","بویراحمد","مرکزی",61,222,5,7,108,342,4,346
"کهکیلویه_و_بویراحمد","بویراحمد","مرکزی",62,954,34,8,195,1191,5,1196
"کهکیلویه_و_بویراحمد","بویراحمد","مرکزی",63,695,128,12,262,1097,7,1104
"کهکیلویه_و_بویراحمد","بویراحمد","مرکزی",64,916,155,16,268,1355,5,1360
"کهکیلویه_و_بویراحمد","بویراحمد","مرکزی",65,416,16,9,143,584,2,586
"کهکیلویه_و_بویراحمد","بویراحمد","مرکزی",66,1153,32,24,262,1471,6,1477
"کهکیلویه_و_بویراحمد","بویراحمد","مرکزی",67,990,130,16,281,1417,4,1421
"کهکیلویه_و_بویراحمد","بویراحمد","مرکزی",68,513,121,127,148,909,5,914
"کهکیلویه_و_بویراحمد","بویراحمد","مرکزی",69,567,116,16,229,928,5,933
"کهکیلویه_و_بویراحمد","بویراحمد","مرکزی",70,328,107,9,117,561,6,567
"کهکیلویه_و_بویراحمد","بویراحمد","مرکزی",71,579,111,29,220,939,2,941
"کهکیلویه_و_بویراحمد","بویراحمد","مرکزی",72,694,4,7,89,794,0,794
"کهکیلویه_و_بویراحمد","بویراحمد","مرکزی",73,845,12,1,54,912,4,916
"کهکیلویه_و_بویراحمد","بویراحمد","مرکزی",74,740,3,1,32,776,2,778
"کهکیلویه_و_بویراحمد","بویراحمد","مرکزی",75,242,1,3,70,316,0,316
"کهکیلویه_و_بویراحمد","بویراحمد","مرکزی",76,605,5,8,155,773,4,777
"کهکیلویه_و_بویراحمد","بویراحمد","مرکزی",77,351,12,3,148,514,3,517
"کهکیلویه_و_بویراحمد","بویراحمد","مرکزی",78,355,7,4,158,524,4,528
"کهکیلویه_و_بویراحمد","بویراحمد","مرکزی",79,600,15,11,207,833,4,837
"کهکیلویه_و_بویراحمد","بویراحمد","مرکزی",80,343,3,9,135,490,5,495
"کهکیلویه_و_بویراحمد","بویراحمد","مرکزی",81,339,5,67,60,471,5,476
"کهکیلویه_و_بویراحمد","بویراحمد","مرکزی",82,526,11,28,148,713,3,716
"کهکیلویه_و_بویراحمد","بویراحمد","مرکزی",83,695,11,1,144,851,5,856
"کهکیلویه_و_بویراحمد","بویراحمد","مرکزی",84,609,127,5,128,869,4,873
"کهکیلویه_و_بویراحمد","بویراحمد","مرکزی",85,161,2,1,42,206,0,206
"کهکیلویه_و_بویراحمد","بویراحمد","مرکزی",86,310,6,3,104,423,6,429
"کهکیلویه_و_بویراحمد","بویراحمد","مرکزی",87,305,14,5,216,540,0,540
"کهکیلویه_و_بویراحمد","بویراحمد","مرکزی",88,787,152,8,300,1247,4,1251
"کهکیلویه_و_بویراحمد","بویراحمد","مرکزی",89,578,7,10,275,870,4,874
"کهکیلویه_و_بویراحمد","بویراحمد","مرکزی",90,453,26,4,177,660,0,660
"کهکیلویه_و_بویراحمد","بویراحمد","مرکزی",91,905,125,11,304,1345,4,1349
"کهکیلویه_و_بویراحمد","بویراحمد","مرکزی",92,637,2,3,133,775,4,779
"کهکیلویه_و_بویراحمد","بویراحمد","مرکزی",93,433,20,2,128,583,6,589
"کهکیلویه_و_بویراحمد","بویراحمد","مرکزی",94,846,12,3,105,966,8,974
"کهکیلویه_و_بویراحمد","بویراحمد","مرکزی",95,980,134,7,304,1425,0,1425
"کهکیلویه_و_بویراحمد","بویراحمد","مرکزی",96,290,8,4,253,555,8,563
"کهکیلویه_و_بویراحمد","بویراحمد","مرکزی",97,635,7,8,293,943,0,943
"کهکیلویه_و_بویراحمد","بویراحمد","مرکزی",98,388,99,26,210,723,0,723
"کهکیلویه_و_بویراحمد","بویراحمد","مرکزی",99,237,0,0,21,258,0,258
"کهکیلویه_و_بویراحمد","بویراحمد","مرکزی",100,495,37,56,98,686,1,687
"کهکیلویه_و_بویراحمد","بویراحمد","مرکزی",101,143,1,0,35,179,1,180
"کهکیلویه_و_بویراحمد","بویراحمد","مرکزی",102,228,6,0,48,282,0,282
"کهکیلویه_و_بویراحمد","بویراحمد","مرکزی",103,402,3,6,125,536,1,537
"کهکیلویه_و_بویراحمد","بویراحمد","مرکزی",104,510,9,6,119,644,1,645
"کهکیلویه_و_بویراحمد","بویراحمد","مرکزی",105,366,110,19,339,834,5,839
"کهکیلویه_و_بویراحمد","بویراحمد","مارگون",1,440,6,1,152,599,1,600
"کهکیلویه_و_بویراحمد","بویراحمد","مارگون",2,508,8,1,38,555,0,555
"کهکیلویه_و_بویراحمد","بویراحمد","مارگون",3,364,8,0,28,400,0,400
"کهکیلویه_و_بویراحمد","بویراحمد","مارگون",4,261,2,1,8,272,4,276
"کهکیلویه_و_بویراحمد","بویراحمد","مارگون",5,459,3,1,56,519,1,520
"کهکیلویه_و_بویراحمد","بویراحمد","مارگون",6,521,1,0,11,533,0,533
"کهکیلویه_و_بویراحمد","بویراحمد","مارگون",7,488,6,6,16,516,0,516
"کهکیلویه_و_بویراحمد","بویراحمد","مارگون",8,347,4,1,47,399,0,399
"کهکیلویه_و_بویراحمد","بویراحمد","مارگون",9,360,0,0,40,400,0,400
"کهکیلویه_و_بویراحمد","بویراحمد","مارگون",10,279,0,0,6,285,0,285
"کهکیلویه_و_بویراحمد","بویراحمد","مارگون",11,301,1,0,62,364,0,364
"کهکیلویه_و_بویراحمد","بویراحمد","مارگون",12,747,3,3,33,786,0,786
"کهکیلویه_و_بویراحمد","بویراحمد","مارگون",13,645,5,1,43,694,1,695
"کهکیلویه_و_بویراحمد","بویراحمد","مارگون",14,398,9,8,136,551,0,551
"کهکیلویه_و_بویراحمد","بویراحمد","مارگون",15,474,2,0,46,522,0,522
"کهکیلویه_و_بویراحمد","بویراحمد","مارگون",16,644,2,1,60,707,3,710
"کهکیلویه_و_بویراحمد","بویراحمد","مارگون",17,342,0,0,11,353,0,353
"کهکیلویه_و_بویراحمد","بویراحمد","مارگون",18,777,3,0,20,800,0,800
"کهکیلویه_و_بویراحمد","بویراحمد","مارگون",19,438,1,0,15,454,0,454
"کهکیلویه_و_بویراحمد","بویراحمد","مارگون",20,305,4,1,18,328,0,328
"کهکیلویه_و_بویراحمد","بویراحمد","مارگون",21,425,0,1,12,438,0,438
"کهکیلویه_و_بویراحمد","بویراحمد","مارگون",22,391,0,0,8,399,0,399
"کهکیلویه_و_بویراحمد","بویراحمد","مارگون",23,524,4,31,11,570,0,570
"کهکیلویه_و_بویراحمد","بویراحمد","مارگون",24,364,2,5,25,396,0,396
"کهکیلویه_و_بویراحمد","بویراحمد","مارگون",25,318,1,2,47,368,2,370
"کهکیلویه_و_بویراحمد","بویراحمد","مارگون",26,203,0,0,17,220,0,220
"کهکیلویه_و_بویراحمد","بویراحمد","مارگون",27,260,0,0,4,264,0,264
"کهکیلویه_و_بویراحمد","بویراحمد","مارگون",28,500,4,2,40,546,0,546
"کهکیلویه_و_بویراحمد","بویراحمد","مارگون",29,152,0,1,23,176,0,176
"کهکیلویه_و_بویراحمد","بویراحمد","مارگون",30,146,1,0,12,159,0,159
"کهکیلویه_و_بویراحمد","بویراحمد","مارگون",31,181,1,0,9,191,0,191
"کهکیلویه_و_بویراحمد","بویراحمد","لوداب",1,283,1,1,44,329,0,329
"کهکیلویه_و_بویراحمد","بویراحمد","لوداب",2,437,0,1,88,526,0,526
"کهکیلویه_و_بویراحمد","بویراحمد","لوداب",3,370,2,0,104,476,0,476
"کهکیلویه_و_بویراحمد","بویراحمد","لوداب",4,477,12,0,111,600,0,600
"کهکیلویه_و_بویراحمد","بویراحمد","لوداب",5,204,0,0,29,233,0,233
"کهکیلویه_و_بویراحمد","بویراحمد","لوداب",6,570,6,0,26,602,0,602
"کهکیلویه_و_بویراحمد","بویراحمد","لوداب",7,536,0,0,7,543,0,543
"کهکیلویه_و_بویراحمد","بویراحمد","لوداب",8,66,0,0,13,79,1,80
"کهکیلویه_و_بویراحمد","بویراحمد","لوداب",9,491,1,0,3,495,0,495
"کهکیلویه_و_بویراحمد","بویراحمد","لوداب",10,849,1,0,39,889,0,889
"کهکیلویه_و_بویراحمد","بویراحمد","لوداب",11,254,4,0,4,262,0,262
"کهکیلویه_و_بویراحمد","بویراحمد","لوداب",12,230,1,0,4,235,0,235
"کهکیلویه_و_بویراحمد","بویراحمد","لوداب",13,49,0,0,2,51,0,51
"کهکیلویه_و_بویراحمد","بویراحمد","لوداب",14,142,1,0,3,146,0,146
"کهکیلویه_و_بویراحمد","بویراحمد","لوداب",15,413,14,1,88,516,0,516
"کهکیلویه_و_بویراحمد","بویراحمد","لوداب",16,424,4,1,36,465,0,465
"کهکیلویه_و_بویراحمد","بویراحمد","لوداب",17,260,2,1,48,311,0,311
"کهکیلویه_و_بویراحمد","بویراحمد","لوداب",18,628,0,3,19,650,0,650
"کهکیلویه_و_بویراحمد","بویراحمد","لوداب",19,554,0,0,11,565,0,565
"کهکیلویه_و_بویراحمد","بویراحمد","لوداب",20,171,0,0,13,184,0,184
"کهکیلویه_و_بویراحمد","بویراحمد","لوداب",21,267,0,0,14,281,0,281
"کهکیلویه_و_بویراحمد","بویراحمد","لوداب",22,260,0,0,14,274,0,274
"کهکیلویه_و_بویراحمد","بویراحمد","لوداب",23,77,0,0,1,78,0,78
"کهکیلویه_و_بویراحمد","بویراحمد","لوداب",24,468,11,0,21,500,0,500
"کهکیلویه_و_بویراحمد","بویراحمد","لوداب",25,338,1,0,36,375,1,376
"کهکیلویه_و_بویراحمد","دنا","مرکزی",1,841,19,8,218,1086,19,1105
"کهکیلویه_و_بویراحمد","دنا","مرکزی",2,423,8,6,132,569,5,574
"کهکیلویه_و_بویراحمد","دنا","مرکزی",3,414,7,4,140,565,8,573
"کهکیلویه_و_بویراحمد","دنا","مرکزی",4,522,11,9,290,832,19,851
"کهکیلویه_و_بویراحمد","دنا","مرکزی",5,495,18,8,290,811,7,818
"کهکیلویه_و_بویراحمد","دنا","مرکزی",6,375,7,10,77,469,9,478
"کهکیلویه_و_بویراحمد","دنا","مرکزی",7,519,8,5,71,603,0,603
"کهکیلویه_و_بویراحمد","دنا","مرکزی",8,341,7,2,112,462,2,464
"کهکیلویه_و_بویراحمد","دنا","مرکزی",9,545,4,4,82,635,5,640
"کهکیلویه_و_بویراحمد","دنا","مرکزی",10,951,6,17,55,1029,3,1032
"کهکیلویه_و_بویراحمد","دنا","مرکزی",11,549,9,5,54,617,0,617
"کهکیلویه_و_بویراحمد","دنا","مرکزی",12,1266,6,0,11,1283,0,1283
"کهکیلویه_و_بویراحمد","دنا","مرکزی",13,777,4,0,67,848,0,848
"کهکیلویه_و_بویراحمد","دنا","مرکزی",14,426,4,1,120,551,0,551
"کهکیلویه_و_بویراحمد","دنا","مرکزی",15,375,2,5,100,482,4,486
"کهکیلویه_و_بویراحمد","دنا","مرکزی",16,276,16,2,121,415,3,418
"کهکیلویه_و_بویراحمد","دنا","مرکزی",17,448,11,8,206,673,0,673
"کهکیلویه_و_بویراحمد","دنا","مرکزی",18,690,8,0,190,888,0,888
"کهکیلویه_و_بویراحمد","دنا","پاتاوه",1,425,17,2,104,548,0,548
"کهکیلویه_و_بویراحمد","دنا","پاتاوه",2,419,7,0,56,482,0,482
"کهکیلویه_و_بویراحمد","دنا","پاتاوه",3,536,9,2,104,651,1,652
"کهکیلویه_و_بویراحمد","دنا","پاتاوه",4,1051,9,1,46,1107,0,1107
"کهکیلویه_و_بویراحمد","دنا","پاتاوه",5,368,5,0,9,382,1,383
"کهکیلویه_و_بویراحمد","دنا","پاتاوه",6,296,1,2,30,329,0,329
"کهکیلویه_و_بویراحمد","دنا","پاتاوه",7,848,5,0,77,930,4,934
"کهکیلویه_و_بویراحمد","دنا","پاتاوه",8,454,3,0,43,500,2,502
"کهکیلویه_و_بویراحمد","دنا","پاتاوه",9,429,15,0,149,593,2,595
"کهکیلویه_و_بویراحمد","دنا","پاتاوه",10,851,3,0,40,894,3,897
"کهکیلویه_و_بویراحمد","دنا","پاتاوه",11,528,8,6,55,597,0,597
"کهکیلویه_و_بویراحمد","دنا","پاتاوه",12,414,19,0,72,505,0,505
"کهکیلویه_و_بویراحمد","دنا","پاتاوه",13,453,9,0,132,594,3,597
"کهکیلویه_و_بویراحمد","دنا","پاتاوه",14,886,3,3,142,1034,0,1034
"کهکیلویه_و_بویراحمد","دنا","پاتاوه",15,411,3,0,84,498,2,500
"کهکیلویه_و_بویراحمد","دنا","پاتاوه",16,347,0,0,53,400,0,400
"کهکیلویه_و_بویراحمد","دنا","پاتاوه",17,408,1,0,40,449,1,450
"کهکیلویه_و_بویراحمد","دنا","پاتاوه",18,542,7,2,98,649,0,649
"کهکیلویه_و_بویراحمد","دنا","پاتاوه",19,314,3,1,36,354,0,354
"کهکیلویه_و_بویراحمد","دنا","پاتاوه",20,224,6,1,17,248,1,249
"کهکیلویه_و_بویراحمد","دنا","پاتاوه",21,379,5,0,16,400,0,400
"کهکیلویه_و_بویراحمد","دنا","پاتاوه",22,455,2,1,106,564,4,568
"کهکیلویه_و_بویراحمد","دنا","پاتاوه",23,306,5,1,28,340,3,343
"کهکیلویه_و_بویراحمد","دنا","پاتاوه",24,1008,5,1,51,1065,0,1065
"کهکیلویه_و_بویراحمد","دنا","پاتاوه",25,875,5,2,103,985,0,985
"کهکیلویه_و_بویراحمد","دنا","پاتاوه",26,406,0,2,26,434,2,436
"کهکیلویه_و_بویراحمد","دنا","پاتاوه",27,332,1,1,72,406,0,406
"کهکیلویه_و_بویراحمد","دنا","پاتاوه",28,232,2,0,27,261,0,261
"کهکیلویه_و_بویراحمد","دنا","کبگیان",1,1030,10,4,154,1198,2,1200
"کهکیلویه_و_بویراحمد","دنا","کبگیان",2,964,11,3,143,1121,0,1121
"کهکیلویه_و_بویراحمد","دنا","کبگیان",3,437,18,3,116,574,2,576
"کهکیلویه_و_بویراحمد","دنا","کبگیان",4,648,7,4,61,720,2,722
"کهکیلویه_و_بویراحمد","دنا","کبگیان",5,1142,5,1,27,1175,0,1175
"کهکیلویه_و_بویراحمد","دنا","کبگیان",6,370,8,4,82,464,3,467
"کهکیلویه_و_بویراحمد","دنا","کبگیان",7,533,19,14,122,688,0,688
"کهکیلویه_و_بویراحمد","دنا","کبگیان",8,247,7,5,99,358,0,358
"کهکیلویه_و_بویراحمد","دنا","کبگیان",9,440,4,0,56,500,0,500
"کهکیلویه_و_بویراحمد","دنا","کبگیان",10,371,2,2,72,447,0,447
"کهکیلویه_و_بویراحمد","دنا","کبگیان",11,296,4,0,29,329,0,329
"کهکیلویه_و_بویراحمد","دنا","کبگیان",12,525,11,0,99,635,0,635
"کهکیلویه_و_بویراحمد","دنا","کبگیان",13,501,2,3,24,530,1,531
"کهکیلویه_و_بویراحمد","دنا","کبگیان",14,192,10,1,38,241,1,242
"کهکیلویه_و_بویراحمد","دنا","کبگیان",15,308,9,2,38,357,0,357
"کهکیلویه_و_بویراحمد","دنا","کبگیان",16,200,6,1,41,248,0,248
"کهکیلویه_و_بویراحمد","دنا","کبگیان",17,435,10,2,110,557,0,557
"کهکیلویه_و_بویراحمد","دنا","کبگیان",18,221,6,0,61,288,1,289
"کهکیلویه_و_بویراحمد","دنا","کبگیان",19,236,0,6,50,292,4,296
"کهکیلویه_و_بویراحمد","کهکیلویه","مرکزی",1,554,38,16,348,956,0,956
"کهکیلویه_و_بویراحمد","کهکیلویه","مرکزی",2,232,31,5,262,530,11,541
"کهکیلویه_و_بویراحمد","کهکیلویه","مرکزی",3,277,21,11,309,618,10,628
"کهکیلویه_و_بویراحمد","کهکیلویه","مرکزی",4,343,39,21,347,750,4,754
"کهکیلویه_و_بویراحمد","کهکیلویه","مرکزی",5,368,30,11,184,593,7,600
"کهکیلویه_و_بویراحمد","کهکیلویه","مرکزی",6,232,11,10,236,489,3,492
"کهکیلویه_و_بویراحمد","کهکیلویه","مرکزی",7,371,27,17,378,793,9,802
"کهکیلویه_و_بویراحمد","کهکیلویه","مرکزی",8,367,40,35,415,857,13,870
"کهکیلویه_و_بویراحمد","کهکیلویه","مرکزی",9,435,37,14,404,890,12,902
"کهکیلویه_و_بویراحمد","کهکیلویه","مرکزی",10,425,14,5,287,731,4,735
"کهکیلویه_و_بویراحمد","کهکیلویه","مرکزی",11,488,27,25,413,953,6,959
"کهکیلویه_و_بویراحمد","کهکیلویه","مرکزی",12,626,25,9,348,1008,10,1018
"کهکیلویه_و_بویراحمد","کهکیلویه","مرکزی",13,570,33,10,330,943,10,953
"کهکیلویه_و_بویراحمد","کهکیلویه","مرکزی",14,571,58,16,450,1095,12,1107
"کهکیلویه_و_بویراحمد","کهکیلویه","مرکزی",15,368,41,5,283,697,8,705
"کهکیلویه_و_بویراحمد","کهکیلویه","مرکزی",16,441,19,27,347,834,0,834
"کهکیلویه_و_بویراحمد","کهکیلویه","مرکزی",17,617,78,19,385,1099,9,1108
"کهکیلویه_و_بویراحمد","کهکیلویه","مرکزی",18,655,44,15,337,1051,9,1060
"کهکیلویه_و_بویراحمد","کهکیلویه","مرکزی",19,336,22,7,179,544,7,551
"کهکیلویه_و_بویراحمد","کهکیلویه","مرکزی",20,440,55,7,228,730,4,734
"کهکیلویه_و_بویراحمد","کهکیلویه","مرکزی",21,455,43,16,194,708,5,713
"کهکیلویه_و_بویراحمد","کهکیلویه","مرکزی",22,656,36,14,377,1083,9,1092
"کهکیلویه_و_بویراحمد","کهکیلویه","مرکزی",23,434,42,13,295,784,0,784
"کهکیلویه_و_بویراحمد","کهکیلویه","مرکزی",24,469,41,17,245,772,4,776
"کهکیلویه_و_بویراحمد","کهکیلویه","مرکزی",25,482,17,4,247,750,8,758
"کهکیلویه_و_بویراحمد","کهکیلویه","مرکزی",26,650,36,9,356,1051,11,1062
"کهکیلویه_و_بویراحمد","کهکیلویه","مرکزی",27,203,13,4,110,330,4,334
"کهکیلویه_و_بویراحمد","کهکیلویه","مرکزی",28,591,64,14,307,976,10,986
"کهکیلویه_و_بویراحمد","کهکیلویه","مرکزی",29,388,21,13,232,654,5,659
"کهکیلویه_و_بویراحمد","کهکیلویه","مرکزی",30,135,10,6,117,268,2,270
"کهکیلویه_و_بویراحمد","کهکیلویه","مرکزی",31,360,16,9,351,736,5,741
"کهکیلویه_و_بویراحمد","کهکیلویه","مرکزی",32,258,22,8,114,402,4,406
"کهکیلویه_و_بویراحمد","کهکیلویه","مرکزی",33,537,80,14,367,998,1,999
"کهکیلویه_و_بویراحمد","کهکیلویه","مرکزی",34,397,40,8,343,788,6,794
"کهکیلویه_و_بویراحمد","کهکیلویه","مرکزی",35,271,19,9,137,436,1,437
"کهکیلویه_و_بویراحمد","کهکیلویه","مرکزی",36,257,5,13,197,472,7,479
"کهکیلویه_و_بویراحمد","کهکیلویه","مرکزی",37,248,8,0,222,478,0,478
"کهکیلویه_و_بویراحمد","کهکیلویه","مرکزی",38,278,11,1,139,429,0,429
"کهکیلویه_و_بویراحمد","کهکیلویه","مرکزی",39,120,7,1,155,283,1,284
"کهکیلویه_و_بویراحمد","کهکیلویه","مرکزی",40,275,4,5,62,346,3,349
"کهکیلویه_و_بویراحمد","کهکیلویه","مرکزی",41,169,5,4,69,247,0,247
"کهکیلویه_و_بویراحمد","کهکیلویه","مرکزی",42,298,7,1,72,378,3,381
"کهکیلویه_و_بویراحمد","کهکیلویه","مرکزی",43,416,73,20,224,733,10,743
"کهکیلویه_و_بویراحمد","کهکیلویه","مرکزی",44,397,63,32,290,782,17,799
"کهکیلویه_و_بویراحمد","کهکیلویه","مرکزی",45,384,54,37,190,665,13,678
"کهکیلویه_و_بویراحمد","کهکیلویه","مرکزی",46,250,41,17,177,485,10,495
"کهکیلویه_و_بویراحمد","کهکیلویه","مرکزی",47,296,31,16,241,584,17,601
"کهکیلویه_و_بویراحمد","کهکیلویه","مرکزی",48,233,35,6,172,446,5,451
"کهکیلویه_و_بویراحمد","کهکیلویه","مرکزی",49,156,13,6,80,255,1,256
"کهکیلویه_و_بویراحمد","کهکیلویه","مرکزی",50,173,8,0,73,254,1,255
"کهکیلویه_و_بویراحمد","کهکیلویه","مرکزی",51,107,7,2,54,170,2,172
"کهکیلویه_و_بویراحمد","کهکیلویه","مرکزی",52,105,9,0,78,192,8,200
"کهکیلویه_و_بویراحمد","کهکیلویه","مرکزی",53,545,53,91,179,868,12,880
"کهکیلویه_و_بویراحمد","کهکیلویه","مرکزی",54,481,16,5,107,609,4,613
"کهکیلویه_و_بویراحمد","کهکیلویه","مرکزی",55,379,15,4,109,507,3,510
"کهکیلویه_و_بویراحمد","کهکیلویه","مرکزی",56,408,29,26,134,597,3,600
"کهکیلویه_و_بویراحمد","کهکیلویه","مرکزی",57,420,12,5,95,532,8,540
"کهکیلویه_و_بویراحمد","کهکیلویه","مرکزی",58,175,1,1,48,225,4,229
"کهکیلویه_و_بویراحمد","کهکیلویه","مرکزی",59,170,10,2,57,239,0,239
"کهکیلویه_و_بویراحمد","کهکیلویه","مرکزی",60,326,42,5,122,495,3,498
"کهکیلویه_و_بویراحمد","کهکیلویه","مرکزی",61,313,34,5,89,441,3,444
"کهکیلویه_و_بویراحمد","کهکیلویه","مرکزی",62,139,29,2,90,260,1,261
"کهکیلویه_و_بویراحمد","کهکیلویه","مرکزی",63,590,36,34,294,954,7,961
"کهکیلویه_و_بویراحمد","کهکیلویه","مرکزی",64,660,28,10,177,875,6,881
"کهکیلویه_و_بویراحمد","کهکیلویه","مرکزی",65,204,3,1,77,285,0,285
"کهکیلویه_و_بویراحمد","کهکیلویه","مرکزی",66,254,7,2,102,365,2,367
"کهکیلویه_و_بویراحمد","کهکیلویه","مرکزی",67,143,7,2,144,296,2,298
"کهکیلویه_و_بویراحمد","کهکیلویه","مرکزی",68,542,17,4,423,986,12,998
"کهکیلویه_و_بویراحمد","کهکیلویه","مرکزی",69,170,4,2,73,249,0,249
"کهکیلویه_و_بویراحمد","کهکیلویه","مرکزی",70,208,10,3,123,344,5,349
"کهکیلویه_و_بویراحمد","کهکیلویه","مرکزی",71,240,9,1,139,389,1,390
"کهکیلویه_و_بویراحمد","کهکیلویه","مرکزی",72,110,3,0,78,191,1,192
"کهکیلویه_و_بویراحمد","کهکیلویه","مرکزی",73,121,4,5,114,244,7,251
"کهکیلویه_و_بویراحمد","کهکیلویه","مرکزی",74,577,14,9,216,816,7,823
"کهکیلویه_و_بویراحمد","کهکیلویه","مرکزی",75,123,2,2,84,211,4,215
"کهکیلویه_و_بویراحمد","کهکیلویه","مرکزی",76,368,11,3,151,533,0,533
"کهکیلویه_و_بویراحمد","کهکیلویه","مرکزی",77,262,1,3,49,315,0,315
"کهکیلویه_و_بویراحمد","کهکیلویه","مرکزی",78,241,11,4,50,306,2,308
"کهکیلویه_و_بویراحمد","کهکیلویه","مرکزی",79,142,4,3,43,192,1,193
"کهکیلویه_و_بویراحمد","کهکیلویه","مرکزی",80,225,2,1,29,257,0,257
"کهکیلویه_و_بویراحمد","کهکیلویه","مرکزی",81,434,26,14,155,629,0,629
"کهکیلویه_و_بویراحمد","کهکیلویه","مرکزی",82,266,7,2,47,322,1,323
"کهکیلویه_و_بویراحمد","کهکیلویه","مرکزی",83,621,18,0,101,740,0,740
"کهکیلویه_و_بویراحمد","کهکیلویه","مرکزی",84,96,3,1,17,117,0,117
"کهکیلویه_و_بویراحمد","کهکیلویه","مرکزی",85,17,0,0,8,25,0,25
"کهکیلویه_و_بویراحمد","کهکیلویه","مرکزی",86,23,0,0,3,26,1,27
"کهکیلویه_و_بویراحمد","کهکیلویه","مرکزی",87,121,1,0,7,129,0,129
"کهکیلویه_و_بویراحمد","کهکیلویه","سرفاریاب",1,261,6,5,105,377,3,380
"کهکیلویه_و_بویراحمد","کهکیلویه","سرفاریاب",2,272,3,8,130,413,1,414
"کهکیلویه_و_بویراحمد","کهکیلویه","سرفاریاب",3,392,8,2,196,598,0,598
"کهکیلویه_و_بویراحمد","کهکیلویه","سرفاریاب",4,400,4,4,116,524,1,525
"کهکیلویه_و_بویراحمد","کهکیلویه","سرفاریاب",5,363,10,4,25,402,0,402
"کهکیلویه_و_بویراحمد","کهکیلویه","سرفاریاب",6,140,2,0,10,152,0,152
"کهکیلویه_و_بویراحمد","کهکیلویه","سرفاریاب",7,184,2,0,9,195,0,195
"کهکیلویه_و_بویراحمد","کهکیلویه","سرفاریاب",8,124,0,1,7,132,0,132
"کهکیلویه_و_بویراحمد","کهکیلویه","سرفاریاب",9,98,3,1,17,119,0,119
"کهکیلویه_و_بویراحمد","کهکیلویه","سرفاریاب",10,218,5,1,74,298,3,301
"کهکیلویه_و_بویراحمد","کهکیلویه","سرفاریاب",11,336,2,6,72,416,2,418
"کهکیلویه_و_بویراحمد","کهکیلویه","سرفاریاب",12,191,4,2,27,224,1,225
"کهکیلویه_و_بویراحمد","کهکیلویه","سرفاریاب",13,332,8,1,130,471,2,473
"کهکیلویه_و_بویراحمد","کهکیلویه","سرفاریاب",14,179,1,0,35,215,1,216
"کهکیلویه_و_بویراحمد","کهکیلویه","سرفاریاب",15,189,2,1,96,288,2,290
"کهکیلویه_و_بویراحمد","کهکیلویه","سرفاریاب",16,105,2,1,57,165,1,166
"کهکیلویه_و_بویراحمد","کهکیلویه","سرفاریاب",17,121,1,1,35,158,1,159
"کهکیلویه_و_بویراحمد","کهکیلویه","سرفاریاب",18,17,0,0,2,19,0,19
"کهکیلویه_و_بویراحمد","کهکیلویه","سرفاریاب",19,39,0,0,9,48,0,48
"کهکیلویه_و_بویراحمد","کهکیلویه","دیشموک",1,466,16,7,220,709,8,717
"کهکیلویه_و_بویراحمد","کهکیلویه","دیشموک",2,346,23,0,106,475,0,475
"کهکیلویه_و_بویراحمد","کهکیلویه","دیشموک",3,241,4,0,64,309,0,309
"کهکیلویه_و_بویراحمد","کهکیلویه","دیشموک",4,218,16,2,119,355,1,356
"کهکیلویه_و_بویراحمد","کهکیلویه","دیشموک",5,195,8,0,39,242,0,242
"کهکیلویه_و_بویراحمد","کهکیلویه","دیشموک",6,414,14,4,109,541,0,541
"کهکیلویه_و_بویراحمد","کهکیلویه","دیشموک",7,171,3,0,38,212,3,215
"کهکیلویه_و_بویراحمد","کهکیلویه","دیشموک",8,208,1,0,37,246,0,246
"کهکیلویه_و_بویراحمد","کهکیلویه","دیشموک",9,151,1,1,76,229,0,229
"کهکیلویه_و_بویراحمد","کهکیلویه","دیشموک",10,590,5,0,41,636,0,636
"کهکیلویه_و_بویراحمد","کهکیلویه","دیشموک",11,210,2,1,63,276,0,276
"کهکیلویه_و_بویراحمد","کهکیلویه","دیشموک",12,195,0,1,23,219,0,219
"کهکیلویه_و_بویراحمد","کهکیلویه","دیشموک",13,204,0,0,14,218,0,218
"کهکیلویه_و_بویراحمد","کهکیلویه","دیشموک",14,132,4,1,46,183,0,183
"کهکیلویه_و_بویراحمد","کهکیلویه","دیشموک",15,122,0,0,8,130,2,132
"کهکیلویه_و_بویراحمد","کهکیلویه","دیشموک",16,337,0,0,30,367,0,367
"کهکیلویه_و_بویراحمد","کهکیلویه","دیشموک",17,285,1,1,29,316,0,316
"کهکیلویه_و_بویراحمد","کهکیلویه","دیشموک",18,201,8,4,66,279,1,280
"کهکیلویه_و_بویراحمد","کهکیلویه","دیشموک",19,347,2,2,11,362,0,362
"کهکیلویه_و_بویراحمد","کهکیلویه","دیشموک",20,437,2,0,83,522,0,522
"کهکیلویه_و_بویراحمد","کهکیلویه","دیشموک",21,472,5,3,23,503,2,505
"کهکیلویه_و_بویراحمد","کهکیلویه","دیشموک",22,273,10,2,79,364,0,364
"کهکیلویه_و_بویراحمد","کهکیلویه","دیشموک",23,210,12,5,104,331,0,331
"کهکیلویه_و_بویراحمد","کهکیلویه","دیشموک",24,207,8,0,25,240,0,240
"کهکیلویه_و_بویراحمد","کهکیلویه","دیشموک",25,347,0,4,33,384,1,385
"کهکیلویه_و_بویراحمد","کهکیلویه","دیشموک",26,172,2,1,75,250,0,250
"کهکیلویه_و_بویراحمد","کهکیلویه","دیشموک",27,245,8,1,32,286,0,286
"کهکیلویه_و_بویراحمد","کهکیلویه","دیشموک",28,189,2,0,18,209,0,209
"کهکیلویه_و_بویراحمد","کهکیلویه","دیشموک",29,153,9,8,58,228,0,228
"کهکیلویه_و_بویراحمد","کهکیلویه","دیشموک",30,110,0,0,56,166,0,166
"کهکیلویه_و_بویراحمد","کهکیلویه","دیشموک",31,216,3,1,9,229,0,229
"کهکیلویه_و_بویراحمد","کهکیلویه","چاروسا",1,468,10,0,93,571,3,574
"کهکیلویه_و_بویراحمد","کهکیلویه","چاروسا",2,192,5,1,20,218,3,221
"کهکیلویه_و_بویراحمد","کهکیلویه","چاروسا",3,418,10,2,118,548,0,548
"کهکیلویه_و_بویراحمد","کهکیلویه","چاروسا",4,309,2,0,25,336,0,336
"کهکیلویه_و_بویراحمد","کهکیلویه","چاروسا",5,497,11,7,44,559,0,559
"کهکیلویه_و_بویراحمد","کهکیلویه","چاروسا",6,920,24,10,272,1226,4,1230
"کهکیلویه_و_بویراحمد","کهکیلویه","چاروسا",7,295,19,16,144,474,8,482
"کهکیلویه_و_بویراحمد","کهکیلویه","چاروسا",8,503,9,3,85,600,0,600
"کهکیلویه_و_بویراحمد","کهکیلویه","چاروسا",9,437,4,1,33,475,5,480
"کهکیلویه_و_بویراحمد","کهکیلویه","چاروسا",10,260,0,3,61,324,1,325
"کهکیلویه_و_بویراحمد","کهکیلویه","چاروسا",11,104,2,0,15,121,5,126
"کهکیلویه_و_بویراحمد","کهکیلویه","چاروسا",12,257,5,0,64,326,0,326
"کهکیلویه_و_بویراحمد","کهکیلویه","چاروسا",13,251,9,0,62,322,2,324
"کهکیلویه_و_بویراحمد","کهکیلویه","چاروسا",14,194,4,2,116,316,3,319
"کهکیلویه_و_بویراحمد","کهکیلویه","چاروسا",15,477,11,3,105,596,9,605
"کهکیلویه_و_بویراحمد","کهکیلویه","چاروسا",16,534,46,9,200,789,6,795
"کهکیلویه_و_بویراحمد","کهکیلویه","چاروسا",17,58,1,0,20,79,0,79
"کهکیلویه_و_بویراحمد","کهکیلویه","چاروسا",18,307,7,0,28,342,3,345
"کهکیلویه_و_بویراحمد","کهکیلویه","چاروسا",19,331,2,4,18,355,0,355
"کهکیلویه_و_بویراحمد","کهکیلویه","چاروسا",20,172,10,0,33,215,3,218
"کهکیلویه_و_بویراحمد","کهکیلویه","چاروسا",21,342,12,2,56,412,3,415
"کهکیلویه_و_بویراحمد","کهکیلویه","چاروسا",22,235,5,2,70,312,0,312
"کهکیلویه_و_بویراحمد","کهکیلویه","چاروسا",23,182,0,1,35,218,2,220
"کهکیلویه_و_بویراحمد","کهکیلویه","چاروسا",24,145,4,0,26,175,0,175
"کهکیلویه_و_بویراحمد","کهکیلویه","چرام",1,369,16,4,177,566,5,571
"کهکیلویه_و_بویراحمد","کهکیلویه","چرام",2,343,19,8,262,632,1,633
"کهکیلویه_و_بویراحمد","کهکیلویه","چرام",3,417,16,4,219,656,7,663
"کهکیلویه_و_بویراحمد","کهکیلویه","چرام",4,664,31,10,243,948,7,955
"کهکیلویه_و_بویراحمد","کهکیلویه","چرام",5,278,7,7,124,416,1,417
"کهکیلویه_و_بویراحمد","کهکیلویه","چرام",6,456,17,6,143,622,3,625
"کهکیلویه_و_بویراحمد","کهکیلویه","چرام",7,433,13,3,210,659,3,662
"کهکیلویه_و_بویراحمد","کهکیلویه","چرام",8,351,21,5,148,525,4,529
"کهکیلویه_و_بویراحمد","کهکیلویه","چرام",9,389,29,16,369,803,9,812
"کهکیلویه_و_بویراحمد","کهکیلویه","چرام",10,152,12,2,233,399,5,404
"کهکیلویه_و_بویراحمد","کهکیلویه","چرام",11,250,5,4,114,373,3,376
"کهکیلویه_و_بویراحمد","کهکیلویه","چرام",12,147,8,6,99,260,4,264
"کهکیلویه_و_بویراحمد","کهکیلویه","چرام",13,195,11,7,238,451,4,455
"کهکیلویه_و_بویراحمد","کهکیلویه","چرام",14,352,1,1,80,434,5,439
"کهکیلویه_و_بویراحمد","کهکیلویه","چرام",15,347,14,2,170,533,6,539
"کهکیلویه_و_بویراحمد","کهکیلویه","چرام",16,245,6,3,73,327,9,336
"کهکیلویه_و_بویراحمد","کهکیلویه","چرام",17,249,12,1,68,330,0,330
"کهکیلویه_و_بویراحمد","کهکیلویه","چرام",18,321,11,10,116,458,3,461
"کهکیلویه_و_بویراحمد","کهکیلویه","چرام",19,211,3,3,84,301,0,301
"کهکیلویه_و_بویراحمد","کهکیلویه","چرام",20,274,8,3,39,324,1,325
"کهکیلویه_و_بویراحمد","کهکیلویه","چرام",21,569,7,0,206,782,5,787
"کهکیلویه_و_بویراحمد","کهکیلویه","چرام",22,163,7,0,106,276,2,278
"کهکیلویه_و_بویراحمد","کهکیلویه","چرام",23,276,2,0,94,372,1,373
"کهکیلویه_و_بویراحمد","کهکیلویه","چرام",24,344,14,16,232,606,3,609
"کهکیلویه_و_بویراحمد","کهکیلویه","چرام",25,257,10,0,178,445,8,453
"کهکیلویه_و_بویراحمد","کهکیلویه","چرام",26,429,10,0,149,588,3,591
"کهکیلویه_و_بویراحمد","کهکیلویه","چرام",27,155,3,1,26,185,1,186
"کهکیلویه_و_بویراحمد","کهکیلویه","چرام",28,72,0,2,44,118,0,118
"کهکیلویه_و_بویراحمد","کهکیلویه","چرام",29,197,4,5,33,239,0,239
"کهکیلویه_و_بویراحمد","کهکیلویه","چرام",30,32,4,1,7,44,0,44
"کهکیلویه_و_بویراحمد","کهکیلویه","چرام",31,38,2,1,55,96,1,97
"کهکیلویه_و_بویراحمد","کهکیلویه","چرام",32,163,0,1,22,186,0,186
"کهکیلویه_و_بویراحمد","کهکیلویه","چرام",33,101,2,1,40,144,1,145
"کهکیلویه_و_بویراحمد","کهکیلویه","چرام",34,100,2,0,30,132,0,132
"کهکیلویه_و_بویراحمد","کهکیلویه","چرام",35,91,3,0,31,125,0,125
"کهکیلویه_و_بویراحمد","کهکیلویه","چرام",36,63,3,0,48,114,0,114
"کهکیلویه_و_بویراحمد","کهکیلویه","لنده",1,331,25,26,178,560,3,563
"کهکیلویه_و_بویراحمد","کهکیلویه","لنده",2,311,38,11,140,500,5,505
"کهکیلویه_و_بویراحمد","کهکیلویه","لنده",3,362,41,9,151,563,4,567
"کهکیلویه_و_بویراحمد","کهکیلویه","لنده",4,550,58,10,139,757,6,763
"کهکیلویه_و_بویراحمد","کهکیلویه","لنده",5,364,22,5,145,536,0,536
"کهکیلویه_و_بویراحمد","کهکیلویه","لنده",6,275,21,9,103,408,3,411
"کهکیلویه_و_بویراحمد","کهکیلویه","لنده",7,380,19,49,125,573,8,581
"کهکیلویه_و_بویراحمد","کهکیلویه","لنده",8,283,36,15,151,485,5,490
"کهکیلویه_و_بویراحمد","کهکیلویه","لنده",9,318,18,5,192,533,2,535
"کهکیلویه_و_بویراحمد","کهکیلویه","لنده",10,319,9,5,83,416,1,417
"کهکیلویه_و_بویراحمد","کهکیلویه","لنده",11,313,32,9,91,445,4,449
"کهکیلویه_و_بویراحمد","کهکیلویه","لنده",12,351,11,5,122,489,3,492
"کهکیلویه_و_بویراحمد","کهکیلویه","لنده",13,78,2,0,33,113,0,113
"کهکیلویه_و_بویراحمد","کهکیلویه","لنده",14,341,25,3,84,453,6,459
"کهکیلویه_و_بویراحمد","کهکیلویه","لنده",15,94,18,0,14,126,0,126
"کهکیلویه_و_بویراحمد","کهکیلویه","لنده",16,145,18,1,30,194,1,195
"کهکیلویه_و_بویراحمد","کهکیلویه","لنده",17,230,4,0,28,262,0,262
"کهکیلویه_و_بویراحمد","کهکیلویه","لنده",18,330,9,3,45,387,0,387
"کهکیلویه_و_بویراحمد","کهکیلویه","لنده",19,222,7,0,13,242,0,242
"کهکیلویه_و_بویراحمد","کهکیلویه","لنده",20,80,2,0,13,95,3,98
"کهکیلویه_و_بویراحمد","کهکیلویه","لنده",21,91,1,1,8,101,0,101
"کهکیلویه_و_بویراحمد","کهکیلویه","لنده",22,175,3,1,33,212,0,212
"کهکیلویه_و_بویراحمد","کهکیلویه","لنده",23,495,38,25,122,680,9,689
"کهکیلویه_و_بویراحمد","کهکیلویه","لنده",24,95,6,3,19,123,0,123
"کهکیلویه_و_بویراحمد","کهکیلویه","لنده",25,110,3,3,14,130,8,138
"کهکیلویه_و_بویراحمد","کهکیلویه","لنده",26,35,7,1,8,51,0,51
"کهکیلویه_و_بویراحمد","کهکیلویه","لنده",27,349,21,3,40,413,6,419
"کهکیلویه_و_بویراحمد","کهکیلویه","لنده",28,75,1,0,25,101,1,102
"کهکیلویه_و_بویراحمد","کهکیلویه","لنده",29,217,17,9,95,338,3,341
"کهکیلویه_و_بویراحمد","کهکیلویه","لنده",30,12,1,1,17,31,2,33
"کهکیلویه_و_بویراحمد","کهکیلویه","لنده",31,454,15,6,66,541,8,549
"کهکیلویه_و_بویراحمد","کهکیلویه","لنده",32,45,0,0,6,51,7,58
"کهکیلویه_و_بویراحمد","کهکیلویه","لنده",33,58,5,12,24,99,1,100
"کهکیلویه_و_بویراحمد","کهکیلویه","لنده",34,128,2,3,25,158,0,158
"کهکیلویه_و_بویراحمد","کهکیلویه","لنده",35,268,3,0,21,292,2,294
"کهکیلویه_و_بویراحمد","کهکیلویه","لنده",36,66,0,0,3,69,0,69
"کهکیلویه_و_بویراحمد","کهکیلویه","لنده",37,169,1,2,28,200,0,200
"کهکیلویه_و_بویراحمد","گچساران","مرکزی",1,202,3,2,220,427,3,430
"کهکیلویه_و_بویراحمد","گچساران","مرکزی",2,403,13,3,371,790,10,800
"کهکیلویه_و_بویراحمد","گچساران","مرکزی",3,480,28,6,573,1087,13,1100
"کهکیلویه_و_بویراحمد","گچساران","مرکزی",4,437,31,6,485,959,10,969
"کهکیلویه_و_بویراحمد","گچساران","مرکزی",5,501,35,4,648,1188,11,1199
"کهکیلویه_و_بویراحمد","گچساران","مرکزی",6,338,20,23,512,893,5,898
"کهکیلویه_و_بویراحمد","گچساران","مرکزی",7,208,18,0,278,504,5,509
"کهکیلویه_و_بویراحمد","گچساران","مرکزی",8,185,8,16,287,496,4,500
"کهکیلویه_و_بویراحمد","گچساران","مرکزی",9,471,27,9,490,997,11,1008
"کهکیلویه_و_بویراحمد","گچساران","مرکزی",10,600,11,3,418,1032,12,1044
"کهکیلویه_و_بویراحمد","گچساران","مرکزی",11,481,11,0,349,841,8,849
"کهکیلویه_و_بویراحمد","گچساران","مرکزی",12,471,7,3,314,795,5,800
"کهکیلویه_و_بویراحمد","گچساران","مرکزی",13,351,8,4,270,633,3,636
"کهکیلویه_و_بویراحمد","گچساران","مرکزی",14,495,8,2,183,688,4,692
"کهکیلویه_و_بویراحمد","گچساران","مرکزی",15,581,3,0,121,705,6,711
"کهکیلویه_و_بویراحمد","گچساران","مرکزی",16,274,3,1,348,626,7,633
"کهکیلویه_و_بویراحمد","گچساران","مرکزی",17,349,17,7,416,789,11,800
"کهکیلویه_و_بویراحمد","گچساران","مرکزی",18,300,7,6,250,563,4,567
"کهکیلویه_و_بویراحمد","گچساران","مرکزی",19,615,10,1,234,860,10,870
"کهکیلویه_و_بویراحمد","گچساران","مرکزی",20,466,18,5,340,829,16,845
"کهکیلویه_و_بویراحمد","گچساران","مرکزی",21,459,12,2,215,688,11,699
"کهکیلویه_و_بویراحمد","گچساران","مرکزی",22,510,32,6,325,873,11,884
"کهکیلویه_و_بویراحمد","گچساران","مرکزی",23,470,10,0,181,661,3,664
"کهکیلویه_و_بویراحمد","گچساران","مرکزی",24,501,13,2,231,747,8,755
"کهکیلویه_و_بویراحمد","گچساران","مرکزی",25,246,5,4,221,476,1,477
"کهکیلویه_و_بویراحمد","گچساران","مرکزی",26,691,13,0,259,963,7,970
"کهکیلویه_و_بویراحمد","گچساران","مرکزی",27,479,11,0,237,727,10,737
"کهکیلویه_و_بویراحمد","گچساران","مرکزی",28,531,9,3,250,793,7,800
"کهکیلویه_و_بویراحمد","گچساران","مرکزی",29,653,8,4,227,892,7,899
"کهکیلویه_و_بویراحمد","گچساران","مرکزی",30,545,23,8,338,914,11,925
"کهکیلویه_و_بویراحمد","گچساران","مرکزی",31,631,16,4,375,1026,8,1034
"کهکیلویه_و_بویراحمد","گچساران","مرکزی",32,761,6,9,414,1190,7,1197
"کهکیلویه_و_بویراحمد","گچساران","مرکزی",33,837,25,9,520,1391,17,1408
"کهکیلویه_و_بویراحمد","گچساران","مرکزی",34,469,8,8,252,737,6,743
"کهکیلویه_و_بویراحمد","گچساران","مرکزی",35,263,6,6,196,471,2,473
"کهکیلویه_و_بویراحمد","گچساران","مرکزی",36,510,14,6,281,811,8,819
"کهکیلویه_و_بویراحمد","گچساران","مرکزی",37,472,22,1,283,778,13,791
"کهکیلویه_و_بویراحمد","گچساران","مرکزی",38,497,31,4,453,985,11,996
"کهکیلویه_و_بویراحمد","گچساران","مرکزی",39,305,9,6,234,554,5,559
"کهکیلویه_و_بویراحمد","گچساران","مرکزی",40,316,22,3,303,644,14,658
"کهکیلویه_و_بویراحمد","گچساران","مرکزی",41,450,27,6,319,802,16,818
"کهکیلویه_و_بویراحمد","گچساران","مرکزی",42,322,46,21,700,1089,10,1099
"کهکیلویه_و_بویراحمد","گچساران","مرکزی",43,325,35,11,616,987,11,998
"کهکیلویه_و_بویراحمد","گچساران","مرکزی",44,274,22,8,435,739,10,749
"کهکیلویه_و_بویراحمد","گچساران","مرکزی",45,423,24,5,507,959,13,972
"کهکیلویه_و_بویراحمد","گچساران","مرکزی",46,385,26,5,310,726,15,741
"کهکیلویه_و_بویراحمد","گچساران","مرکزی",47,363,21,11,348,743,10,753
"کهکیلویه_و_بویراحمد","گچساران","مرکزی",48,312,22,3,391,728,10,738
"کهکیلویه_و_بویراحمد","گچساران","مرکزی",49,531,25,5,259,820,9,829
"کهکیلویه_و_بویراحمد","گچساران","مرکزی",50,683,21,14,371,1089,10,1099
"کهکیلویه_و_بویراحمد","گچساران","مرکزی",51,902,27,6,383,1318,5,1323
"کهکیلویه_و_بویراحمد","گچساران","مرکزی",52,473,26,10,543,1052,12,1064
"کهکیلویه_و_بویراحمد","گچساران","مرکزی",53,387,26,8,482,903,12,915
"کهکیلویه_و_بویراحمد","گچساران","مرکزی",54,140,17,3,222,382,4,386
"کهکیلویه_و_بویراحمد","گچساران","مرکزی",55,286,16,2,156,460,5,465
"کهکیلویه_و_بویراحمد","گچساران","مرکزی",56,198,19,5,312,534,2,536
"کهکیلویه_و_بویراحمد","گچساران","مرکزی",57,581,9,3,272,865,6,871
"کهکیلویه_و_بویراحمد","گچساران","مرکزی",58,560,15,3,139,717,9,726
"کهکیلویه_و_بویراحمد","گچساران","مرکزی",59,174,2,0,42,218,2,220
"کهکیلویه_و_بویراحمد","گچساران","مرکزی",60,501,10,3,281,795,13,808
"کهکیلویه_و_بویراحمد","گچساران","مرکزی",61,297,3,0,105,405,2,407
"کهکیلویه_و_بویراحمد","گچساران","مرکزی",62,234,3,0,39,276,6,282
"کهکیلویه_و_بویراحمد","گچساران","مرکزی",63,253,0,0,4,257,0,257
"کهکیلویه_و_بویراحمد","گچساران","مرکزی",64,240,1,0,48,289,0,289
"کهکیلویه_و_بویراحمد","گچساران","مرکزی",65,360,3,0,34,397,1,398
"کهکیلویه_و_بویراحمد","گچساران","مرکزی",66,433,12,2,131,578,1,579
"کهکیلویه_و_بویراحمد","گچساران","مرکزی",67,15,0,0,13,28,0,28
"کهکیلویه_و_بویراحمد","گچساران","مرکزی",68,105,1,0,17,123,0,123
"کهکیلویه_و_بویراحمد","گچساران","مرکزی",69,30,1,0,27,58,4,62
"کهکیلویه_و_بویراحمد","گچساران","مرکزی",70,172,7,0,107,286,2,288
"کهکیلویه_و_بویراحمد","گچساران","مرکزی",71,220,0,0,74,294,3,297
"کهکیلویه_و_بویراحمد","گچساران","مرکزی",72,331,2,0,59,392,2,394
"کهکیلویه_و_بویراحمد","گچساران","مرکزی",73,420,8,0,61,489,3,492
"کهکیلویه_و_بویراحمد","گچساران","مرکزی",74,794,2,2,65,863,4,867
"کهکیلویه_و_بویراحمد","گچساران","مرکزی",75,379,3,0,113,495,0,495
"کهکیلویه_و_بویراحمد","گچساران","مرکزی",76,416,1,0,245,662,4,666
"کهکیلویه_و_بویراحمد","گچساران","مرکزی",77,600,2,1,101,704,5,709
"کهکیلویه_و_بویراحمد","گچساران","مرکزی",78,382,9,3,117,511,6,517
"کهکیلویه_و_بویراحمد","گچساران","مرکزی",79,366,4,3,240,613,7,620
"کهکیلویه_و_بویراحمد","گچساران","مرکزی",80,532,2,2,118,654,3,657
"کهکیلویه_و_بویراحمد","گچساران","مرکزی",81,276,1,0,75,352,3,355
"کهکیلویه_و_بویراحمد","گچساران","مرکزی",82,89,0,0,60,149,1,150
"کهکیلویه_و_بویراحمد","گچساران","مرکزی",83,352,0,0,100,452,0,452
"کهکیلویه_و_بویراحمد","گچساران","مرکزی",84,304,2,0,31,337,1,338
"کهکیلویه_و_بویراحمد","گچساران","مرکزی",85,410,11,1,151,573,11,584
"کهکیلویه_و_بویراحمد","گچساران","مرکزی",86,340,12,2,138,492,8,500
"کهکیلویه_و_بویراحمد","گچساران","مرکزی",87,317,1,3,210,531,2,533
"کهکیلویه_و_بویراحمد","گچساران","مرکزی",88,224,6,2,94,326,4,330
"کهکیلویه_و_بویراحمد","گچساران","مرکزی",89,250,2,0,43,295,8,303
"کهکیلویه_و_بویراحمد","گچساران","مرکزی",90,268,7,0,77,352,1,353
"کهکیلویه_و_بویراحمد","گچساران","مرکزی",91,561,9,2,98,670,5,675
"کهکیلویه_و_بویراحمد","گچساران","باشت",1,118,6,0,248,372,3,375
"کهکیلویه_و_بویراحمد","گچساران","باشت",2,278,12,1,136,427,0,427
"کهکیلویه_و_بویراحمد","گچساران","باشت",3,181,10,1,179,371,1,372
"کهکیلویه_و_بویراحمد","گچساران","باشت",4,332,13,5,38,388,1,389
"کهکیلویه_و_بویراحمد","گچساران","باشت",5,161,9,2,138,310,1,311
"کهکیلویه_و_بویراحمد","گچساران","باشت",6,293,7,3,143,446,3,449
"کهکیلویه_و_بویراحمد","گچساران","باشت",7,347,6,1,103,457,2,459
"کهکیلویه_و_بویراحمد","گچساران","باشت",8,361,12,1,120,494,6,500
"کهکیلویه_و_بویراحمد","گچساران","باشت",9,66,3,0,95,164,2,166
"کهکیلویه_و_بویراحمد","گچساران","باشت",10,244,11,1,190,446,4,450
"کهکیلویه_و_بویراحمد","گچساران","باشت",11,206,7,1,96,310,0,310
"کهکیلویه_و_بویراحمد","گچساران","باشت",12,155,12,1,158,326,0,326
"کهکیلویه_و_بویراحمد","گچساران","باشت",13,385,3,5,98,491,4,495
"کهکیلویه_و_بویراحمد","گچساران","باشت",14,346,0,5,62,413,1,414
"کهکیلویه_و_بویراحمد","گچساران","باشت",15,281,5,8,158,452,1,453
"کهکیلویه_و_بویراحمد","گچساران","باشت",16,436,2,1,197,636,3,639
"کهکیلویه_و_بویراحمد","گچساران","باشت",17,467,7,2,286,762,1,763
"کهکیلویه_و_بویراحمد","گچساران","باشت",18,98,7,1,72,178,2,180
"کهکیلویه_و_بویراحمد","گچساران","باشت",19,304,5,0,137,446,0,446
"کهکیلویه_و_بویراحمد","گچساران","باشت",20,314,2,7,101,424,0,424
"کهکیلویه_و_بویراحمد","گچساران","باشت",21,331,4,0,204,539,3,542
"کهکیلویه_و_بویراحمد","گچساران","باشت",22,308,1,0,40,349,0,349
"کهکیلویه_و_بویراحمد","گچساران","باشت",23,173,1,0,26,200,0,200
"کهکیلویه_و_بویراحمد","گچساران","باشت",24,151,2,0,65,218,6,224
"کهکیلویه_و_بویراحمد","گچساران","باشت",25,157,0,0,9,166,0,166
"کهکیلویه_و_بویراحمد","گچساران","باشت",26,128,0,0,55,183,0,183
"کهکیلویه_و_بویراحمد","گچساران","باشت",27,74,1,0,19,94,0,94
"کهکیلویه_و_بویراحمد","گچساران","باشت",28,328,5,0,104,437,3,440
"کهکیلویه_و_بویراحمد","گچساران","باشت",29,225,0,0,72,297,0,297
"کهکیلویه_و_بویراحمد","گچساران","باشت",30,288,1,0,189,478,2,480
"کهکیلویه_و_بویراحمد","گچساران","باشت",31,126,5,0,61,192,4,196
"کهکیلویه_و_بویراحمد","گچساران","باشت",32,114,2,0,61,177,3,180
"کهکیلویه_و_بویراحمد","گچساران","باشت",33,61,3,0,27,91,0,91
"کهکیلویه_و_بویراحمد","گچساران","باشت",34,29,7,1,5,42,1,43
"کهکیلویه_و_بویراحمد","گچساران","باشت",35,260,1,0,155,416,0,416
"کهکیلویه_و_بویراحمد","گچساران","باشت",36,269,8,0,63,340,2,342
"کهکیلویه_و_بویراحمد","گچساران","باشت",37,268,4,0,134,406,2,408
"کهکیلویه_و_بویراحمد","گچساران","باشت",38,38,0,0,7,45,0,45
"کهکیلویه_و_بویراحمد","گچساران","باشت",39,10,0,0,5,15,1,16
"کهکیلویه_و_بویراحمد","گچساران","باشت",40,68,0,0,28,96,1,97
"کهکیلویه_و_بویراحمد","گچساران","باشت",41,76,0,0,4,80,0,80
"گلستان","آزادشهر","مرکزی",1,919,15,5,323,1262,21,1283
"گلستان","آزادشهر","مرکزی",2,777,3,2,174,956,4,960
"گلستان","آزادشهر","مرکزی",3,671,16,6,295,988,24,1012
"گلستان","آزادشهر","مرکزی",4,506,8,3,133,650,13,663
"گلستان","آزادشهر","مرکزی",5,963,9,1,182,1155,14,1169
"گلستان","آزادشهر","مرکزی",6,293,7,2,223,525,8,533
"گلستان","آزادشهر","مرکزی",7,502,8,7,297,814,15,829
"گلستان","آزادشهر","مرکزی",8,641,7,0,338,986,13,999
"گلستان","آزادشهر","مرکزی",9,245,7,2,98,352,0,352
"گلستان","آزادشهر","مرکزی",10,369,1,6,171,547,8,555
"گلستان","آزادشهر","مرکزی",11,423,7,1,213,644,5,649
"گلستان","آزادشهر","مرکزی",12,408,3,1,136,548,2,550
"گلستان","آزادشهر","مرکزی",13,935,16,5,380,1336,24,1360
"گلستان","آزادشهر","مرکزی",14,225,5,2,99,331,15,346
"گلستان","آزادشهر","مرکزی",15,633,8,1,203,845,14,859
"گلستان","آزادشهر","مرکزی",16,700,2,1,145,848,11,859
"گلستان","آزادشهر","مرکزی",17,391,3,2,349,745,8,753
"گلستان","آزادشهر","مرکزی",18,601,9,1,263,874,16,890
"گلستان","آزادشهر","مرکزی",19,858,4,7,274,1143,23,1166
"گلستان","آزادشهر","مرکزی",20,490,6,6,325,827,14,841
"گلستان","آزادشهر","مرکزی",21,679,8,4,199,890,18,908
"گلستان","آزادشهر","مرکزی",22,443,7,1,98,549,5,554
"گلستان","آزادشهر","مرکزی",23,568,8,2,199,777,0,777
"گلستان","آزادشهر","مرکزی",24,532,11,1,186,730,10,740
"گلستان","آزادشهر","مرکزی",25,987,8,2,198,1195,16,1211
"گلستان","آزادشهر","مرکزی",26,984,5,1,79,1069,15,1084
"گلستان","آزادشهر","مرکزی",27,204,5,1,78,288,7,295
"گلستان","آزادشهر","مرکزی",28,141,0,1,44,186,2,188
"گلستان","آزادشهر","مرکزی",29,798,2,3,153,956,3,959
"گلستان","آزادشهر","مرکزی",30,988,2,0,86,1076,4,1080
"گلستان","آزادشهر","مرکزی",31,477,4,3,79,563,1,564
"گلستان","آزادشهر","مرکزی",32,570,5,1,182,758,7,765
"گلستان","آزادشهر","مرکزی",33,170,0,3,128,301,4,305
"گلستان","آزادشهر","مرکزی",34,159,4,52,423,638,16,654
"گلستان","آزادشهر","مرکزی",35,352,2,0,81,435,5,440
"گلستان","آزادشهر","مرکزی",36,530,0,0,76,606,2,608
"گلستان","آزادشهر","مرکزی",37,596,1,3,148,748,0,748
"گلستان","آزادشهر","مرکزی",38,396,0,0,60,456,4,460
"گلستان","آزادشهر","مرکزی",39,482,1,0,102,585,11,596
"گلستان","آزادشهر","مرکزی",40,554,2,1,132,689,0,689
"گلستان","آزادشهر","مرکزی",41,790,3,1,124,918,15,933
"گلستان","آزادشهر","مرکزی",42,245,0,1,45,291,4,295
"گلستان","آزادشهر","مرکزی",43,679,4,2,101,786,14,800
"گلستان","آزادشهر","مرکزی",44,377,0,0,39,416,7,423
"گلستان","آزادشهر","مرکزی",45,477,0,0,197,674,19,693
"گلستان","آزادشهر","مرکزی",46,158,1,6,355,520,7,527
"گلستان","آزادشهر","مرکزی",47,316,0,8,404,728,11,739
"گلستان","آزادشهر","مرکزی",48,518,5,0,44,567,3,570
"گلستان","آزادشهر","مرکزی",49,401,0,0,49,450,8,458
"گلستان","آزادشهر","مرکزی",50,104,2,2,374,482,5,487
"گلستان","آزادشهر","مرکزی",51,326,1,7,242,576,4,580
"گلستان","آزادشهر","مرکزی",52,201,0,4,238,443,10,453
"گلستان","آزادشهر","مرکزی",53,440,3,0,244,687,8,695
"گلستان","آزادشهر","مرکزی",54,106,3,8,280,397,7,404
"گلستان","آزادشهر","مرکزی",55,212,3,18,368,601,13,614
"گلستان","آزادشهر","مرکزی",56,464,2,8,488,962,15,977
"گلستان","آزادشهر","مرکزی",57,518,4,16,300,838,19,857
"گلستان","آزادشهر","مرکزی",58,219,2,7,406,634,9,643
"گلستان","آزادشهر","مرکزی",59,192,0,0,16,208,4,212
"گلستان","آزادشهر","چشمه_ساران",1,528,3,3,199,733,9,742
"گلستان","آزادشهر","چشمه_ساران",2,307,2,0,69,378,10,388
"گلستان","آزادشهر","چشمه_ساران",3,285,6,0,83,374,2,376
"گلستان","آزادشهر","چشمه_ساران",4,493,0,0,54,547,1,548
"گلستان","آزادشهر","چشمه_ساران",5,700,6,1,68,775,2,777
"گلستان","آزادشهر","چشمه_ساران",6,543,2,1,37,583,7,590
"گلستان","آزادشهر","چشمه_ساران",7,125,2,0,8,135,1,136
"گلستان","آزادشهر","چشمه_ساران",8,171,1,4,12,188,2,190
"گلستان","آزادشهر","چشمه_ساران",9,517,3,1,22,543,7,550
"گلستان","آزادشهر","چشمه_ساران",10,587,2,0,19,608,3,611
"گلستان","آزادشهر","چشمه_ساران",11,227,1,0,23,251,3,254
"گلستان","آزادشهر","چشمه_ساران",12,422,7,1,50,480,3,483
"گلستان","آزادشهر","چشمه_ساران",13,358,3,0,35,396,4,400
"گلستان","آزادشهر","چشمه_ساران",14,193,0,0,21,214,2,216
"گلستان","آزادشهر","چشمه_ساران",15,346,1,0,31,378,4,382
"گلستان","آزادشهر","چشمه_ساران",16,428,2,0,23,453,4,457
"گلستان","آزادشهر","چشمه_ساران",17,332,0,1,20,353,15,368
"گلستان","آزادشهر","چشمه_ساران",18,579,0,0,6,585,4,589
"گلستان","آزادشهر","چشمه_ساران",19,348,0,0,8,356,2,358
"گلستان","آزادشهر","چشمه_ساران",20,702,0,0,75,777,8,785
"گلستان","آزادشهر","چشمه_ساران",21,322,0,0,11,333,0,333
"گلستان","آزادشهر","چشمه_ساران",22,385,1,4,182,572,6,578
"گلستان","آق_قلا","مرکزی",1,226,4,16,808,1054,12,1066
"گلستان","آق_قلا","مرکزی",2,149,1,10,409,569,8,577
"گلستان","آق_قلا","مرکزی",3,159,0,13,408,580,8,588
"گلستان","آق_قلا","مرکزی",4,264,4,34,795,1097,38,1135
"گلستان","آق_قلا","مرکزی",5,136,5,4,463,608,14,622
"گلستان","آق_قلا","مرکزی",6,111,2,10,543,666,7,673
"گلستان","آق_قلا","مرکزی",7,113,2,5,385,505,6,511
"گلستان","آق_قلا","مرکزی",8,289,0,2,152,443,15,458
"گلستان","آق_قلا","مرکزی",9,233,3,1,45,282,5,287
"گلستان","آق_قلا","مرکزی",10,67,1,6,399,473,9,482
"گلستان","آق_قلا","مرکزی",11,128,3,5,513,649,13,662
"گلستان","آق_قلا","مرکزی",12,156,4,5,537,702,13,715
"گلستان","آق_قلا","مرکزی",13,138,7,6,568,719,16,735
"گلستان","آق_قلا","مرکزی",14,110,1,9,305,425,6,431
"گلستان","آق_قلا","مرکزی",15,165,2,10,407,584,14,598
"گلستان","آق_قلا","مرکزی",16,302,4,5,517,828,8,836
"گلستان","آق_قلا","مرکزی",17,206,4,4,466,680,17,697
"گلستان","آق_قلا","مرکزی",18,40,0,1,186,227,3,230
"گلستان","آق_قلا","مرکزی",19,150,6,12,380,548,11,559
"گلستان","آق_قلا","مرکزی",20,34,0,6,127,167,2,169
"گلستان","آق_قلا","مرکزی",21,146,0,7,249,402,10,412
"گلستان","آق_قلا","مرکزی",22,31,1,4,162,198,7,205
"گلستان","آق_قلا","مرکزی",23,120,1,1,126,248,4,252
"گلستان","آق_قلا","مرکزی",24,100,1,4,202,307,6,313
"گلستان","آق_قلا","مرکزی",25,263,2,14,613,892,25,917
"گلستان","آق_قلا","مرکزی",26,154,2,10,136,302,6,308
"گلستان","آق_قلا","مرکزی",27,318,5,1,604,928,15,943
"گلستان","آق_قلا","مرکزی",28,105,2,2,235,344,7,351
"گلستان","آق_قلا","مرکزی",29,185,3,9,562,759,19,778
"گلستان","آق_قلا","مرکزی",30,190,2,3,325,520,26,546
"گلستان","آق_قلا","مرکزی",31,177,1,4,128,310,13,323
"گلستان","آق_قلا","مرکزی",32,278,6,9,287,580,12,592
"گلستان","آق_قلا","مرکزی",33,52,3,1,130,186,2,188
"گلستان","آق_قلا","مرکزی",34,296,2,2,219,519,5,524
"گلستان","آق_قلا","مرکزی",35,221,1,4,448,674,15,689
"گلستان","آق_قلا","مرکزی",36,113,2,2,273,390,2,392
"گلستان","آق_قلا","مرکزی",37,309,1,4,250,564,13,577
"گلستان","آق_قلا","مرکزی",38,261,1,1,204,467,3,470
"گلستان","آق_قلا","مرکزی",39,327,0,1,115,443,10,453
"گلستان","آق_قلا","مرکزی",40,117,3,1,384,505,2,507
"گلستان","آق_قلا","مرکزی",41,118,3,1,368,490,4,494
"گلستان","آق_قلا","مرکزی",42,156,0,1,305,462,8,470
"گلستان","آق_قلا","مرکزی",43,260,2,14,409,685,12,697
"گلستان","آق_قلا","مرکزی",44,728,3,63,429,1223,15,1238
"گلستان","آق_قلا","مرکزی",45,389,2,17,301,709,17,726
"گلستان","آق_قلا","مرکزی",46,463,0,3,163,629,14,643
"گلستان","آق_قلا","مرکزی",47,627,2,15,551,1195,24,1219
"گلستان","آق_قلا","مرکزی",48,969,0,0,29,998,2,1000
"گلستان","آق_قلا","مرکزی",49,389,2,3,71,465,1,466
"گلستان","آق_قلا","مرکزی",50,247,5,16,402,670,20,690
"گلستان","آق_قلا","مرکزی",51,281,4,25,418,728,22,750
"گلستان","آق_قلا","مرکزی",52,310,0,13,161,484,15,499
"گلستان","آق_قلا","مرکزی",53,261,1,11,275,548,9,557
"گلستان","آق_قلا","مرکزی",54,198,3,3,341,545,24,569
"گلستان","آق_قلا","مرکزی",55,156,1,5,250,412,25,437
"گلستان","آق_قلا","مرکزی",56,318,1,6,289,614,22,636
"گلستان","آق_قلا","مرکزی",57,216,2,9,280,507,17,524
"گلستان","آق_قلا","مرکزی",58,191,4,7,262,464,7,471
"گلستان","آق_قلا","مرکزی",59,91,0,0,221,312,3,315
"گلستان","آق_قلا","مرکزی",60,98,2,0,288,388,8,396
"گلستان","آق_قلا","مرکزی",61,448,4,2,222,676,24,700
"گلستان","آق_قلا","مرکزی",62,153,1,4,330,488,5,493
"گلستان","آق_قلا","مرکزی",63,115,0,0,167,282,5,287
"گلستان","آق_قلا","مرکزی",64,709,2,3,13,727,6,733
"گلستان","آق_قلا","مرکزی",65,109,0,1,99,209,4,213
"گلستان","آق_قلا","مرکزی",66,129,1,1,390,521,12,533
"گلستان","آق_قلا","مرکزی",67,183,0,0,30,213,0,213
"گلستان","آق_قلا","مرکزی",68,51,0,2,54,107,2,109
"گلستان","آق_قلا","وشمگیر",1,149,2,12,562,725,16,741
"گلستان","آق_قلا","وشمگیر",2,202,1,7,569,779,20,799
"گلستان","آق_قلا","وشمگیر",3,860,3,5,39,907,13,920
"گلستان","آق_قلا","وشمگیر",4,594,2,2,44,642,0,642
"گلستان","آق_قلا","وشمگیر",5,312,0,1,192,505,15,520
"گلستان","آق_قلا","وشمگیر",6,439,5,2,157,603,7,610
"گلستان","آق_قلا","وشمگیر",7,698,0,0,8,706,15,721
"گلستان","آق_قلا","وشمگیر",8,550,0,0,16,566,3,569
"گلستان","آق_قلا","وشمگیر",9,255,3,4,646,908,9,917
"گلستان","آق_قلا","وشمگیر",10,309,0,4,371,684,22,706
"گلستان","آق_قلا","وشمگیر",11,228,3,27,262,520,16,536
"گلستان","آق_قلا","وشمگیر",12,366,0,1,65,432,2,434
"گلستان","آق_قلا","وشمگیر",13,217,0,1,25,243,2,245
"گلستان","آق_قلا","وشمگیر",14,402,0,0,132,534,3,537
"گلستان","آق_قلا","وشمگیر",15,606,0,1,18,625,3,628
"گلستان","آق_قلا","وشمگیر",16,434,1,0,15,450,2,452
"گلستان","آق_قلا","وشمگیر",17,282,2,1,14,299,2,301
"گلستان","آق_قلا","وشمگیر",18,361,2,12,413,788,17,805
"گلستان","آق_قلا","وشمگیر",19,404,0,2,339,745,13,758
"گلستان","آق_قلا","وشمگیر",20,189,0,0,28,217,1,218
"گلستان","آق_قلا","وشمگیر",21,138,0,3,46,187,2,189
"گلستان","بندر_گز","مرکزی",1,604,1,4,243,852,11,863
"گلستان","بندر_گز","مرکزی",2,582,7,9,204,802,18,820
"گلستان","بندر_گز","مرکزی",3,402,4,11,186,603,15,618
"گلستان","بندر_گز","مرکزی",4,417,4,5,200,626,21,647
"گلستان","بندر_گز","مرکزی",5,892,8,6,301,1207,16,1223
"گلستان","بندر_گز","مرکزی",6,894,4,3,202,1103,17,1120
"گلستان","بندر_گز","مرکزی",7,314,3,7,225,549,16,565
"گلستان","بندر_گز","مرکزی",8,189,4,4,90,287,6,293
"گلستان","بندر_گز","مرکزی",9,634,8,6,411,1059,23,1082
"گلستان","بندر_گز","مرکزی",10,552,5,1,150,708,17,725
"گلستان","بندر_گز","مرکزی",11,746,13,7,325,1091,25,1116
"گلستان","بندر_گز","مرکزی",12,428,6,1,97,532,13,545
"گلستان","بندر_گز","مرکزی",13,397,1,2,76,476,9,485
"گلستان","بندر_گز","مرکزی",14,316,4,0,59,379,4,383
"گلستان","بندر_گز","مرکزی",15,522,3,3,191,719,20,739
"گلستان","بندر_گز","مرکزی",16,350,1,0,109,460,10,470
"گلستان","بندر_گز","مرکزی",17,217,0,0,84,301,9,310
"گلستان","بندر_گز","مرکزی",18,434,2,1,65,502,7,509
"گلستان","بندر_گز","مرکزی",19,377,0,0,123,500,8,508
"گلستان","بندر_گز","مرکزی",20,359,1,0,115,475,15,490
"گلستان","بندر_گز","مرکزی",21,385,0,0,6,391,0,391
"گلستان","بندر_گز","مرکزی",22,462,0,0,35,497,1,498
"گلستان","بندر_گز","مرکزی",23,238,0,0,57,295,1,296
"گلستان","بندر_گز","مرکزی",24,414,0,0,62,476,0,476
"گلستان","بندر_گز","مرکزی",25,748,3,0,135,886,17,903
"گلستان","بندر_گز","مرکزی",26,797,2,1,264,1064,16,1080
"گلستان","بندر_گز","مرکزی",27,304,0,5,59,368,18,386
"گلستان","بندر_گز","مرکزی",28,422,3,2,113,540,14,554
"گلستان","بندر_گز","مرکزی",29,358,1,3,89,451,3,454
"گلستان","بندر_گز","مرکزی",30,306,1,0,29,336,1,337
"گلستان","بندر_گز","مرکزی",31,201,1,0,12,214,0,214
"گلستان","بندر_گز","مرکزی",32,713,0,0,24,737,2,739
"گلستان","بندر_گز","مرکزی",33,227,1,1,42,271,6,277
"گلستان","بندر_گز","مرکزی",34,91,0,0,39,130,1,131
"گلستان","بندر_گز","مرکزی",35,84,0,0,29,113,1,114
"گلستان","بندر_گز","نوکنده",1,142,2,6,110,260,2,262
"گلستان","بندر_گز","نوکنده",2,489,2,1,193,685,17,702
"گلستان","بندر_گز","نوکنده",3,565,3,9,144,721,13,734
"گلستان","بندر_گز","نوکنده",4,563,4,3,148,718,10,728
"گلستان","بندر_گز","نوکنده",5,676,2,10,192,880,4,884
"گلستان","بندر_گز","نوکنده",6,564,2,3,157,726,12,738
"گلستان","بندر_گز","نوکنده",7,345,2,0,79,426,8,434
"گلستان","بندر_گز","نوکنده",8,493,0,1,98,592,13,605
"گلستان","بندر_گز","نوکنده",9,681,0,1,94,776,17,793
"گلستان","بندر_گز","نوکنده",10,327,0,0,17,344,2,346
"گلستان","بندر_گز","نوکنده",11,332,8,2,59,401,10,411
"گلستان","بندر_گز","نوکنده",12,780,2,1,141,924,19,943
"گلستان","بندر_گز","نوکنده",13,924,6,5,144,1079,21,1100
"گلستان","بندر_گز","نوکنده",14,625,6,1,127,759,11,770
"گلستان","بندر_گز","نوکنده",15,458,0,5,49,512,8,520
"گلستان","بندر_گز","نوکنده",16,565,2,1,213,781,7,788
"گلستان","بندر_گز","نوکنده",17,153,0,3,74,230,11,241
"گلستان","بندر_گز","نوکنده",18,183,0,0,36,219,0,219
"گلستان","بندر_گز","نوکنده",19,83,0,4,25,112,0,112
"گلستان","ترکمن","مرکزی",1,106,4,8,308,426,11,437
"گلستان","ترکمن","مرکزی",2,251,9,15,593,868,23,891
"گلستان","ترکمن","مرکزی",3,212,32,11,536,791,10,801
"گلستان","ترکمن","مرکزی",4,117,9,8,319,453,13,466
"گلستان","ترکمن","مرکزی",5,232,1,4,650,887,20,907
"گلستان","ترکمن","مرکزی",6,230,5,11,321,567,12,579
"گلستان","ترکمن","مرکزی",7,420,4,3,401,828,8,836
"گلستان","ترکمن","مرکزی",8,201,2,9,348,560,11,571
"گلستان","ترکمن","مرکزی",9,140,6,7,324,477,11,488
"گلستان","ترکمن","مرکزی",10,531,8,5,367,911,15,926
"گلستان","ترکمن","مرکزی",11,259,5,27,727,1018,24,1042
"گلستان","ترکمن","مرکزی",12,233,4,6,538,781,23,804
"گلستان","ترکمن","مرکزی",13,238,1,2,225,466,10,476
"گلستان","ترکمن","مرکزی",14,253,4,5,251,513,16,529
"گلستان","ترکمن","مرکزی",15,122,1,32,450,605,14,619
"گلستان","ترکمن","مرکزی",16,83,2,12,363,460,14,474
"گلستان","ترکمن","مرکزی",17,150,8,13,562,733,9,742
"گلستان","ترکمن","مرکزی",18,139,4,34,515,692,23,715
"گلستان","ترکمن","مرکزی",19,184,16,25,625,850,21,871
"گلستان","ترکمن","مرکزی",20,257,8,21,564,850,20,870
"گلستان","ترکمن","مرکزی",21,187,8,2,416,613,18,631
"گلستان","ترکمن","مرکزی",22,191,7,44,643,885,14,899
"گلستان","ترکمن","مرکزی",23,219,11,36,673,939,15,954
"گلستان","ترکمن","مرکزی",24,197,7,11,425,640,17,657
"گلستان","ترکمن","مرکزی",25,111,3,16,360,490,8,498
"گلستان","ترکمن","مرکزی",26,245,12,21,662,940,30,970
"گلستان","ترکمن","مرکزی",27,223,5,46,804,1078,52,1130
"گلستان","ترکمن","مرکزی",28,153,4,11,440,608,14,622
"گلستان","ترکمن","مرکزی",29,111,1,16,316,444,14,458
"گلستان","ترکمن","مرکزی",30,114,8,9,381,512,8,520
"گلستان","ترکمن","مرکزی",31,191,3,11,416,621,6,627
"گلستان","ترکمن","مرکزی",32,393,4,5,390,792,10,802
"گلستان","ترکمن","مرکزی",33,187,2,5,287,481,11,492
"گلستان","ترکمن","مرکزی",34,105,4,7,266,382,14,396
"گلستان","ترکمن","مرکزی",35,295,4,13,454,766,16,782
"گلستان","ترکمن","مرکزی",36,111,12,16,280,419,8,427
"گلستان","ترکمن","مرکزی",37,265,2,23,350,640,30,670
"گلستان","ترکمن","مرکزی",38,124,0,14,149,287,12,299
"گلستان","ترکمن","مرکزی",39,170,1,28,232,431,7,438
"گلستان","ترکمن","مرکزی",40,209,8,68,378,663,14,677
"گلستان","ترکمن","مرکزی",41,128,6,58,291,483,31,514
"گلستان","ترکمن","مرکزی",42,118,17,28,121,284,18,302
"گلستان","ترکمن","مرکزی",43,169,0,4,252,425,4,429
"گلستان","ترکمن","مرکزی",44,274,0,8,172,454,10,464
"گلستان","ترکمن","مرکزی",45,61,7,5,92,165,3,168
"گلستان","ترکمن","مرکزی",46,169,4,24,253,450,4,454
"گلستان","ترکمن","مرکزی",47,230,2,5,36,273,8,281
"گلستان","ترکمن","مرکزی",48,407,0,2,49,458,12,470
"گلستان","ترکمن","مرکزی",49,64,2,15,244,325,5,330
"گلستان","ترکمن","مرکزی",50,107,1,8,133,249,0,249
"گلستان","ترکمن","مرکزی",51,314,1,0,335,650,30,680
"گلستان","ترکمن","مرکزی",52,139,0,2,157,298,8,306
"گلستان","ترکمن","گمیشان",1,150,5,61,384,600,2,602
"گلستان","ترکمن","گمیشان",2,277,2,49,484,812,34,846
"گلستان","ترکمن","گمیشان",3,239,3,83,535,860,15,875
"گلستان","ترکمن","گمیشان",4,202,1,80,413,696,9,705
"گلستان","ترکمن","گمیشان",5,354,3,111,568,1036,23,1059
"گلستان","ترکمن","گمیشان",6,250,2,128,451,831,20,851
"گلستان","ترکمن","گمیشان",7,250,2,45,207,504,21,525
"گلستان","ترکمن","گمیشان",8,108,0,29,331,468,4,472
"گلستان","ترکمن","گمیشان",9,170,1,55,364,590,16,606
"گلستان","ترکمن","گمیشان",10,293,2,48,336,679,17,696
"گلستان","ترکمن","گمیشان",11,75,0,29,255,359,8,367
"گلستان","ترکمن","گمیشان",12,130,2,49,366,547,17,564
"گلستان","ترکمن","گمیشان",13,144,1,93,319,557,14,571
"گلستان","ترکمن","گمیشان",14,194,3,16,205,418,8,426
"گلستان","ترکمن","گمیشان",15,169,16,61,414,660,13,673
"گلستان","ترکمن","گمیشان",16,183,4,43,308,538,26,564
"گلستان","ترکمن","گمیشان",17,139,0,31,257,427,16,443
"گلستان","ترکمن","گمیشان",18,79,7,23,331,440,19,459
"گلستان","ترکمن","گمیشان",19,97,4,8,369,478,15,493
"گلستان","ترکمن","گمیشان",20,53,0,14,241,308,6,314
"گلستان","ترکمن","گمیشان",21,144,1,25,464,634,10,644
"گلستان","ترکمن","گمیشان",22,138,5,22,726,891,18,909
"گلستان","ترکمن","گمیشان",23,93,4,20,382,499,0,499
"گلستان","ترکمن","گمیشان",24,83,4,21,334,442,3,445
"گلستان","ترکمن","گمیشان",25,150,9,10,411,580,21,601
"گلستان","ترکمن","گمیشان",26,77,0,3,199,279,2,281
"گلستان","ترکمن","گمیشان",27,205,3,5,354,567,26,593
"گلستان","ترکمن","گمیشان",28,309,4,22,273,608,16,624
"گلستان","ترکمن","گمیشان",29,133,33,29,268,463,19,482
"گلستان","ترکمن","گمیشان",30,258,17,42,236,553,28,581
"گلستان","ترکمن","گمیشان",31,236,1,8,379,624,0,624
"گلستان","ترکمن","گمیشان",32,93,1,7,292,393,13,406
"گلستان","ترکمن","گمیشان",33,131,1,45,496,673,11,684
"گلستان","ترکمن","گمیشان",34,115,1,30,222,368,7,375
"گلستان","ترکمن","گمیشان",35,185,2,7,287,481,9,490
"گلستان","ترکمن","گمیشان",36,158,3,5,161,327,12,339
"گلستان","ترکمن","گمیشان",37,71,1,6,184,262,11,273
"گلستان","ترکمن","گمیشان",38,55,0,8,166,229,5,234
"گلستان","ترکمن","گمیشان",39,180,2,60,243,485,12,497
"گلستان","ترکمن","گمیشان",40,87,0,7,272,366,3,369
"گلستان","ترکمن","گمیشان",41,121,4,11,401,537,12,549
"گلستان","ترکمن","گمیشان",42,66,3,11,447,527,3,530
"گلستان","ترکمن","گمیشان",43,231,5,52,280,568,6,574
"گلستان","ترکمن","گمیشان",44,113,3,8,173,297,11,308
"گلستان","ترکمن","گمیشان",45,67,4,23,167,261,3,264
"گلستان","ترکمن","گمیشان",46,122,3,10,198,333,5,338
"گلستان","ترکمن","گمیشان",47,83,7,11,236,337,3,340
"گلستان","ترکمن","گمیشان",48,79,1,13,292,385,7,392
"گلستان","ترکمن","گمیشان",49,19,1,1,168,189,0,189
"گلستان","ترکمن","گمیشان",50,135,4,31,253,423,13,436
"گلستان","ترکمن","گمیشان",51,216,7,14,276,513,15,528
"گلستان","ترکمن","گمیشان",52,104,2,65,259,430,12,442
"گلستان","ترکمن","گمیشان",53,85,2,34,148,269,13,282
"گلستان","ترکمن","گمیشان",54,179,0,56,178,413,14,427
"گلستان","ترکمن","گمیشان",55,109,1,13,357,480,22,502
"گلستان","ترکمن","گمیشان",56,52,0,1,30,83,0,83
"گلستان","رامیان","مرکزی",1,517,11,12,515,1055,14,1069
"گلستان","رامیان","مرکزی",2,458,3,3,335,799,14,813
"گلستان","رامیان","مرکزی",3,394,5,4,314,717,18,735
"گلستان","رامیان","مرکزی",4,480,8,1,247,736,13,749
"گلستان","رامیان","مرکزی",5,898,14,1,240,1153,27,1180
"گلستان","رامیان","مرکزی",6,405,3,2,283,693,7,700
"گلستان","رامیان","مرکزی",7,269,4,4,151,428,9,437
"گلستان","رامیان","مرکزی",8,377,9,7,271,664,8,672
"گلستان","رامیان","مرکزی",9,572,10,1,180,763,16,779
"گلستان","رامیان","مرکزی",10,675,9,3,234,921,17,938
"گلستان","رامیان","مرکزی",11,877,9,2,314,1202,31,1233
"گلستان","رامیان","مرکزی",12,395,2,1,111,509,6,515
"گلستان","رامیان","مرکزی",13,684,5,1,102,792,21,813
"گلستان","رامیان","مرکزی",14,556,1,0,82,639,14,653
"گلستان","رامیان","مرکزی",15,402,2,0,90,494,7,501
"گلستان","رامیان","مرکزی",16,543,2,1,84,630,7,637
"گلستان","رامیان","مرکزی",17,525,8,2,155,690,11,701
"گلستان","رامیان","مرکزی",18,104,0,0,80,184,1,185
"گلستان","رامیان","مرکزی",19,320,9,2,48,379,1,380
"گلستان","رامیان","مرکزی",20,897,2,2,125,1026,11,1037
"گلستان","رامیان","مرکزی",21,130,0,0,62,192,1,193
"گلستان","رامیان","مرکزی",22,131,3,6,237,377,8,385
"گلستان","رامیان","مرکزی",23,155,1,1,133,290,9,299
"گلستان","رامیان","مرکزی",24,508,1,2,204,715,10,725
"گلستان","رامیان","مرکزی",25,219,0,0,34,253,0,253
"گلستان","رامیان","مرکزی",26,186,0,5,183,374,6,380
"گلستان","رامیان","مرکزی",27,353,5,1,127,486,10,496
"گلستان","رامیان","مرکزی",28,484,6,0,147,637,3,640
"گلستان","رامیان","مرکزی",29,393,1,0,40,434,4,438
"گلستان","رامیان","مرکزی",30,458,4,2,100,564,20,584
"گلستان","رامیان","مرکزی",31,668,1,1,218,888,13,901
"گلستان","رامیان","مرکزی",32,408,4,5,116,533,4,537
"گلستان","رامیان","مرکزی",33,298,1,1,30,330,2,332
"گلستان","رامیان","مرکزی",34,162,1,2,45,210,5,215
"گلستان","رامیان","مرکزی",35,384,1,0,21,406,2,408
"گلستان","رامیان","مرکزی",36,332,1,0,25,358,5,363
"گلستان","رامیان","مرکزی",37,256,1,0,85,342,5,347
"گلستان","رامیان","مرکزی",38,127,0,0,63,190,3,193
"گلستان","رامیان","مرکزی",39,211,0,0,17,228,2,230
"گلستان","رامیان","مرکزی",40,422,3,2,355,782,11,793
"گلستان","رامیان","مرکزی",41,433,2,6,495,936,4,940
"گلستان","رامیان","مرکزی",42,515,2,0,82,599,9,608
"گلستان","رامیان","مرکزی",43,321,0,0,10,331,16,347
"گلستان","رامیان","مرکزی",44,597,3,1,326,927,7,934
"گلستان","رامیان","مرکزی",45,77,0,0,38,115,1,116
"گلستان","رامیان","مرکزی",46,142,1,1,98,242,8,250
"گلستان","رامیان","مرکزی",47,104,1,1,82,188,2,190
"گلستان","رامیان","فندرسک",1,439,8,1,248,696,7,703
"گلستان","رامیان","فندرسک",2,1115,11,1,239,1366,9,1375
"گلستان","رامیان","فندرسک",3,376,1,6,187,570,10,580
"گلستان","رامیان","فندرسک",4,397,7,1,146,551,6,557
"گلستان","رامیان","فندرسک",5,682,0,1,92,775,18,793
"گلستان","رامیان","فندرسک",6,542,5,4,110,661,3,664
"گلستان","رامیان","فندرسک",7,325,1,1,89,416,7,423
"گلستان","رامیان","فندرسک",8,1100,1,5,259,1365,6,1371
"گلستان","رامیان","فندرسک",9,596,2,0,29,627,0,627
"گلستان","رامیان","فندرسک",10,613,6,3,147,769,1,770
"گلستان","رامیان","فندرسک",11,530,4,2,138,674,9,683
"گلستان","رامیان","فندرسک",12,498,2,0,89,589,2,591
"گلستان","رامیان","فندرسک",13,444,2,1,141,588,10,598
"گلستان","رامیان","فندرسک",14,459,5,3,441,908,3,911
"گلستان","رامیان","فندرسک",15,557,2,0,205,764,12,776
"گلستان","رامیان","فندرسک",16,394,0,0,37,431,5,436
"گلستان","رامیان","فندرسک",17,604,4,0,193,801,8,809
"گلستان","رامیان","فندرسک",18,397,0,1,47,445,4,449
"گلستان","رامیان","فندرسک",19,493,10,3,117,623,8,631
"گلستان","رامیان","فندرسک",20,287,2,0,10,299,3,302
"گلستان","رامیان","فندرسک",21,151,0,0,45,196,2,198
"گلستان","رامیان","فندرسک",22,393,3,9,224,629,3,632
"گلستان","رامیان","فندرسک",23,652,0,1,190,843,1,844
"گلستان","رامیان","فندرسک",24,345,0,2,123,470,4,474
"گلستان","رامیان","فندرسک",25,577,4,0,236,817,10,827
"گلستان","رامیان","فندرسک",26,549,5,2,43,599,4,603
"گلستان","رامیان","فندرسک",27,473,0,1,64,538,2,540
"گلستان","رامیان","فندرسک",28,265,0,0,41,306,6,312
"گلستان","رامیان","فندرسک",29,303,4,3,43,353,6,359
"گلستان","رامیان","فندرسک",30,123,1,0,5,129,1,130
"گلستان","رامیان","فندرسک",31,387,0,0,2,389,0,389
"گلستان","رامیان","فندرسک",32,589,8,4,60,661,0,661
"گلستان","رامیان","فندرسک",33,203,1,0,19,223,0,223
"گلستان","رامیان","فندرسک",34,247,1,0,9,257,5,262
"گلستان","رامیان","فندرسک",35,116,1,0,79,196,1,197
"گلستان","رامیان","فندرسک",36,339,0,0,21,360,5,365
"گلستان","رامیان","فندرسک",37,313,0,0,17,330,2,332
"گلستان","علی_آباد","مرکزی",1,335,3,5,142,485,5,490
"گلستان","علی_آباد","مرکزی",2,739,29,12,424,1204,3,1207
"گلستان","علی_آباد","مرکزی",3,1187,10,6,251,1454,13,1467
"گلستان","علی_آباد","مرکزی",4,930,7,3,177,1117,9,1126
"گلستان","علی_آباد","مرکزی",5,1175,11,9,438,1633,13,1646
"گلستان","علی_آباد","مرکزی",6,699,2,1,83,785,14,799
"گلستان","علی_آباد","مرکزی",7,780,16,1,202,999,15,1014
"گلستان","علی_آباد","مرکزی",8,1140,6,3,300,1449,11,1460
"گلستان","علی_آباد","مرکزی",9,623,4,2,174,803,10,813
"گلستان","علی_آباد","مرکزی",10,790,4,7,244,1045,13,1058
"گلستان","علی_آباد","مرکزی",11,1133,11,2,366,1512,24,1536
"گلستان","علی_آباد","مرکزی",12,833,3,2,306,1144,16,1160
"گلستان","علی_آباد","مرکزی",13,438,7,0,112,557,7,564
"گلستان","علی_آباد","مرکزی",14,542,9,0,151,702,9,711
"گلستان","علی_آباد","مرکزی",15,1004,12,1,241,1258,1,1259
"گلستان","علی_آباد","مرکزی",16,1170,7,5,336,1518,28,1546
"گلستان","علی_آباد","مرکزی",17,662,4,0,337,1003,11,1014
"گلستان","علی_آباد","مرکزی",18,692,9,3,485,1189,13,1202
"گلستان","علی_آباد","مرکزی",19,269,7,3,141,420,6,426
"گلستان","علی_آباد","مرکزی",20,607,7,4,294,912,14,926
"گلستان","علی_آباد","مرکزی",21,662,21,1,417,1101,12,1113
"گلستان","علی_آباد","مرکزی",22,765,15,3,607,1390,21,1411
"گلستان","علی_آباد","مرکزی",23,401,15,1,221,638,3,641
"گلستان","علی_آباد","مرکزی",24,614,10,5,583,1212,11,1223
"گلستان","علی_آباد","مرکزی",25,424,10,0,282,716,9,725
"گلستان","علی_آباد","مرکزی",26,207,2,1,81,291,3,294
"گلستان","علی_آباد","مرکزی",27,788,7,0,244,1039,13,1052
"گلستان","علی_آباد","مرکزی",28,141,1,0,53,195,0,195
"گلستان","علی_آباد","مرکزی",29,690,10,0,191,891,7,898
"گلستان","علی_آباد","مرکزی",30,515,2,1,220,738,14,752
"گلستان","علی_آباد","مرکزی",31,638,2,0,192,832,4,836
"گلستان","علی_آباد","مرکزی",32,460,2,1,143,606,3,609
"گلستان","علی_آباد","مرکزی",33,335,1,1,112,449,3,452
"گلستان","علی_آباد","مرکزی",34,562,2,0,131,695,13,708
"گلستان","علی_آباد","مرکزی",35,577,11,2,401,991,6,997
"گلستان","علی_آباد","مرکزی",36,739,6,1,368,1114,9,1123
"گلستان","علی_آباد","مرکزی",37,407,4,0,204,615,4,619
"گلستان","علی_آباد","مرکزی",38,480,0,2,39,521,4,525
"گلستان","علی_آباد","مرکزی",39,1033,3,3,101,1140,4,1144
"گلستان","علی_آباد","مرکزی",40,863,3,0,48,914,6,920
"گلستان","علی_آباد","مرکزی",41,904,5,0,103,1012,9,1021
"گلستان","علی_آباد","مرکزی",42,721,2,0,94,817,11,828
"گلستان","علی_آباد","مرکزی",43,594,3,0,39,636,16,652
"گلستان","علی_آباد","مرکزی",44,371,2,1,35,409,5,414
"گلستان","علی_آباد","مرکزی",45,756,1,2,62,821,8,829
"گلستان","علی_آباد","مرکزی",46,1161,8,1,135,1305,9,1314
"گلستان","علی_آباد","مرکزی",47,822,1,0,52,875,7,882
"گلستان","علی_آباد","مرکزی",48,558,3,0,75,636,4,640
"گلستان","علی_آباد","مرکزی",49,487,2,0,74,563,10,573
"گلستان","علی_آباد","مرکزی",50,741,3,1,199,944,18,962
"گلستان","علی_آباد","مرکزی",51,379,2,3,33,417,1,418
"گلستان","علی_آباد","مرکزی",52,401,6,0,102,509,5,514
"گلستان","علی_آباد","مرکزی",53,348,5,24,244,621,9,630
"گلستان","علی_آباد","مرکزی",54,337,2,16,618,973,11,984
"گلستان","علی_آباد","مرکزی",55,164,3,8,285,460,2,462
"گلستان","علی_آباد","مرکزی",56,298,1,9,191,499,4,503
"گلستان","علی_آباد","مرکزی",57,421,5,15,476,917,6,923
"گلستان","علی_آباد","مرکزی",58,496,1,24,265,786,16,802
"گلستان","علی_آباد","مرکزی",59,410,4,24,549,987,14,1001
"گلستان","علی_آباد","مرکزی",60,197,0,10,303,510,3,513
"گلستان","علی_آباد","کمالان",1,408,3,3,101,515,5,520
"گلستان","علی_آباد","کمالان",2,581,6,0,344,931,8,939
"گلستان","علی_آباد","کمالان",3,808,7,11,387,1213,8,1221
"گلستان","علی_آباد","کمالان",4,1141,16,5,255,1417,28,1445
"گلستان","علی_آباد","کمالان",5,644,8,2,322,976,3,979
"گلستان","علی_آباد","کمالان",6,432,7,3,244,686,11,697
"گلستان","علی_آباد","کمالان",7,946,2,1,105,1054,11,1065
"گلستان","علی_آباد","کمالان",8,282,2,0,54,338,0,338
"گلستان","علی_آباد","کمالان",9,899,4,0,181,1084,13,1097
"گلستان","علی_آباد","کمالان",10,519,3,0,67,589,1,590
"گلستان","علی_آباد","کمالان",11,696,4,5,194,899,11,910
"گلستان","علی_آباد","کمالان",12,508,3,1,74,586,3,589
"گلستان","علی_آباد","کمالان",13,478,5,11,193,687,4,691
"گلستان","علی_آباد","کمالان",14,432,1,9,102,544,2,546
"گلستان","علی_آباد","کمالان",15,353,1,10,209,573,14,587
"گلستان","علی_آباد","کمالان",16,352,0,5,282,639,5,644
"گلستان","علی_آباد","کمالان",17,371,2,3,316,692,12,704
"گلستان","علی_آباد","کمالان",18,155,1,1,71,228,3,231
"گلستان","علی_آباد","کمالان",19,100,2,0,112,214,4,218
"گلستان","علی_آباد","کمالان",20,93,0,1,56,150,3,153
"گلستان","علی_آباد","کمالان",21,512,3,0,143,658,3,661
"گلستان","علی_آباد","کمالان",22,539,5,1,125,670,4,674
"گلستان","علی_آباد","کمالان",23,519,1,1,99,620,0,620
"گلستان","علی_آباد","کمالان",24,107,0,5,189,301,1,302
"گلستان","علی_آباد","کمالان",25,454,0,0,103,557,5,562
"گلستان","علی_آباد","کمالان",26,576,4,2,81,663,1,664
"گلستان","علی_آباد","کمالان",27,450,2,2,132,586,5,591
"گلستان","علی_آباد","کمالان",28,211,4,19,297,531,3,534
"گلستان","علی_آباد","کمالان",29,238,4,29,470,741,7,748
"گلستان","علی_آباد","کمالان",30,435,1,19,200,655,0,655
"گلستان","علی_آباد","کمالان",31,189,2,13,182,386,8,394
"گلستان","علی_آباد","کمالان",32,289,1,9,286,585,10,595
"گلستان","کردکوی","مرکزی",1,607,9,3,429,1048,23,1071
"گلستان","کردکوی","مرکزی",2,863,11,2,384,1260,32,1292
"گلستان","کردکوی","مرکزی",3,151,5,0,69,225,8,233
"گلستان","کردکوی","مرکزی",4,488,14,3,329,834,16,850
"گلستان","کردکوی","مرکزی",5,916,6,4,154,1080,15,1095
"گلستان","کردکوی","مرکزی",6,148,0,0,57,205,1,206
"گلستان","کردکوی","مرکزی",7,444,6,0,188,638,14,652
"گلستان","کردکوی","مرکزی",8,139,2,3,64,208,4,212
"گلستان","کردکوی","مرکزی",9,712,4,3,342,1061,31,1092
"گلستان","کردکوی","مرکزی",10,623,6,3,385,1017,23,1040
"گلستان","کردکوی","مرکزی",11,363,8,2,332,705,22,727
"گلستان","کردکوی","مرکزی",12,835,4,2,344,1185,25,1210
"گلستان","کردکوی","مرکزی",13,667,7,3,204,881,13,894
"گلستان","کردکوی","مرکزی",14,795,1,1,183,980,32,1012
"گلستان","کردکوی","مرکزی",15,789,4,2,85,880,8,888
"گلستان","کردکوی","مرکزی",16,543,3,4,336,886,18,904
"گلستان","کردکوی","مرکزی",17,567,5,2,260,834,15,849
"گلستان","کردکوی","مرکزی",18,376,0,1,107,484,8,492
"گلستان","کردکوی","مرکزی",19,270,5,3,206,484,20,504
"گلستان","کردکوی","مرکزی",20,253,5,2,179,439,7,446
"گلستان","کردکوی","مرکزی",21,403,7,4,323,737,34,771
"گلستان","کردکوی","مرکزی",22,138,0,2,68,208,7,215
"گلستان","کردکوی","مرکزی",23,246,2,2,218,468,8,476
"گلستان","کردکوی","مرکزی",24,779,4,3,200,986,35,1021
"گلستان","کردکوی","مرکزی",25,660,1,1,185,847,25,872
"گلستان","کردکوی","مرکزی",26,670,4,2,208,884,24,908
"گلستان","کردکوی","مرکزی",27,171,2,0,87,260,3,263
"گلستان","کردکوی","مرکزی",28,92,2,0,37,131,3,134
"گلستان","کردکوی","مرکزی",29,208,7,0,54,269,4,273
"گلستان","کردکوی","مرکزی",30,815,11,0,229,1055,28,1083
"گلستان","کردکوی","مرکزی",31,251,5,1,73,330,4,334
"گلستان","کردکوی","مرکزی",32,847,5,4,189,1045,10,1055
"گلستان","کردکوی","مرکزی",33,635,1,1,129,766,11,777
"گلستان","کردکوی","مرکزی",34,316,1,3,56,376,7,383
"گلستان","کردکوی","مرکزی",35,480,3,0,308,791,22,813
"گلستان","کردکوی","مرکزی",36,352,0,6,294,652,8,660
"گلستان","کردکوی","مرکزی",37,464,0,0,47,511,15,526
"گلستان","کردکوی","مرکزی",38,738,0,0,234,972,19,991
"گلستان","کردکوی","مرکزی",39,622,8,0,189,819,20,839
"گلستان","کردکوی","مرکزی",40,427,0,0,231,658,16,674
"گلستان","کردکوی","مرکزی",41,1032,6,3,200,1241,30,1271
"گلستان","کردکوی","مرکزی",42,811,6,3,235,1055,28,1083
"گلستان","کردکوی","مرکزی",43,498,6,1,198,703,7,710
"گلستان","کردکوی","مرکزی",44,335,18,0,148,501,9,510
"گلستان","کردکوی","مرکزی",45,270,4,3,168,445,8,453
"گلستان","کردکوی","مرکزی",46,474,2,0,203,679,12,691
"گلستان","کردکوی","مرکزی",47,525,3,2,200,730,20,750
"گلستان","کردکوی","مرکزی",48,274,0,0,182,456,6,462
"گلستان","کردکوی","مرکزی",49,332,1,0,54,387,5,392
"گلستان","کردکوی","مرکزی",50,864,2,0,161,1027,23,1050
"گلستان","کردکوی","مرکزی",51,520,1,0,187,708,8,716
"گلستان","کردکوی","مرکزی",52,505,2,1,409,917,12,929
"گلستان","کردکوی","مرکزی",53,617,5,3,236,861,26,887
"گلستان","کردکوی","مرکزی",54,424,2,14,227,667,12,679
"گلستان","کردکوی","مرکزی",55,281,2,1,35,319,4,323
"گلستان","کردکوی","مرکزی",56,107,1,0,109,217,2,219
"گلستان","کردکوی","مرکزی",57,314,0,0,153,467,5,472
"گلستان","کردکوی","مرکزی",58,179,3,0,166,348,3,351
"گلستان","کردکوی","مرکزی",59,133,2,0,41,176,8,184
"گلستان","کردکوی","مرکزی",60,241,0,3,18,262,5,267
"گلستان","کردکوی","مرکزی",61,190,0,0,61,251,8,259
"گلستان","کردکوی","مرکزی",62,117,0,0,29,146,1,147
"گلستان","کردکوی","مرکزی",63,172,1,0,12,185,2,187
"گلستان","کردکوی","مرکزی",64,157,0,0,19,176,0,176
"گلستان","کردکوی","مرکزی",65,139,0,2,35,176,1,177
"گلستان","کردکوی","مرکزی",66,131,1,0,28,160,5,165
"گلستان","کردکوی","مرکزی",67,101,2,0,41,144,1,145
"گلستان","کردکوی","مرکزی",68,110,0,0,28,138,3,141
"گلستان","کردکوی","مرکزی",69,127,0,0,25,152,4,156
"گلستان","کلاله","مرکزی",1,856,6,7,622,1491,20,1511
"گلستان","کلاله","مرکزی",2,370,2,10,384,766,14,780
"گلستان","کلاله","مرکزی",3,564,11,15,694,1284,17,1301
"گلستان","کلاله","مرکزی",4,407,5,4,149,565,0,565
"گلستان","کلاله","مرکزی",5,1042,18,3,385,1448,22,1470
"گلستان","کلاله","مرکزی",6,977,7,1,177,1162,20,1182
"گلستان","کلاله","مرکزی",7,1260,3,4,194,1461,10,1471
"گلستان","کلاله","مرکزی",8,709,3,11,665,1388,15,1403
"گلستان","کلاله","مرکزی",9,511,5,5,503,1024,13,1037
"گلستان","کلاله","مرکزی",10,137,4,4,731,876,9,885
"گلستان","کلاله","مرکزی",11,700,4,2,140,846,4,850
"گلستان","کلاله","مرکزی",12,646,2,6,747,1401,11,1412
"گلستان","کلاله","مرکزی",13,688,5,19,443,1155,3,1158
"گلستان","کلاله","مرکزی",14,710,5,0,142,857,9,866
"گلستان","کلاله","مرکزی",15,182,2,6,137,327,2,329
"گلستان","کلاله","مرکزی",16,688,5,7,396,1096,4,1100
"گلستان","کلاله","مرکزی",17,507,4,0,23,534,6,540
"گلستان","کلاله","مرکزی",18,275,4,1,309,589,5,594
"گلستان","کلاله","مرکزی",19,176,3,5,244,428,4,432
"گلستان","کلاله","مرکزی",20,793,3,4,240,1040,19,1059
"گلستان","کلاله","مرکزی",21,850,3,0,45,898,9,907
"گلستان","کلاله","مرکزی",22,427,1,10,389,827,12,839
"گلستان","کلاله","مرکزی",23,524,2,0,44,570,4,574
"گلستان","کلاله","مرکزی",24,309,2,3,772,1086,12,1098
"گلستان","کلاله","مرکزی",25,426,4,2,118,550,5,555
"گلستان","کلاله","مرکزی",26,163,5,3,363,534,6,540
"گلستان","کلاله","مرکزی",27,550,0,0,52,602,8,610
"گلستان","کلاله","مرکزی",28,644,0,0,14,658,4,662
"گلستان","کلاله","مرکزی",29,244,0,3,328,575,5,580
"گلستان","کلاله","مرکزی",30,456,1,0,15,472,0,472
"گلستان","کلاله","مرکزی",31,814,4,0,169,987,11,998
"گلستان","کلاله","مرکزی",32,507,2,1,89,599,5,604
"گلستان","کلاله","مرکزی",33,461,0,0,60,521,3,524
"گلستان","کلاله","مرکزی",34,150,2,83,1017,1252,25,1277
"گلستان","کلاله","مرکزی",35,202,3,24,1225,1454,12,1466
"گلستان","کلاله","مرکزی",36,180,0,3,930,1113,11,1124
"گلستان","کلاله","مرکزی",37,49,3,12,845,909,14,923
"گلستان","کلاله","مرکزی",38,144,0,6,388,538,3,541
"گلستان","کلاله","مرکزی",39,803,3,0,19,825,3,828
"گلستان","کلاله","مرکزی",40,50,2,21,674,747,16,763
"گلستان","کلاله","مرکزی",41,228,1,47,510,786,21,807
"گلستان","کلاله","مرکزی",42,171,11,84,875,1141,20,1161
"گلستان","کلاله","مرکزی",43,163,4,18,433,618,11,629
"گلستان","کلاله","مرکزی",44,294,3,48,568,913,12,925
"گلستان","کلاله","مرکزی",45,125,4,26,819,974,30,1004
"گلستان","کلاله","مرکزی",46,141,1,64,596,802,19,821
"گلستان","کلاله","مرکزی",47,298,5,26,374,703,9,712
"گلستان","کلاله","مرکزی",48,96,1,5,191,293,7,300
"گلستان","کلاله","مرکزی",49,190,2,9,231,432,3,435
"گلستان","کلاله","مرکزی",50,52,0,6,213,271,1,272
"گلستان","کلاله","مرکزی",51,233,4,5,515,757,17,774
"گلستان","کلاله","مرکزی",52,83,2,2,430,517,13,530
"گلستان","کلاله","مرکزی",53,228,0,8,323,559,12,571
"گلستان","کلاله","مرکزی",54,76,0,14,369,459,9,468
"گلستان","کلاله","مرکزی",55,27,0,5,246,278,3,281
"گلستان","کلاله","مرکزی",56,56,7,16,307,386,4,390
"گلستان","کلاله","مرکزی",57,101,1,21,521,644,2,646
"گلستان","کلاله","مرکزی",58,114,0,13,551,678,2,680
"گلستان","کلاله","مرکزی",59,180,2,6,732,920,17,937
"گلستان","کلاله","مرکزی",60,147,3,2,189,341,3,344
"گلستان","کلاله","مرکزی",61,163,3,5,771,942,22,964
"گلستان","کلاله","مرکزی",62,33,0,8,529,570,10,580
"گلستان","کلاله","مرکزی",63,163,3,9,347,522,5,527
"گلستان","کلاله","مرکزی",64,26,2,6,653,687,21,708
"گلستان","کلاله","مرکزی",65,69,2,11,724,806,13,819
"گلستان","کلاله","مرکزی",66,87,3,2,411,503,4,507
"گلستان","کلاله","مرکزی",67,54,0,5,358,417,1,418
"گلستان","کلاله","مرکزی",68,79,3,8,542,632,11,643
"گلستان","کلاله","مرکزی",69,66,1,6,531,604,5,609
"گلستان","گرگان","مرکزی",1,1358,1,3,173,1535,21,1556
"گلستان","گرگان","مرکزی",2,822,7,5,261,1095,13,1108
"گلستان","گرگان","مرکزی",3,803,23,25,880,1731,41,1772
"گلستان","گرگان","مرکزی",4,978,19,5,578,1580,37,1617
"گلستان","گرگان","مرکزی",5,1147,2,2,220,1371,17,1388
"گلستان","گرگان","مرکزی",6,945,16,2,668,1631,36,1667
"گلستان","گرگان","مرکزی",7,1045,18,8,416,1487,20,1507
"گلستان","گرگان","مرکزی",8,1719,29,6,546,2300,36,2336
"گلستان","گرگان","مرکزی",9,714,11,5,235,965,15,980
"گلستان","گرگان","مرکزی",10,1223,16,8,492,1739,31,1770
"گلستان","گرگان","مرکزی",11,640,13,9,588,1250,18,1268
"گلستان","گرگان","مرکزی",12,925,3,2,257,1187,11,1198
"گلستان","گرگان","مرکزی",13,1354,9,13,407,1783,32,1815
"گلستان","گرگان","مرکزی",14,1010,10,1,214,1235,23,1258
"گلستان","گرگان","مرکزی",15,1037,12,8,181,1238,25,1263
"گلستان","گرگان","مرکزی",16,765,19,17,571,1372,36,1408
"گلستان","گرگان","مرکزی",17,1171,18,8,445,1642,19,1661
"گلستان","گرگان","مرکزی",18,895,14,9,438,1356,25,1381
"گلستان","گرگان","مرکزی",19,662,6,2,234,904,11,915
"گلستان","گرگان","مرکزی",20,1138,24,12,579,1753,37,1790
"گلستان","گرگان","مرکزی",21,424,30,19,664,1137,21,1158
"گلستان","گرگان","مرکزی",22,892,29,22,716,1659,31,1690
"گلستان","گرگان","مرکزی",23,525,12,14,593,1144,24,1168
"گلستان","گرگان","مرکزی",24,322,24,41,1469,1856,28,1884
"گلستان","گرگان","مرکزی",25,731,14,28,1096,1869,53,1922
"گلستان","گرگان","مرکزی",26,421,16,26,867,1330,25,1355
"گلستان","گرگان","مرکزی",27,878,18,28,960,1884,0,1884
"گلستان","گرگان","مرکزی",28,864,33,25,935,1857,42,1899
"گلستان","گرگان","مرکزی",29,344,21,47,1843,2255,22,2277
"گلستان","گرگان","مرکزی",30,799,15,8,444,1266,14,1280
"گلستان","گرگان","مرکزی",31,287,19,38,1483,1827,10,1837
"گلستان","گرگان","مرکزی",32,524,16,24,846,1410,31,1441
"گلستان","گرگان","مرکزی",33,1264,11,18,225,1518,35,1553
"گلستان","گرگان","مرکزی",34,575,23,19,1027,1644,23,1667
"گلستان","گرگان","مرکزی",35,500,25,22,1232,1779,31,1810
"گلستان","گرگان","مرکزی",36,669,38,36,1054,1797,23,1820
"گلستان","گرگان","مرکزی",37,716,41,32,1224,2013,33,2046
"گلستان","گرگان","مرکزی",38,435,16,31,1004,1486,27,1513
"گلستان","گرگان","مرکزی",39,524,31,49,1407,2011,18,2029
"گلستان","گرگان","مرکزی",40,625,19,27,880,1551,36,1587
"گلستان","گرگان","مرکزی",41,537,31,16,970,1554,36,1590
"گلستان","گرگان","مرکزی",42,873,28,7,693,1601,37,1638
"گلستان","گرگان","مرکزی",43,988,16,7,441,1452,25,1477
"گلستان","گرگان","مرکزی",44,832,33,14,682,1561,20,1581
"گلستان","گرگان","مرکزی",45,850,8,1,239,1098,23,1121
"گلستان","گرگان","مرکزی",46,991,14,7,296,1308,15,1323
"گلستان","گرگان","مرکزی",47,1119,27,10,483,1639,40,1679
"گلستان","گرگان","مرکزی",48,1419,17,19,497,1952,41,1993
"گلستان","گرگان","مرکزی",49,510,15,11,300,836,16,852
"گلستان","گرگان","مرکزی",50,669,17,29,591,1306,28,1334
"گلستان","گرگان","مرکزی",51,809,18,26,746,1599,38,1637
"گلستان","گرگان","مرکزی",52,729,15,14,545,1303,16,1319
"گلستان","گرگان","مرکزی",53,1059,33,12,569,1673,20,1693
"گلستان","گرگان","مرکزی",54,994,6,3,385,1388,19,1407
"گلستان","گرگان","مرکزی",55,1138,20,9,357,1524,30,1554
"گلستان","گرگان","مرکزی",56,520,3,6,254,783,17,800
"گلستان","گرگان","مرکزی",57,824,1,2,162,989,20,1009
"گلستان","گرگان","مرکزی",58,913,5,6,325,1249,0,1249
"گلستان","گرگان","مرکزی",59,716,20,19,1166,1921,16,1937
"گلستان","گرگان","مرکزی",60,864,20,6,627,1517,26,1543
"گلستان","گرگان","مرکزی",61,716,14,19,549,1298,23,1321
"گلستان","گرگان","مرکزی",62,636,18,15,480,1149,17,1166
"گلستان","گرگان","مرکزی",63,1090,6,6,327,1429,32,1461
"گلستان","گرگان","مرکزی",64,968,16,12,563,1559,26,1585
"گلستان","گرگان","مرکزی",65,974,13,7,581,1575,22,1597
"گلستان","گرگان","مرکزی",66,764,25,17,1143,1949,49,1998
"گلستان","گرگان","مرکزی",67,548,16,42,838,1444,20,1464
"گلستان","گرگان","مرکزی",68,580,29,13,720,1342,20,1362
"گلستان","گرگان","مرکزی",69,474,30,16,760,1280,18,1298
"گلستان","گرگان","مرکزی",70,898,25,7,645,1575,39,1614
"گلستان","گرگان","مرکزی",71,878,17,13,772,1680,26,1706
"گلستان","گرگان","مرکزی",72,756,31,11,653,1451,22,1473
"گلستان","گرگان","مرکزی",73,766,22,14,827,1629,33,1662
"گلستان","گرگان","مرکزی",74,703,20,8,528,1259,22,1281
"گلستان","گرگان","مرکزی",75,447,11,13,529,1000,18,1018
"گلستان","گرگان","مرکزی",76,515,10,14,607,1146,13,1159
"گلستان","گرگان","مرکزی",77,982,16,9,412,1419,27,1446
"گلستان","گرگان","مرکزی",78,681,22,17,565,1285,14,1299
"گلستان","گرگان","مرکزی",79,514,19,12,559,1104,21,1125
"گلستان","گرگان","مرکزی",80,953,18,20,579,1570,26,1596
"گلستان","گرگان","مرکزی",81,574,14,8,370,966,17,983
"گلستان","گرگان","مرکزی",82,453,24,23,646,1146,23,1169
"گلستان","گرگان","مرکزی",83,347,10,3,447,807,17,824
"گلستان","گرگان","مرکزی",84,767,22,12,551,1352,17,1369
"گلستان","گرگان","مرکزی",85,573,17,12,709,1311,32,1343
"گلستان","گرگان","مرکزی",86,573,21,12,665,1271,28,1299
"گلستان","گرگان","مرکزی",87,929,17,14,590,1550,17,1567
"گلستان","گرگان","مرکزی",88,724,18,12,1013,1767,30,1797
"گلستان","گرگان","مرکزی",89,702,16,7,325,1050,16,1066
"گلستان","گرگان","مرکزی",90,826,20,15,469,1330,27,1357
"گلستان","گرگان","مرکزی",91,425,15,14,500,954,25,979
"گلستان","گرگان","مرکزی",92,225,9,4,211,449,8,457
"گلستان","گرگان","مرکزی",93,410,11,10,359,790,9,799
"گلستان","گرگان","مرکزی",94,362,18,8,364,752,34,786
"گلستان","گرگان","مرکزی",95,629,9,12,363,1013,25,1038
"گلستان","گرگان","مرکزی",96,523,12,6,154,695,6,701
"گلستان","گرگان","مرکزی",97,476,38,5,511,1030,26,1056
"گلستان","گرگان","مرکزی",98,532,3,4,138,677,10,687
"گلستان","گرگان","مرکزی",99,484,10,5,151,650,12,662
"گلستان","گرگان","مرکزی",100,351,4,5,263,623,17,640
"گلستان","گرگان","مرکزی",101,213,5,6,251,475,15,490
"گلستان","گرگان","مرکزی",102,268,10,8,116,402,7,409
"گلستان","گرگان","مرکزی",103,379,8,5,207,599,10,609
"گلستان","گرگان","مرکزی",104,978,41,28,601,1648,33,1681
"گلستان","گرگان","مرکزی",105,485,1,0,189,675,5,680
"گلستان","گرگان","مرکزی",106,678,4,0,81,763,11,774
"گلستان","گرگان","مرکزی",107,970,14,3,441,1428,31,1459
"گلستان","گرگان","مرکزی",108,479,8,0,174,661,12,673
"گلستان","گرگان","مرکزی",109,619,1,2,362,984,0,984
"گلستان","گرگان","مرکزی",110,455,3,2,180,640,10,650
"گلستان","گرگان","مرکزی",111,431,4,0,123,558,2,560
"گلستان","گرگان","مرکزی",112,384,3,1,207,595,6,601
"گلستان","گرگان","مرکزی",113,180,3,2,79,264,2,266
"گلستان","گرگان","مرکزی",114,299,1,3,158,461,2,463
"گلستان","گرگان","مرکزی",115,1231,14,3,332,1580,20,1600
"گلستان","گرگان","مرکزی",116,618,10,1,531,1160,30,1190
"گلستان","گرگان","مرکزی",117,266,4,0,109,379,2,381
"گلستان","گرگان","مرکزی",118,740,5,1,104,850,2,852
"گلستان","گرگان","مرکزی",119,586,22,19,537,1164,15,1179
"گلستان","گرگان","مرکزی",120,362,4,22,226,614,15,629
"گلستان","گرگان","مرکزی",121,682,4,3,264,953,22,975
"گلستان","گرگان","مرکزی",122,1000,5,8,235,1248,27,1275
"گلستان","گرگان","مرکزی",123,588,3,1,577,1169,11,1180
"گلستان","گرگان","مرکزی",124,315,4,5,88,412,8,420
"گلستان","گرگان","مرکزی",125,418,6,8,196,628,12,640
"گلستان","گرگان","مرکزی",126,318,2,0,152,472,6,478
"گلستان","گرگان","مرکزی",127,398,4,0,84,486,8,494
"گلستان","گرگان","مرکزی",128,696,2,3,418,1119,13,1132
"گلستان","گرگان","مرکزی",129,1527,4,0,224,1755,18,1773
"گلستان","گرگان","مرکزی",130,1128,7,1,92,1228,22,1250
"گلستان","گرگان","مرکزی",131,401,2,7,83,493,6,499
"گلستان","گرگان","مرکزی",132,185,1,2,66,254,0,254
"گلستان","گرگان","مرکزی",133,474,5,2,215,696,13,709
"گلستان","گرگان","مرکزی",134,479,1,6,77,563,12,575
"گلستان","گرگان","مرکزی",135,707,6,5,410,1128,17,1145
"گلستان","گرگان","مرکزی",136,794,0,0,147,941,11,952
"گلستان","گرگان","مرکزی",137,975,11,2,209,1197,20,1217
"گلستان","گرگان","مرکزی",138,996,2,2,104,1104,16,1120
"گلستان","گرگان","مرکزی",139,261,0,1,26,288,8,296
"گلستان","گرگان","مرکزی",140,525,14,4,863,1406,23,1429
"گلستان","گرگان","مرکزی",141,550,5,24,313,892,18,910
"گلستان","گرگان","مرکزی",142,1076,4,0,345,1425,18,1443
"گلستان","گرگان","مرکزی",143,1226,3,1,113,1343,6,1349
"گلستان","گرگان","مرکزی",144,1084,15,2,415,1516,26,1542
"گلستان","گرگان","مرکزی",145,1048,21,4,425,1498,21,1519
"گلستان","گرگان","مرکزی",146,223,1,0,34,258,0,258
"گلستان","گرگان","مرکزی",147,206,6,11,174,397,13,410
"گلستان","گرگان","مرکزی",148,577,21,1,216,815,11,826
"گلستان","گرگان","مرکزی",149,468,1,1,194,664,15,679
"گلستان","گرگان","مرکزی",150,934,12,2,299,1247,8,1255
"گلستان","گرگان","مرکزی",151,698,7,0,515,1220,21,1241
"گلستان","گرگان","مرکزی",152,287,4,8,64,363,4,367
"گلستان","گرگان","مرکزی",153,674,3,1,26,704,2,706
"گلستان","گرگان","مرکزی",154,826,5,6,235,1072,15,1087
"گلستان","گرگان","مرکزی",155,369,2,4,186,561,9,570
"گلستان","گرگان","مرکزی",156,579,9,5,274,867,18,885
"گلستان","گرگان","مرکزی",157,513,0,1,95,609,8,617
"گلستان","گرگان","مرکزی",158,433,1,1,53,488,0,488
"گلستان","گرگان","مرکزی",159,288,8,5,290,591,17,608
"گلستان","گرگان","مرکزی",160,611,7,1,147,766,13,779
"گلستان","گرگان","مرکزی",161,865,4,5,185,1059,16,1075
"گلستان","گرگان","مرکزی",162,175,0,2,38,215,3,218
"گلستان","گرگان","مرکزی",163,124,0,0,13,137,8,145
"گلستان","گرگان","مرکزی",164,870,4,1,34,909,21,930
"گلستان","گرگان","مرکزی",165,431,4,2,130,567,13,580
"گلستان","گرگان","مرکزی",166,227,1,1,35,264,5,269
"گلستان","گرگان","مرکزی",167,388,6,7,84,485,8,493
"گلستان","گرگان","بهاران",1,890,6,4,200,1100,17,1117
"گلستان","گرگان","بهاران",2,1024,8,7,433,1472,28,1500
"گلستان","گرگان","بهاران",3,336,8,2,117,463,12,475
"گلستان","گرگان","بهاران",4,326,12,10,252,600,15,615
"گلستان","گرگان","بهاران",5,1080,1,3,64,1148,6,1154
"گلستان","گرگان","بهاران",6,1510,7,3,111,1631,22,1653
"گلستان","گرگان","بهاران",7,932,1,1,89,1023,13,1036
"گلستان","گرگان","بهاران",8,741,6,5,230,982,22,1004
"گلستان","گرگان","بهاران",9,792,3,34,250,1079,14,1093
"گلستان","گرگان","بهاران",10,547,3,0,194,744,16,760
"گلستان","گرگان","بهاران",11,519,12,0,132,663,6,669
"گلستان","گرگان","بهاران",12,577,6,1,268,852,16,868
"گلستان","گرگان","بهاران",13,568,2,0,68,638,9,647
"گلستان","گرگان","بهاران",14,420,0,0,150,570,8,578
"گلستان","گرگان","بهاران",15,419,0,4,71,494,6,500
"گلستان","گرگان","بهاران",16,978,6,5,142,1131,20,1151
"گلستان","گرگان","بهاران",17,713,0,0,194,907,13,920
"گلستان","گرگان","بهاران",18,726,2,1,30,759,8,767
"گلستان","گرگان","بهاران",19,669,0,1,207,877,5,882
"گلستان","گرگان","بهاران",20,146,1,0,49,196,6,202
"گلستان","گرگان","بهاران",21,549,2,3,28,582,6,588
"گلستان","گرگان","بهاران",22,876,4,0,340,1220,18,1238
"گلستان","گرگان","بهاران",23,594,8,1,120,723,15,738
"گلستان","گرگان","بهاران",24,327,4,0,82,413,5,418
"گلستان","گرگان","بهاران",25,222,1,1,22,246,1,247
"گلستان","گرگان","بهاران",26,589,1,0,27,617,0,617
"گلستان","گرگان","بهاران",27,670,0,1,43,714,3,717
"گلستان","گرگان","بهاران",28,113,0,0,90,203,0,203
"گلستان","گرگان","بهاران",29,981,6,3,114,1104,12,1116
"گلستان","گرگان","بهاران",30,619,4,1,125,749,9,758
"گلستان","گرگان","بهاران",31,702,5,0,81,788,12,800
"گلستان","گرگان","بهاران",32,435,3,7,375,820,17,837
"گلستان","گرگان","بهاران",33,561,6,1,64,632,8,640
"گلستان","گرگان","بهاران",34,488,5,1,123,617,1,618
"گلستان","گرگان","بهاران",35,743,4,1,97,845,17,862
"گلستان","گرگان","بهاران",36,572,18,3,141,734,11,745
"گلستان","گرگان","بهاران",37,614,0,0,44,658,6,664
"گلستان","گرگان","بهاران",38,197,1,2,84,284,8,292
"گلستان","گرگان","بهاران",39,362,0,0,40,402,8,410
"گلستان","گرگان","بهاران",40,553,5,5,188,751,21,772
"گلستان","گرگان","بهاران",41,390,2,0,43,435,4,439
"گلستان","گرگان","بهاران",42,229,0,0,14,243,5,248
"گلستان","گرگان","بهاران",43,117,0,0,12,129,0,129
"گلستان","گرگان","بهاران",44,113,2,0,5,120,0,120
"گلستان","گرگان","بهاران",45,196,3,1,27,227,8,235
"گلستان","گرگان","بهاران",46,303,3,1,69,376,1,377
"گلستان","گرگان","بهاران",47,113,0,1,10,124,5,129
"گلستان","گنبدکاووس","مرکزی",1,705,20,21,654,1400,24,1424
"گلستان","گنبدکاووس","مرکزی",2,189,15,28,1011,1243,26,1269
"گلستان","گنبدکاووس","مرکزی",3,378,15,30,931,1354,21,1375
"گلستان","گنبدکاووس","مرکزی",4,186,1,21,604,812,13,825
"گلستان","گنبدکاووس","مرکزی",5,288,1,29,719,1037,20,1057
"گلستان","گنبدکاووس","مرکزی",6,142,7,8,513,670,15,685
"گلستان","گنبدکاووس","مرکزی",7,245,2,11,922,1180,7,1187
"گلستان","گنبدکاووس","مرکزی",8,610,5,7,324,946,14,960
"گلستان","گنبدکاووس","مرکزی",9,215,9,10,571,805,9,814
"گلستان","گنبدکاووس","مرکزی",10,195,7,7,718,927,18,945
"گلستان","گنبدکاووس","مرکزی",11,515,9,20,654,1198,18,1216
"گلستان","گنبدکاووس","مرکزی",12,411,11,14,677,1113,12,1125
"گلستان","گنبدکاووس","مرکزی",13,815,10,18,649,1492,8,1500
"گلستان","گنبدکاووس","مرکزی",14,1136,5,18,433,1592,21,1613
"گلستان","گنبدکاووس","مرکزی",15,506,4,15,521,1046,14,1060
"گلستان","گنبدکاووس","مرکزی",16,353,2,17,501,873,18,891
"گلستان","گنبدکاووس","مرکزی",17,352,5,14,890,1261,10,1271
"گلستان","گنبدکاووس","مرکزی",18,392,2,5,389,788,6,794
"گلستان","گنبدکاووس","مرکزی",19,700,2,1,246,949,10,959
"گلستان","گنبدکاووس","مرکزی",20,563,7,1,86,657,1,658
"گلستان","گنبدکاووس","مرکزی",21,518,16,6,477,1017,14,1031
"گلستان","گنبدکاووس","مرکزی",22,619,10,6,476,1111,14,1125
"گلستان","گنبدکاووس","مرکزی",23,1139,11,7,557,1714,17,1731
"گلستان","گنبدکاووس","مرکزی",24,970,22,11,492,1495,24,1519
"گلستان","گنبدکاووس","مرکزی",25,776,22,4,393,1195,7,1202
"گلستان","گنبدکاووس","مرکزی",26,497,8,12,391,908,12,920
"گلستان","گنبدکاووس","مرکزی",27,541,4,3,482,1030,14,1044
"گلستان","گنبدکاووس","مرکزی",28,911,17,6,655,1589,20,1609
"گلستان","گنبدکاووس","مرکزی",29,156,2,3,253,414,4,418
"گلستان","گنبدکاووس","مرکزی",30,399,1,5,197,602,6,608
"گلستان","گنبدکاووس","مرکزی",31,736,9,7,409,1161,21,1182
"گلستان","گنبدکاووس","مرکزی",32,699,6,3,305,1013,15,1028
"گلستان","گنبدکاووس","مرکزی",33,900,5,5,422,1332,18,1350
"گلستان","گنبدکاووس","مرکزی",34,819,12,12,498,1341,24,1365
"گلستان","گنبدکاووس","مرکزی",35,168,6,6,156,336,7,343
"گلستان","گنبدکاووس","مرکزی",36,490,6,22,560,1078,13,1091
"گلستان","گنبدکاووس","مرکزی",37,540,12,13,530,1095,16,1111
"گلستان","گنبدکاووس","مرکزی",38,303,2,4,328,637,10,647
"گلستان","گنبدکاووس","مرکزی",39,348,7,23,686,1064,18,1082
"گلستان","گنبدکاووس","مرکزی",40,436,8,15,778,1237,14,1251
"گلستان","گنبدکاووس","مرکزی",41,273,10,8,285,576,11,587
"گلستان","گنبدکاووس","مرکزی",42,432,9,9,442,892,7,899
"گلستان","گنبدکاووس","مرکزی",43,523,8,4,406,941,19,960
"گلستان","گنبدکاووس","مرکزی",44,756,15,10,341,1122,13,1135
"گلستان","گنبدکاووس","مرکزی",45,685,9,1,194,889,6,895
"گلستان","گنبدکاووس","مرکزی",46,631,10,4,164,809,9,818
"گلستان","گنبدکاووس","مرکزی",47,382,6,16,296,700,13,713
"گلستان","گنبدکاووس","مرکزی",48,1016,13,18,231,1278,22,1300
"گلستان","گنبدکاووس","مرکزی",49,1109,9,2,133,1253,15,1268
"گلستان","گنبدکاووس","مرکزی",50,1125,9,5,166,1305,14,1319
"گلستان","گنبدکاووس","مرکزی",51,1061,1,3,98,1163,23,1186
"گلستان","گنبدکاووس","مرکزی",52,842,5,17,332,1196,19,1215
"گلستان","گنبدکاووس","مرکزی",53,192,1,27,614,834,5,839
"گلستان","گنبدکاووس","مرکزی",54,584,13,13,561,1171,23,1194
"گلستان","گنبدکاووس","مرکزی",55,586,13,21,756,1376,21,1397
"گلستان","گنبدکاووس","مرکزی",56,240,4,42,732,1018,19,1037
"گلستان","گنبدکاووس","مرکزی",57,557,3,9,280,849,19,868
"گلستان","گنبدکاووس","مرکزی",58,292,4,58,978,1332,24,1356
"گلستان","گنبدکاووس","مرکزی",59,106,1,9,606,722,14,736
"گلستان","گنبدکاووس","مرکزی",60,152,10,32,859,1053,16,1069
"گلستان","گنبدکاووس","مرکزی",61,111,1,9,595,716,10,726
"گلستان","گنبدکاووس","مرکزی",62,133,4,18,764,919,17,936
"گلستان","گنبدکاووس","مرکزی",63,170,1,26,1050,1247,13,1260
"گلستان","گنبدکاووس","مرکزی",64,220,3,16,939,1178,8,1186
"گلستان","گنبدکاووس","مرکزی",65,231,6,26,1108,1371,13,1384
"گلستان","گنبدکاووس","مرکزی",66,123,1,10,650,784,12,796
"گلستان","گنبدکاووس","مرکزی",67,353,13,2,162,530,15,545
"گلستان","گنبدکاووس","مرکزی",68,266,3,1,188,458,3,461
"گلستان","گنبدکاووس","مرکزی",69,146,7,1,101,255,4,259
"گلستان","گنبدکاووس","مرکزی",70,238,4,0,88,330,3,333
"گلستان","گنبدکاووس","مرکزی",71,180,12,6,547,745,15,760
"گلستان","گنبدکاووس","مرکزی",72,425,0,2,202,629,4,633
"گلستان","گنبدکاووس","مرکزی",73,136,6,9,208,359,6,365
"گلستان","گنبدکاووس","مرکزی",74,318,4,17,652,991,9,1000
"گلستان","گنبدکاووس","مرکزی",75,297,4,5,358,664,11,675
"گلستان","گنبدکاووس","مرکزی",76,469,1,4,205,679,8,687
"گلستان","گنبدکاووس","مرکزی",77,373,5,10,507,895,47,942
"گلستان","گنبدکاووس","مرکزی",78,159,0,9,381,549,10,559
"گلستان","گنبدکاووس","مرکزی",79,794,1,5,234,1034,15,1049
"گلستان","گنبدکاووس","مرکزی",80,543,3,9,435,990,21,1011
"گلستان","گنبدکاووس","مرکزی",81,393,2,0,43,438,8,446
"گلستان","گنبدکاووس","مرکزی",82,512,1,2,343,858,6,864
"گلستان","گنبدکاووس","مرکزی",83,123,14,9,204,350,5,355
"گلستان","گنبدکاووس","مرکزی",84,829,0,0,28,857,1,858
"گلستان","گنبدکاووس","مرکزی",85,262,5,17,126,410,12,422
"گلستان","گنبدکاووس","مرکزی",86,454,2,25,264,745,11,756
"گلستان","گنبدکاووس","مرکزی",87,642,3,9,371,1025,17,1042
"گلستان","گنبدکاووس","مرکزی",88,419,3,18,422,862,16,878
"گلستان","گنبدکاووس","مرکزی",89,410,2,2,278,692,14,706
"گلستان","گنبدکاووس","مرکزی",90,204,1,4,167,376,3,379
"گلستان","گنبدکاووس","مرکزی",91,299,1,16,481,797,3,800
"گلستان","گنبدکاووس","مرکزی",92,438,9,10,545,1002,7,1009
"گلستان","گنبدکاووس","مرکزی",93,384,1,14,193,592,5,597
"گلستان","گنبدکاووس","مرکزی",94,965,7,2,138,1112,12,1124
"گلستان","گنبدکاووس","مرکزی",95,1058,1,0,43,1102,7,1109
"گلستان","گنبدکاووس","مرکزی",96,947,1,0,70,1018,11,1029
"گلستان","گنبدکاووس","مرکزی",97,404,4,38,637,1083,17,1100
"گلستان","گنبدکاووس","مرکزی",98,249,4,6,673,932,13,945
"گلستان","گنبدکاووس","مرکزی",99,546,1,1,76,624,6,630
"گلستان","گنبدکاووس","مرکزی",100,418,0,4,364,786,12,798
"گلستان","گنبدکاووس","مرکزی",101,332,3,2,395,732,3,735
"گلستان","گنبدکاووس","مرکزی",102,889,4,5,515,1413,9,1422
"گلستان","گنبدکاووس","مرکزی",103,411,0,5,490,906,1,907
"گلستان","گنبدکاووس","مرکزی",104,682,4,8,302,996,7,1003
"گلستان","گنبدکاووس","مرکزی",105,215,11,10,274,510,10,520
"گلستان","گنبدکاووس","مرکزی",106,330,2,26,627,985,9,994
"گلستان","گنبدکاووس","مرکزی",107,365,6,30,451,852,8,860
"گلستان","گنبدکاووس","مرکزی",108,256,4,10,540,810,5,815
"گلستان","گنبدکاووس","مرکزی",109,180,3,25,356,564,5,569
"گلستان","گنبدکاووس","مرکزی",110,149,4,24,281,458,2,460
"گلستان","گنبدکاووس","مرکزی",111,225,3,35,332,595,11,606
"گلستان","گنبدکاووس","مرکزی",112,300,6,22,420,748,4,752
"گلستان","گنبدکاووس","مرکزی",113,209,0,14,495,718,3,721
"گلستان","گنبدکاووس","مرکزی",114,254,2,16,563,835,12,847
"گلستان","گنبدکاووس","مرکزی",115,295,8,6,183,492,6,498
"گلستان","گنبدکاووس","مرکزی",116,663,9,49,601,1322,31,1353
"گلستان","گنبدکاووس","مرکزی",117,227,4,34,499,764,5,769
"گلستان","گنبدکاووس","مرکزی",118,310,11,46,526,893,28,921
"گلستان","گنبدکاووس","مرکزی",119,350,2,12,530,894,8,902
"گلستان","گنبدکاووس","مرکزی",120,189,3,29,285,506,10,516
"گلستان","گنبدکاووس","مرکزی",121,286,1,4,588,879,5,884
"گلستان","گنبدکاووس","مرکزی",122,263,8,13,711,995,8,1003
"گلستان","گنبدکاووس","مرکزی",123,224,8,1,729,962,15,977
"گلستان","گنبدکاووس","مرکزی",124,417,1,11,344,773,8,781
"گلستان","گنبدکاووس","مرکزی",125,593,4,9,512,1118,12,1130
"گلستان","گنبدکاووس","مرکزی",126,439,1,0,57,497,0,497
"گلستان","گنبدکاووس","مرکزی",127,197,6,6,501,710,3,713
"گلستان","گنبدکاووس","مرکزی",128,261,2,12,657,932,18,950
"گلستان","گنبدکاووس","مرکزی",129,365,2,11,221,599,1,600
"گلستان","گنبدکاووس","مرکزی",130,661,1,1,75,738,8,746
"گلستان","گنبدکاووس","مرکزی",131,309,3,21,781,1114,16,1130
"گلستان","گنبدکاووس","مرکزی",132,282,7,18,662,969,21,990
"گلستان","گنبدکاووس","مرکزی",133,342,10,23,350,725,8,733
"گلستان","گنبدکاووس","مرکزی",134,260,0,40,741,1041,11,1052
"گلستان","گنبدکاووس","مرکزی",135,362,8,19,567,956,17,973
"گلستان","گنبدکاووس","مرکزی",136,354,4,13,564,935,11,946
"گلستان","گنبدکاووس","مرکزی",137,201,1,12,522,736,4,740
"گلستان","گنبدکاووس","مرکزی",138,364,7,31,545,947,13,960
"گلستان","گنبدکاووس","مرکزی",139,245,1,36,382,664,11,675
"گلستان","گنبدکاووس","مرکزی",140,413,1,0,44,458,6,464
"گلستان","گنبدکاووس","مرکزی",141,266,4,3,20,293,2,295
"گلستان","گنبدکاووس","مرکزی",142,219,0,2,16,237,1,238
"گلستان","گنبدکاووس","مرکزی",143,276,0,0,14,290,4,294
"گلستان","گنبدکاووس","مرکزی",144,324,0,0,9,333,1,334
"گلستان","گنبدکاووس","مرکزی",145,58,4,36,133,231,6,237
"گلستان","گنبدکاووس","داشلی_برون",1,272,11,110,537,930,14,944
"گلستان","گنبدکاووس","داشلی_برون",2,483,5,85,468,1041,1,1042
"گلستان","گنبدکاووس","داشلی_برون",3,297,2,80,391,770,0,770
"گلستان","گنبدکاووس","داشلی_برون",4,123,0,23,151,297,3,300
"گلستان","گنبدکاووس","داشلی_برون",5,239,6,111,435,791,21,812
"گلستان","گنبدکاووس","داشلی_برون",6,24,1,4,79,108,3,111
"گلستان","گنبدکاووس","داشلی_برون",7,152,6,20,265,443,0,443
"گلستان","گنبدکاووس","داشلی_برون",8,77,3,36,244,360,6,366
"گلستان","گنبدکاووس","داشلی_برون",9,109,4,15,180,308,1,309
"گلستان","گنبدکاووس","داشلی_برون",10,162,4,10,151,327,2,329
"گلستان","گنبدکاووس","داشلی_برون",11,122,2,40,155,319,15,334
"گلستان","گنبدکاووس","داشلی_برون",12,201,3,46,320,570,5,575
"گلستان","گنبدکاووس","داشلی_برون",13,199,4,44,462,709,13,722
"گلستان","گنبدکاووس","داشلی_برون",14,84,4,18,204,310,2,312
"گلستان","گنبدکاووس","داشلی_برون",15,51,1,94,519,665,3,668
"گلستان","گنبدکاووس","داشلی_برون",16,66,2,14,154,236,1,237
"گلستان","گنبدکاووس","داشلی_برون",17,121,2,4,341,468,8,476
"گلستان","گنبدکاووس","داشلی_برون",18,94,2,27,308,431,3,434
"گلستان","گنبدکاووس","داشلی_برون",19,206,5,15,219,445,4,449
"گلستان","گنبدکاووس","داشلی_برون",20,40,0,6,93,139,0,139
"گلستان","مراوه_تپه","مرکزی",1,342,4,40,440,826,5,831
"گلستان","مراوه_تپه","مرکزی",2,420,13,86,774,1293,22,1315
"گلستان","مراوه_تپه","مرکزی",3,245,2,41,378,666,9,675
"گلستان","مراوه_تپه","مرکزی",4,124,0,35,225,384,5,389
"گلستان","مراوه_تپه","مرکزی",5,72,2,21,431,526,0,526
"گلستان","مراوه_تپه","مرکزی",6,232,40,19,367,658,10,668
"گلستان","مراوه_تپه","مرکزی",7,200,3,23,286,512,8,520
"گلستان","مراوه_تپه","مرکزی",8,234,16,13,597,860,12,872
"گلستان","مراوه_تپه","مرکزی",9,200,2,15,515,732,16,748
"گلستان","مراوه_تپه","مرکزی",10,47,14,3,162,226,0,226
"گلستان","مراوه_تپه","مرکزی",11,186,6,327,528,1047,8,1055
"گلستان","مراوه_تپه","مرکزی",12,303,1,92,504,900,7,907
"گلستان","مراوه_تپه","مرکزی",13,196,1,128,231,556,4,560
"گلستان","مراوه_تپه","مرکزی",14,168,4,25,239,436,4,440
"گلستان","مراوه_تپه","مرکزی",15,157,4,48,260,469,1,470
"گلستان","مراوه_تپه","مرکزی",16,415,1,34,353,803,17,820
"گلستان","مراوه_تپه","گلیداغ",1,391,3,9,380,783,16,799
"گلستان","مراوه_تپه","گلیداغ",2,223,4,11,567,805,7,812
"گلستان","مراوه_تپه","گلیداغ",3,61,1,2,468,532,9,541
"گلستان","مراوه_تپه","گلیداغ",4,121,1,2,549,673,19,692
"گلستان","مراوه_تپه","گلیداغ",5,135,4,13,867,1019,7,1026
"گلستان","مراوه_تپه","گلیداغ",6,231,2,7,289,529,17,546
"گلستان","مراوه_تپه","گلیداغ",7,115,0,8,479,602,17,619
"گلستان","مراوه_تپه","گلیداغ",8,53,7,23,420,503,15,518
"گلستان","مراوه_تپه","گلیداغ",9,123,0,11,598,732,18,750
"گلستان","مراوه_تپه","گلیداغ",10,174,1,9,437,621,4,625
"گلستان","مراوه_تپه","گلیداغ",11,158,5,29,951,1143,24,1167
"گلستان","مراوه_تپه","گلیداغ",12,146,5,1,274,426,8,434
"گلستان","مراوه_تپه","گلیداغ",13,170,3,31,424,628,11,639
"گلستان","مراوه_تپه","گلیداغ",14,209,4,8,780,1001,31,1032
"گلستان","مراوه_تپه","گلیداغ",15,57,1,4,769,831,9,840
"گلستان","مراوه_تپه","گلیداغ",16,35,0,16,323,374,3,377
"گلستان","مینو_دشت","مرکزی",1,556,13,5,292,866,15,881
"گلستان","مینو_دشت","مرکزی",2,529,8,2,172,711,11,722
"گلستان","مینو_دشت","مرکزی",3,976,38,12,584,1610,20,1630
"گلستان","مینو_دشت","مرکزی",4,833,13,4,293,1143,23,1166
"گلستان","مینو_دشت","مرکزی",5,1090,8,8,272,1378,15,1393
"گلستان","مینو_دشت","مرکزی",6,1018,15,10,325,1368,25,1393
"گلستان","مینو_دشت","مرکزی",7,1220,13,3,201,1437,14,1451
"گلستان","مینو_دشت","مرکزی",8,654,11,6,83,754,4,758
"گلستان","مینو_دشت","مرکزی",9,1110,17,10,216,1353,21,1374
"گلستان","مینو_دشت","مرکزی",10,1110,20,10,242,1382,22,1404
"گلستان","مینو_دشت","مرکزی",11,748,13,2,151,914,6,920
"گلستان","مینو_دشت","مرکزی",12,591,10,5,162,768,13,781
"گلستان","مینو_دشت","مرکزی",13,450,2,1,122,575,12,587
"گلستان","مینو_دشت","مرکزی",14,618,6,3,213,840,10,850
"گلستان","مینو_دشت","مرکزی",15,394,4,3,63,464,13,477
"گلستان","مینو_دشت","مرکزی",16,1113,10,0,148,1271,10,1281
"گلستان","مینو_دشت","مرکزی",17,829,8,1,72,910,14,924
"گلستان","مینو_دشت","مرکزی",18,415,5,1,39,460,0,460
"گلستان","مینو_دشت","مرکزی",19,861,3,0,148,1012,8,1020
"گلستان","مینو_دشت","مرکزی",20,902,4,3,173,1082,18,1100
"گلستان","مینو_دشت","مرکزی",21,314,0,0,14,328,0,328
"گلستان","مینو_دشت","مرکزی",22,223,1,1,168,393,8,401
"گلستان","مینو_دشت","مرکزی",23,614,1,18,298,931,8,939
"گلستان","مینو_دشت","مرکزی",24,332,1,1,51,385,0,385
"گلستان","مینو_دشت","مرکزی",25,254,0,0,26,280,4,284
"گلستان","مینو_دشت","مرکزی",26,539,0,1,29,569,6,575
"گلستان","مینو_دشت","مرکزی",27,437,1,2,48,488,3,491
"گلستان","مینو_دشت","مرکزی",28,289,1,0,22,312,10,322
"گلستان","مینو_دشت","مرکزی",29,289,1,0,21,311,16,327
"گلستان","مینو_دشت","مرکزی",30,284,0,1,11,296,4,300
"گلستان","مینو_دشت","مرکزی",31,429,3,0,76,508,3,511
"گلستان","مینو_دشت","مرکزی",32,429,7,0,40,476,7,483
"گلستان","مینو_دشت","مرکزی",33,234,4,0,9,247,0,247
"گلستان","مینو_دشت","مرکزی",34,504,2,0,13,519,8,527
"گلستان","مینو_دشت","مرکزی",35,512,6,3,197,718,6,724
"گلستان","مینو_دشت","مرکزی",36,432,5,1,73,511,1,512
"گلستان","مینو_دشت","مرکزی",37,706,6,1,103,816,9,825
"گلستان","مینو_دشت","مرکزی",38,320,2,2,85,409,3,412
"گلستان","مینو_دشت","مرکزی",39,487,2,4,70,563,5,568
"گلستان","مینو_دشت","مرکزی",40,450,0,0,45,495,6,501
"گلستان","مینو_دشت","مرکزی",41,446,3,1,33,483,6,489
"گلستان","مینو_دشت","مرکزی",42,177,3,2,11,193,1,194
"گلستان","مینو_دشت","مرکزی",43,385,2,0,7,394,2,396
"گلستان","مینو_دشت","مرکزی",44,331,2,7,16,356,3,359
"گلستان","مینو_دشت","مرکزی",45,594,6,0,31,631,8,639
"گلستان","مینو_دشت","مرکزی",46,447,4,0,26,477,13,490
"گلستان","مینو_دشت","مرکزی",47,388,4,0,24,416,2,418
"گلستان","مینو_دشت","مرکزی",48,284,0,1,15,300,4,304
"گلستان","مینو_دشت","مرکزی",49,416,0,0,54,470,3,473
"گلستان","مینو_دشت","مرکزی",50,349,3,0,10,362,2,364
"گلستان","مینو_دشت","مرکزی",51,410,0,0,11,421,9,430
"گلستان","مینو_دشت","مرکزی",52,631,4,1,22,658,3,661
"گلستان","مینو_دشت","مرکزی",53,1141,7,2,44,1194,15,1209
"گلستان","مینو_دشت","مرکزی",54,999,1,3,29,1032,13,1045
"گلستان","مینو_دشت","مرکزی",55,868,1,1,39,909,1,910
"گلستان","مینو_دشت","مرکزی",56,711,0,1,39,751,2,753
"گلستان","مینو_دشت","مرکزی",57,569,1,0,15,585,8,593
"گلستان","مینو_دشت","مرکزی",58,425,8,3,56,492,3,495
"گلستان","مینو_دشت","مرکزی",59,670,2,0,17,689,0,689
"گلستان","مینو_دشت","مرکزی",60,610,4,1,15,630,8,638
"گلستان","مینو_دشت","گالیکش",1,1043,11,6,328,1388,24,1412
"گلستان","مینو_دشت","گالیکش",2,960,9,6,262,1237,12,1249
"گلستان","مینو_دشت","گالیکش",3,416,3,5,145,569,7,576
"گلستان","مینو_دشت","گالیکش",4,1018,5,3,170,1196,14,1210
"گلستان","مینو_دشت","گالیکش",5,862,12,0,265,1139,14,1153
"گلستان","مینو_دشت","گالیکش",6,447,10,1,112,570,4,574
"گلستان","مینو_دشت","گالیکش",7,728,10,4,308,1050,20,1070
"گلستان","مینو_دشت","گالیکش",8,715,8,0,201,924,15,939
"گلستان","مینو_دشت","گالیکش",9,791,4,0,91,886,13,899
"گلستان","مینو_دشت","گالیکش",10,580,4,19,248,851,11,862
"گلستان","مینو_دشت","گالیکش",11,484,11,2,164,661,4,665
"گلستان","مینو_دشت","گالیکش",12,238,5,1,82,326,4,330
"گلستان","مینو_دشت","گالیکش",13,577,9,4,212,802,11,813
"گلستان","مینو_دشت","گالیکش",14,122,2,3,97,224,0,224
"گلستان","مینو_دشت","گالیکش",15,145,0,0,159,304,1,305
"گلستان","مینو_دشت","گالیکش",16,381,5,1,314,701,10,711
"گلستان","مینو_دشت","گالیکش",17,337,0,0,72,409,2,411
"گلستان","مینو_دشت","گالیکش",18,102,1,0,224,327,7,334
"گلستان","مینو_دشت","گالیکش",19,821,2,18,91,932,22,954
"گلستان","مینو_دشت","گالیکش",20,849,2,2,175,1028,15,1043
"گلستان","مینو_دشت","گالیکش",21,573,1,0,221,795,5,800
"گلستان","مینو_دشت","گالیکش",22,535,1,6,87,629,5,634
"گلستان","مینو_دشت","گالیکش",23,380,0,0,123,503,7,510
"گلستان","مینو_دشت","گالیکش",24,201,0,1,138,340,2,342
"گلستان","مینو_دشت","گالیکش",25,204,0,2,79,285,10,295
"گلستان","مینو_دشت","گالیکش",26,230,0,1,433,664,8,672
"گلستان","مینو_دشت","گالیکش",27,191,0,0,28,219,3,222
"گلستان","مینو_دشت","گالیکش",28,963,1,8,46,1018,7,1025
"گلستان","مینو_دشت","گالیکش",29,481,6,5,122,614,10,624
"گلستان","مینو_دشت","گالیکش",30,323,1,0,36,360,5,365
"گلستان","مینو_دشت","گالیکش",31,161,2,0,25,188,2,190
"گلستان","مینو_دشت","گالیکش",32,347,0,0,71,418,4,422
"گلستان","مینو_دشت","گالیکش",33,160,0,6,398,564,11,575
"گلستان","مینو_دشت","گالیکش",34,274,0,0,19,293,1,294
"گلستان","مینو_دشت","گالیکش",35,212,0,1,22,235,2,237
"گلستان","مینو_دشت","گالیکش",36,243,3,0,16,262,2,264
"گلستان","مینو_دشت","گالیکش",37,214,3,8,205,430,3,433
"گلستان","مینو_دشت","گالیکش",38,433,0,0,41,474,2,476
"گلستان","مینو_دشت","گالیکش",39,494,5,2,30,531,4,535
"گلستان","مینو_دشت","گالیکش",40,472,1,0,57,530,7,537
"گلستان","مینو_دشت","گالیکش",41,370,5,2,453,830,20,850
"گلستان","مینو_دشت","گالیکش",42,646,6,1,369,1022,3,1025
"گلستان","مینو_دشت","گالیکش",43,166,1,3,262,432,4,436
"گلستان","مینو_دشت","گالیکش",44,287,4,5,464,760,11,771
"گلستان","مینو_دشت","گالیکش",45,179,1,39,119,338,5,343
"گلستان","مینو_دشت","گالیکش",46,464,2,2,69,537,10,547
"گلستان","مینو_دشت","گالیکش",47,205,2,1,245,453,8,461
"گلستان","مینو_دشت","گالیکش",48,520,2,0,255,777,14,791
"گلستان","مینو_دشت","گالیکش",49,165,2,0,18,185,1,186
"گلستان","مینو_دشت","گالیکش",50,581,7,1,35,624,7,631
"گلستان","مینو_دشت","گالیکش",51,580,1,1,18,600,11,611
"گلستان","مینو_دشت","گالیکش",52,88,0,8,622,718,12,730
"گلستان","مینو_دشت","گالیکش",53,180,1,2,149,332,8,340
"گلستان","مینو_دشت","گالیکش",54,521,3,2,154,680,6,686
"گلستان","مینو_دشت","گالیکش",55,500,0,18,282,800,8,808
"گلستان","مینو_دشت","گالیکش",56,331,1,0,257,589,3,592
"گیلان","آستارا","مرکزی",1,379,1,4,344,728,7,735
"گیلان","آستارا","مرکزی",2,479,7,4,612,1102,7,1109
"گیلان","آستارا","مرکزی",3,560,14,8,705,1287,22,1309
"گیلان","آستارا","مرکزی",4,104,2,5,224,335,4,339
"گیلان","آستارا","مرکزی",5,87,4,2,237,330,1,331
"گیلان","آستارا","مرکزی",6,150,6,7,229,392,8,400
"گیلان","آستارا","مرکزی",7,485,13,18,744,1260,18,1278
"گیلان","آستارا","مرکزی",8,336,6,6,281,629,1,630
"گیلان","آستارا","مرکزی",9,539,8,13,544,1104,10,1114
"گیلان","آستارا","مرکزی",10,239,4,2,162,407,6,413
"گیلان","آستارا","مرکزی",11,487,12,3,367,869,12,881
"گیلان","آستارا","مرکزی",12,256,3,4,564,827,5,832
"گیلان","آستارا","مرکزی",13,268,2,5,480,755,9,764
"گیلان","آستارا","مرکزی",14,221,3,4,238,466,6,472
"گیلان","آستارا","مرکزی",15,664,13,4,684,1365,11,1376
"گیلان","آستارا","مرکزی",16,502,8,7,455,972,14,986
"گیلان","آستارا","مرکزی",17,563,3,3,477,1046,21,1067
"گیلان","آستارا","مرکزی",18,478,11,5,499,993,11,1004
"گیلان","آستارا","مرکزی",19,591,15,4,479,1089,11,1100
"گیلان","آستارا","مرکزی",20,210,2,1,125,338,3,341
"گیلان","آستارا","مرکزی",21,492,15,3,440,950,9,959
"گیلان","آستارا","مرکزی",22,500,6,5,360,871,9,880
"گیلان","آستارا","مرکزی",23,127,5,0,197,329,5,334
"گیلان","آستارا","مرکزی",24,455,8,4,587,1054,9,1063
"گیلان","آستارا","مرکزی",25,634,9,7,455,1105,5,1110
"گیلان","آستارا","مرکزی",26,931,11,3,645,1590,11,1601
"گیلان","آستارا","مرکزی",27,208,7,3,400,618,2,620
"گیلان","آستارا","مرکزی",28,108,1,0,91,200,3,203
"گیلان","آستارا","مرکزی",29,129,1,3,237,370,6,376
"گیلان","آستارا","مرکزی",30,260,4,1,99,364,3,367
"گیلان","آستارا","مرکزی",31,114,2,0,51,167,1,168
"گیلان","آستارا","مرکزی",32,137,1,1,287,426,1,427
"گیلان","آستارا","مرکزی",33,243,2,0,92,337,5,342
"گیلان","آستارا","مرکزی",34,274,1,3,139,417,2,419
"گیلان","آستارا","مرکزی",35,299,1,0,64,364,5,369
"گیلان","آستارا","مرکزی",36,180,0,1,68,249,1,250
"گیلان","آستارا","مرکزی",37,218,1,3,100,322,1,323
"گیلان","آستارا","مرکزی",38,693,0,3,143,839,10,849
"گیلان","آستارا","مرکزی",39,357,4,0,110,471,5,476
"گیلان","آستارا","مرکزی",40,236,1,0,47,284,3,287
"گیلان","آستارا","مرکزی",41,346,3,0,161,510,3,513
"گیلان","آستارا","مرکزی",42,358,12,0,189,559,2,561
"گیلان","آستارا","مرکزی",43,392,1,1,145,539,8,547
"گیلان","آستارا","مرکزی",44,330,6,4,153,493,8,501
"گیلان","آستارا","مرکزی",45,629,7,8,176,820,7,827
"گیلان","آستارا","مرکزی",46,313,1,5,88,407,1,408
"گیلان","آستارا","مرکزی",47,484,3,4,244,735,7,742
"گیلان","آستارا","مرکزی",48,331,1,0,28,360,2,362
"گیلان","آستارا","مرکزی",49,754,13,2,314,1083,9,1092
"گیلان","آستارا","مرکزی",50,170,0,2,71,243,2,245
"گیلان","آستارا","مرکزی",51,207,11,6,362,586,6,592
"گیلان","آستارا","مرکزی",52,236,3,0,45,284,3,287
"گیلان","آستارا","مرکزی",53,296,3,0,42,341,1,342
"گیلان","آستارا","مرکزی",54,256,1,0,71,328,3,331
"گیلان","آستارا","مرکزی",55,161,3,3,110,277,2,279
"گیلان","آستارا","لوندویل",1,753,3,13,497,1266,9,1275
"گیلان","آستارا","لوندویل",2,605,3,1,364,973,8,981
"گیلان","آستارا","لوندویل",3,305,7,2,247,561,4,565
"گیلان","آستارا","لوندویل",4,299,4,1,210,514,3,517
"گیلان","آستارا","لوندویل",5,666,3,4,233,906,4,910
"گیلان","آستارا","لوندویل",6,346,3,6,190,545,3,548
"گیلان","آستارا","لوندویل",7,159,2,4,162,327,3,330
"گیلان","آستارا","لوندویل",8,531,3,1,261,796,8,804
"گیلان","آستارا","لوندویل",9,213,0,1,111,325,0,325
"گیلان","آستارا","لوندویل",10,501,3,0,127,631,5,636
"گیلان","آستارا","لوندویل",11,420,0,0,46,466,1,467
"گیلان","آستارا","لوندویل",12,195,3,10,265,473,1,474
"گیلان","آستارا","لوندویل",13,493,1,0,286,780,1,781
"گیلان","آستارا","لوندویل",14,227,0,0,62,289,0,289
"گیلان","آستارا","لوندویل",15,373,0,0,27,400,2,402
"گیلان","آستارا","لوندویل",16,414,2,1,177,594,6,600
"گیلان","آستارا","لوندویل",17,243,2,3,140,388,2,390
"گیلان","آستارا","لوندویل",18,293,0,0,42,335,3,338
"گیلان","آستارا","لوندویل",19,269,0,0,46,315,1,316
"گیلان","آستارا","لوندویل",20,104,0,0,9,113,1,114
"گیلان","آستارا","لوندویل",21,291,7,1,271,570,4,574
"گیلان","آستانه_اشرفیه","مرکزی",1,1025,26,3,474,1528,14,1542
"گیلان","آستانه_اشرفیه","مرکزی",2,812,18,8,312,1150,17,1167
"گیلان","آستانه_اشرفیه","مرکزی",3,169,1,3,164,337,7,344
"گیلان","آستانه_اشرفیه","مرکزی",4,389,11,2,279,681,10,691
"گیلان","آستانه_اشرفیه","مرکزی",5,679,15,7,495,1196,16,1212
"گیلان","آستانه_اشرفیه","مرکزی",6,439,4,2,208,653,8,661
"گیلان","آستانه_اشرفیه","مرکزی",7,668,21,5,408,1102,19,1121
"گیلان","آستانه_اشرفیه","مرکزی",8,627,13,3,333,976,13,989
"گیلان","آستانه_اشرفیه","مرکزی",9,322,13,9,363,707,7,714
"گیلان","آستانه_اشرفیه","مرکزی",10,626,12,2,514,1154,13,1167
"گیلان","آستانه_اشرفیه","مرکزی",11,995,15,7,280,1297,3,1300
"گیلان","آستانه_اشرفیه","مرکزی",12,518,14,4,473,1009,16,1025
"گیلان","آستانه_اشرفیه","مرکزی",13,626,17,0,414,1057,11,1068
"گیلان","آستانه_اشرفیه","مرکزی",14,395,6,1,127,529,8,537
"گیلان","آستانه_اشرفیه","مرکزی",15,341,7,2,143,493,5,498
"گیلان","آستانه_اشرفیه","مرکزی",16,636,10,3,236,885,15,900
"گیلان","آستانه_اشرفیه","مرکزی",17,591,8,8,333,940,21,961
"گیلان","آستانه_اشرفیه","مرکزی",18,249,8,1,412,670,4,674
"گیلان","آستانه_اشرفیه","مرکزی",19,544,15,2,377,938,13,951
"گیلان","آستانه_اشرفیه","مرکزی",20,639,9,6,473,1127,23,1150
"گیلان","آستانه_اشرفیه","مرکزی",21,363,16,7,424,810,9,819
"گیلان","آستانه_اشرفیه","مرکزی",22,257,7,4,209,477,14,491
"گیلان","آستانه_اشرفیه","مرکزی",23,563,4,3,237,807,15,822
"گیلان","آستانه_اشرفیه","مرکزی",24,264,2,3,105,374,6,380
"گیلان","آستانه_اشرفیه","مرکزی",25,129,4,0,106,239,1,240
"گیلان","آستانه_اشرفیه","مرکزی",26,801,8,3,238,1050,15,1065
"گیلان","آستانه_اشرفیه","مرکزی",27,340,1,3,69,413,2,415
"گیلان","آستانه_اشرفیه","مرکزی",28,428,0,1,46,475,5,480
"گیلان","آستانه_اشرفیه","مرکزی",29,281,2,0,127,410,5,415
"گیلان","آستانه_اشرفیه","مرکزی",30,253,3,0,81,337,2,339
"گیلان","آستانه_اشرفیه","مرکزی",31,214,3,0,73,290,2,292
"گیلان","آستانه_اشرفیه","مرکزی",32,127,2,0,65,194,5,199
"گیلان","آستانه_اشرفیه","مرکزی",33,224,0,0,81,305,5,310
"گیلان","آستانه_اشرفیه","مرکزی",34,459,6,0,166,631,3,634
"گیلان","آستانه_اشرفیه","مرکزی",35,238,2,0,16,256,1,257
"گیلان","آستانه_اشرفیه","مرکزی",36,64,0,0,23,87,1,88
"گیلان","آستانه_اشرفیه","مرکزی",37,197,1,0,79,277,0,277
"گیلان","آستانه_اشرفیه","مرکزی",38,186,1,0,31,218,4,222
"گیلان","آستانه_اشرفیه","مرکزی",39,479,4,1,114,598,9,607
"گیلان","آستانه_اشرفیه","مرکزی",40,196,0,0,20,216,0,216
"گیلان","آستانه_اشرفیه","مرکزی",41,378,4,0,123,505,1,506
"گیلان","آستانه_اشرفیه","مرکزی",42,446,1,1,49,497,3,500
"گیلان","آستانه_اشرفیه","مرکزی",43,139,0,1,43,183,3,186
"گیلان","آستانه_اشرفیه","مرکزی",44,175,1,2,88,266,3,269
"گیلان","آستانه_اشرفیه","مرکزی",45,469,1,2,83,555,1,556
"گیلان","آستانه_اشرفیه","مرکزی",46,267,2,2,89,360,2,362
"گیلان","آستانه_اشرفیه","مرکزی",47,276,4,0,59,339,1,340
"گیلان","آستانه_اشرفیه","مرکزی",48,309,0,0,161,470,8,478
"گیلان","آستانه_اشرفیه","مرکزی",49,80,0,0,14,94,1,95
"گیلان","آستانه_اشرفیه","مرکزی",50,517,4,0,141,662,7,669
"گیلان","آستانه_اشرفیه","مرکزی",51,110,0,0,18,128,7,135
"گیلان","آستانه_اشرفیه","مرکزی",52,409,3,0,56,468,1,469
"گیلان","آستانه_اشرفیه","مرکزی",53,339,1,0,78,418,6,424
"گیلان","آستانه_اشرفیه","مرکزی",54,107,0,0,17,124,0,124
"گیلان","آستانه_اشرفیه","مرکزی",55,431,2,3,74,510,6,516
"گیلان","آستانه_اشرفیه","مرکزی",56,133,1,1,60,195,4,199
"گیلان","آستانه_اشرفیه","مرکزی",57,351,1,8,150,510,0,510
"گیلان","آستانه_اشرفیه","مرکزی",58,124,0,0,11,135,0,135
"گیلان","آستانه_اشرفیه","مرکزی",59,374,7,3,85,469,7,476
"گیلان","آستانه_اشرفیه","مرکزی",60,66,2,0,21,89,1,90
"گیلان","آستانه_اشرفیه","مرکزی",61,503,5,13,116,637,6,643
"گیلان","آستانه_اشرفیه","مرکزی",62,257,2,0,54,313,1,314
"گیلان","آستانه_اشرفیه","مرکزی",63,176,2,1,51,230,2,232
"گیلان","آستانه_اشرفیه","مرکزی",64,241,2,3,54,300,3,303
"گیلان","آستانه_اشرفیه","مرکزی",65,224,2,0,39,265,3,268
"گیلان","آستانه_اشرفیه","مرکزی",66,124,1,1,25,151,0,151
"گیلان","آستانه_اشرفیه","مرکزی",67,113,1,0,10,124,3,127
"گیلان","آستانه_اشرفیه","مرکزی",68,74,1,1,34,110,5,115
"گیلان","آستانه_اشرفیه","مرکزی",69,315,3,0,38,356,3,359
"گیلان","آستانه_اشرفیه","مرکزی",70,121,1,2,30,154,3,157
"گیلان","آستانه_اشرفیه","مرکزی",71,181,3,0,51,235,3,238
"گیلان","آستانه_اشرفیه","مرکزی",72,403,3,1,129,536,9,545
"گیلان","آستانه_اشرفیه","مرکزی",73,480,5,5,53,543,3,546
"گیلان","آستانه_اشرفیه","مرکزی",74,573,3,3,152,731,6,737
"گیلان","آستانه_اشرفیه","مرکزی",75,839,4,2,194,1039,7,1046
"گیلان","آستانه_اشرفیه","مرکزی",76,442,5,1,81,529,3,532
"گیلان","آستانه_اشرفیه","مرکزی",77,126,0,2,15,143,0,143
"گیلان","آستانه_اشرفیه","مرکزی",78,113,0,0,8,121,1,122
"گیلان","آستانه_اشرفیه","مرکزی",79,429,2,22,81,534,1,535
"گیلان","آستانه_اشرفیه","مرکزی",80,227,2,2,27,258,4,262
"گیلان","آستانه_اشرفیه","مرکزی",81,274,1,0,57,332,3,335
"گیلان","آستانه_اشرفیه","مرکزی",82,167,1,0,23,191,1,192
"گیلان","آستانه_اشرفیه","مرکزی",83,329,0,0,44,373,5,378
"گیلان","آستانه_اشرفیه","مرکزی",84,136,0,0,26,162,2,164
"گیلان","آستانه_اشرفیه","مرکزی",85,120,2,0,39,161,0,161
"گیلان","آستانه_اشرفیه","مرکزی",86,199,1,2,78,280,2,282
"گیلان","آستانه_اشرفیه","مرکزی",87,577,4,0,174,755,3,758
"گیلان","آستانه_اشرفیه","مرکزی",88,181,2,1,90,274,2,276
"گیلان","آستانه_اشرفیه","مرکزی",89,131,1,0,51,183,1,184
"گیلان","آستانه_اشرفیه","مرکزی",90,243,1,0,49,293,0,293
"گیلان","آستانه_اشرفیه","مرکزی",91,731,4,4,147,886,2,888
"گیلان","آستانه_اشرفیه","مرکزی",92,453,1,0,37,491,2,493
"گیلان","آستانه_اشرفیه","مرکزی",93,340,1,0,63,404,2,406
"گیلان","آستانه_اشرفیه","مرکزی",94,306,3,1,56,366,1,367
"گیلان","آستانه_اشرفیه","مرکزی",95,113,0,0,17,130,2,132
"گیلان","آستانه_اشرفیه","مرکزی",96,215,0,0,41,256,0,256
"گیلان","آستانه_اشرفیه","مرکزی",97,420,2,0,30,452,0,452
"گیلان","آستانه_اشرفیه","مرکزی",98,201,0,0,12,213,0,213
"گیلان","آستانه_اشرفیه","کیاشهر",1,621,4,5,435,1065,7,1072
"گیلان","آستانه_اشرفیه","کیاشهر",2,342,9,0,289,640,2,642
"گیلان","آستانه_اشرفیه","کیاشهر",3,343,4,7,450,804,8,812
"گیلان","آستانه_اشرفیه","کیاشهر",4,425,11,9,639,1084,13,1097
"گیلان","آستانه_اشرفیه","کیاشهر",5,474,5,5,330,814,5,819
"گیلان","آستانه_اشرفیه","کیاشهر",6,299,9,5,333,646,3,649
"گیلان","آستانه_اشرفیه","کیاشهر",7,763,20,2,407,1192,9,1201
"گیلان","آستانه_اشرفیه","کیاشهر",8,277,5,0,220,502,2,504
"گیلان","آستانه_اشرفیه","کیاشهر",9,335,7,4,335,681,9,690
"گیلان","آستانه_اشرفیه","کیاشهر",10,401,6,3,269,679,7,686
"گیلان","آستانه_اشرفیه","کیاشهر",11,117,2,1,91,211,4,215
"گیلان","آستانه_اشرفیه","کیاشهر",12,245,0,75,36,356,1,357
"گیلان","آستانه_اشرفیه","کیاشهر",13,213,2,0,94,309,2,311
"گیلان","آستانه_اشرفیه","کیاشهر",14,123,0,3,46,172,0,172
"گیلان","آستانه_اشرفیه","کیاشهر",15,361,6,1,75,443,4,447
"گیلان","آستانه_اشرفیه","کیاشهر",16,200,3,0,44,247,7,254
"گیلان","آستانه_اشرفیه","کیاشهر",17,185,1,0,49,235,2,237
"گیلان","آستانه_اشرفیه","کیاشهر",18,280,2,0,110,392,3,395
"گیلان","آستانه_اشرفیه","کیاشهر",19,201,3,1,37,242,3,245
"گیلان","آستانه_اشرفیه","کیاشهر",20,274,2,0,63,339,3,342
"گیلان","آستانه_اشرفیه","کیاشهر",21,183,2,0,32,217,2,219
"گیلان","آستانه_اشرفیه","کیاشهر",22,141,0,0,16,157,0,157
"گیلان","آستانه_اشرفیه","کیاشهر",23,145,0,1,100,246,0,246
"گیلان","آستانه_اشرفیه","کیاشهر",24,209,2,1,115,327,5,332
"گیلان","آستانه_اشرفیه","کیاشهر",25,486,1,3,194,684,3,687
"گیلان","آستانه_اشرفیه","کیاشهر",26,271,3,2,287,563,1,564
"گیلان","آستانه_اشرفیه","کیاشهر",27,356,2,0,150,508,3,511
"گیلان","آستانه_اشرفیه","کیاشهر",28,389,5,1,244,639,10,649
"گیلان","آستانه_اشرفیه","کیاشهر",29,306,3,0,324,633,2,635
"گیلان","آستانه_اشرفیه","کیاشهر",30,244,3,2,169,418,0,418
"گیلان","آستانه_اشرفیه","کیاشهر",31,445,5,0,149,599,6,605
"گیلان","آستانه_اشرفیه","کیاشهر",32,349,3,2,212,566,1,567
"گیلان","آستانه_اشرفیه","کیاشهر",33,493,4,2,229,728,0,728
"گیلان","آستانه_اشرفیه","کیاشهر",34,133,0,0,32,165,1,166
"گیلان","آستانه_اشرفیه","کیاشهر",35,230,1,0,66,297,3,300
"گیلان","آستانه_اشرفیه","کیاشهر",36,214,4,0,99,317,2,319
"گیلان","آستانه_اشرفیه","کیاشهر",37,254,3,1,50,308,6,314
"گیلان","آستانه_اشرفیه","کیاشهر",38,199,4,0,63,266,7,273
"گیلان","آستانه_اشرفیه","کیاشهر",39,278,0,1,81,360,3,363
"گیلان","آستانه_اشرفیه","کیاشهر",40,241,1,0,43,285,6,291
"گیلان","آستانه_اشرفیه","کیاشهر",41,600,8,3,203,814,8,822
"گیلان","آستانه_اشرفیه","کیاشهر",42,505,3,1,176,685,8,693
"گیلان","آستانه_اشرفیه","کیاشهر",43,348,5,3,120,476,1,477
"گیلان","آستانه_اشرفیه","کیاشهر",44,276,3,0,75,354,2,356
"گیلان","آستانه_اشرفیه","کیاشهر",45,468,1,0,69,538,3,541
"گیلان","آستانه_اشرفیه","کیاشهر",46,371,2,0,109,482,2,484
"گیلان","املش","مرکزی",1,871,11,7,245,1134,6,1140
"گیلان","املش","مرکزی",2,671,24,8,372,1075,14,1089
"گیلان","املش","مرکزی",3,670,10,4,285,969,9,978
"گیلان","املش","مرکزی",4,740,10,13,579,1342,12,1354
"گیلان","املش","مرکزی",5,451,5,4,210,670,5,675
"گیلان","املش","مرکزی",6,570,6,4,488,1068,12,1080
"گیلان","املش","مرکزی",7,355,14,5,226,600,4,604
"گیلان","املش","مرکزی",8,372,13,9,302,696,2,698
"گیلان","املش","مرکزی",9,514,5,5,157,681,7,688
"گیلان","املش","مرکزی",10,684,6,2,302,994,16,1010
"گیلان","املش","مرکزی",11,292,1,2,65,360,2,362
"گیلان","املش","مرکزی",12,204,3,1,81,289,6,295
"گیلان","املش","مرکزی",13,209,1,4,125,339,1,340
"گیلان","املش","مرکزی",14,297,0,3,30,330,1,331
"گیلان","املش","مرکزی",15,547,2,2,48,599,7,606
"گیلان","املش","مرکزی",16,195,1,2,52,250,1,251
"گیلان","املش","مرکزی",17,290,0,0,95,385,5,390
"گیلان","املش","مرکزی",18,303,1,1,26,331,0,331
"گیلان","املش","مرکزی",19,421,1,4,78,504,3,507
"گیلان","املش","مرکزی",20,539,2,1,134,676,3,679
"گیلان","املش","مرکزی",21,247,1,0,19,267,1,268
"گیلان","املش","مرکزی",22,315,0,4,44,363,4,367
"گیلان","املش","مرکزی",23,219,0,0,19,238,1,239
"گیلان","املش","مرکزی",24,299,0,2,68,369,1,370
"گیلان","املش","مرکزی",25,198,0,1,5,204,0,204
"گیلان","املش","مرکزی",26,176,1,1,22,200,0,200
"گیلان","املش","مرکزی",27,567,0,4,165,736,14,750
"گیلان","املش","مرکزی",28,438,5,7,140,590,8,598
"گیلان","املش","مرکزی",29,586,1,3,215,805,4,809
"گیلان","املش","مرکزی",30,444,9,0,187,640,6,646
"گیلان","املش","مرکزی",31,306,3,0,94,403,7,410
"گیلان","املش","مرکزی",32,256,2,1,63,322,0,322
"گیلان","املش","مرکزی",33,190,0,0,38,228,2,230
"گیلان","املش","مرکزی",34,297,2,1,130,430,4,434
"گیلان","املش","مرکزی",35,278,3,0,29,310,1,311
"گیلان","املش","مرکزی",36,339,2,2,49,392,5,397
"گیلان","املش","مرکزی",37,319,1,5,32,357,1,358
"گیلان","املش","رانکوه",1,572,5,0,110,687,6,693
"گیلان","املش","رانکوه",2,390,5,0,104,499,5,504
"گیلان","املش","رانکوه",3,307,1,0,50,358,6,364
"گیلان","املش","رانکوه",4,300,0,0,23,323,1,324
"گیلان","املش","رانکوه",5,801,2,2,260,1065,7,1072
"گیلان","املش","رانکوه",6,380,0,0,27,407,3,410
"گیلان","املش","رانکوه",7,716,7,2,84,809,2,811
"گیلان","املش","رانکوه",8,339,2,0,104,445,2,447
"گیلان","املش","رانکوه",9,334,2,0,19,355,2,357
"گیلان","املش","رانکوه",10,234,0,2,37,273,1,274
"گیلان","املش","رانکوه",11,266,6,0,91,363,2,365
"گیلان","املش","رانکوه",12,509,1,1,111,622,5,627
"گیلان","املش","رانکوه",13,346,0,0,22,368,1,369
"گیلان","املش","رانکوه",14,514,0,2,155,671,10,681
"گیلان","املش","رانکوه",15,556,0,0,33,589,0,589
"گیلان","املش","رانکوه",16,219,1,0,6,226,2,228
"گیلان","املش","رانکوه",17,355,4,1,78,438,1,439
"گیلان","املش","رانکوه",18,222,1,1,33,257,1,258
"گیلان","املش","رانکوه",19,270,2,0,50,322,1,323
"گیلان","املش","رانکوه",20,174,3,0,21,198,0,198
"گیلان","املش","رانکوه",21,209,0,4,28,241,0,241
"گیلان","املش","رانکوه",22,224,2,1,16,243,0,243
"گیلان","املش","رانکوه",23,251,1,1,37,290,0,290
"گیلان","املش","رانکوه",24,604,1,0,10,615,0,615
"گیلان","املش","رانکوه",25,490,1,0,51,542,5,547
"گیلان","املش","رانکوه",26,329,0,0,18,347,1,348
"گیلان","بندانزلی","مرکزی",1,536,3,0,189,728,5,733
"گیلان","بندانزلی","مرکزی",2,909,9,10,252,1180,20,1200
"گیلان","بندانزلی","مرکزی",3,443,6,0,219,668,8,676
"گیلان","بندانزلی","مرکزی",4,829,15,3,260,1107,20,1127
"گیلان","بندانزلی","مرکزی",5,696,8,1,245,950,16,966
"گیلان","بندانزلی","مرکزی",6,861,18,13,324,1216,18,1234
"گیلان","بندانزلی","مرکزی",7,487,4,2,289,782,21,803
"گیلان","بندانزلی","مرکزی",8,844,16,2,223,1085,12,1097
"گیلان","بندانزلی","مرکزی",9,365,7,2,122,496,4,500
"گیلان","بندانزلی","مرکزی",10,592,5,4,162,763,13,776
"گیلان","بندانزلی","مرکزی",11,551,10,7,263,831,15,846
"گیلان","بندانزلی","مرکزی",12,1007,10,3,325,1345,23,1368
"گیلان","بندانزلی","مرکزی",13,964,6,10,315,1295,23,1318
"گیلان","بندانزلی","مرکزی",14,844,9,3,269,1125,9,1134
"گیلان","بندانزلی","مرکزی",15,779,9,1,227,1016,13,1029
"گیلان","بندانزلی","مرکزی",16,500,9,8,374,891,10,901
"گیلان","بندانزلی","مرکزی",17,414,9,9,418,850,11,861
"گیلان","بندانزلی","مرکزی",18,458,5,7,227,697,7,704
"گیلان","بندانزلی","مرکزی",19,483,22,8,511,1024,8,1032
"گیلان","بندانزلی","مرکزی",20,556,14,11,488,1069,10,1079
"گیلان","بندانزلی","مرکزی",21,149,8,4,275,436,8,444
"گیلان","بندانزلی","مرکزی",22,500,11,8,519,1038,18,1056
"گیلان","بندانزلی","مرکزی",23,452,23,14,405,894,12,906
"گیلان","بندانزلی","مرکزی",24,474,16,7,803,1300,18,1318
"گیلان","بندانزلی","مرکزی",25,527,4,3,321,855,14,869
"گیلان","بندانزلی","مرکزی",26,793,22,8,780,1603,20,1623
"گیلان","بندانزلی","مرکزی",27,393,16,11,506,926,17,943
"گیلان","بندانزلی","مرکزی",28,484,6,11,412,913,16,929
"گیلان","بندانزلی","مرکزی",29,331,21,13,1234,1599,20,1619
"گیلان","بندانزلی","مرکزی",30,589,19,10,891,1509,26,1535
"گیلان","بندانزلی","مرکزی",31,459,19,10,599,1087,16,1103
"گیلان","بندانزلی","مرکزی",32,594,18,10,517,1139,10,1149
"گیلان","بندانزلی","مرکزی",33,274,12,7,300,593,10,603
"گیلان","بندانزلی","مرکزی",34,756,14,3,376,1149,19,1168
"گیلان","بندانزلی","مرکزی",35,944,12,7,308,1271,7,1278
"گیلان","بندانزلی","مرکزی",36,663,19,16,545,1243,15,1258
"گیلان","بندانزلی","مرکزی",37,614,22,6,454,1096,16,1112
"گیلان","بندانزلی","مرکزی",38,345,12,1,144,502,7,509
"گیلان","بندانزلی","مرکزی",39,352,2,2,184,540,6,546
"گیلان","بندانزلی","مرکزی",40,314,9,4,389,716,14,730
"گیلان","بندانزلی","مرکزی",41,199,9,5,302,515,8,523
"گیلان","بندانزلی","مرکزی",42,667,27,11,541,1246,38,1284
"گیلان","بندانزلی","مرکزی",43,777,19,14,507,1317,10,1327
"گیلان","بندانزلی","مرکزی",44,447,21,6,904,1378,8,1386
"گیلان","بندانزلی","مرکزی",45,684,22,8,647,1361,15,1376
"گیلان","بندانزلی","مرکزی",46,234,4,1,200,439,5,444
"گیلان","بندانزلی","مرکزی",47,451,5,2,328,786,5,791
"گیلان","بندانزلی","مرکزی",48,746,12,2,323,1083,17,1100
"گیلان","بندانزلی","مرکزی",49,283,5,3,330,621,8,629
"گیلان","بندانزلی","مرکزی",50,634,9,3,402,1048,22,1070
"گیلان","بندانزلی","مرکزی",51,755,14,5,372,1146,17,1163
"گیلان","بندانزلی","مرکزی",52,850,7,5,380,1242,18,1260
"گیلان","بندانزلی","مرکزی",53,732,4,4,222,962,18,980
"گیلان","بندانزلی","مرکزی",54,483,25,14,498,1020,8,1028
"گیلان","بندانزلی","مرکزی",55,908,22,15,764,1709,23,1732
"گیلان","بندانزلی","مرکزی",56,567,17,13,468,1065,10,1075
"گیلان","بندانزلی","مرکزی",57,284,4,11,341,640,5,645
"گیلان","بندانزلی","مرکزی",58,209,6,1,235,451,6,457
"گیلان","بندانزلی","مرکزی",59,920,13,9,548,1490,14,1504
"گیلان","بندانزلی","مرکزی",60,788,9,3,353,1153,8,1161
"گیلان","بندانزلی","مرکزی",61,432,23,24,997,1476,8,1484
"گیلان","بندانزلی","مرکزی",62,360,9,9,380,758,6,764
"گیلان","بندانزلی","مرکزی",63,266,4,0,156,426,9,435
"گیلان","بندانزلی","مرکزی",64,182,8,2,66,258,5,263
"گیلان","بندانزلی","مرکزی",65,619,6,2,249,876,10,886
"گیلان","بندانزلی","مرکزی",66,459,3,1,163,626,10,636
"گیلان","بندانزلی","مرکزی",67,222,1,0,89,312,2,314
"گیلان","بندانزلی","مرکزی",68,181,0,0,46,227,1,228
"گیلان","بندانزلی","مرکزی",69,226,0,1,59,286,4,290
"گیلان","بندانزلی","مرکزی",70,272,0,0,72,344,2,346
"گیلان","بندانزلی","مرکزی",71,475,4,0,47,526,4,530
"گیلان","بندانزلی","مرکزی",72,333,0,1,42,376,0,376
"گیلان","بندانزلی","مرکزی",73,219,3,0,65,287,1,288
"گیلان","بندانزلی","مرکزی",74,355,1,0,46,402,3,405
"گیلان","بندانزلی","مرکزی",75,133,1,1,40,175,0,175
"گیلان","بندانزلی","مرکزی",76,212,0,0,51,263,1,264
"گیلان","بندانزلی","مرکزی",77,485,5,0,146,636,7,643
"گیلان","بندانزلی","مرکزی",78,635,3,1,97,736,6,742
"گیلان","بندانزلی","مرکزی",79,489,4,0,104,597,3,600
"گیلان","بندانزلی","مرکزی",80,308,0,2,74,384,3,387
"گیلان","بندانزلی","مرکزی",81,352,5,6,79,442,7,449
"گیلان","بندانزلی","مرکزی",82,848,16,1,277,1142,14,1156
"گیلان","بندانزلی","مرکزی",83,512,2,2,154,670,3,673
"گیلان","بندانزلی","مرکزی",84,801,3,9,278,1091,9,1100
"گیلان","بندانزلی","مرکزی",85,826,11,10,455,1302,15,1317
"گیلان","بندانزلی","مرکزی",86,580,11,2,308,901,8,909
"گیلان","بندانزلی","مرکزی",87,723,6,7,148,884,9,893
"گیلان","بندانزلی","مرکزی",88,452,3,1,106,562,4,566
"گیلان","بندانزلی","مرکزی",89,503,2,2,207,714,5,719
"گیلان","بندانزلی","مرکزی",90,484,8,7,166,665,14,679
"گیلان","بندانزلی","مرکزی",91,164,3,3,120,290,10,300
"گیلان","رشت","مرکزی",1,1070,32,27,854,1983,11,1994
"گیلان","رشت","مرکزی",2,804,20,14,685,1523,22,1545
"گیلان","رشت","مرکزی",3,477,28,18,649,1172,23,1195
"گیلان","رشت","مرکزی",4,510,21,8,588,1127,29,1156
"گیلان","رشت","مرکزی",5,439,23,24,859,1345,11,1356
"گیلان","رشت","مرکزی",6,838,22,34,1485,2379,24,2403
"گیلان","رشت","مرکزی",7,541,13,6,249,809,8,817
"گیلان","رشت","مرکزی",8,255,14,5,326,600,8,608
"گیلان","رشت","مرکزی",9,494,10,9,296,809,8,817
"گیلان","رشت","مرکزی",10,525,27,18,843,1413,20,1433
"گیلان","رشت","مرکزی",11,343,22,34,1130,1529,17,1546
"گیلان","رشت","مرکزی",12,184,11,4,416,615,4,619
"گیلان","رشت","مرکزی",13,285,14,12,799,1110,0,1110
"گیلان","رشت","مرکزی",14,409,22,27,821,1279,15,1294
"گیلان","رشت","مرکزی",15,558,16,2,421,997,13,1010
"گیلان","رشت","مرکزی",16,203,11,17,373,604,3,607
"گیلان","رشت","مرکزی",17,406,13,13,636,1068,17,1085
"گیلان","رشت","مرکزی",18,436,16,14,757,1223,16,1239
"گیلان","رشت","مرکزی",19,307,14,21,1025,1367,16,1383
"گیلان","رشت","مرکزی",20,640,33,26,1109,1808,20,1828
"گیلان","رشت","مرکزی",21,488,25,21,1073,1607,19,1626
"گیلان","رشت","مرکزی",22,694,13,7,321,1035,16,1051
"گیلان","رشت","مرکزی",23,631,11,10,482,1134,23,1157
"گیلان","رشت","مرکزی",24,738,21,5,540,1304,10,1314
"گیلان","رشت","مرکزی",25,778,21,9,639,1447,8,1455
"گیلان","رشت","مرکزی",26,582,16,14,787,1399,16,1415
"گیلان","رشت","مرکزی",27,515,30,8,661,1214,18,1232
"گیلان","رشت","مرکزی",28,690,17,8,484,1199,0,1199
"گیلان","رشت","مرکزی",29,647,22,7,673,1349,6,1355
"گیلان","رشت","مرکزی",30,704,20,3,342,1069,13,1082
"گیلان","رشت","مرکزی",31,1242,20,4,519,1785,17,1802
"گیلان","رشت","مرکزی",32,837,21,7,724,1589,13,1602
"گیلان","رشت","مرکزی",33,985,14,14,528,1541,6,1547
"گیلان","رشت","مرکزی",34,1233,11,5,530,1779,19,1798
"گیلان","رشت","مرکزی",35,1478,14,5,450,1947,15,1962
"گیلان","رشت","مرکزی",36,621,10,2,350,983,15,998
"گیلان","رشت","مرکزی",37,282,8,3,213,506,9,515
"گیلان","رشت","مرکزی",38,431,9,5,306,751,8,759
"گیلان","رشت","مرکزی",39,648,12,0,175,835,1,836
"گیلان","رشت","مرکزی",40,417,24,38,1275,1754,28,1782
"گیلان","رشت","مرکزی",41,586,35,37,1429,2087,15,2102
"گیلان","رشت","مرکزی",42,461,19,16,888,1384,25,1409
"گیلان","رشت","مرکزی",43,248,19,11,706,984,15,999
"گیلان","رشت","مرکزی",44,1108,18,9,780,1915,21,1936
"گیلان","رشت","مرکزی",45,624,15,33,1222,1894,29,1923
"گیلان","رشت","مرکزی",46,687,24,14,941,1666,17,1683
"گیلان","رشت","مرکزی",47,980,28,14,660,1682,0,1682
"گیلان","رشت","مرکزی",48,1235,37,9,816,2097,3,2100
"گیلان","رشت","مرکزی",49,1373,12,3,428,1816,17,1833
"گیلان","رشت","مرکزی",50,1248,23,17,735,2023,14,2037
"گیلان","رشت","مرکزی",51,877,34,11,1071,1993,19,2012
"گیلان","رشت","مرکزی",52,969,6,3,223,1201,4,1205
"گیلان","رشت","مرکزی",53,620,15,3,280,918,15,933
"گیلان","رشت","مرکزی",54,174,18,11,523,726,5,731
"گیلان","رشت","مرکزی",55,748,12,13,542,1315,18,1333
"گیلان","رشت","مرکزی",56,782,32,27,1141,1982,21,2003
"گیلان","رشت","مرکزی",57,1418,4,6,311,1739,12,1751
"گیلان","رشت","مرکزی",58,421,17,11,782,1231,12,1243
"گیلان","رشت","مرکزی",59,145,9,12,438,604,14,618
"گیلان","رشت","مرکزی",60,254,20,12,658,944,4,948
"گیلان","رشت","مرکزی",61,420,16,15,1111,1562,17,1579
"گیلان","رشت","مرکزی",62,416,33,12,1116,1577,21,1598
"گیلان","رشت","مرکزی",63,642,26,21,1392,2081,28,2109
"گیلان","رشت","مرکزی",64,548,20,7,612,1187,14,1201
"گیلان","رشت","مرکزی",65,399,35,39,1262,1735,13,1748
"گیلان","رشت","مرکزی",66,390,31,36,1246,1703,14,1717
"گیلان","رشت","مرکزی",67,1018,22,13,505,1558,17,1575
"گیلان","رشت","مرکزی",68,695,10,1,422,1128,7,1135
"گیلان","رشت","مرکزی",69,1171,12,4,746,1933,27,1960
"گیلان","رشت","مرکزی",70,648,25,16,834,1523,16,1539
"گیلان","رشت","مرکزی",71,852,31,17,1117,2017,19,2036
"گیلان","رشت","مرکزی",72,1040,21,15,553,1629,20,1649
"گیلان","رشت","مرکزی",73,1200,18,0,472,1690,23,1713
"گیلان","رشت","مرکزی",74,1244,9,2,278,1533,7,1540
"گیلان","رشت","مرکزی",75,1450,21,3,585,2059,19,2078
"گیلان","رشت","مرکزی",76,1091,14,1,478,1584,13,1597
"گیلان","رشت","مرکزی",77,1475,4,5,301,1785,8,1793
"گیلان","رشت","مرکزی",78,1093,13,2,238,1346,15,1361
"گیلان","رشت","مرکزی",79,1547,6,1,189,1743,9,1752
"گیلان","رشت","مرکزی",80,985,28,21,1087,2121,30,2151
"گیلان","رشت","مرکزی",81,680,21,15,759,1475,12,1487
"گیلان","رشت","مرکزی",82,615,15,29,1147,1806,20,1826
"گیلان","رشت","مرکزی",83,496,14,9,640,1159,17,1176
"گیلان","رشت","مرکزی",84,356,17,25,896,1294,5,1299
"گیلان","رشت","مرکزی",85,704,25,6,1216,1951,22,1973
"گیلان","رشت","مرکزی",86,336,23,17,950,1326,21,1347
"گیلان","رشت","مرکزی",87,497,32,23,1360,1912,17,1929
"گیلان","رشت","مرکزی",88,384,23,24,793,1224,9,1233
"گیلان","رشت","مرکزی",89,696,27,11,813,1547,0,1547
"گیلان","رشت","مرکزی",90,1088,17,43,1162,2310,26,2336
"گیلان","رشت","مرکزی",91,496,20,13,839,1368,17,1385
"گیلان","رشت","مرکزی",92,752,14,8,489,1263,18,1281
"گیلان","رشت","مرکزی",93,923,21,9,691,1644,13,1657
"گیلان","رشت","مرکزی",94,1784,22,8,907,2721,21,2742
"گیلان","رشت","مرکزی",95,1357,21,9,835,2222,22,2244
"گیلان","رشت","مرکزی",96,1161,9,5,465,1640,20,1660
"گیلان","رشت","مرکزی",97,853,21,10,705,1589,18,1607
"گیلان","رشت","مرکزی",98,997,12,10,652,1671,24,1695
"گیلان","رشت","مرکزی",99,984,12,15,441,1452,22,1474
"گیلان","رشت","مرکزی",100,773,18,8,616,1415,14,1429
"گیلان","رشت","مرکزی",101,892,16,8,410,1326,17,1343
"گیلان","رشت","مرکزی",102,1423,8,2,305,1738,10,1748
"گیلان","رشت","مرکزی",103,1612,6,4,273,1895,10,1905
"گیلان","رشت","مرکزی",104,1146,12,3,517,1678,21,1699
"گیلان","رشت","مرکزی",105,1134,19,3,363,1519,22,1541
"گیلان","رشت","مرکزی",106,1075,7,9,254,1345,12,1357
"گیلان","رشت","مرکزی",107,491,12,3,263,769,8,777
"گیلان","رشت","مرکزی",108,864,8,12,233,1117,3,1120
"گیلان","رشت","مرکزی",109,1245,4,4,380,1633,19,1652
"گیلان","رشت","مرکزی",110,706,4,2,273,985,18,1003
"گیلان","رشت","مرکزی",111,542,12,8,474,1036,13,1049
"گیلان","رشت","مرکزی",112,653,42,14,1210,1919,20,1939
"گیلان","رشت","مرکزی",113,496,19,16,1001,1532,20,1552
"گیلان","رشت","مرکزی",114,805,32,12,1157,2006,15,2021
"گیلان","رشت","مرکزی",115,660,12,7,633,1312,21,1333
"گیلان","رشت","مرکزی",116,791,29,4,818,1642,15,1657
"گیلان","رشت","مرکزی",117,976,25,11,846,1858,24,1882
"گیلان","رشت","مرکزی",118,624,24,12,606,1266,17,1283
"گیلان","رشت","مرکزی",119,219,13,18,634,884,4,888
"گیلان","رشت","مرکزی",120,508,18,23,1005,1554,12,1566
"گیلان","رشت","مرکزی",121,724,12,5,470,1211,8,1219
"گیلان","رشت","مرکزی",122,1341,15,4,364,1724,8,1732
"گیلان","رشت","مرکزی",123,432,22,37,1289,1780,17,1797
"گیلان","رشت","مرکزی",124,161,9,34,1310,1514,14,1528
"گیلان","رشت","مرکزی",125,196,14,22,1334,1566,10,1576
"گیلان","رشت","مرکزی",126,411,40,43,1803,2297,22,2319
"گیلان","رشت","مرکزی",127,150,8,9,886,1053,0,1053
"گیلان","رشت","مرکزی",128,245,24,25,1119,1413,13,1426
"گیلان","رشت","مرکزی",129,208,13,38,1168,1427,5,1432
"گیلان","رشت","مرکزی",130,312,29,17,1000,1358,16,1374
"گیلان","رشت","مرکزی",131,332,29,77,2132,2570,18,2588
"گیلان","رشت","مرکزی",132,249,7,28,1082,1366,15,1381
"گیلان","رشت","مرکزی",133,403,36,21,1390,1850,14,1864
"گیلان","رشت","مرکزی",134,234,6,2,137,379,2,381
"گیلان","رشت","مرکزی",135,637,32,33,1397,2099,18,2117
"گیلان","رشت","مرکزی",136,419,24,32,1065,1540,13,1553
"گیلان","رشت","مرکزی",137,680,34,23,1265,2002,27,2029
"گیلان","رشت","مرکزی",138,641,6,4,811,1462,14,1476
"گیلان","رشت","مرکزی",139,1043,19,4,726,1792,14,1806
"گیلان","رشت","مرکزی",140,506,13,7,427,953,9,962
"گیلان","رشت","مرکزی",141,668,32,20,981,1701,20,1721
"گیلان","رشت","مرکزی",142,590,15,11,666,1282,10,1292
"گیلان","رشت","مرکزی",143,309,7,4,311,631,3,634
"گیلان","رشت","مرکزی",144,1030,11,9,535,1585,14,1599
"گیلان","رشت","مرکزی",145,1058,18,6,616,1698,20,1718
"گیلان","رشت","مرکزی",146,763,23,22,940,1748,20,1768
"گیلان","رشت","مرکزی",147,666,23,23,820,1532,9,1541
"گیلان","رشت","مرکزی",148,526,26,19,941,1512,13,1525
"گیلان","رشت","مرکزی",149,563,18,12,559,1152,7,1159
"گیلان","رشت","مرکزی",150,748,33,6,511,1298,22,1320
"گیلان","رشت","مرکزی",151,97,8,6,330,441,11,452
"گیلان","رشت","مرکزی",152,485,13,5,624,1127,7,1134
"گیلان","رشت","مرکزی",153,559,36,20,1173,1788,0,1788
"گیلان","رشت","مرکزی",154,410,21,20,1046,1497,20,1517
"گیلان","رشت","مرکزی",155,250,11,8,531,800,8,808
"گیلان","رشت","مرکزی",156,1111,19,22,712,1864,13,1877
"گیلان","رشت","مرکزی",157,740,18,7,355,1120,14,1134
"گیلان","رشت","مرکزی",158,745,16,14,817,1592,9,1601
"گیلان","رشت","مرکزی",159,403,11,10,547,971,18,989
"گیلان","رشت","مرکزی",160,615,24,5,405,1049,0,1049
"گیلان","رشت","مرکزی",161,1017,18,5,528,1568,16,1584
"گیلان","رشت","مرکزی",162,666,8,11,379,1064,19,1083
"گیلان","رشت","مرکزی",163,536,2,4,299,841,11,852
"گیلان","رشت","مرکزی",164,1509,24,12,630,2175,27,2202
"گیلان","رشت","مرکزی",165,901,17,22,677,1617,13,1630
"گیلان","رشت","مرکزی",166,1021,26,19,625,1691,26,1717
"گیلان","رشت","مرکزی",167,696,19,27,395,1137,13,1150
"گیلان","رشت","مرکزی",168,1239,15,7,542,1803,21,1824
"گیلان","رشت","مرکزی",169,1301,21,3,313,1638,18,1656
"گیلان","رشت","مرکزی",170,805,13,5,360,1183,12,1195
"گیلان","رشت","مرکزی",171,1433,32,14,623,2102,22,2124
"گیلان","رشت","مرکزی",172,1116,14,1,281,1412,11,1423
"گیلان","رشت","مرکزی",173,1052,13,6,394,1465,7,1472
"گیلان","رشت","مرکزی",174,623,5,9,330,967,6,973
"گیلان","رشت","مرکزی",175,966,11,3,353,1333,13,1346
"گیلان","رشت","مرکزی",176,854,9,13,296,1172,7,1179
"گیلان","رشت","مرکزی",177,596,18,14,750,1378,0,1378
"گیلان","رشت","مرکزی",178,691,11,29,529,1260,15,1275
"گیلان","رشت","مرکزی",179,992,24,16,535,1567,31,1598
"گیلان","رشت","مرکزی",180,604,20,9,708,1341,12,1353
"گیلان","رشت","مرکزی",181,542,22,9,707,1280,14,1294
"گیلان","رشت","مرکزی",182,411,18,14,649,1092,16,1108
"گیلان","رشت","مرکزی",183,567,26,20,581,1194,8,1202
"گیلان","رشت","مرکزی",184,893,12,3,453,1361,19,1380
"گیلان","رشت","مرکزی",185,347,15,13,446,821,10,831
"گیلان","رشت","مرکزی",186,917,21,5,501,1444,12,1456
"گیلان","رشت","مرکزی",187,707,22,11,663,1403,18,1421
"گیلان","رشت","مرکزی",188,565,39,20,710,1334,17,1351
"گیلان","رشت","مرکزی",189,584,22,11,519,1136,0,1136
"گیلان","رشت","مرکزی",190,350,12,11,259,632,10,642
"گیلان","رشت","مرکزی",191,1651,19,7,423,2100,17,2117
"گیلان","رشت","مرکزی",192,1008,9,4,402,1423,10,1433
"گیلان","رشت","مرکزی",193,679,25,13,476,1193,15,1208
"گیلان","رشت","مرکزی",194,825,32,3,482,1342,13,1355
"گیلان","رشت","مرکزی",195,660,17,12,636,1325,20,1345
"گیلان","رشت","مرکزی",196,1187,13,7,266,1473,7,1480
"گیلان","رشت","مرکزی",197,950,3,1,212,1166,10,1176
"گیلان","رشت","مرکزی",198,723,3,2,174,902,8,910
"گیلان","رشت","مرکزی",199,788,56,41,428,1313,0,1313
"گیلان","رشت","مرکزی",200,404,5,6,173,588,6,594
"گیلان","رشت","مرکزی",201,344,8,5,133,490,10,500
"گیلان","رشت","مرکزی",202,810,23,9,244,1086,23,1109
"گیلان","رشت","مرکزی",203,318,10,1,345,674,10,684
"گیلان","رشت","مرکزی",204,301,12,4,201,518,8,526
"گیلان","رشت","مرکزی",205,940,4,2,294,1240,7,1247
"گیلان","رشت","مرکزی",206,913,6,5,238,1162,14,1176
"گیلان","رشت","مرکزی",207,747,6,2,205,960,10,970
"گیلان","رشت","مرکزی",208,737,12,4,427,1180,5,1185
"گیلان","رشت","مرکزی",209,854,9,9,294,1166,5,1171
"گیلان","رشت","مرکزی",210,1300,19,4,414,1737,5,1742
"گیلان","رشت","مرکزی",211,606,0,0,111,717,7,724
"گیلان","رشت","مرکزی",212,694,3,0,144,841,2,843
"گیلان","رشت","مرکزی",213,95,0,0,25,120,1,121
"گیلان","رشت","مرکزی",214,439,8,6,138,591,1,592
"گیلان","رشت","مرکزی",215,250,1,0,52,303,1,304
"گیلان","رشت","مرکزی",216,554,1,0,89,644,2,646
"گیلان","رشت","مرکزی",217,280,2,0,38,320,0,320
"گیلان","رشت","مرکزی",218,297,1,0,36,334,3,337
"گیلان","رشت","مرکزی",219,283,2,0,110,395,0,395
"گیلان","رشت","مرکزی",220,910,5,5,729,1649,15,1664
"گیلان","رشت","مرکزی",221,1381,4,1,277,1663,11,1674
"گیلان","رشت","مرکزی",222,682,5,3,86,776,0,776
"گیلان","رشت","مرکزی",223,940,15,3,238,1196,3,1199
"گیلان","رشت","مرکزی",224,726,3,0,259,988,12,1000
"گیلان","رشت","مرکزی",225,885,3,3,184,1075,7,1082
"گیلان","رشت","مرکزی",226,350,5,1,47,403,2,405
"گیلان","رشت","مرکزی",227,336,1,2,48,387,1,388
"گیلان","رشت","مرکزی",228,334,1,0,35,370,2,372
"گیلان","رشت","مرکزی",229,183,0,0,6,189,1,190
"گیلان","رشت","مرکزی",230,523,4,6,77,610,1,611
"گیلان","رشت","مرکزی",231,990,6,2,138,1136,6,1142
"گیلان","رشت","مرکزی",232,518,1,0,93,612,2,614
"گیلان","رشت","مرکزی",233,274,2,1,56,333,3,336
"گیلان","رشت","مرکزی",234,343,0,0,53,396,7,403
"گیلان","رشت","مرکزی",235,393,1,4,51,449,2,451
"گیلان","رشت","مرکزی",236,478,6,6,171,661,8,669
"گیلان","رشت","مرکزی",237,305,1,4,81,391,4,395
"گیلان","رشت","مرکزی",238,408,3,2,153,566,4,570
"گیلان","رشت","مرکزی",239,312,2,1,91,406,2,408
"گیلان","رشت","مرکزی",240,467,2,2,236,707,4,711
"گیلان","رشت","مرکزی",241,628,5,1,124,758,7,765
"گیلان","رشت","مرکزی",242,292,0,0,59,351,2,353
"گیلان","رشت","مرکزی",243,370,1,0,64,435,5,440
"گیلان","رشت","مرکزی",244,1203,15,5,454,1677,16,1693
"گیلان","رشت","مرکزی",245,624,4,2,229,859,17,876
"گیلان","رشت","مرکزی",246,604,3,3,191,801,8,809
"گیلان","رشت","مرکزی",247,178,0,0,37,215,3,218
"گیلان","رشت","مرکزی",248,396,0,2,45,443,1,444
"گیلان","رشت","مرکزی",249,1010,8,2,318,1338,8,1346
"گیلان","رشت","مرکزی",250,222,2,1,45,270,0,270
"گیلان","رشت","مرکزی",251,305,0,0,51,356,0,356
"گیلان","رشت","مرکزی",252,236,0,2,92,330,0,330
"گیلان","رشت","مرکزی",253,265,0,17,0,282,1,283
"گیلان","رشت","مرکزی",254,1159,3,10,468,1640,10,1650
"گیلان","رشت","مرکزی",255,312,1,1,69,383,8,391
"گیلان","رشت","مرکزی",256,612,2,0,82,696,5,701
"گیلان","رشت","مرکزی",257,408,1,0,27,436,0,436
"گیلان","رشت","مرکزی",258,134,1,0,46,181,0,181
"گیلان","رشت","مرکزی",259,285,2,7,50,344,2,346
"گیلان","رشت","مرکزی",260,636,0,1,68,705,4,709
"گیلان","رشت","مرکزی",261,689,2,2,196,889,2,891
"گیلان","رشت","مرکزی",262,488,3,2,111,604,1,605
"گیلان","رشت","مرکزی",263,702,2,1,85,790,6,796
"گیلان","رشت","مرکزی",264,994,5,2,295,1296,12,1308
"گیلان","رشت","مرکزی",265,943,2,0,175,1120,9,1129
"گیلان","رشت","مرکزی",266,407,2,4,174,587,2,589
"گیلان","رشت","مرکزی",267,192,1,0,12,205,0,205
"گیلان","رشت","خمام",1,652,7,5,530,1194,6,1200
"گیلان","رشت","خمام",2,1073,18,3,546,1640,10,1650
"گیلان","رشت","خمام",3,781,8,3,414,1206,10,1216
"گیلان","رشت","خمام",4,908,21,10,677,1616,12,1628
"گیلان","رشت","خمام",5,274,6,1,256,537,7,544
"گیلان","رشت","خمام",6,514,16,3,352,885,10,895
"گیلان","رشت","خمام",7,631,2,4,147,784,12,796
"گیلان","رشت","خمام",8,288,4,1,37,330,9,339
"گیلان","رشت","خمام",9,554,2,1,144,701,6,707
"گیلان","رشت","خمام",10,558,0,5,116,679,6,685
"گیلان","رشت","خمام",11,726,0,0,142,868,8,876
"گیلان","رشت","خمام",12,815,3,1,92,911,1,912
"گیلان","رشت","خمام",13,432,2,0,50,484,0,484
"گیلان","رشت","خمام",14,641,1,3,34,679,4,683
"گیلان","رشت","خمام",15,505,0,1,125,631,5,636
"گیلان","رشت","خمام",16,747,6,2,110,865,4,869
"گیلان","رشت","خمام",17,255,1,1,74,331,2,333
"گیلان","رشت","خمام",18,471,6,1,84,562,11,573
"گیلان","رشت","خمام",19,240,0,0,20,260,0,260
"گیلان","رشت","خمام",20,403,1,1,96,501,7,508
"گیلان","رشت","خمام",21,656,4,1,152,813,4,817
"گیلان","رشت","خمام",22,497,1,1,65,564,5,569
"گیلان","رشت","خمام",23,189,0,0,16,205,1,206
"گیلان","رشت","خمام",24,637,1,1,51,690,0,690
"گیلان","رشت","خمام",25,429,3,3,146,581,16,597
"گیلان","رشت","خمام",26,208,0,1,46,255,1,256
"گیلان","رشت","خمام",27,752,0,7,134,893,7,900
"گیلان","رشت","خمام",28,408,4,0,175,587,4,591
"گیلان","رشت","خمام",29,190,1,1,30,222,6,228
"گیلان","رشت","خمام",30,381,1,1,68,451,0,451
"گیلان","رشت","خمام",31,525,5,0,97,627,1,628
"گیلان","رشت","خمام",32,559,0,1,60,620,2,622
"گیلان","رشت","خمام",33,955,4,1,282,1242,12,1254
"گیلان","رشت","خمام",34,666,5,0,196,867,10,877
"گیلان","رشت","خمام",35,773,3,2,202,980,12,992
"گیلان","رشت","خمام",36,351,2,2,80,435,2,437
"گیلان","رشت","خمام",37,942,1,2,219,1164,12,1176
"گیلان","رشت","خمام",38,812,6,5,184,1007,9,1016
"گیلان","رشت","خمام",39,583,2,0,138,723,19,742
"گیلان","رشت","خمام",40,765,2,2,91,860,8,868
"گیلان","رشت","خمام",41,497,1,1,77,576,4,580
"گیلان","رشت","خمام",42,889,5,4,139,1037,11,1048
"گیلان","رشت","خمام",43,612,0,1,10,623,1,624
"گیلان","رشت","خمام",44,239,0,3,45,287,0,287
"گیلان","رشت","خشکبیجار",1,648,5,4,410,1067,7,1074
"گیلان","رشت","خشکبیجار",2,333,7,6,195,541,6,547
"گیلان","رشت","خشکبیجار",3,552,10,6,324,892,5,897
"گیلان","رشت","خشکبیجار",4,323,7,9,308,647,6,653
"گیلان","رشت","خشکبیجار",5,393,4,16,255,668,10,678
"گیلان","رشت","خشکبیجار",6,207,1,5,60,273,5,278
"گیلان","رشت","خشکبیجار",7,273,0,6,87,366,0,366
"گیلان","رشت","خشکبیجار",8,396,2,0,48,446,2,448
"گیلان","رشت","خشکبیجار",9,441,1,2,85,529,0,529
"گیلان","رشت","خشکبیجار",10,540,2,0,147,689,5,694
"گیلان","رشت","خشکبیجار",11,390,3,2,246,641,2,643
"گیلان","رشت","خشکبیجار",12,436,4,4,379,823,5,828
"گیلان","رشت","خشکبیجار",13,218,2,7,103,330,4,334
"گیلان","رشت","خشکبیجار",14,558,1,2,111,672,6,678
"گیلان","رشت","خشکبیجار",15,335,2,4,80,421,4,425
"گیلان","رشت","خشکبیجار",16,185,0,1,36,222,2,224
"گیلان","رشت","خشکبیجار",17,503,0,0,22,525,2,527
"گیلان","رشت","خشکبیجار",18,522,4,0,113,639,3,642
"گیلان","رشت","خشکبیجار",19,467,3,5,102,577,2,579
"گیلان","رشت","خشکبیجار",20,314,1,0,52,367,2,369
"گیلان","رشت","خشکبیجار",21,364,1,0,28,393,0,393
"گیلان","رشت","خشکبیجار",22,445,1,0,28,474,5,479
"گیلان","رشت","خشکبیجار",23,465,0,0,79,544,6,550
"گیلان","رشت","خشکبیجار",24,360,4,10,238,612,6,618
"گیلان","رشت","خشکبیجار",25,210,3,0,30,243,3,246
"گیلان","رشت","خشکبیجار",26,452,6,0,79,537,15,552
"گیلان","رشت","خشکبیجار",27,272,5,0,207,484,10,494
"گیلان","رشت","خشکبیجار",28,440,1,24,138,603,4,607
"گیلان","رشت","خشکبیجار",29,276,0,0,59,335,0,335
"گیلان","رشت","خشکبیجار",30,380,3,0,152,535,4,539
"گیلان","رشت","خشکبیجار",31,446,3,0,98,547,5,552
"گیلان","رشت","خشکبیجار",32,164,7,1,91,263,3,266
"گیلان","رشت","خشکبیجار",33,388,1,0,39,428,1,429
"گیلان","رشت","خشکبیجار",34,207,0,0,40,247,1,248
"گیلان","رشت","خشکبیجار",35,152,1,1,145,299,0,299
"گیلان","رشت","خشکبیجار",36,197,0,0,41,238,6,244
"گیلان","رشت","خشکبیجار",37,260,1,0,25,286,1,287
"گیلان","رشت","خشکبیجار",38,71,0,0,16,87,0,87
"گیلان","رشت","لشت_نشاء",1,817,14,22,642,1495,16,1511
"گیلان","رشت","لشت_نشاء",2,606,15,5,378,1004,16,1020
"گیلان","رشت","لشت_نشاء",3,626,5,3,339,973,15,988
"گیلان","رشت","لشت_نشاء",4,451,1,14,348,814,13,827
"گیلان","رشت","لشت_نشاء",5,460,6,8,376,850,7,857
"گیلان","رشت","لشت_نشاء",6,296,6,11,203,516,1,517
"گیلان","رشت","لشت_نشاء",7,439,4,6,103,552,2,554
"گیلان","رشت","لشت_نشاء",8,203,4,0,84,291,5,296
"گیلان","رشت","لشت_نشاء",9,669,12,4,438,1123,4,1127
"گیلان","رشت","لشت_نشاء",10,447,2,0,192,641,4,645
"گیلان","رشت","لشت_نشاء",11,517,3,2,345,867,6,873
"گیلان","رشت","لشت_نشاء",12,182,1,0,28,211,0,211
"گیلان","رشت","لشت_نشاء",13,413,1,2,178,594,12,606
"گیلان","رشت","لشت_نشاء",14,194,0,0,94,288,6,294
"گیلان","رشت","لشت_نشاء",15,453,3,3,61,520,3,523
"گیلان","رشت","لشت_نشاء",16,274,1,2,36,313,0,313
"گیلان","رشت","لشت_نشاء",17,318,0,0,25,343,0,343
"گیلان","رشت","لشت_نشاء",18,171,1,0,37,209,3,212
"گیلان","رشت","لشت_نشاء",19,703,4,2,176,885,9,894
"گیلان","رشت","لشت_نشاء",20,438,2,2,120,562,8,570
"گیلان","رشت","لشت_نشاء",21,711,5,2,145,863,10,873
"گیلان","رشت","لشت_نشاء",22,410,2,0,59,471,3,474
"گیلان","رشت","لشت_نشاء",23,287,5,0,42,334,1,335
"گیلان","رشت","لشت_نشاء",24,396,5,0,98,499,2,501
"گیلان","رشت","لشت_نشاء",25,307,3,0,48,358,4,362
"گیلان","رشت","لشت_نشاء",26,200,0,0,40,240,4,244
"گیلان","رشت","لشت_نشاء",27,271,1,0,45,317,0,317
"گیلان","رشت","لشت_نشاء",28,246,2,0,75,323,0,323
"گیلان","رشت","لشت_نشاء",29,682,5,2,122,811,0,811
"گیلان","رشت","لشت_نشاء",30,356,1,0,28,385,1,386
"گیلان","رشت","لشت_نشاء",31,226,1,1,34,262,0,262
"گیلان","رشت","لشت_نشاء",32,256,0,0,66,322,2,324
"گیلان","رشت","لشت_نشاء",33,419,3,0,71,493,2,495
"گیلان","رشت","لشت_نشاء",34,356,7,0,114,477,4,481
"گیلان","رشت","لشت_نشاء",35,245,3,0,54,302,2,304
"گیلان","رشت","لشت_نشاء",36,196,3,3,30,232,2,234
"گیلان","رشت","لشت_نشاء",37,751,4,2,70,827,6,833
"گیلان","رشت","لشت_نشاء",38,211,4,12,30,257,2,259
"گیلان","رشت","لشت_نشاء",39,191,5,3,66,265,3,268
"گیلان","رشت","لشت_نشاء",40,620,4,4,195,823,15,838
"گیلان","رشت","لشت_نشاء",41,225,0,0,67,292,0,292
"گیلان","رشت","لشت_نشاء",42,315,4,0,104,423,6,429
"گیلان","رشت","لشت_نشاء",43,156,0,1,19,176,0,176
"گیلان","رشت","لشت_نشاء",44,215,0,0,37,252,2,254
"گیلان","رشت","لشت_نشاء",45,214,0,0,54,268,0,268
"گیلان","رشت","لشت_نشاء",46,484,18,8,301,811,8,819
"گیلان","رشت","لشت_نشاء",47,218,4,1,26,249,1,250
"گیلان","رشت","کوچصفهان",1,1049,10,7,436,1502,15,1517
"گیلان","رشت","کوچصفهان",2,778,5,11,415,1209,12,1221
"گیلان","رشت","کوچصفهان",3,503,7,1,324,835,7,842
"گیلان","رشت","کوچصفهان",4,400,9,2,279,690,0,690
"گیلان","رشت","کوچصفهان",5,610,10,3,345,968,10,978
"گیلان","رشت","کوچصفهان",6,780,6,1,307,1094,14,1108
"گیلان","رشت","کوچصفهان",7,642,7,2,320,971,14,985
"گیلان","رشت","کوچصفهان",8,460,6,0,100,566,6,572
"گیلان","رشت","کوچصفهان",9,535,4,1,162,702,7,709
"گیلان","رشت","کوچصفهان",10,421,6,1,73,501,6,507
"گیلان","رشت","کوچصفهان",11,243,0,4,55,302,0,302
"گیلان","رشت","کوچصفهان",12,208,1,0,53,262,1,263
"گیلان","رشت","کوچصفهان",13,423,7,0,80,510,4,514
"گیلان","رشت","کوچصفهان",14,735,2,2,121,860,5,865
"گیلان","رشت","کوچصفهان",15,255,2,1,19,277,0,277
"گیلان","رشت","کوچصفهان",16,337,1,0,87,425,2,427
"گیلان","رشت","کوچصفهان",17,688,2,2,84,776,3,779
"گیلان","رشت","کوچصفهان",18,523,2,3,131,659,3,662
"گیلان","رشت","کوچصفهان",19,817,8,1,274,1100,10,1110
"گیلان","رشت","کوچصفهان",20,613,3,1,180,797,3,800
"گیلان","رشت","کوچصفهان",21,166,0,0,25,191,0,191
"گیلان","رشت","کوچصفهان",22,270,0,0,54,324,0,324
"گیلان","رشت","کوچصفهان",23,825,6,1,223,1055,6,1061
"گیلان","رشت","کوچصفهان",24,235,0,0,37,272,3,275
"گیلان","رشت","کوچصفهان",25,329,4,3,106,442,2,444
"گیلان","رشت","کوچصفهان",26,392,2,0,47,441,0,441
"گیلان","رشت","کوچصفهان",27,833,1,0,63,897,5,902
"گیلان","رشت","کوچصفهان",28,640,1,2,111,754,11,765
"گیلان","رشت","کوچصفهان",29,499,5,5,136,645,8,653
"گیلان","رشت","کوچصفهان",30,383,10,4,152,549,5,554
"گیلان","رشت","کوچصفهان",31,528,5,0,142,675,11,686
"گیلان","رشت","کوچصفهان",32,627,2,0,91,720,2,722
"گیلان","رشت","کوچصفهان",33,720,6,2,138,866,3,869
"گیلان","رشت","کوچصفهان",34,321,2,1,44,368,4,372
"گیلان","رشت","کوچصفهان",35,513,7,2,66,588,6,594
"گیلان","رشت","کوچصفهان",36,620,2,3,118,743,3,746
"گیلان","رشت","کوچصفهان",37,925,3,2,127,1057,7,1064
"گیلان","رشت","کوچصفهان",38,369,4,0,58,431,9,440
"گیلان","رشت","کوچصفهان",39,464,8,5,80,557,7,564
"گیلان","رشت","کوچصفهان",40,331,2,0,22,355,2,357
"گیلان","رشت","کوچصفهان",41,452,2,1,76,531,5,536
"گیلان","رشت","کوچصفهان",42,156,1,0,13,170,1,171
"گیلان","رشت","کوچصفهان",43,641,8,3,94,746,7,753
"گیلان","رشت","کوچصفهان",44,329,0,0,15,344,0,344
"گیلان","رشت","کوچصفهان",45,313,1,0,62,376,7,383
"گیلان","رشت","کوچصفهان",46,636,4,0,142,782,7,789
"گیلان","رشت","کوچصفهان",47,561,1,0,34,596,3,599
"گیلان","رشت","کوچصفهان",48,207,0,0,32,239,0,239
"گیلان","رشت","کوچصفهان",49,272,1,2,53,328,1,329
"گیلان","رشت","کوچصفهان",50,228,1,0,52,281,0,281
"گیلان","رشت","کوچصفهان",51,437,1,0,50,488,4,492
"گیلان","رشت","کوچصفهان",52,598,4,4,111,717,8,725
"گیلان","رشت","کوچصفهان",53,298,0,0,37,335,0,335
"گیلان","رشت","سنگر",1,992,3,2,275,1272,12,1284
"گیلان","رشت","سنگر",2,1212,8,3,213,1436,17,1453
"گیلان","رشت","سنگر",3,487,6,1,73,567,2,569
"گیلان","رشت","سنگر",4,709,5,8,215,937,8,945
"گیلان","رشت","سنگر",5,552,6,2,127,687,6,693
"گیلان","رشت","سنگر",6,426,0,3,80,509,9,518
"گیلان","رشت","سنگر",7,1298,4,0,150,1452,10,1462
"گیلان","رشت","سنگر",8,318,4,0,81,403,1,404
"گیلان","رشت","سنگر",9,779,1,1,101,882,9,891
"گیلان","رشت","سنگر",10,882,4,0,99,985,3,988
"گیلان","رشت","سنگر",11,441,0,1,27,469,0,469
"گیلان","رشت","سنگر",12,754,0,1,47,802,12,814
"گیلان","رشت","سنگر",13,373,0,0,34,407,4,411
"گیلان","رشت","سنگر",14,567,0,1,49,617,6,623
"گیلان","رشت","سنگر",15,450,2,1,29,482,2,484
"گیلان","رشت","سنگر",16,614,2,3,49,668,1,669
"گیلان","رشت","سنگر",17,568,1,1,94,664,2,666
"گیلان","رشت","سنگر",18,571,7,1,97,676,6,682
"گیلان","رشت","سنگر",19,350,0,0,15,365,1,366
"گیلان","رشت","سنگر",20,356,1,0,20,377,2,379
"گیلان","رشت","سنگر",21,230,1,0,30,261,2,263
"گیلان","رشت","سنگر",22,459,1,0,36,496,0,496
"گیلان","رشت","سنگر",23,368,1,0,30,399,0,399
"گیلان","رشت","سنگر",24,914,3,6,153,1076,4,1080
"گیلان","رشت","سنگر",25,642,6,0,155,803,8,811
"گیلان","رشت","سنگر",26,760,2,0,132,894,0,894
"گیلان","رشت","سنگر",27,1099,6,2,117,1224,4,1228
"گیلان","رشت","سنگر",28,285,4,1,58,348,0,348
"گیلان","رشت","سنگر",29,323,3,2,135,463,3,466
"گیلان","رشت","سنگر",30,929,2,0,78,1009,7,1016
"گیلان","رشت","سنگر",31,1032,7,2,188,1229,8,1237
"گیلان","رشت","سنگر",32,382,0,0,71,453,2,455
"گیلان","رشت","سنگر",33,719,0,0,42,761,3,764
"گیلان","رشت","سنگر",34,356,2,1,47,406,1,407
"گیلان","رشت","سنگر",35,523,1,1,87,612,2,614
"گیلان","رشت","سنگر",36,703,1,1,88,793,7,800
"گیلان","رشت","سنگر",37,414,3,0,48,465,8,473
"گیلان","رشت","سنگر",38,520,3,1,54,578,2,580
"گیلان","رشت","سنگر",39,289,2,2,29,322,0,322
"گیلان","رشت","سنگر",40,513,3,0,67,583,6,589
"گیلان","رشت","سنگر",41,311,0,0,31,342,2,344
"گیلان","رشت","سنگر",42,251,1,0,40,292,4,296
"گیلان","رشت","سنگر",43,405,0,0,58,463,2,465
"گیلان","رشت","سنگر",44,289,0,0,34,323,0,323
"گیلان","رشت","سنگر",45,986,8,3,271,1268,6,1274
"گیلان","رشت","سنگر",46,738,4,5,116,863,2,865
"گیلان","رشت","سنگر",47,982,8,4,176,1170,2,1172
"گیلان","رشت","سنگر",48,660,8,4,156,828,4,832
"گیلان","رشت","سنگر",49,587,5,0,140,732,5,737
"گیلان","رشت","سنگر",50,821,6,2,312,1141,7,1148
"گیلان","رشت","سنگر",51,763,6,0,234,1003,6,1009
"گیلان","رشت","سنگر",52,624,1,2,124,751,3,754
"گیلان","رشت","سنگر",53,569,1,0,95,665,5,670
"گیلان","رشت","سنگر",54,536,9,2,165,712,2,714
"گیلان","رشت","سنگر",55,266,1,1,67,335,1,336
"گیلان","رشت","سنگر",56,276,5,2,19,302,2,304
"گیلان","رشت","سنگر",57,308,5,0,84,397,3,400
"گیلان","رضوانشهر","مرکزی",1,509,4,2,379,894,7,901
"گیلان","رضوانشهر","مرکزی",2,793,14,6,593,1406,19,1425
"گیلان","رضوانشهر","مرکزی",3,578,11,2,431,1022,18,1040
"گیلان","رضوانشهر","مرکزی",4,187,3,0,119,309,8,317
"گیلان","رضوانشهر","مرکزی",5,282,2,1,145,430,4,434
"گیلان","رضوانشهر","مرکزی",6,118,4,0,96,218,2,220
"گیلان","رضوانشهر","مرکزی",7,372,6,4,291,673,6,679
"گیلان","رضوانشهر","مرکزی",8,165,1,2,181,349,2,351
"گیلان","رضوانشهر","مرکزی",9,295,8,2,191,496,7,503
"گیلان","رضوانشهر","مرکزی",10,301,4,1,213,519,2,521
"گیلان","رضوانشهر","مرکزی",11,89,1,0,86,176,2,178
"گیلان","رضوانشهر","مرکزی",12,518,2,0,213,733,6,739
"گیلان","رضوانشهر","مرکزی",13,394,3,2,220,619,2,621
"گیلان","رضوانشهر","مرکزی",14,137,0,1,50,188,0,188
"گیلان","رضوانشهر","مرکزی",15,258,3,1,85,347,0,347
"گیلان","رضوانشهر","مرکزی",16,241,14,0,166,421,0,421
"گیلان","رضوانشهر","مرکزی",17,387,3,2,243,635,3,638
"گیلان","رضوانشهر","مرکزی",18,559,6,4,170,739,13,752
"گیلان","رضوانشهر","مرکزی",19,216,0,1,36,253,0,253
"گیلان","رضوانشهر","مرکزی",20,124,0,0,224,348,0,348
"گیلان","رضوانشهر","مرکزی",21,558,2,0,91,651,3,654
"گیلان","رضوانشهر","مرکزی",22,339,2,0,120,461,0,461
"گیلان","رضوانشهر","مرکزی",23,154,0,0,39,193,0,193
"گیلان","رضوانشهر","مرکزی",24,319,1,0,144,464,4,468
"گیلان","رضوانشهر","مرکزی",25,113,0,0,43,156,3,159
"گیلان","رضوانشهر","مرکزی",26,387,0,0,104,491,3,494
"گیلان","رضوانشهر","مرکزی",27,325,3,3,155,486,2,488
"گیلان","رضوانشهر","مرکزی",28,230,1,1,142,374,5,379
"گیلان","رضوانشهر","مرکزی",29,700,2,3,283,988,12,1000
"گیلان","رضوانشهر","مرکزی",30,340,1,0,143,484,0,484
"گیلان","رضوانشهر","مرکزی",31,287,0,0,142,429,3,432
"گیلان","رضوانشهر","مرکزی",32,212,0,1,91,304,1,305
"گیلان","رضوانشهر","مرکزی",33,153,2,0,62,217,1,218
"گیلان","رضوانشهر","مرکزی",34,179,1,5,69,254,1,255
"گیلان","رضوانشهر","مرکزی",35,468,1,0,270,739,6,745
"گیلان","رضوانشهر","مرکزی",36,83,0,1,89,173,2,175
"گیلان","رضوانشهر","مرکزی",37,310,0,0,61,371,2,373
"گیلان","رضوانشهر","مرکزی",38,370,0,1,211,582,7,589
"گیلان","رضوانشهر","مرکزی",39,548,1,2,222,773,5,778
"گیلان","رضوانشهر","مرکزی",40,366,12,5,274,657,8,665
"گیلان","رضوانشهر","مرکزی",41,106,7,4,157,274,2,276
"گیلان","رضوانشهر","مرکزی",42,185,10,19,197,411,2,413
"گیلان","رضوانشهر","مرکزی",43,134,0,1,59,194,3,197
"گیلان","رضوانشهر","مرکزی",44,162,2,0,141,305,13,318
"گیلان","رضوانشهر","مرکزی",45,258,1,1,50,310,2,312
"گیلان","رضوانشهر","مرکزی",46,168,0,0,32,200,1,201
"گیلان","رضوانشهر","مرکزی",47,218,0,0,15,233,0,233
"گیلان","رضوانشهر","مرکزی",48,265,1,0,90,356,5,361
"گیلان","رضوانشهر","پره_سر",1,865,10,7,431,1313,0,1313
"گیلان","رضوانشهر","پره_سر",2,459,7,3,324,793,12,805
"گیلان","رضوانشهر","پره_سر",3,509,12,10,493,1024,18,1042
"گیلان","رضوانشهر","پره_سر",4,450,6,6,442,904,14,918
"گیلان","رضوانشهر","پره_سر",5,282,1,1,156,440,3,443
"گیلان","رضوانشهر","پره_سر",6,225,5,49,283,562,1,563
"گیلان","رضوانشهر","پره_سر",7,176,1,8,181,366,3,369
"گیلان","رضوانشهر","پره_سر",8,205,2,0,94,301,2,303
"گیلان","رضوانشهر","پره_سر",9,304,1,0,162,467,4,471
"گیلان","رضوانشهر","پره_سر",10,210,0,1,82,293,8,301
"گیلان","رضوانشهر","پره_سر",11,191,1,1,55,248,2,250
"گیلان","رضوانشهر","پره_سر",12,161,1,1,86,249,1,250
"گیلان","رضوانشهر","پره_سر",13,315,0,1,49,365,1,366
"گیلان","رضوانشهر","پره_سر",14,89,0,0,62,151,0,151
"گیلان","رضوانشهر","پره_سر",15,270,1,1,147,419,6,425
"گیلان","رضوانشهر","پره_سر",16,294,4,0,65,363,4,367
"گیلان","رضوانشهر","پره_سر",17,255,0,0,64,319,1,320
"گیلان","رضوانشهر","پره_سر",18,361,1,7,151,520,0,520
"گیلان","رضوانشهر","پره_سر",19,320,1,0,106,427,6,433
"گیلان","رضوانشهر","پره_سر",20,206,2,2,106,316,3,319
"گیلان","رضوانشهر","پره_سر",21,196,0,2,100,298,2,300
"گیلان","رضوانشهر","پره_سر",22,309,1,0,82,392,8,400
"گیلان","رضوانشهر","پره_سر",23,200,0,1,38,239,1,240
"گیلان","رضوانشهر","پره_سر",24,80,1,1,34,116,0,116
"گیلان","رضوانشهر","پره_سر",25,383,5,3,135,526,2,528
"گیلان","رضوانشهر","پره_سر",26,209,2,1,117,329,0,329
"گیلان","رضوانشهر","پره_سر",27,371,4,0,132,507,4,511
"گیلان","رضوانشهر","پره_سر",28,449,8,1,89,547,4,551
"گیلان","رضوانشهر","پره_سر",29,194,6,0,55,255,1,256
"گیلان","رضوانشهر","پره_سر",30,759,6,4,302,1071,6,1077
"گیلان","رضوانشهر","پره_سر",31,322,2,0,129,453,0,453
"گیلان","رضوانشهر","پره_سر",32,133,2,0,144,279,3,282
"گیلان","رضوانشهر","پره_سر",33,304,1,0,88,393,1,394
"گیلان","رضوانشهر","پره_سر",34,235,0,0,76,311,2,313
"گیلان","رضوانشهر","پره_سر",35,106,5,1,65,177,3,180
"گیلان","رضوانشهر","پره_سر",36,185,0,0,21,206,2,208
"گیلان","رضوانشهر","پره_سر",37,121,0,1,101,223,1,224
"گیلان","رضوانشهر","پره_سر",38,83,1,0,39,123,0,123
"گیلان","رضوانشهر","پره_سر",39,142,0,1,32,175,1,176
"گیلان","رضوانشهر","پره_سر",40,74,0,0,42,116,0,116
"گیلان","رودبار","مرکزی",1,363,9,1,217,590,10,600
"گیلان","رودبار","مرکزی",2,173,1,1,58,233,2,235
"گیلان","رودبار","مرکزی",3,496,7,2,177,682,6,688
"گیلان","رودبار","مرکزی",4,359,6,5,181,551,6,557
"گیلان","رودبار","مرکزی",5,292,3,0,157,452,4,456
"گیلان","رودبار","مرکزی",6,506,6,2,253,767,6,773
"گیلان","رودبار","مرکزی",7,394,5,0,108,507,5,512
"گیلان","رودبار","مرکزی",8,663,15,9,506,1193,13,1206
"گیلان","رودبار","مرکزی",9,350,2,0,132,484,6,490
"گیلان","رودبار","مرکزی",10,173,7,2,193,375,6,381
"گیلان","رودبار","مرکزی",11,348,1,0,63,412,5,417
"گیلان","رودبار","مرکزی",12,123,1,0,44,168,0,168
"گیلان","رودبار","مرکزی",13,357,2,0,32,391,1,392
"گیلان","رودبار","مرکزی",14,228,0,0,70,298,3,301
"گیلان","رودبار","مرکزی",15,353,1,2,135,491,8,499
"گیلان","رودبار","مرکزی",16,209,3,4,82,298,6,304
"گیلان","رودبار","مرکزی",17,561,16,5,407,989,6,995
"گیلان","رودبار","مرکزی",18,677,11,3,408,1099,10,1109
"گیلان","رودبار","مرکزی",19,782,12,4,433,1231,11,1242
"گیلان","رودبار","مرکزی",20,824,16,4,412,1256,16,1272
"گیلان","رودبار","مرکزی",21,576,11,2,401,990,5,995
"گیلان","رودبار","مرکزی",22,864,2,1,208,1075,14,1089
"گیلان","رودبار","مرکزی",23,406,2,0,66,474,3,477
"گیلان","رودبار","مرکزی",24,216,7,2,132,357,9,366
"گیلان","رودبار","مرکزی",25,660,14,14,231,919,24,943
"گیلان","رودبار","مرکزی",26,639,5,0,126,770,2,772
"گیلان","رودبار","مرکزی",27,527,4,1,131,663,7,670
"گیلان","رودبار","مرکزی",28,426,1,3,93,523,3,526
"گیلان","رودبار","مرکزی",29,758,9,6,208,981,9,990
"گیلان","رودبار","مرکزی",30,448,6,6,139,599,7,606
"گیلان","رودبار","مرکزی",31,880,8,7,287,1182,11,1193
"گیلان","رودبار","مرکزی",32,372,4,3,194,573,9,582
"گیلان","رودبار","مرکزی",33,606,23,13,415,1057,6,1063
"گیلان","رودبار","مرکزی",34,640,6,7,273,926,10,936
"گیلان","رودبار","مرکزی",35,270,3,3,56,332,1,333
"گیلان","رودبار","مرکزی",36,808,13,2,130,953,6,959
"گیلان","رودبار","مرکزی",37,215,1,1,59,276,2,278
"گیلان","رودبار","مرکزی",38,632,8,2,186,828,5,833
"گیلان","رودبار","مرکزی",39,640,6,3,129,778,1,779
"گیلان","رودبار","مرکزی",40,959,6,1,447,1413,6,1419
"گیلان","رودبار","مرکزی",41,698,6,3,355,1062,16,1078
"گیلان","رودبار","مرکزی",42,550,3,1,169,723,3,726
"گیلان","رودبار","مرکزی",43,467,2,0,129,598,2,600
"گیلان","رودبار","مرکزی",44,384,8,1,167,560,5,565
"گیلان","رودبار","مرکزی",45,931,5,13,365,1314,20,1334
"گیلان","رودبار","مرکزی",46,479,7,3,206,695,5,700
"گیلان","رودبار","مرکزی",47,338,7,0,71,416,9,425
"گیلان","رودبار","مرکزی",48,412,4,33,111,560,6,566
"گیلان","رودبار","مرکزی",49,114,2,2,52,170,0,170
"گیلان","رودبار","مرکزی",50,1040,8,1,96,1145,4,1149
"گیلان","رودبار","مرکزی",51,654,9,2,170,835,6,841
"گیلان","رودبار","مرکزی",52,253,0,1,118,372,1,373
"گیلان","رودبار","مرکزی",53,326,0,1,79,406,7,413
"گیلان","رودبار","مرکزی",54,632,6,2,231,871,9,880
"گیلان","رودبار","مرکزی",55,466,3,0,164,633,5,638
"گیلان","رودبار","مرکزی",56,331,1,0,59,391,2,393
"گیلان","رودبار","مرکزی",57,264,3,1,113,381,4,385
"گیلان","رودبار","مرکزی",58,400,3,0,118,521,4,525
"گیلان","رودبار","مرکزی",59,516,8,3,140,667,6,673
"گیلان","رودبار","مرکزی",60,333,2,1,178,514,2,516
"گیلان","رودبار","مرکزی",61,366,5,3,150,524,3,527
"گیلان","رودبار","عمارلو",1,527,3,0,119,649,1,650
"گیلان","رودبار","عمارلو",2,367,2,0,66,435,2,437
"گیلان","رودبار","عمارلو",3,299,0,0,35,334,4,338
"گیلان","رودبار","عمارلو",4,271,2,0,106,379,0,379
"گیلان","رودبار","عمارلو",5,296,5,0,31,332,2,334
"گیلان","رودبار","عمارلو",6,269,1,1,40,311,9,320
"گیلان","رودبار","عمارلو",7,258,0,0,16,274,1,275
"گیلان","رودبار","عمارلو",8,143,0,1,4,148,1,149
"گیلان","رودبار","عمارلو",9,441,1,0,79,521,4,525
"گیلان","رودبار","عمارلو",10,313,1,1,28,343,2,345
"گیلان","رودبار","عمارلو",11,278,0,0,15,293,0,293
"گیلان","رودبار","عمارلو",12,504,1,0,39,544,2,546
"گیلان","رودبار","عمارلو",13,158,0,0,8,166,0,166
"گیلان","رودبار","عمارلو",14,400,1,0,32,433,2,435
"گیلان","رودبار","عمارلو",15,183,1,0,56,240,0,240
"گیلان","رودبار","عمارلو",16,99,0,0,15,114,2,116
"گیلان","رودبار","خورگام",1,430,3,2,89,524,1,525
"گیلان","رودبار","خورگام",2,205,1,0,31,237,1,238
"گیلان","رودبار","خورگام",3,240,0,0,22,262,3,265
"گیلان","رودبار","خورگام",4,484,1,0,33,518,1,519
"گیلان","رودبار","خورگام",5,562,6,2,83,653,1,654
"گیلان","رودبار","خورگام",6,299,1,1,74,375,3,378
"گیلان","رودبار","خورگام",7,525,3,0,59,587,2,589
"گیلان","رودبار","خورگام",8,411,2,1,20,434,1,435
"گیلان","رودبار","خورگام",9,507,5,1,68,581,1,582
"گیلان","رودبار","خورگام",10,196,0,0,28,224,3,227
"گیلان","رودبار","خورگام",11,292,0,0,57,349,1,350
"گیلان","رودبار","خورگام",12,517,2,1,34,554,5,559
"گیلان","رودبار","خورگام",13,498,1,0,19,518,1,519
"گیلان","رودبار","خورگام",14,532,1,0,27,560,0,560
"گیلان","رودبار","خورگام",15,435,1,3,11,450,0,450
"گیلان","رودبار","خورگام",16,572,0,0,69,641,1,642
"گیلان","رودبار","خورگام",17,288,0,0,18,306,1,307
"گیلان","رودبار","خورگام",18,94,0,0,16,110,0,110
"گیلان","رودبار","رحمت_آباد_و_ملوکاء",1,535,2,2,351,890,8,898
"گیلان","رودبار","رحمت_آباد_و_ملوکاء",2,273,7,0,190,470,3,473
"گیلان","رودبار","رحمت_آباد_و_ملوکاء",3,503,7,4,73,587,3,590
"گیلان","رودبار","رحمت_آباد_و_ملوکاء",4,378,2,1,41,422,1,423
"گیلان","رودبار","رحمت_آباد_و_ملوکاء",5,420,7,0,57,484,7,491
"گیلان","رودبار","رحمت_آباد_و_ملوکاء",6,406,0,2,78,486,2,488
"گیلان","رودبار","رحمت_آباد_و_ملوکاء",7,168,0,0,28,196,3,199
"گیلان","رودبار","رحمت_آباد_و_ملوکاء",8,471,0,1,55,527,2,529
"گیلان","رودبار","رحمت_آباد_و_ملوکاء",9,217,0,9,50,276,3,279
"گیلان","رودبار","رحمت_آباد_و_ملوکاء",10,466,2,1,139,608,0,608
"گیلان","رودبار","رحمت_آباد_و_ملوکاء",11,538,1,1,156,696,5,701
"گیلان","رودبار","رحمت_آباد_و_ملوکاء",12,361,1,3,101,466,4,470
"گیلان","رودبار","رحمت_آباد_و_ملوکاء",13,474,1,0,138,613,2,615
"گیلان","رودبار","رحمت_آباد_و_ملوکاء",14,291,4,0,38,333,1,334
"گیلان","رودبار","رحمت_آباد_و_ملوکاء",15,185,1,0,61,247,1,248
"گیلان","رودبار","رحمت_آباد_و_ملوکاء",16,277,1,0,55,333,0,333
"گیلان","رودبار","رحمت_آباد_و_ملوکاء",17,435,1,0,122,558,2,560
"گیلان","رودبار","رحمت_آباد_و_ملوکاء",18,387,1,0,62,450,1,451
"گیلان","رودبار","رحمت_آباد_و_ملوکاء",19,468,2,2,57,529,1,530
"گیلان","رودبار","رحمت_آباد_و_ملوکاء",20,368,1,1,76,446,2,448
"گیلان","رودبار","رحمت_آباد_و_ملوکاء",21,617,6,0,125,748,11,759
"گیلان","رودبار","رحمت_آباد_و_ملوکاء",22,505,0,2,69,576,1,577
"گیلان","رودبار","رحمت_آباد_و_ملوکاء",23,277,2,0,9,288,0,288
"گیلان","رودبار","رحمت_آباد_و_ملوکاء",24,344,0,0,27,371,0,371
"گیلان","رودبار","رحمت_آباد_و_ملوکاء",25,550,3,1,158,712,4,716
"گیلان","رودبار","رحمت_آباد_و_ملوکاء",26,243,0,0,54,297,3,300
"گیلان","رودسر","مرکزی",1,555,14,22,743,1334,18,1352
"گیلان","رودسر","مرکزی",2,454,12,8,509,983,16,999
"گیلان","رودسر","مرکزی",3,204,4,1,226,435,6,441
"گیلان","رودسر","مرکزی",4,431,16,11,468,926,13,939
"گیلان","رودسر","مرکزی",5,428,11,6,395,840,8,848
"گیلان","رودسر","مرکزی",6,271,7,10,262,550,6,556
"گیلان","رودسر","مرکزی",7,630,7,11,391,1039,14,1053
"گیلان","رودسر","مرکزی",8,668,8,12,582,1270,13,1283
"گیلان","رودسر","مرکزی",9,267,3,7,527,804,8,812
"گیلان","رودسر","مرکزی",10,846,23,1,568,1438,11,1449
"گیلان","رودسر","مرکزی",11,784,23,4,597,1408,18,1426
"گیلان","رودسر","مرکزی",12,474,10,12,361,857,11,868
"گیلان","رودسر","مرکزی",13,744,12,10,416,1182,7,1189
"گیلان","رودسر","مرکزی",14,409,8,10,444,871,10,881
"گیلان","رودسر","مرکزی",15,252,14,8,328,602,10,612
"گیلان","رودسر","مرکزی",16,580,13,7,676,1276,16,1292
"گیلان","رودسر","مرکزی",17,602,10,3,445,1060,7,1067
"گیلان","رودسر","مرکزی",18,595,17,5,419,1036,4,1040
"گیلان","رودسر","مرکزی",19,488,11,7,445,951,10,961
"گیلان","رودسر","مرکزی",20,531,9,3,425,968,6,974
"گیلان","رودسر","مرکزی",21,248,11,16,222,497,7,504
"گیلان","رودسر","مرکزی",22,413,5,5,408,831,13,844
"گیلان","رودسر","مرکزی",23,275,5,3,301,584,4,588
"گیلان","رودسر","مرکزی",24,160,4,4,107,275,4,279
"گیلان","رودسر","مرکزی",25,212,3,1,99,315,3,318
"گیلان","رودسر","مرکزی",26,235,7,4,161,407,5,412
"گیلان","رودسر","مرکزی",27,518,1,7,299,825,5,830
"گیلان","رودسر","مرکزی",28,729,5,3,275,1012,19,1031
"گیلان","رودسر","مرکزی",29,299,3,1,70,373,1,374
"گیلان","رودسر","مرکزی",30,223,1,2,90,316,1,317
"گیلان","رودسر","مرکزی",31,677,5,3,287,972,24,996
"گیلان","رودسر","مرکزی",32,177,0,2,143,322,2,324
"گیلان","رودسر","مرکزی",33,271,1,0,95,367,2,369
"گیلان","رودسر","مرکزی",34,220,0,2,55,277,1,278
"گیلان","رودسر","مرکزی",35,355,2,1,46,404,9,413
"گیلان","رودسر","مرکزی",36,209,1,0,85,295,2,297
"گیلان","رودسر","مرکزی",37,399,5,2,168,574,7,581
"گیلان","رودسر","مرکزی",38,262,5,2,153,422,4,426
"گیلان","رودسر","مرکزی",39,414,5,2,137,558,3,561
"گیلان","رودسر","مرکزی",40,206,0,0,42,248,2,250
"گیلان","رودسر","مرکزی",41,527,2,1,136,666,3,669
"گیلان","رودسر","مرکزی",42,246,0,2,43,291,7,298
"گیلان","رودسر","مرکزی",43,330,2,1,65,398,7,405
"گیلان","رودسر","مرکزی",44,402,0,0,81,483,3,486
"گیلان","رودسر","مرکزی",45,372,2,0,80,454,0,454
"گیلان","رودسر","مرکزی",46,204,3,1,78,286,8,294
"گیلان","رودسر","مرکزی",47,157,0,0,21,178,2,180
"گیلان","رودسر","مرکزی",48,239,1,0,78,318,1,319
"گیلان","رودسر","مرکزی",49,452,6,3,200,661,10,671
"گیلان","رودسر","مرکزی",50,290,2,0,25,317,1,318
"گیلان","رودسر","مرکزی",51,166,0,0,46,212,2,214
"گیلان","رودسر","مرکزی",52,205,0,3,57,265,1,266
"گیلان","رودسر","مرکزی",53,140,0,3,58,201,1,202
"گیلان","رودسر","مرکزی",54,360,5,1,100,466,6,472
"گیلان","رودسر","مرکزی",55,260,3,3,66,332,0,332
"گیلان","رودسر","مرکزی",56,236,1,3,120,360,2,362
"گیلان","رودسر","مرکزی",57,163,2,0,45,210,0,210
"گیلان","رودسر","مرکزی",58,273,4,3,107,387,2,389
"گیلان","رودسر","مرکزی",59,152,2,1,60,215,4,219
"گیلان","رودسر","مرکزی",60,142,3,0,67,212,2,214
"گیلان","رودسر","مرکزی",61,121,2,1,60,184,1,185
"گیلان","رودسر","مرکزی",62,119,3,0,68,190,5,195
"گیلان","رودسر","مرکزی",63,397,6,2,305,710,10,720
"گیلان","رودسر","مرکزی",64,418,3,1,121,543,1,544
"گیلان","رودسر","مرکزی",65,146,2,0,61,209,1,210
"گیلان","رودسر","مرکزی",66,160,3,1,52,216,1,217
"گیلان","رودسر","مرکزی",67,240,2,0,57,299,1,300
"گیلان","رودسر","مرکزی",68,190,1,1,36,228,0,228
"گیلان","رودسر","چابکسر",1,498,19,4,731,1252,14,1266
"گیلان","رودسر","چابکسر",2,483,9,3,557,1052,18,1070
"گیلان","رودسر","چابکسر",3,362,8,2,324,696,10,706
"گیلان","رودسر","چابکسر",4,193,6,8,203,410,4,414
"گیلان","رودسر","چابکسر",5,339,9,3,443,794,11,805
"گیلان","رودسر","چابکسر",6,334,12,1,342,689,3,692
"گیلان","رودسر","چابکسر",7,123,5,1,105,234,2,236
"گیلان","رودسر","چابکسر",8,434,12,2,461,909,6,915
"گیلان","رودسر","چابکسر",9,194,0,0,63,257,2,259
"گیلان","رودسر","چابکسر",10,282,0,2,116,400,0,400
"گیلان","رودسر","چابکسر",11,403,12,0,193,608,3,611
"گیلان","رودسر","چابکسر",12,165,0,0,253,418,8,426
"گیلان","رودسر","چابکسر",13,265,7,0,217,489,3,492
"گیلان","رودسر","چابکسر",14,502,6,0,310,818,6,824
"گیلان","رودسر","چابکسر",15,356,4,0,205,565,3,568
"گیلان","رودسر","چابکسر",16,349,3,1,182,535,6,541
"گیلان","رودسر","چابکسر",17,769,15,1,436,1221,5,1226
"گیلان","رودسر","چابکسر",18,241,4,1,235,481,3,484
"گیلان","رودسر","چابکسر",19,368,4,1,154,527,4,531
"گیلان","رودسر","چابکسر",20,469,0,2,246,717,4,721
"گیلان","رودسر","چابکسر",21,367,1,4,188,560,2,562
"گیلان","رودسر","چابکسر",22,300,3,1,137,441,4,445
"گیلان","رودسر","چابکسر",23,450,4,3,415,872,5,877
"گیلان","رودسر","چابکسر",24,437,4,2,246,689,5,694
"گیلان","رودسر","چابکسر",25,216,3,1,96,316,4,320
"گیلان","رودسر","چابکسر",26,418,7,5,263,693,5,698
"گیلان","رودسر","چابکسر",27,448,1,1,215,665,1,666
"گیلان","رودسر","چابکسر",28,261,2,0,127,390,2,392
"گیلان","رودسر","چابکسر",29,173,0,0,97,270,5,275
"گیلان","رودسر","چابکسر",30,319,1,2,45,367,1,368
"گیلان","رودسر","رحیم_آباد",1,773,11,5,645,1434,16,1450
"گیلان","رودسر","رحیم_آباد",2,680,15,3,428,1126,11,1137
"گیلان","رودسر","رحیم_آباد",3,249,6,2,237,494,9,503
"گیلان","رودسر","رحیم_آباد",4,186,2,1,96,285,1,286
"گیلان","رودسر","رحیم_آباد",5,376,2,4,203,585,2,587
"گیلان","رودسر","رحیم_آباد",6,653,13,5,256,927,10,937
"گیلان","رودسر","رحیم_آباد",7,400,7,0,199,606,3,609
"گیلان","رودسر","رحیم_آباد",8,507,10,1,209,727,4,731
"گیلان","رودسر","رحیم_آباد",9,521,4,0,255,780,4,784
"گیلان","رودسر","رحیم_آباد",10,609,1,3,63,676,2,678
"گیلان","رودسر","رحیم_آباد",11,367,3,1,89,460,7,467
"گیلان","رودسر","رحیم_آباد",12,354,5,2,207,568,3,571
"گیلان","رودسر","رحیم_آباد",13,207,3,0,39,249,3,252
"گیلان","رودسر","رحیم_آباد",14,393,3,0,77,473,4,477
"گیلان","رودسر","رحیم_آباد",15,1133,25,2,144,1304,7,1311
"گیلان","رودسر","رحیم_آباد",16,604,1,1,63,669,3,672
"گیلان","رودسر","رحیم_آباد",17,336,1,0,24,361,1,362
"گیلان","رودسر","رحیم_آباد",18,616,2,1,147,766,1,767
"گیلان","رودسر","رحیم_آباد",19,517,4,1,96,618,4,622
"گیلان","رودسر","رحیم_آباد",20,446,0,1,33,480,0,480
"گیلان","رودسر","رحیم_آباد",21,199,1,0,24,224,0,224
"گیلان","رودسر","رحیم_آباد",22,448,0,0,75,523,2,525
"گیلان","رودسر","رحیم_آباد",23,315,1,0,35,351,1,352
"گیلان","رودسر","رحیم_آباد",24,743,4,1,35,783,0,783
"گیلان","رودسر","رحیم_آباد",25,375,1,0,31,407,0,407
"گیلان","رودسر","رحیم_آباد",26,277,2,0,26,305,1,306
"گیلان","رودسر","رحیم_آباد",27,193,0,0,7,200,0,200
"گیلان","رودسر","رحیم_آباد",28,206,0,0,34,240,6,246
"گیلان","رودسر","رحیم_آباد",29,382,1,5,34,422,5,427
"گیلان","رودسر","رحیم_آباد",30,242,1,1,19,263,1,264
"گیلان","رودسر","رحیم_آباد",31,161,0,0,10,171,0,171
"گیلان","رودسر","رحیم_آباد",32,191,1,0,42,234,1,235
"گیلان","رودسر","رحیم_آباد",33,457,0,0,44,501,0,501
"گیلان","رودسر","رحیم_آباد",34,255,0,0,32,287,4,291
"گیلان","رودسر","رحیم_آباد",35,269,1,0,69,339,0,339
"گیلان","رودسر","رحیم_آباد",36,106,1,0,63,170,0,170
"گیلان","رودسر","رحیم_آباد",37,226,0,1,30,257,0,257
"گیلان","رودسر","رحیم_آباد",38,181,0,0,50,231,1,232
"گیلان","رودسر","رحیم_آباد",39,234,0,0,30,264,5,269
"گیلان","رودسر","رحیم_آباد",40,239,1,0,48,288,0,288
"گیلان","رودسر","رحیم_آباد",41,224,0,0,20,244,4,248
"گیلان","رودسر","کلاچای",1,711,19,13,739,1482,18,1500
"گیلان","رودسر","کلاچای",2,545,16,8,596,1165,15,1180
"گیلان","رودسر","کلاچای",3,515,19,6,487,1027,17,1044
"گیلان","رودسر","کلاچای",4,556,12,5,344,917,7,924
"گیلان","رودسر","کلاچای",5,466,18,3,398,885,13,898
"گیلان","رودسر","کلاچای",6,554,16,11,561,1142,14,1156
"گیلان","رودسر","کلاچای",7,211,1,4,161,377,6,383
"گیلان","رودسر","کلاچای",8,570,14,11,414,1009,6,1015
"گیلان","رودسر","کلاچای",9,238,3,5,233,479,6,485
"گیلان","رودسر","کلاچای",10,366,4,3,243,616,8,624
"گیلان","رودسر","کلاچای",11,271,5,2,216,494,1,495
"گیلان","رودسر","کلاچای",12,254,2,4,162,422,6,428
"گیلان","رودسر","کلاچای",13,282,2,0,122,406,4,410
"گیلان","رودسر","کلاچای",14,361,4,0,161,526,0,526
"گیلان","رودسر","کلاچای",15,171,0,2,47,220,3,223
"گیلان","رودسر","کلاچای",16,355,5,6,169,535,2,537
"گیلان","رودسر","کلاچای",17,402,2,2,72,478,7,485
"گیلان","رودسر","کلاچای",18,406,1,3,95,505,2,507
"گیلان","رودسر","کلاچای",19,666,8,3,378,1055,17,1072
"گیلان","رودسر","کلاچای",20,564,3,1,126,694,11,705
"گیلان","رودسر","کلاچای",21,230,3,0,67,300,2,302
"گیلان","رودسر","کلاچای",22,342,1,3,120,466,6,472
"گیلان","رودسر","کلاچای",23,462,1,7,113,583,0,583
"گیلان","رودسر","کلاچای",24,413,4,0,93,510,1,511
"گیلان","رودسر","کلاچای",25,217,4,0,122,343,2,345
"گیلان","رودسر","کلاچای",26,372,3,1,232,608,7,615
"گیلان","رودسر","کلاچای",27,213,1,0,70,284,3,287
"گیلان","رودسر","کلاچای",28,427,2,0,60,489,1,490
"گیلان","رودسر","کلاچای",29,382,1,0,28,411,3,414
"گیلان","رودسر","کلاچای",30,478,1,0,96,575,5,580
"گیلان","رودسر","کلاچای",31,557,3,0,101,661,8,669
"گیلان","رودسر","کلاچای",32,318,0,0,96,414,3,417
"گیلان","رودسر","کلاچای",33,287,6,0,139,432,2,434
"گیلان","رودسر","کلاچای",34,512,11,1,290,814,11,825
"گیلان","رودسر","کلاچای",35,241,5,0,43,289,1,290
"گیلان","رودسر","کلاچای",36,218,0,0,38,256,1,257
"گیلان","رودسر","کلاچای",37,423,3,5,110,541,7,548
"گیلان","سیاهکل","مرکزی",1,478,11,4,251,744,10,754
"گیلان","سیاهکل","مرکزی",2,752,5,4,238,999,6,1005
"گیلان","سیاهکل","مرکزی",3,1092,14,5,421,1532,10,1542
"گیلان","سیاهکل","مرکزی",4,424,12,1,214,651,13,664
"گیلان","سیاهکل","مرکزی",5,747,11,6,216,980,3,983
"گیلان","سیاهکل","مرکزی",6,549,5,4,296,854,11,865
"گیلان","سیاهکل","مرکزی",7,336,2,7,133,478,5,483
"گیلان","سیاهکل","مرکزی",8,424,13,2,138,577,5,582
"گیلان","سیاهکل","مرکزی",9,729,2,7,260,998,7,1005
"گیلان","سیاهکل","مرکزی",10,957,8,9,163,1137,5,1142
"گیلان","سیاهکل","مرکزی",11,518,2,2,211,733,11,744
"گیلان","سیاهکل","مرکزی",12,367,10,6,257,640,8,648
"گیلان","سیاهکل","مرکزی",13,343,2,3,185,533,7,540
"گیلان","سیاهکل","مرکزی",14,542,2,1,208,753,7,760
"گیلان","سیاهکل","مرکزی",15,300,5,1,122,428,6,434
"گیلان","سیاهکل","مرکزی",16,346,0,0,28,374,0,374
"گیلان","سیاهکل","مرکزی",17,238,6,0,49,293,1,294
"گیلان","سیاهکل","مرکزی",18,372,7,2,57,438,1,439
"گیلان","سیاهکل","مرکزی",19,425,1,3,58,487,2,489
"گیلان","سیاهکل","مرکزی",20,272,3,0,43,318,2,320
"گیلان","سیاهکل","مرکزی",21,284,0,0,48,332,2,334
"گیلان","سیاهکل","مرکزی",22,242,1,0,75,318,4,322
"گیلان","سیاهکل","مرکزی",23,413,3,1,71,488,3,491
"گیلان","سیاهکل","مرکزی",24,301,1,0,38,340,1,341
"گیلان","سیاهکل","مرکزی",25,132,0,0,19,151,0,151
"گیلان","سیاهکل","مرکزی",26,223,2,2,45,272,3,275
"گیلان","سیاهکل","مرکزی",27,393,1,0,8,402,0,402
"گیلان","سیاهکل","مرکزی",28,506,1,0,34,541,1,542
"گیلان","سیاهکل","مرکزی",29,293,0,0,77,370,3,373
"گیلان","سیاهکل","مرکزی",30,116,0,0,3,119,0,119
"گیلان","سیاهکل","مرکزی",31,91,1,0,11,103,2,105
"گیلان","سیاهکل","مرکزی",32,203,0,0,7,210,6,216
"گیلان","سیاهکل","مرکزی",33,475,3,1,26,505,4,509
"گیلان","سیاهکل","مرکزی",34,184,0,1,17,202,0,202
"گیلان","سیاهکل","مرکزی",35,351,0,0,16,367,1,368
"گیلان","سیاهکل","مرکزی",36,395,0,1,41,437,2,439
"گیلان","سیاهکل","مرکزی",37,560,4,1,39,604,7,611
"گیلان","سیاهکل","مرکزی",38,198,1,0,13,212,3,215
"گیلان","سیاهکل","مرکزی",39,748,0,0,54,802,3,805
"گیلان","سیاهکل","مرکزی",40,557,0,1,21,579,0,579
"گیلان","سیاهکل","مرکزی",41,428,2,0,50,480,3,483
"گیلان","سیاهکل","مرکزی",42,372,0,0,49,421,2,423
"گیلان","سیاهکل","مرکزی",43,326,0,0,22,348,4,352
"گیلان","سیاهکل","مرکزی",44,192,1,1,16,210,0,210
"گیلان","سیاهکل","مرکزی",45,650,0,3,62,715,4,719
"گیلان","سیاهکل","مرکزی",46,205,0,0,5,210,0,210
"گیلان","سیاهکل","مرکزی",47,218,1,0,55,274,6,280
"گیلان","سیاهکل","دیلمان",1,633,6,2,138,779,5,784
"گیلان","سیاهکل","دیلمان",2,375,6,1,167,549,6,555
"گیلان","سیاهکل","دیلمان",3,424,2,0,90,516,5,521
"گیلان","سیاهکل","دیلمان",4,407,1,0,12,420,4,424
"گیلان","سیاهکل","دیلمان",5,285,0,0,34,319,0,319
"گیلان","سیاهکل","دیلمان",6,241,4,1,50,296,2,298
"گیلان","سیاهکل","دیلمان",7,434,0,0,58,492,3,495
"گیلان","سیاهکل","دیلمان",8,310,3,3,58,374,0,374
"گیلان","سیاهکل","دیلمان",9,303,2,0,34,339,0,339
"گیلان","سیاهکل","دیلمان",10,251,0,0,20,271,0,271
"گیلان","سیاهکل","دیلمان",11,185,0,0,22,207,0,207
"گیلان","سیاهکل","دیلمان",12,298,0,0,10,308,0,308
"گیلان","سیاهکل","دیلمان",13,291,0,0,11,302,0,302
"گیلان","سیاهکل","دیلمان",14,281,0,1,24,306,0,306
"گیلان","سیاهکل","دیلمان",15,276,2,0,36,314,0,314
"گیلان","سیاهکل","دیلمان",16,164,0,0,23,187,3,190
"گیلان","سیاهکل","دیلمان",17,121,0,0,8,129,4,133
"گیلان","سیاهکل","دیلمان",18,189,3,0,17,209,4,213
"گیلان","سیاهکل","دیلمان",19,367,1,0,59,427,0,427
"گیلان","سیاهکل","دیلمان",20,327,1,0,8,336,0,336
"گیلان","سیاهکل","دیلمان",21,268,0,2,1,271,0,271
"گیلان","سیاهکل","دیلمان",22,232,1,0,4,237,1,238
"گیلان","سیاهکل","دیلمان",23,366,3,2,17,388,5,393
"گیلان","سیاهکل","دیلمان",24,184,0,1,10,195,0,195
"گیلان","سیاهکل","دیلمان",25,186,2,0,25,213,3,216
"گیلان","سیاهکل","دیلمان",26,228,0,0,10,238,0,238
"گیلان","سیاهکل","دیلمان",27,264,2,0,26,292,0,292
"گیلان","سیاهکل","دیلمان",28,308,1,4,19,332,1,333
"گیلان","سیاهکل","دیلمان",29,112,0,1,20,133,0,133
"گیلان","شفت","مرکزی",1,136,3,2,90,231,2,233
"گیلان","شفت","مرکزی",2,458,3,1,268,730,11,741
"گیلان","شفت","مرکزی",3,347,2,0,166,515,7,522
"گیلان","شفت","مرکزی",4,243,3,0,169,415,6,421
"گیلان","شفت","مرکزی",5,726,5,3,417,1151,15,1166
"گیلان","شفت","مرکزی",6,371,8,4,198,581,4,585
"گیلان","شفت","مرکزی",7,501,6,4,308,819,12,831
"گیلان","شفت","مرکزی",8,415,2,2,112,531,3,534
"گیلان","شفت","مرکزی",9,282,0,0,36,318,0,318
"گیلان","شفت","مرکزی",10,147,0,0,16,163,3,166
"گیلان","شفت","مرکزی",11,213,5,0,67,285,0,285
"گیلان","شفت","مرکزی",12,204,1,0,45,250,0,250
"گیلان","شفت","مرکزی",13,263,0,0,23,286,4,290
"گیلان","شفت","مرکزی",14,304,2,4,78,388,3,391
"گیلان","شفت","مرکزی",15,439,1,0,94,534,2,536
"گیلان","شفت","مرکزی",16,412,2,0,36,450,3,453
"گیلان","شفت","مرکزی",17,147,0,0,52,199,2,201
"گیلان","شفت","مرکزی",18,337,9,0,111,457,4,461
"گیلان","شفت","مرکزی",19,202,0,0,24,226,0,226
"گیلان","شفت","مرکزی",20,299,0,0,18,317,1,318
"گیلان","شفت","مرکزی",21,390,1,0,34,425,2,427
"گیلان","شفت","مرکزی",22,211,1,0,27,239,0,239
"گیلان","شفت","مرکزی",23,117,0,0,19,136,2,138
"گیلان","شفت","مرکزی",24,493,2,1,51,547,3,550
"گیلان","شفت","مرکزی",25,252,1,4,23,280,0,280
"گیلان","شفت","مرکزی",26,322,0,2,98,422,0,422
"گیلان","شفت","مرکزی",27,474,1,0,45,520,6,526
"گیلان","شفت","مرکزی",28,493,4,1,143,641,8,649
"گیلان","شفت","مرکزی",29,251,0,0,53,304,1,305
"گیلان","شفت","مرکزی",30,286,0,0,24,310,0,310
"گیلان","شفت","مرکزی",31,324,1,1,46,372,0,372
"گیلان","شفت","مرکزی",32,215,3,1,29,248,3,251
"گیلان","شفت","مرکزی",33,342,0,1,109,452,5,457
"گیلان","شفت","مرکزی",34,164,1,0,14,179,1,180
"گیلان","شفت","مرکزی",35,184,0,0,20,204,0,204
"گیلان","شفت","مرکزی",36,262,0,0,11,273,0,273
"گیلان","شفت","مرکزی",37,100,0,0,5,105,1,106
"گیلان","شفت","مرکزی",38,370,1,2,49,422,0,422
"گیلان","شفت","مرکزی",39,131,1,0,12,144,0,144
"گیلان","شفت","مرکزی",40,243,1,0,10,254,1,255
"گیلان","شفت","مرکزی",41,164,0,0,14,178,0,178
"گیلان","شفت","مرکزی",42,337,0,0,7,344,2,346
"گیلان","شفت","مرکزی",43,327,1,0,27,355,3,358
"گیلان","شفت","مرکزی",44,134,0,0,17,151,0,151
"گیلان","شفت","مرکزی",45,251,0,0,26,277,0,277
"گیلان","شفت","مرکزی",46,184,0,0,4,188,0,188
"گیلان","شفت","مرکزی",47,289,0,0,22,311,3,314
"گیلان","شفت","مرکزی",48,241,1,0,51,293,4,297
"گیلان","شفت","مرکزی",49,463,4,1,144,612,9,621
"گیلان","شفت","مرکزی",50,502,2,0,76,580,2,582
"گیلان","شفت","مرکزی",51,362,0,0,105,467,5,472
"گیلان","شفت","مرکزی",52,218,0,0,40,258,3,261
"گیلان","شفت","مرکزی",53,82,1,0,9,92,0,92
"گیلان","شفت","مرکزی",54,105,3,0,12,120,1,121
"گیلان","شفت","مرکزی",55,242,0,0,14,256,0,256
"گیلان","شفت","مرکزی",56,153,0,0,29,182,0,182
"گیلان","شفت","مرکزی",57,582,5,2,129,718,6,724
"گیلان","شفت","مرکزی",58,280,6,0,45,331,5,336
"گیلان","شفت","مرکزی",59,440,3,0,84,527,3,530
"گیلان","شفت","مرکزی",60,347,0,0,42,389,2,391
"گیلان","شفت","مرکزی",61,410,7,4,119,540,1,541
"گیلان","شفت","مرکزی",62,555,8,2,243,808,4,812
"گیلان","شفت","مرکزی",63,543,12,2,213,770,7,777
"گیلان","شفت","مرکزی",64,750,5,2,117,874,12,886
"گیلان","شفت","مرکزی",65,369,1,5,75,450,1,451
"گیلان","شفت","مرکزی",66,358,1,1,114,474,10,484
"گیلان","شفت","مرکزی",67,563,2,12,106,683,7,690
"گیلان","شفت","احمدسرگوراب",1,265,2,2,186,455,8,463
"گیلان","شفت","احمدسرگوراب",2,553,4,1,322,880,9,889
"گیلان","شفت","احمدسرگوراب",3,122,1,0,32,155,3,158
"گیلان","شفت","احمدسرگوراب",4,551,4,1,79,635,2,637
"گیلان","شفت","احمدسرگوراب",5,759,2,1,72,834,5,839
"گیلان","شفت","احمدسرگوراب",6,483,3,2,141,629,5,634
"گیلان","شفت","احمدسرگوراب",7,504,3,0,54,561,2,563
"گیلان","شفت","احمدسرگوراب",8,485,3,0,126,614,6,620
"گیلان","شفت","احمدسرگوراب",9,584,2,0,95,681,8,689
"گیلان","شفت","احمدسرگوراب",10,302,5,0,58,365,5,370
"گیلان","شفت","احمدسرگوراب",11,337,0,0,24,361,5,366
"گیلان","شفت","احمدسرگوراب",12,417,2,0,25,444,2,446
"گیلان","شفت","احمدسرگوراب",13,341,0,0,8,349,2,351
"گیلان","شفت","احمدسرگوراب",14,602,1,1,201,805,6,811
"گیلان","شفت","احمدسرگوراب",15,364,0,0,26,390,3,393
"گیلان","شفت","احمدسرگوراب",16,130,0,0,39,169,1,170
"گیلان","شفت","احمدسرگوراب",17,382,0,0,24,406,2,408
"گیلان","شفت","احمدسرگوراب",18,465,3,0,52,520,5,525
"گیلان","شفت","احمدسرگوراب",19,184,0,0,5,189,0,189
"گیلان","شفت","احمدسرگوراب",20,353,4,0,225,582,4,586
"گیلان","شفت","احمدسرگوراب",21,429,0,2,144,575,1,576
"گیلان","شفت","احمدسرگوراب",22,170,0,0,19,189,0,189
"گیلان","شفت","احمدسرگوراب",23,412,4,0,41,457,4,461
"گیلان","شفت","احمدسرگوراب",24,265,1,0,69,335,4,339
"گیلان","شفت","احمدسرگوراب",25,372,1,0,54,427,3,430
"گیلان","شفت","احمدسرگوراب",26,301,0,0,146,447,0,447
"گیلان","شفت","احمدسرگوراب",27,241,2,0,174,417,7,424
"گیلان","شفت","احمدسرگوراب",28,293,1,1,192,487,6,493
"گیلان","شفت","احمدسرگوراب",29,132,1,0,72,205,4,209
"گیلان","شفت","احمدسرگوراب",30,465,3,0,193,661,6,667
"گیلان","شفت","احمدسرگوراب",31,181,0,0,13,194,4,198
"گیلان","شفت","احمدسرگوراب",32,224,0,0,21,245,3,248
"گیلان","شفت","احمدسرگوراب",33,128,1,0,36,165,0,165
"گیلان","شفت","احمدسرگوراب",34,99,1,1,47,148,0,148
"گیلان","شفت","احمدسرگوراب",35,312,2,2,85,401,4,405
"گیلان","شفت","احمدسرگوراب",36,309,5,1,223,538,7,545
"گیلان","شفت","احمدسرگوراب",37,255,1,0,80,336,1,337
"گیلان","شفت","احمدسرگوراب",38,276,0,0,45,321,0,321
"گیلان","شفت","احمدسرگوراب",39,192,2,0,80,274,4,278
"گیلان","شفت","احمدسرگوراب",40,154,0,0,17,171,3,174
"گیلان","شفت","احمدسرگوراب",41,307,0,0,85,392,3,395
"گیلان","شفت","احمدسرگوراب",42,351,3,0,46,400,1,401
"گیلان","شفت","احمدسرگوراب",43,521,0,0,14,535,4,539
"گیلان","شفت","احمدسرگوراب",44,193,2,0,55,250,1,251
"گیلان","شفت","احمدسرگوراب",45,104,1,0,8,113,1,114
"گیلان","شفت","احمدسرگوراب",46,134,2,0,22,158,1,159
"گیلان","شفت","احمدسرگوراب",47,168,0,0,60,228,3,231
"گیلان","شفت","احمدسرگوراب",48,100,2,0,12,114,0,114
"گیلان","صومعه_سرا","مرکزی",1,418,5,3,267,693,7,700
"گیلان","صومعه_سرا","مرکزی",2,578,5,10,376,969,17,986
"گیلان","صومعه_سرا","مرکزی",3,490,15,3,434,942,21,963
"گیلان","صومعه_سرا","مرکزی",4,1017,11,6,483,1517,22,1539
"گیلان","صومعه_سرا","مرکزی",5,992,17,5,418,1432,15,1447
"گیلان","صومعه_سرا","مرکزی",6,544,11,13,629,1197,23,1220
"گیلان","صومعه_سرا","مرکزی",7,349,8,1,381,739,15,754
"گیلان","صومعه_سرا","مرکزی",8,450,15,4,308,777,9,786
"گیلان","صومعه_سرا","مرکزی",9,617,18,1,390,1026,13,1039
"گیلان","صومعه_سرا","مرکزی",10,240,1,1,100,342,6,348
"گیلان","صومعه_سرا","مرکزی",11,834,10,3,515,1362,0,1362
"گیلان","صومعه_سرا","مرکزی",12,468,7,3,411,889,19,908
"گیلان","صومعه_سرا","مرکزی",13,534,4,2,224,764,4,768
"گیلان","صومعه_سرا","مرکزی",14,780,11,4,314,1109,14,1123
"گیلان","صومعه_سرا","مرکزی",15,406,8,3,300,717,7,724
"گیلان","صومعه_سرا","مرکزی",16,231,5,4,123,363,2,365
"گیلان","صومعه_سرا","مرکزی",17,688,15,4,515,1222,21,1243
"گیلان","صومعه_سرا","مرکزی",18,668,22,3,422,1115,9,1124
"گیلان","صومعه_سرا","مرکزی",19,447,5,5,278,735,9,744
"گیلان","صومعه_سرا","مرکزی",20,459,7,5,370,841,15,856
"گیلان","صومعه_سرا","مرکزی",21,174,2,1,72,249,4,253
"گیلان","صومعه_سرا","مرکزی",22,321,2,1,193,517,2,519
"گیلان","صومعه_سرا","مرکزی",23,316,3,1,196,516,5,521
"گیلان","صومعه_سرا","مرکزی",24,529,1,0,160,690,6,696
"گیلان","صومعه_سرا","مرکزی",25,189,1,0,23,213,1,214
"گیلان","صومعه_سرا","مرکزی",26,281,0,0,47,328,2,330
"گیلان","صومعه_سرا","مرکزی",27,345,1,0,95,441,5,446
"گیلان","صومعه_سرا","مرکزی",28,458,1,0,36,495,6,501
"گیلان","صومعه_سرا","مرکزی",29,353,5,1,63,422,11,433
"گیلان","صومعه_سرا","مرکزی",30,515,2,1,139,657,3,660
"گیلان","صومعه_سرا","مرکزی",31,257,1,3,48,309,1,310
"گیلان","صومعه_سرا","مرکزی",32,370,1,0,66,437,0,437
"گیلان","صومعه_سرا","مرکزی",33,300,5,2,45,352,0,352
"گیلان","صومعه_سرا","مرکزی",34,137,1,0,12,150,1,151
"گیلان","صومعه_سرا","مرکزی",35,99,0,2,8,109,1,110
"گیلان","صومعه_سرا","مرکزی",36,120,3,0,38,161,0,161
"گیلان","صومعه_سرا","مرکزی",37,261,0,0,153,414,1,415
"گیلان","صومعه_سرا","مرکزی",38,199,1,0,15,215,1,216
"گیلان","صومعه_سرا","مرکزی",39,225,1,0,44,270,1,271
"گیلان","صومعه_سرا","مرکزی",40,267,2,2,66,337,6,343
"گیلان","صومعه_سرا","مرکزی",41,197,0,1,43,241,2,243
"گیلان","صومعه_سرا","مرکزی",42,307,1,0,158,466,2,468
"گیلان","صومعه_سرا","مرکزی",43,118,2,0,69,189,0,189
"گیلان","صومعه_سرا","مرکزی",44,380,0,1,124,505,0,505
"گیلان","صومعه_سرا","مرکزی",45,309,2,0,25,336,2,338
"گیلان","صومعه_سرا","مرکزی",46,162,0,0,22,184,2,186
"گیلان","صومعه_سرا","مرکزی",47,148,3,1,62,214,1,215
"گیلان","صومعه_سرا","مرکزی",48,486,3,3,113,605,3,608
"گیلان","صومعه_سرا","مرکزی",49,460,7,1,178,646,6,652
"گیلان","صومعه_سرا","مرکزی",50,84,2,0,30,116,0,116
"گیلان","صومعه_سرا","مرکزی",51,165,1,4,59,229,1,230
"گیلان","صومعه_سرا","مرکزی",52,259,2,1,73,335,5,340
"گیلان","صومعه_سرا","مرکزی",53,240,0,1,42,283,1,284
"گیلان","صومعه_سرا","مرکزی",54,212,2,5,87,306,2,308
"گیلان","صومعه_سرا","مرکزی",55,159,0,0,43,202,4,206
"گیلان","صومعه_سرا","مرکزی",56,163,2,2,65,232,4,236
"گیلان","صومعه_سرا","مرکزی",57,273,1,6,50,330,1,331
"گیلان","صومعه_سرا","مرکزی",58,171,2,0,54,227,2,229
"گیلان","صومعه_سرا","مرکزی",59,449,4,3,185,641,9,650
"گیلان","صومعه_سرا","مرکزی",60,337,4,2,111,454,15,469
"گیلان","صومعه_سرا","مرکزی",61,153,2,2,24,181,1,182
"گیلان","صومعه_سرا","مرکزی",62,192,0,0,37,229,2,231
"گیلان","صومعه_سرا","مرکزی",63,197,0,0,40,237,1,238
"گیلان","صومعه_سرا","مرکزی",64,118,1,0,29,148,3,151
"گیلان","صومعه_سرا","مرکزی",65,223,0,1,63,287,2,289
"گیلان","صومعه_سرا","مرکزی",66,154,0,0,64,218,0,218
"گیلان","صومعه_سرا","مرکزی",67,194,0,1,45,240,0,240
"گیلان","صومعه_سرا","مرکزی",68,182,0,2,40,224,1,225
"گیلان","صومعه_سرا","مرکزی",69,131,2,0,23,156,0,156
"گیلان","صومعه_سرا","مرکزی",70,202,0,0,34,236,1,237
"گیلان","صومعه_سرا","مرکزی",71,281,1,0,66,348,1,349
"گیلان","صومعه_سرا","مرکزی",72,303,1,1,31,336,0,336
"گیلان","صومعه_سرا","مرکزی",73,157,0,0,31,188,3,191
"گیلان","صومعه_سرا","مرکزی",74,308,1,0,19,328,1,329
"گیلان","صومعه_سرا","مرکزی",75,494,3,0,78,575,5,580
"گیلان","صومعه_سرا","مرکزی",76,80,0,0,9,89,1,90
"گیلان","صومعه_سرا","مرکزی",77,178,5,1,26,210,1,211
"گیلان","صومعه_سرا","مرکزی",78,135,2,0,68,205,3,208
"گیلان","صومعه_سرا","مرکزی",79,114,0,0,12,126,0,126
"گیلان","صومعه_سرا","مرکزی",80,99,2,0,29,130,1,131
"گیلان","صومعه_سرا","مرکزی",81,95,1,0,56,152,2,154
"گیلان","صومعه_سرا","مرکزی",82,127,0,0,28,155,2,157
"گیلان","صومعه_سرا","مرکزی",83,203,0,0,33,236,3,239
"گیلان","صومعه_سرا","مرکزی",84,136,0,0,64,200,0,200
"گیلان","صومعه_سرا","مرکزی",85,694,2,0,219,915,9,924
"گیلان","صومعه_سرا","مرکزی",86,361,3,0,78,442,3,445
"گیلان","صومعه_سرا","مرکزی",87,772,8,1,307,1088,12,1100
"گیلان","صومعه_سرا","مرکزی",88,412,3,0,148,563,11,574
"گیلان","صومعه_سرا","مرکزی",89,241,0,0,110,351,1,352
"گیلان","صومعه_سرا","مرکزی",90,160,1,1,54,216,1,217
"گیلان","صومعه_سرا","مرکزی",91,260,3,3,150,416,6,422
"گیلان","صومعه_سرا","مرکزی",92,110,0,0,39,149,1,150
"گیلان","صومعه_سرا","مرکزی",93,122,1,0,32,155,1,156
"گیلان","صومعه_سرا","مرکزی",94,199,0,0,29,228,0,228
"گیلان","صومعه_سرا","مرکزی",95,131,0,1,36,168,2,170
"گیلان","صومعه_سرا","مرکزی",96,66,0,0,19,85,0,85
"گیلان","صومعه_سرا","مرکزی",97,83,1,0,13,97,1,98
"گیلان","صومعه_سرا","مرکزی",98,161,0,0,7,168,0,168
"گیلان","صومعه_سرا","مرکزی",99,178,0,0,8,186,3,189
"گیلان","صومعه_سرا","مرکزی",100,289,2,0,45,336,4,340
"گیلان","صومعه_سرا","مرکزی",101,155,0,0,58,213,2,215
"گیلان","صومعه_سرا","مرکزی",102,113,0,0,8,121,0,121
"گیلان","صومعه_سرا","مرکزی",103,144,0,0,17,161,2,163
"گیلان","صومعه_سرا","مرکزی",104,387,1,0,55,443,2,445
"گیلان","صومعه_سرا","مرکزی",105,71,1,0,31,103,1,104
"گیلان","صومعه_سرا","مرکزی",106,133,0,0,11,144,0,144
"گیلان","صومعه_سرا","مرکزی",107,456,3,0,68,527,5,532
"گیلان","صومعه_سرا","مرکزی",108,224,0,0,33,257,3,260
"گیلان","صومعه_سرا","مرکزی",109,174,2,0,42,218,1,219
"گیلان","صومعه_سرا","مرکزی",110,125,1,0,5,131,0,131
"گیلان","صومعه_سرا","مرکزی",111,172,0,0,26,198,1,199
"گیلان","صومعه_سرا","مرکزی",112,297,2,0,10,309,3,312
"گیلان","صومعه_سرا","مرکزی",113,228,3,0,72,303,6,309
"گیلان","صومعه_سرا","مرکزی",114,254,0,0,14,268,3,271
"گیلان","صومعه_سرا","تولمات",115,374,0,3,176,553,9,562
"گیلان","صومعه_سرا","تولمات",116,771,8,10,270,1059,9,1068
"گیلان","صومعه_سرا","تولمات",117,468,5,15,260,748,15,763
"گیلان","صومعه_سرا","تولمات",118,511,7,2,241,761,12,773
"گیلان","صومعه_سرا","تولمات",119,570,1,0,124,695,5,700
"گیلان","صومعه_سرا","تولمات",120,275,3,0,158,436,1,437
"گیلان","صومعه_سرا","تولمات",121,219,2,0,78,299,4,303
"گیلان","صومعه_سرا","تولمات",122,313,0,0,132,445,5,450
"گیلان","صومعه_سرا","تولمات",123,486,5,0,215,706,13,719
"گیلان","صومعه_سرا","تولمات",124,690,2,0,226,918,5,923
"گیلان","صومعه_سرا","تولمات",125,343,0,0,97,440,1,441
"گیلان","صومعه_سرا","تولمات",126,740,3,0,104,847,9,856
"گیلان","صومعه_سرا","تولمات",127,438,1,0,57,496,4,500
"گیلان","صومعه_سرا","تولمات",128,752,4,0,122,878,12,890
"گیلان","صومعه_سرا","تولمات",129,726,0,4,181,911,5,916
"گیلان","صومعه_سرا","تولمات",130,684,10,1,69,764,6,770
"گیلان","صومعه_سرا","تولمات",131,310,2,0,166,478,2,480
"گیلان","صومعه_سرا","تولمات",132,195,1,0,113,309,3,312
"گیلان","صومعه_سرا","تولمات",133,395,2,0,39,436,0,436
"گیلان","صومعه_سرا","تولمات",134,463,2,0,130,595,2,597
"گیلان","صومعه_سرا","تولمات",135,387,2,0,97,486,0,486
"گیلان","صومعه_سرا","تولمات",136,365,1,1,99,466,1,467
"گیلان","صومعه_سرا","تولمات",137,532,1,5,112,650,2,652
"گیلان","صومعه_سرا","تولمات",138,401,3,0,99,503,5,508
"گیلان","صومعه_سرا","تولمات",139,127,0,0,28,155,3,158
"گیلان","صومعه_سرا","تولمات",140,361,0,0,19,380,2,382
"گیلان","صومعه_سرا","تولمات",141,310,2,0,57,369,7,376
"گیلان","صومعه_سرا","تولمات",142,283,2,0,40,325,2,327
"گیلان","صومعه_سرا","تولمات",143,289,0,0,80,369,4,373
"گیلان","صومعه_سرا","تولمات",144,265,1,2,97,365,4,369
"گیلان","صومعه_سرا","تولمات",145,262,1,1,35,299,1,300
"گیلان","صومعه_سرا","تولمات",146,291,1,2,115,409,3,412
"گیلان","صومعه_سرا","تولمات",147,295,0,0,36,331,1,332
"گیلان","صومعه_سرا","تولمات",148,203,0,56,42,301,1,302
"گیلان","صومعه_سرا","تولمات",149,338,0,0,90,428,4,432
"گیلان","صومعه_سرا","تولمات",150,373,1,1,124,499,5,504
"گیلان","صومعه_سرا","تولمات",151,175,0,0,69,244,5,249
"گیلان","صومعه_سرا","تولمات",152,222,0,0,51,273,1,274
"گیلان","صومعه_سرا","تولمات",153,354,1,0,118,473,1,474
"گیلان","صومعه_سرا","تولمات",154,232,1,0,92,325,4,329
"گیلان","صومعه_سرا","تولمات",155,225,3,0,24,252,0,252
"گیلان","صومعه_سرا","میرزاکوچک",156,644,14,1,207,866,7,873
"گیلان","صومعه_سرا","میرزاکوچک",157,506,7,1,161,675,9,684
"گیلان","صومعه_سرا","میرزاکوچک",158,270,1,0,60,331,0,331
"گیلان","صومعه_سرا","میرزاکوچک",159,175,0,0,45,220,0,220
"گیلان","صومعه_سرا","میرزاکوچک",160,343,1,2,100,446,8,454
"گیلان","صومعه_سرا","میرزاکوچک",161,253,1,0,76,330,3,333
"گیلان","صومعه_سرا","میرزاکوچک",162,795,2,1,193,991,9,1000
"گیلان","صومعه_سرا","میرزاکوچک",163,494,0,2,44,540,2,542
"گیلان","صومعه_سرا","میرزاکوچک",164,346,0,0,60,406,0,406
"گیلان","صومعه_سرا","میرزاکوچک",165,270,1,0,112,383,1,384
"گیلان","صومعه_سرا","میرزاکوچک",166,439,2,7,86,534,0,534
"گیلان","صومعه_سرا","میرزاکوچک",167,460,0,0,15,475,0,475
"گیلان","صومعه_سرا","میرزاکوچک",168,267,0,0,31,298,0,298
"گیلان","صومعه_سرا","میرزاکوچک",169,487,0,0,7,494,0,494
"گیلان","صومعه_سرا","میرزاکوچک",170,136,0,0,18,154,0,154
"گیلان","صومعه_سرا","میرزاکوچک",171,747,5,2,241,995,4,999
"گیلان","صومعه_سرا","میرزاکوچک",172,272,0,0,40,312,0,312
"گیلان","صومعه_سرا","میرزاکوچک",173,396,2,0,78,476,8,484
"گیلان","صومعه_سرا","میرزاکوچک",174,217,2,2,66,287,4,291
"گیلان","صومعه_سرا","میرزاکوچک",175,392,0,1,35,428,1,429
"گیلان","صومعه_سرا","میرزاکوچک",176,549,0,0,70,619,5,624
"گیلان","صومعه_سرا","میرزاکوچک",177,365,1,1,61,428,4,432
"گیلان","صومعه_سرا","میرزاکوچک",178,386,3,0,64,453,1,454
"گیلان","صومعه_سرا","میرزاکوچک",179,468,0,0,65,533,0,533
"گیلان","صومعه_سرا","میرزاکوچک",180,503,0,0,63,566,1,567
"گیلان","صومعه_سرا","میرزاکوچک",181,406,1,0,53,460,7,467
"گیلان","صومعه_سرا","میرزاکوچک",182,288,0,0,9,297,1,298
"گیلان","صومعه_سرا","میرزاکوچک",183,143,0,1,9,153,2,155
"گیلان","صومعه_سرا","میرزاکوچک",184,357,0,0,11,368,0,368
"گیلان","صومعه_سرا","میرزاکوچک",185,330,0,0,41,371,2,373
"گیلان","صومعه_سرا","میرزاکوچک",186,595,0,0,79,674,2,676
"گیلان","صومعه_سرا","میرزاکوچک",187,187,0,0,28,215,0,215
"گیلان","صومعه_سرا","میرزاکوچک",188,191,2,0,25,218,0,218
"گیلان","صومعه_سرا","میرزاکوچک",189,482,0,0,124,606,3,609
"گیلان","صومعه_سرا","میرزاکوچک",190,195,0,0,50,245,1,246
"گیلان","صومعه_سرا","میرزاکوچک",191,342,1,1,51,395,5,400
"گیلان","صومعه_سرا","میرزاکوچک",192,216,3,0,23,242,5,247
"گیلان","صومعه_سرا","میرزاکوچک",193,134,0,0,14,148,4,152
"گیلان","صومعه_سرا","میرزاکوچک",194,83,1,0,49,133,3,136
"گیلان","صومعه_سرا","میرزاکوچک",195,198,0,0,30,228,0,228
"گیلان","صومعه_سرا","میرزاکوچک",196,287,0,3,39,329,1,330
"گیلان","صومعه_سرا","میرزاکوچک",197,220,3,0,67,290,2,292
"گیلان","تالش","مرکزی",1,882,11,13,611,1517,15,1532
"گیلان","تالش","مرکزی",2,360,7,2,128,497,7,504
"گیلان","تالش","مرکزی",3,150,4,1,74,229,1,230
"گیلان","تالش","مرکزی",4,443,2,5,109,559,3,562
"گیلان","تالش","مرکزی",5,510,0,2,84,596,4,600
"گیلان","تالش","مرکزی",6,545,4,2,197,748,9,757
"گیلان","تالش","مرکزی",7,375,3,4,433,815,5,820
"گیلان","تالش","مرکزی",8,199,4,3,221,427,11,438
"گیلان","تالش","مرکزی",9,341,14,2,397,754,6,760
"گیلان","تالش","مرکزی",10,153,6,1,184,344,6,350
"گیلان","تالش","مرکزی",11,307,2,5,377,691,7,698
"گیلان","تالش","مرکزی",12,266,3,1,331,601,3,604
"گیلان","تالش","مرکزی",13,152,6,1,176,335,7,342
"گیلان","تالش","مرکزی",14,155,3,0,187,345,4,349
"گیلان","تالش","مرکزی",15,469,13,11,439,932,11,943
"گیلان","تالش","مرکزی",16,387,8,7,476,878,14,892
"گیلان","تالش","مرکزی",17,192,4,2,183,381,3,384
"گیلان","تالش","مرکزی",18,404,4,4,477,889,11,900
"گیلان","تالش","مرکزی",19,263,8,0,393,664,11,675
"گیلان","تالش","مرکزی",20,350,4,1,255,610,2,612
"گیلان","تالش","مرکزی",21,532,7,10,540,1089,10,1099
"گیلان","تالش","مرکزی",22,249,3,1,178,431,3,434
"گیلان","تالش","مرکزی",23,515,8,0,319,842,12,854
"گیلان","تالش","مرکزی",24,355,2,1,191,549,3,552
"گیلان","تالش","مرکزی",25,511,4,4,331,850,8,858
"گیلان","تالش","مرکزی",26,468,7,2,262,739,10,749
"گیلان","تالش","مرکزی",27,311,2,2,87,402,4,406
"گیلان","تالش","مرکزی",28,448,7,4,84,543,10,553
"گیلان","تالش","مرکزی",29,378,5,1,80,464,4,468
"گیلان","تالش","مرکزی",30,166,1,2,197,366,3,369
"گیلان","تالش","مرکزی",31,176,5,0,119,300,4,304
"گیلان","تالش","مرکزی",32,512,4,19,155,690,2,692
"گیلان","تالش","مرکزی",33,413,3,0,60,476,1,477
"گیلان","تالش","مرکزی",34,139,0,1,97,237,2,239
"گیلان","تالش","مرکزی",35,123,2,0,58,183,1,184
"گیلان","تالش","مرکزی",36,368,0,4,158,530,6,536
"گیلان","تالش","مرکزی",37,588,9,2,371,970,8,978
"گیلان","تالش","مرکزی",38,271,6,2,154,433,4,437
"گیلان","تالش","مرکزی",39,110,6,1,69,186,1,187
"گیلان","تالش","مرکزی",40,182,3,0,103,288,0,288
"گیلان","تالش","مرکزی",41,277,4,1,265,547,3,550
"گیلان","تالش","مرکزی",42,266,2,3,190,461,4,465
"گیلان","تالش","مرکزی",43,307,5,5,315,632,9,641
"گیلان","تالش","مرکزی",44,194,1,0,94,289,1,290
"گیلان","تالش","مرکزی",45,360,2,6,221,589,9,598
"گیلان","تالش","مرکزی",46,250,3,2,87,342,1,343
"گیلان","تالش","مرکزی",47,354,1,5,27,387,3,390
"گیلان","تالش","مرکزی",48,760,3,1,103,867,0,867
"گیلان","تالش","مرکزی",49,392,4,2,129,527,1,528
"گیلان","تالش","مرکزی",50,463,0,1,30,494,0,494
"گیلان","تالش","مرکزی",51,383,0,7,40,430,6,436
"گیلان","تالش","مرکزی",52,420,1,2,89,512,6,518
"گیلان","تالش","مرکزی",53,390,5,2,47,444,5,449
"گیلان","تالش","مرکزی",54,379,2,1,56,438,1,439
"گیلان","تالش","مرکزی",55,161,0,0,31,192,3,195
"گیلان","تالش","مرکزی",56,530,3,4,118,655,2,657
"گیلان","تالش","مرکزی",57,100,0,0,91,191,1,192
"گیلان","تالش","مرکزی",58,87,0,0,27,114,1,115
"گیلان","تالش","مرکزی",59,120,1,1,40,162,0,162
"گیلان","تالش","مرکزی",60,169,1,1,114,285,7,292
"گیلان","تالش","مرکزی",61,222,1,0,93,316,2,318
"گیلان","تالش","مرکزی",62,242,0,0,85,327,0,327
"گیلان","تالش","مرکزی",63,347,0,0,32,379,0,379
"گیلان","تالش","مرکزی",64,109,0,1,40,150,0,150
"گیلان","تالش","مرکزی",65,148,0,0,139,287,1,288
"گیلان","تالش","مرکزی",66,185,1,1,92,279,1,280
"گیلان","تالش","مرکزی",67,212,1,0,70,283,5,288
"گیلان","تالش","مرکزی",68,249,0,1,82,332,3,335
"گیلان","تالش","مرکزی",69,345,0,0,45,390,3,393
"گیلان","تالش","مرکزی",70,174,0,0,31,205,2,207
"گیلان","تالش","مرکزی",71,401,4,1,84,490,2,492
"گیلان","تالش","مرکزی",72,409,0,3,54,466,0,466
"گیلان","تالش","مرکزی",73,470,0,2,88,560,5,565
"گیلان","تالش","مرکزی",74,412,2,4,202,620,4,624
"گیلان","تالش","مرکزی",75,544,4,1,154,703,4,707
"گیلان","تالش","مرکزی",76,160,2,1,57,220,1,221
"گیلان","تالش","مرکزی",77,130,5,4,47,186,2,188
"گیلان","تالش","مرکزی",78,222,4,0,27,253,0,253
"گیلان","تالش","مرکزی",79,284,0,0,34,318,4,322
"گیلان","تالش","مرکزی",80,121,0,1,48,170,0,170
"گیلان","تالش","مرکزی",81,94,1,0,14,109,0,109
"گیلان","تالش","مرکزی",82,771,5,2,215,993,4,997
"گیلان","تالش","مرکزی",83,447,3,6,127,583,2,585
"گیلان","تالش","مرکزی",84,323,0,0,64,387,5,392
"گیلان","تالش","مرکزی",85,229,1,0,30,260,1,261
"گیلان","تالش","مرکزی",86,137,1,0,66,204,2,206
"گیلان","تالش","مرکزی",87,349,2,1,91,443,2,445
"گیلان","تالش","مرکزی",88,492,5,1,150,648,2,650
"گیلان","تالش","مرکزی",89,262,0,2,76,340,3,343
"گیلان","تالش","مرکزی",90,302,1,0,35,338,0,338
"گیلان","تالش","مرکزی",91,342,0,4,34,380,1,381
"گیلان","تالش","مرکزی",92,237,2,0,28,267,0,267
"گیلان","تالش","مرکزی",93,200,2,0,130,332,0,332
"گیلان","تالش","مرکزی",94,444,0,0,62,506,1,507
"گیلان","تالش","مرکزی",95,318,0,0,44,362,2,364
"گیلان","تالش","مرکزی",96,518,0,1,16,535,1,536
"گیلان","تالش","مرکزی",97,271,0,0,48,319,2,321
"گیلان","تالش","مرکزی",98,175,0,0,43,218,0,218
"گیلان","تالش","مرکزی",99,80,1,0,15,96,0,96
"گیلان","تالش","مرکزی",100,143,0,0,19,162,0,162
"گیلان","تالش","مرکزی",101,389,2,1,67,459,3,462
"گیلان","تالش","مرکزی",102,353,1,0,25,379,3,382
"گیلان","تالش","مرکزی",103,546,0,1,43,590,1,591
"گیلان","تالش","مرکزی",104,381,0,0,29,410,1,411
"گیلان","تالش","مرکزی",105,460,0,0,38,498,1,499
"گیلان","تالش","اسالم",1,555,11,6,224,796,4,800
"گیلان","تالش","اسالم",2,214,2,1,112,329,9,338
"گیلان","تالش","اسالم",3,260,2,0,169,431,7,438
"گیلان","تالش","اسالم",4,455,6,0,237,698,14,712
"گیلان","تالش","اسالم",5,276,2,1,263,542,8,550
"گیلان","تالش","اسالم",6,305,4,3,271,583,8,591
"گیلان","تالش","اسالم",7,556,8,10,415,989,10,999
"گیلان","تالش","اسالم",8,254,5,0,150,409,5,414
"گیلان","تالش","اسالم",9,202,0,1,95,298,1,299
"گیلان","تالش","اسالم",10,360,4,1,266,631,3,634
"گیلان","تالش","اسالم",11,281,4,0,274,559,17,576
"گیلان","تالش","اسالم",12,264,2,0,104,370,3,373
"گیلان","تالش","اسالم",13,664,7,1,342,1014,10,1024
"گیلان","تالش","اسالم",14,299,1,2,217,519,4,523
"گیلان","تالش","اسالم",15,311,2,1,96,410,1,411
"گیلان","تالش","اسالم",16,313,1,1,163,478,1,479
"گیلان","تالش","اسالم",17,220,1,0,82,303,1,304
"گیلان","تالش","اسالم",18,482,4,2,204,692,8,700
"گیلان","تالش","اسالم",19,480,2,1,258,741,19,760
"گیلان","تالش","اسالم",20,487,4,5,239,735,23,758
"گیلان","تالش","اسالم",21,387,2,3,172,564,2,566
"گیلان","تالش","اسالم",22,425,1,0,170,596,4,600
"گیلان","تالش","اسالم",23,130,0,1,37,168,1,169
"گیلان","تالش","اسالم",24,228,1,1,213,443,5,448
"گیلان","تالش","اسالم",25,151,2,0,76,229,1,230
"گیلان","تالش","اسالم",26,230,3,0,114,347,3,350
"گیلان","تالش","اسالم",27,136,0,0,28,164,0,164
"گیلان","تالش","اسالم",28,111,0,0,115,226,4,230
"گیلان","تالش","اسالم",29,116,0,0,37,153,1,154
"گیلان","تالش","اسالم",30,97,1,0,51,149,1,150
"گیلان","تالش","اسالم",31,249,0,1,81,331,1,332
"گیلان","تالش","اسالم",32,333,1,1,91,426,3,429
"گیلان","تالش","اسالم",33,467,1,1,87,556,4,560
"گیلان","تالش","اسالم",34,233,0,2,148,383,4,387
"گیلان","تالش","اسالم",35,131,1,0,26,158,1,159
"گیلان","تالش","اسالم",36,270,0,2,193,465,12,477
"گیلان","تالش","اسالم",37,470,3,3,191,667,6,673
"گیلان","تالش","اسالم",38,192,1,0,60,253,2,255
"گیلان","تالش","اسالم",39,296,0,0,142,438,10,448
"گیلان","تالش","اسالم",40,352,3,5,87,447,0,447
"گیلان","تالش","اسالم",41,447,1,3,208,659,6,665
"گیلان","تالش","اسالم",42,215,1,1,53,270,2,272
"گیلان","تالش","اسالم",43,319,1,0,84,404,4,408
"گیلان","تالش","اسالم",44,370,1,3,54,428,4,432
"گیلان","تالش","اسالم",45,417,6,0,193,616,0,616
"گیلان","تالش","اسالم",46,229,0,0,181,410,5,415
"گیلان","تالش","اسالم",47,223,2,0,153,378,7,385
"گیلان","تالش","اسالم",48,251,0,0,94,345,2,347
"گیلان","تالش","اسالم",49,216,0,0,125,341,2,343
"گیلان","تالش","اسالم",50,199,8,2,236,445,1,446
"گیلان","تالش","حویق",1,347,1,0,132,480,2,482
"گیلان","تالش","حویق",2,189,1,0,43,233,0,233
"گیلان","تالش","حویق",3,434,1,0,78,513,2,515
"گیلان","تالش","حویق",4,277,1,0,36,314,2,316
"گیلان","تالش","حویق",5,297,2,0,42,341,1,342
"گیلان","تالش","حویق",6,250,0,0,61,311,1,312
"گیلان","تالش","حویق",7,295,1,0,43,339,1,340
"گیلان","تالش","حویق",8,889,3,0,137,1029,5,1034
"گیلان","تالش","حویق",9,459,2,0,76,537,1,538
"گیلان","تالش","حویق",10,439,1,0,76,516,3,519
"گیلان","تالش","حویق",11,382,1,1,70,454,4,458
"گیلان","تالش","حویق",12,357,3,0,108,468,0,468
"گیلان","تالش","حویق",13,182,0,0,32,214,2,216
"گیلان","تالش","حویق",14,378,2,0,107,487,4,491
"گیلان","تالش","حویق",15,752,8,4,232,996,14,1010
"گیلان","تالش","حویق",16,341,3,4,115,463,2,465
"گیلان","تالش","حویق",17,278,1,0,114,393,4,397
"گیلان","تالش","حویق",18,444,6,3,117,570,0,570
"گیلان","تالش","حویق",19,296,2,1,65,364,4,368
"گیلان","تالش","حویق",20,714,3,2,155,874,0,874
"گیلان","تالش","حویق",21,132,2,0,35,169,0,169
"گیلان","تالش","حویق",22,617,3,3,123,746,0,746
"گیلان","تالش","حویق",23,315,1,1,32,349,0,349
"گیلان","تالش","حویق",24,173,0,1,62,236,0,236
"گیلان","تالش","حویق",25,326,2,2,34,364,0,364
"گیلان","تالش","حویق",26,341,0,7,111,459,0,459
"گیلان","تالش","حویق",27,294,2,0,35,331,1,332
"گیلان","تالش","حویق",28,193,1,0,59,253,2,255
"گیلان","تالش","حویق",29,275,0,1,275,551,2,553
"گیلان","تالش","حویق",30,417,3,3,106,529,2,531
"گیلان","تالش","حویق",31,504,2,0,88,594,6,600
"گیلان","تالش","حویق",32,145,1,0,15,161,2,163
"گیلان","تالش","حویق",33,197,0,0,112,309,0,309
"گیلان","تالش","حویق",34,150,0,0,24,174,4,178
"گیلان","تالش","حویق",35,180,0,0,35,215,0,215
"گیلان","تالش","حویق",36,405,1,0,14,420,0,420
"گیلان","تالش","حویق",37,129,0,1,61,191,4,195
"گیلان","تالش","حویق",38,341,1,0,51,393,4,397
"گیلان","تالش","حویق",39,174,0,0,14,188,0,188
"گیلان","تالش","حویق",40,402,0,0,12,414,1,415
"گیلان","تالش","حویق",41,185,0,0,2,187,4,191
"گیلان","تالش","حویق",42,171,0,0,7,178,0,178
"گیلان","تالش","حویق",43,33,0,0,0,33,0,33
"گیلان","تالش","حویق",44,337,0,0,8,345,1,346
"گیلان","تالش","حویق",45,123,0,0,8,131,0,131
"گیلان","تالش","حویق",46,229,0,0,16,245,0,245
"گیلان","تالش","کرگانرود",1,401,8,1,174,584,2,586
"گیلان","تالش","کرگانرود",2,162,1,0,47,210,1,211
"گیلان","تالش","کرگانرود",3,65,3,0,54,122,1,123
"گیلان","تالش","کرگانرود",4,112,0,0,55,167,0,167
"گیلان","تالش","کرگانرود",5,467,1,6,219,693,7,700
"گیلان","تالش","کرگانرود",6,448,2,2,51,503,2,505
"گیلان","تالش","کرگانرود",7,152,1,0,38,191,1,192
"گیلان","تالش","کرگانرود",8,286,1,0,50,337,0,337
"گیلان","تالش","کرگانرود",9,352,1,1,54,408,2,410
"گیلان","تالش","کرگانرود",10,358,1,0,78,437,2,439
"گیلان","تالش","کرگانرود",11,161,0,2,44,207,0,207
"گیلان","تالش","کرگانرود",12,337,1,0,23,361,0,361
"گیلان","تالش","کرگانرود",13,329,3,0,122,454,1,455
"گیلان","تالش","کرگانرود",14,348,2,0,50,400,4,404
"گیلان","تالش","کرگانرود",15,369,0,0,42,411,2,413
"گیلان","تالش","کرگانرود",16,221,3,0,6,230,0,230
"گیلان","تالش","کرگانرود",17,176,1,0,29,206,3,209
"گیلان","تالش","کرگانرود",18,273,0,0,25,298,0,298
"گیلان","تالش","کرگانرود",19,259,1,0,47,307,0,307
"گیلان","تالش","کرگانرود",20,411,2,0,63,476,1,477
"گیلان","تالش","کرگانرود",21,268,0,0,66,334,2,336
"گیلان","تالش","کرگانرود",22,206,0,1,74,281,2,283
"گیلان","تالش","کرگانرود",23,321,3,0,51,375,1,376
"گیلان","تالش","کرگانرود",24,183,0,0,12,195,0,195
"گیلان","تالش","کرگانرود",25,278,6,0,64,348,0,348
"گیلان","تالش","کرگانرود",26,520,0,0,70,590,1,591
"گیلان","تالش","کرگانرود",27,326,4,0,51,381,0,381
"گیلان","تالش","کرگانرود",28,202,1,1,38,242,1,243
"گیلان","تالش","کرگانرود",29,452,3,2,38,495,0,495
"گیلان","تالش","کرگانرود",30,553,3,1,58,615,6,621
"گیلان","تالش","کرگانرود",31,128,0,1,8,137,2,139
"گیلان","تالش","کرگانرود",32,309,1,3,118,431,0,431
"گیلان","تالش","کرگانرود",33,177,2,0,40,219,0,219
"گیلان","تالش","کرگانرود",34,187,1,0,66,254,1,255
"گیلان","تالش","کرگانرود",35,109,2,0,75,186,0,186
"گیلان","تالش","کرگانرود",36,263,0,0,21,284,2,286
"گیلان","تالش","کرگانرود",37,134,0,0,22,156,0,156
"گیلان","تالش","کرگانرود",38,254,0,1,12,267,0,267
"گیلان","تالش","کرگانرود",39,249,0,2,11,262,0,262
"گیلان","تالش","کرگانرود",40,205,0,0,10,215,0,215
"گیلان","تالش","کرگانرود",41,541,8,6,139,694,3,697
"گیلان","تالش","کرگانرود",42,195,2,0,34,231,0,231
"گیلان","تالش","کرگانرود",43,423,2,1,64,490,2,492
"گیلان","تالش","کرگانرود",44,201,0,1,25,227,0,227
"گیلان","تالش","کرگانرود",45,328,0,0,24,352,1,353
"گیلان","تالش","کرگانرود",46,295,1,0,19,315,0,315
"گیلان","تالش","کرگانرود",47,166,0,0,35,201,2,203
"گیلان","تالش","کرگانرود",48,94,0,0,17,111,2,113
"گیلان","تالش","کرگانرود",49,152,0,0,6,158,0,158
"گیلان","فومن","مرکزی",1,849,7,5,405,1266,11,1277
"گیلان","فومن","مرکزی",2,484,2,4,293,783,19,802
"گیلان","فومن","مرکزی",3,651,7,3,315,976,12,988
"گیلان","فومن","مرکزی",4,670,14,8,613,1305,20,1325
"گیلان","فومن","مرکزی",5,645,4,0,275,924,3,927
"گیلان","فومن","مرکزی",6,1363,12,6,311,1692,17,1709
"گیلان","فومن","مرکزی",7,563,4,2,280,849,10,859
"گیلان","فومن","مرکزی",8,525,12,3,234,774,6,780
"گیلان","فومن","مرکزی",9,468,5,1,183,657,20,677
"گیلان","فومن","مرکزی",10,589,13,2,384,988,12,1000
"گیلان","فومن","مرکزی",11,839,14,2,321,1176,18,1194
"گیلان","فومن","مرکزی",12,510,4,4,280,798,11,809
"گیلان","فومن","مرکزی",13,302,12,7,251,572,14,586
"گیلان","فومن","مرکزی",14,473,16,5,417,911,15,926
"گیلان","فومن","مرکزی",15,399,4,3,281,687,8,695
"گیلان","فومن","مرکزی",16,531,8,4,418,961,12,973
"گیلان","فومن","مرکزی",17,257,5,4,272,538,6,544
"گیلان","فومن","مرکزی",18,221,0,0,86,307,7,314
"گیلان","فومن","مرکزی",19,162,1,0,47,210,6,216
"گیلان","فومن","مرکزی",20,597,1,2,237,837,7,844
"گیلان","فومن","مرکزی",21,222,3,0,58,283,4,287
"گیلان","فومن","مرکزی",22,477,0,0,161,638,7,645
"گیلان","فومن","مرکزی",23,297,1,1,66,365,4,369
"گیلان","فومن","مرکزی",24,258,0,2,26,286,2,288
"گیلان","فومن","مرکزی",25,442,2,1,78,523,3,526
"گیلان","فومن","مرکزی",26,256,0,0,19,275,1,276
"گیلان","فومن","مرکزی",27,247,0,1,95,343,1,344
"گیلان","فومن","مرکزی",28,480,1,0,42,523,5,528
"گیلان","فومن","مرکزی",29,339,1,1,53,394,3,397
"گیلان","فومن","مرکزی",30,483,1,1,66,551,0,551
"گیلان","فومن","مرکزی",31,304,10,0,62,376,4,380
"گیلان","فومن","مرکزی",32,448,2,3,62,515,7,522
"گیلان","فومن","مرکزی",33,227,0,0,27,254,2,256
"گیلان","فومن","مرکزی",34,267,0,0,85,352,4,356
"گیلان","فومن","مرکزی",35,369,0,1,53,423,1,424
"گیلان","فومن","مرکزی",36,214,0,0,80,294,1,295
"گیلان","فومن","مرکزی",37,183,1,0,46,230,0,230
"گیلان","فومن","مرکزی",38,831,1,1,153,986,5,991
"گیلان","فومن","مرکزی",39,185,2,0,38,225,0,225
"گیلان","فومن","مرکزی",40,272,0,2,40,314,0,314
"گیلان","فومن","مرکزی",41,365,1,1,75,442,8,450
"گیلان","فومن","مرکزی",42,315,0,1,28,344,0,344
"گیلان","فومن","مرکزی",43,191,1,0,15,207,0,207
"گیلان","فومن","مرکزی",44,155,2,0,15,172,0,172
"گیلان","فومن","مرکزی",45,858,2,0,79,939,2,941
"گیلان","فومن","مرکزی",46,600,5,1,37,643,2,645
"گیلان","فومن","مرکزی",47,144,0,1,55,200,2,202
"گیلان","فومن","مرکزی",48,158,0,0,45,203,1,204
"گیلان","فومن","مرکزی",49,518,3,0,89,610,2,612
"گیلان","فومن","مرکزی",50,291,2,3,84,380,4,384
"گیلان","فومن","مرکزی",51,458,2,2,22,484,3,487
"گیلان","فومن","مرکزی",52,319,2,0,19,340,1,341
"گیلان","فومن","مرکزی",53,418,1,0,36,455,4,459
"گیلان","فومن","مرکزی",54,464,3,2,94,563,4,567
"گیلان","فومن","مرکزی",55,445,0,1,45,491,5,496
"گیلان","فومن","مرکزی",56,503,0,0,51,554,2,556
"گیلان","فومن","مرکزی",57,456,3,0,87,546,3,549
"گیلان","فومن","مرکزی",58,233,0,2,81,316,4,320
"گیلان","فومن","مرکزی",59,422,1,0,28,451,2,453
"گیلان","فومن","مرکزی",60,202,0,1,25,228,0,228
"گیلان","فومن","مرکزی",61,251,0,1,37,289,2,291
"گیلان","فومن","مرکزی",62,894,2,3,143,1042,9,1051
"گیلان","فومن","مرکزی",63,319,1,3,109,432,5,437
"گیلان","فومن","مرکزی",64,365,1,0,87,453,4,457
"گیلان","فومن","مرکزی",65,314,2,1,90,407,8,415
"گیلان","فومن","مرکزی",66,423,1,0,87,511,4,515
"گیلان","فومن","مرکزی",67,482,5,0,80,567,8,575
"گیلان","فومن","مرکزی",68,235,1,0,88,324,4,328
"گیلان","فومن","مرکزی",69,487,4,0,194,685,4,689
"گیلان","فومن","مرکزی",70,345,2,0,28,375,6,381
"گیلان","فومن","مرکزی",71,220,1,0,36,257,0,257
"گیلان","فومن","مرکزی",72,322,0,1,38,361,2,363
"گیلان","فومن","مرکزی",73,379,0,0,47,426,6,432
"گیلان","فومن","مرکزی",74,354,3,2,114,473,1,474
"گیلان","فومن","مرکزی",75,137,2,0,34,173,6,179
"گیلان","فومن","مرکزی",76,199,1,1,66,267,2,269
"گیلان","فومن","مرکزی",77,346,0,0,47,393,3,396
"گیلان","فومن","مرکزی",78,192,3,2,49,246,7,253
"گیلان","فومن","مرکزی",79,582,0,0,169,751,3,754
"گیلان","فومن","مرکزی",80,424,3,1,87,515,3,518
"گیلان","فومن","مرکزی",81,194,1,0,24,219,2,221
"گیلان","فومن","مرکزی",82,504,0,1,166,671,4,675
"گیلان","فومن","مرکزی",83,202,1,0,57,260,2,262
"گیلان","فومن","مرکزی",84,205,1,1,13,220,2,222
"گیلان","فومن","مرکزی",85,428,0,2,226,656,2,658
"گیلان","فومن","مرکزی",86,257,2,0,23,282,3,285
"گیلان","فومن","مرکزی",87,101,0,0,15,116,0,116
"گیلان","فومن","مرکزی",88,183,1,2,27,213,0,213
"گیلان","فومن","مرکزی",89,353,5,0,63,421,0,421
"گیلان","فومن","مرکزی",90,150,1,0,103,254,1,255
"گیلان","فومن","مرکزی",91,155,1,2,96,254,2,256
"گیلان","فومن","مرکزی",92,241,1,0,42,284,3,287
"گیلان","فومن","مرکزی",93,535,5,0,58,598,5,603
"گیلان","فومن","مرکزی",94,569,3,3,79,654,3,657
"گیلان","فومن","مرکزی",95,184,0,1,32,217,1,218
"گیلان","فومن","مرکزی",96,721,2,1,134,858,1,859
"گیلان","فومن","مرکزی",97,266,1,0,64,331,5,336
"گیلان","فومن","مرکزی",98,402,3,0,62,467,1,468
"گیلان","فومن","مرکزی",99,331,1,0,82,414,5,419
"گیلان","فومن","مرکزی",100,530,2,0,141,673,2,675
"گیلان","فومن","مرکزی",101,336,1,0,81,418,3,421
"گیلان","فومن","مرکزی",102,327,0,1,70,398,0,398
"گیلان","فومن","مرکزی",103,302,0,0,59,361,1,362
"گیلان","فومن","سردار_جنگل",1,237,10,2,457,706,9,715
"گیلان","فومن","سردار_جنگل",2,204,8,2,262,476,8,484
"گیلان","فومن","سردار_جنگل",3,479,5,1,165,650,2,652
"گیلان","فومن","سردار_جنگل",4,515,2,0,142,659,6,665
"گیلان","فومن","سردار_جنگل",5,208,1,0,41,250,2,252
"گیلان","فومن","سردار_جنگل",6,542,2,3,89,636,3,639
"گیلان","فومن","سردار_جنگل",7,208,0,0,73,281,2,283
"گیلان","فومن","سردار_جنگل",8,242,3,3,52,300,4,304
"گیلان","فومن","سردار_جنگل",9,131,1,1,22,155,0,155
"گیلان","فومن","سردار_جنگل",10,415,3,0,29,447,1,448
"گیلان","فومن","سردار_جنگل",11,561,4,0,111,676,2,678
"گیلان","فومن","سردار_جنگل",12,491,3,0,84,578,6,584
"گیلان","فومن","سردار_جنگل",13,172,0,0,11,183,1,184
"گیلان","فومن","سردار_جنگل",14,364,2,3,68,437,2,439
"گیلان","فومن","سردار_جنگل",15,279,3,0,39,321,0,321
"گیلان","فومن","سردار_جنگل",16,214,3,0,74,291,1,292
"گیلان","فومن","سردار_جنگل",17,317,1,0,42,360,1,361
"گیلان","فومن","سردار_جنگل",18,284,2,2,62,350,2,352
"گیلان","فومن","سردار_جنگل",19,218,1,0,24,243,0,243
"گیلان","فومن","سردار_جنگل",20,308,0,0,60,368,1,369
"گیلان","فومن","سردار_جنگل",21,404,0,0,119,523,2,525
"گیلان","فومن","سردار_جنگل",22,280,1,0,81,362,0,362
"گیلان","فومن","سردار_جنگل",23,258,1,0,97,356,1,357
"گیلان","فومن","سردار_جنگل",24,281,0,0,148,429,0,429
"گیلان","فومن","سردار_جنگل",25,317,0,0,47,364,2,366
"گیلان","فومن","سردار_جنگل",26,146,0,0,31,177,0,177
"گیلان","لاهیجان","مرکزی",1,731,16,7,372,1126,12,1138
"گیلان","لاهیجان","مرکزی",2,986,23,6,465,1480,18,1498
"گیلان","لاهیجان","مرکزی",3,444,14,11,350,819,10,829
"گیلان","لاهیجان","مرکزی",4,551,24,6,484,1065,12,1077
"گیلان","لاهیجان","مرکزی",5,766,25,10,483,1284,15,1299
"گیلان","لاهیجان","مرکزی",6,703,28,9,745,1485,24,1509
"گیلان","لاهیجان","مرکزی",7,221,11,11,400,643,9,652
"گیلان","لاهیجان","مرکزی",8,462,26,9,559,1056,18,1074
"گیلان","لاهیجان","مرکزی",9,403,8,9,322,742,13,755
"گیلان","لاهیجان","مرکزی",10,447,15,3,267,732,7,739
"گیلان","لاهیجان","مرکزی",11,633,14,6,435,1088,12,1100
"گیلان","لاهیجان","مرکزی",12,354,17,3,588,962,24,986
"گیلان","لاهیجان","مرکزی",13,477,23,6,548,1054,18,1072
"گیلان","لاهیجان","مرکزی",14,714,24,5,535,1278,15,1293
"گیلان","لاهیجان","مرکزی",15,898,22,12,647,1579,30,1609
"گیلان","لاهیجان","مرکزی",16,741,25,4,529,1299,20,1319
"گیلان","لاهیجان","مرکزی",17,507,20,18,843,1388,20,1408
"گیلان","لاهیجان","مرکزی",18,694,22,11,748,1475,25,1500
"گیلان","لاهیجان","مرکزی",19,544,23,10,776,1353,17,1370
"گیلان","لاهیجان","مرکزی",20,354,11,13,439,817,15,832
"گیلان","لاهیجان","مرکزی",21,491,16,15,417,939,15,954
"گیلان","لاهیجان","مرکزی",22,246,5,3,261,515,3,518
"گیلان","لاهیجان","مرکزی",23,161,8,17,461,647,8,655
"گیلان","لاهیجان","مرکزی",24,421,6,2,172,601,5,606
"گیلان","لاهیجان","مرکزی",25,235,10,13,640,898,9,907
"گیلان","لاهیجان","مرکزی",26,423,19,35,1294,1771,21,1792
"گیلان","لاهیجان","مرکزی",27,628,14,8,494,1144,10,1154
"گیلان","لاهیجان","مرکزی",28,1048,14,8,312,1382,14,1396
"گیلان","لاهیجان","مرکزی",29,453,6,2,263,724,6,730
"گیلان","لاهیجان","مرکزی",30,551,9,4,243,807,4,811
"گیلان","لاهیجان","مرکزی",31,226,11,4,640,881,11,892
"گیلان","لاهیجان","مرکزی",32,256,24,27,1193,1500,15,1515
"گیلان","لاهیجان","مرکزی",33,270,16,32,992,1310,14,1324
"گیلان","لاهیجان","مرکزی",34,1168,20,6,412,1606,17,1623
"گیلان","لاهیجان","مرکزی",35,243,5,1,118,367,6,373
"گیلان","لاهیجان","مرکزی",36,464,13,10,750,1237,11,1248
"گیلان","لاهیجان","مرکزی",37,433,11,5,355,804,11,815
"گیلان","لاهیجان","مرکزی",38,506,6,0,182,694,13,707
"گیلان","لاهیجان","مرکزی",39,612,14,13,507,1146,11,1157
"گیلان","لاهیجان","مرکزی",40,863,9,9,362,1243,11,1254
"گیلان","لاهیجان","مرکزی",41,470,3,0,78,551,1,552
"گیلان","لاهیجان","مرکزی",42,840,10,1,246,1097,10,1107
"گیلان","لاهیجان","مرکزی",43,384,10,23,714,1131,14,1145
"گیلان","لاهیجان","مرکزی",44,255,15,8,612,890,15,905
"گیلان","لاهیجان","مرکزی",45,291,11,10,513,825,10,835
"گیلان","لاهیجان","مرکزی",46,153,9,1,219,382,5,387
"گیلان","لاهیجان","مرکزی",47,204,5,1,112,322,3,325
"گیلان","لاهیجان","مرکزی",48,622,3,2,108,735,5,740
"گیلان","لاهیجان","مرکزی",49,658,3,0,79,740,4,744
"گیلان","لاهیجان","مرکزی",50,139,1,0,22,162,1,163
"گیلان","لاهیجان","مرکزی",51,328,1,0,22,351,0,351
"گیلان","لاهیجان","مرکزی",52,544,0,0,29,573,4,577
"گیلان","لاهیجان","مرکزی",53,480,0,1,37,518,1,519
"گیلان","لاهیجان","مرکزی",54,272,0,1,15,288,1,289
"گیلان","لاهیجان","مرکزی",55,440,0,1,53,494,0,494
"گیلان","لاهیجان","مرکزی",56,604,5,0,96,705,3,708
"گیلان","لاهیجان","مرکزی",57,557,9,0,88,654,4,658
"گیلان","لاهیجان","مرکزی",58,615,7,1,191,814,11,825
"گیلان","لاهیجان","مرکزی",59,662,9,0,111,782,9,791
"گیلان","لاهیجان","مرکزی",60,378,2,0,60,440,4,444
"گیلان","لاهیجان","مرکزی",61,472,3,2,106,583,4,587
"گیلان","لاهیجان","مرکزی",62,455,4,1,176,636,3,639
"گیلان","لاهیجان","مرکزی",63,487,3,5,90,585,3,588
"گیلان","لاهیجان","مرکزی",64,185,1,0,76,262,3,265
"گیلان","لاهیجان","مرکزی",65,196,1,0,28,225,0,225
"گیلان","لاهیجان","مرکزی",66,274,0,2,63,339,1,340
"گیلان","لاهیجان","مرکزی",67,345,3,0,110,458,4,462
"گیلان","لاهیجان","مرکزی",68,194,0,1,34,229,2,231
"گیلان","لاهیجان","مرکزی",69,218,0,0,54,272,3,275
"گیلان","لاهیجان","مرکزی",70,733,6,7,93,839,5,844
"گیلان","لاهیجان","مرکزی",71,416,1,2,197,616,8,624
"گیلان","لاهیجان","مرکزی",72,295,1,1,37,334,2,336
"گیلان","لاهیجان","مرکزی",73,260,3,0,26,289,3,292
"گیلان","لاهیجان","مرکزی",74,469,0,1,64,534,7,541
"گیلان","لاهیجان","مرکزی",75,310,4,0,93,407,2,409
"گیلان","لاهیجان","مرکزی",76,699,6,0,101,806,4,810
"گیلان","لاهیجان","مرکزی",77,630,0,0,52,682,4,686
"گیلان","لاهیجان","مرکزی",78,744,9,4,276,1033,4,1037
"گیلان","لاهیجان","مرکزی",79,399,1,1,105,506,9,515
"گیلان","لاهیجان","مرکزی",80,650,4,9,221,884,9,893
"گیلان","لاهیجان","مرکزی",81,528,2,2,125,657,2,659
"گیلان","لاهیجان","مرکزی",82,393,0,1,64,458,5,463
"گیلان","لاهیجان","مرکزی",83,424,1,0,129,554,3,557
"گیلان","لاهیجان","مرکزی",84,295,3,1,23,322,0,322
"گیلان","لاهیجان","مرکزی",85,464,1,2,130,597,5,602
"گیلان","لاهیجان","مرکزی",86,156,1,0,19,176,1,177
"گیلان","لاهیجان","مرکزی",87,299,5,2,39,345,0,345
"گیلان","لاهیجان","مرکزی",88,368,1,0,73,442,3,445
"گیلان","لاهیجان","مرکزی",89,306,1,1,48,356,1,357
"گیلان","لاهیجان","مرکزی",90,501,3,1,163,668,1,669
"گیلان","لاهیجان","مرکزی",91,353,0,3,64,420,0,420
"گیلان","لاهیجان","مرکزی",92,303,0,0,46,349,4,353
"گیلان","لاهیجان","مرکزی",93,249,2,1,57,309,1,310
"گیلان","لاهیجان","مرکزی",94,241,0,0,19,260,0,260
"گیلان","لاهیجان","مرکزی",95,465,2,0,56,523,5,528
"گیلان","لاهیجان","مرکزی",96,136,0,0,9,145,1,146
"گیلان","لاهیجان","مرکزی",97,278,1,0,16,295,0,295
"گیلان","لاهیجان","مرکزی",98,210,1,1,27,239,1,240
"گیلان","لاهیجان","مرکزی",99,785,2,0,198,985,13,998
"گیلان","لاهیجان","مرکزی",100,577,1,0,83,661,8,669
"گیلان","لاهیجان","مرکزی",101,365,1,0,66,432,4,436
"گیلان","لاهیجان","مرکزی",102,398,1,1,46,446,1,447
"گیلان","لاهیجان","مرکزی",103,742,2,2,44,790,2,792
"گیلان","لاهیجان","مرکزی",104,297,1,1,50,349,0,349
"گیلان","لاهیجان","مرکزی",105,377,6,5,242,630,10,640
"گیلان","لاهیجان","مرکزی",106,625,4,0,148,777,10,787
"گیلان","لاهیجان","مرکزی",107,316,0,0,4,320,0,320
"گیلان","لاهیجان","مرکزی",108,745,4,0,89,838,2,840
"گیلان","لاهیجان","مرکزی",109,341,0,0,35,376,3,379
"گیلان","لاهیجان","مرکزی",110,656,2,0,18,676,0,676
"گیلان","لاهیجان","مرکزی",111,617,1,0,14,632,2,634
"گیلان","لاهیجان","مرکزی",112,312,1,0,27,340,7,347
"گیلان","لاهیجان","مرکزی",113,304,0,0,23,327,1,328
"گیلان","لاهیجان","مرکزی",114,226,0,0,35,261,8,269
"گیلان","لاهیجان","رودبنه",1,368,3,1,215,587,2,589
"گیلان","لاهیجان","رودبنه",2,527,4,1,399,931,10,941
"گیلان","لاهیجان","رودبنه",3,344,3,0,178,525,5,530
"گیلان","لاهیجان","رودبنه",4,328,3,1,119,451,4,455
"گیلان","لاهیجان","رودبنه",5,197,0,0,66,263,0,263
"گیلان","لاهیجان","رودبنه",6,336,0,0,61,397,2,399
"گیلان","لاهیجان","رودبنه",7,179,0,1,109,289,2,291
"گیلان","لاهیجان","رودبنه",8,234,0,1,24,259,0,259
"گیلان","لاهیجان","رودبنه",9,286,8,0,98,392,7,399
"گیلان","لاهیجان","رودبنه",10,312,0,0,36,348,2,350
"گیلان","لاهیجان","رودبنه",11,276,2,0,62,340,1,341
"گیلان","لاهیجان","رودبنه",12,340,0,1,79,420,2,422
"گیلان","لاهیجان","رودبنه",13,430,2,1,173,606,2,608
"گیلان","لاهیجان","رودبنه",14,397,5,1,28,431,5,436
"گیلان","لاهیجان","رودبنه",15,436,2,1,51,490,5,495
"گیلان","لاهیجان","رودبنه",16,422,9,2,104,537,4,541
"گیلان","لاهیجان","رودبنه",17,256,4,0,67,327,0,327
"گیلان","لاهیجان","رودبنه",18,397,1,4,38,440,1,441
"گیلان","لاهیجان","رودبنه",19,213,2,1,129,345,8,353
"گیلان","لاهیجان","رودبنه",20,329,8,0,106,443,3,446
"گیلان","لاهیجان","رودبنه",21,501,9,0,273,783,12,795
"گیلان","لاهیجان","رودبنه",22,169,3,0,30,202,0,202
"گیلان","لاهیجان","رودبنه",23,631,10,0,133,774,0,774
"گیلان","لاهیجان","رودبنه",24,367,1,0,35,403,0,403
"گیلان","لاهیجان","رودبنه",25,252,0,0,30,282,4,286
"گیلان","لاهیجان","رودبنه",26,541,3,4,89,637,7,644
"گیلان","لاهیجان","رودبنه",27,516,4,0,53,573,5,578
"گیلان","لاهیجان","رودبنه",28,385,3,1,126,515,2,517
"گیلان","لاهیجان","رودبنه",29,256,2,3,48,309,2,311
"گیلان","لاهیجان","رودبنه",30,579,8,3,192,782,3,785
"گیلان","لاهیجان","رودبنه",31,234,0,1,37,272,1,273
"گیلان","لاهیجان","رودبنه",32,273,2,0,60,335,2,337
"گیلان","لاهیجان","رودبنه",33,270,1,1,42,314,4,318
"گیلان","لاهیجان","رودبنه",34,362,9,0,91,462,2,464
"گیلان","لاهیجان","رودبنه",35,543,4,6,153,706,15,721
"گیلان","لاهیجان","رودبنه",36,183,2,0,34,219,3,222
"گیلان","لاهیجان","رودبنه",37,360,3,2,85,450,6,456
"گیلان","لاهیجان","رودبنه",38,741,9,20,112,882,10,892
"گیلان","لاهیجان","رودبنه",39,472,2,17,210,701,6,707
"گیلان","لاهیجان","رودبنه",40,188,1,0,40,229,5,234
"گیلان","لاهیجان","رودبنه",41,267,0,0,66,333,2,335
"گیلان","لاهیجان","رودبنه",42,672,4,10,97,783,3,786
"گیلان","لاهیجان","رودبنه",43,348,1,3,95,447,4,451
"گیلان","لاهیجان","رودبنه",44,294,3,0,22,319,0,319
"گیلان","لاهیجان","رودبنه",45,567,0,1,34,602,2,604
"گیلان","لاهیجان","رودبنه",46,408,0,1,137,546,2,548
"گیلان","لاهیجان","رودبنه",47,286,1,2,146,435,4,439
"گیلان","لنگرود","مرکزی",1,499,12,5,481,997,18,1015
"گیلان","لنگرود","مرکزی",2,707,20,11,712,1450,11,1461
"گیلان","لنگرود","مرکزی",3,499,15,0,233,747,6,753
"گیلان","لنگرود","مرکزی",4,647,16,3,372,1038,20,1058
"گیلان","لنگرود","مرکزی",5,266,19,10,686,981,16,997
"گیلان","لنگرود","مرکزی",6,219,9,4,356,588,8,596
"گیلان","لنگرود","مرکزی",7,520,13,6,974,1513,17,1530
"گیلان","لنگرود","مرکزی",8,242,11,0,527,780,10,790
"گیلان","لنگرود","مرکزی",9,337,12,0,394,743,19,762
"گیلان","لنگرود","مرکزی",10,442,10,4,307,763,8,771
"گیلان","لنگرود","مرکزی",11,737,18,7,678,1440,16,1456
"گیلان","لنگرود","مرکزی",12,613,19,1,286,919,9,928
"گیلان","لنگرود","مرکزی",13,224,6,3,217,450,2,452
"گیلان","لنگرود","مرکزی",14,247,10,0,220,477,9,486
"گیلان","لنگرود","مرکزی",15,581,5,0,114,700,4,704
"گیلان","لنگرود","مرکزی",16,813,23,1,491,1328,14,1342
"گیلان","لنگرود","مرکزی",17,573,9,3,274,859,10,869
"گیلان","لنگرود","مرکزی",18,358,8,2,199,567,9,576
"گیلان","لنگرود","مرکزی",19,1018,21,5,304,1348,15,1363
"گیلان","لنگرود","مرکزی",20,694,35,7,740,1476,21,1497
"گیلان","لنگرود","مرکزی",21,1256,17,5,282,1560,20,1580
"گیلان","لنگرود","مرکزی",22,688,9,0,219,916,11,927
"گیلان","لنگرود","مرکزی",23,977,6,4,304,1291,16,1307
"گیلان","لنگرود","مرکزی",24,344,3,2,280,629,6,635
"گیلان","لنگرود","مرکزی",25,747,37,6,552,1342,23,1365
"گیلان","لنگرود","مرکزی",26,667,16,2,569,1254,17,1271
"گیلان","لنگرود","مرکزی",27,219,6,1,254,480,10,490
"گیلان","لنگرود","مرکزی",28,658,9,3,354,1024,7,1031
"گیلان","لنگرود","مرکزی",29,507,5,4,124,640,5,645
"گیلان","لنگرود","مرکزی",30,252,6,8,297,563,3,566
"گیلان","لنگرود","مرکزی",31,518,5,0,168,691,2,693
"گیلان","لنگرود","مرکزی",32,616,5,2,227,850,8,858
"گیلان","لنگرود","مرکزی",33,337,18,2,261,618,7,625
"گیلان","لنگرود","مرکزی",34,838,9,1,212,1060,4,1064
"گیلان","لنگرود","مرکزی",35,790,13,1,212,1016,7,1023
"گیلان","لنگرود","مرکزی",36,604,11,2,225,842,10,852
"گیلان","لنگرود","مرکزی",37,490,27,7,319,843,17,860
"گیلان","لنگرود","مرکزی",38,491,23,4,478,996,9,1005
"گیلان","لنگرود","مرکزی",39,832,12,0,322,1166,8,1174
"گیلان","لنگرود","مرکزی",40,380,3,0,152,535,6,541
"گیلان","لنگرود","مرکزی",41,660,16,1,350,1027,16,1043
"گیلان","لنگرود","مرکزی",42,324,2,0,135,461,5,466
"گیلان","لنگرود","مرکزی",43,329,9,7,196,541,13,554
"گیلان","لنگرود","مرکزی",44,345,1,0,77,423,3,426
"گیلان","لنگرود","مرکزی",45,384,5,2,238,629,6,635
"گیلان","لنگرود","مرکزی",46,489,6,0,173,668,6,674
"گیلان","لنگرود","مرکزی",47,391,5,1,265,662,5,667
"گیلان","لنگرود","مرکزی",48,289,2,1,239,531,10,541
"گیلان","لنگرود","مرکزی",49,208,2,0,53,263,3,266
"گیلان","لنگرود","مرکزی",50,452,6,2,268,728,9,737
"گیلان","لنگرود","مرکزی",51,380,6,2,184,572,6,578
"گیلان","لنگرود","مرکزی",52,204,4,0,182,390,7,397
"گیلان","لنگرود","مرکزی",53,710,11,2,192,915,12,927
"گیلان","لنگرود","مرکزی",54,462,6,0,85,553,0,553
"گیلان","لنگرود","مرکزی",55,385,2,0,135,522,3,525
"گیلان","لنگرود","مرکزی",56,679,7,0,238,924,10,934
"گیلان","لنگرود","مرکزی",57,512,5,4,236,757,16,773
"گیلان","لنگرود","مرکزی",58,726,5,0,109,840,9,849
"گیلان","لنگرود","مرکزی",59,343,3,1,122,469,6,475
"گیلان","لنگرود","مرکزی",60,255,1,0,79,335,4,339
"گیلان","لنگرود","مرکزی",61,484,6,0,105,595,3,598
"گیلان","لنگرود","مرکزی",62,307,1,0,68,376,1,377
"گیلان","لنگرود","مرکزی",63,463,7,1,396,867,4,871
"گیلان","لنگرود","مرکزی",64,294,1,2,199,496,5,501
"گیلان","لنگرود","مرکزی",65,367,1,3,62,433,1,434
"گیلان","لنگرود","مرکزی",66,351,10,2,59,422,1,423
"گیلان","لنگرود","مرکزی",67,546,8,23,259,836,13,849
"گیلان","لنگرود","مرکزی",68,467,5,9,324,805,13,818
"گیلان","لنگرود","مرکزی",69,458,3,0,68,529,11,540
"گیلان","لنگرود","مرکزی",70,400,2,0,27,429,1,430
"گیلان","لنگرود","مرکزی",71,472,3,1,62,538,2,540
"گیلان","لنگرود","مرکزی",72,492,2,0,66,560,1,561
"گیلان","لنگرود","مرکزی",73,580,7,4,135,726,2,728
"گیلان","لنگرود","مرکزی",74,269,3,0,80,352,4,356
"گیلان","لنگرود","مرکزی",75,361,3,0,79,443,2,445
"گیلان","لنگرود","مرکزی",76,482,1,1,204,688,5,693
"گیلان","لنگرود","مرکزی",77,252,1,0,23,276,2,278
"گیلان","لنگرود","مرکزی",78,751,11,2,211,975,8,983
"گیلان","لنگرود","مرکزی",79,269,0,0,15,284,4,288
"گیلان","لنگرود","مرکزی",80,800,5,0,105,910,11,921
"گیلان","لنگرود","مرکزی",81,308,1,0,37,346,0,346
"گیلان","لنگرود","مرکزی",82,202,6,0,89,297,5,302
"گیلان","لنگرود","مرکزی",83,691,0,0,104,795,9,804
"گیلان","لنگرود","مرکزی",84,434,0,0,82,516,1,517
"گیلان","لنگرود","مرکزی",85,261,3,4,142,410,2,412
"گیلان","لنگرود","مرکزی",86,112,3,0,61,176,0,176
"گیلان","لنگرود","مرکزی",87,254,2,0,36,292,3,295
"گیلان","لنگرود","مرکزی",88,558,1,0,105,664,1,665
"گیلان","لنگرود","مرکزی",89,347,2,0,68,417,2,419
"گیلان","لنگرود","مرکزی",90,335,2,2,93,432,4,436
"گیلان","لنگرود","کومله",1,529,20,5,301,855,13,868
"گیلان","لنگرود","کومله",2,442,3,1,200,646,11,657
"گیلان","لنگرود","کومله",3,485,8,2,282,777,12,789
"گیلان","لنگرود","کومله",4,300,4,3,202,509,7,516
"گیلان","لنگرود","کومله",5,356,2,0,101,459,10,469
"گیلان","لنگرود","کومله",6,349,5,0,144,498,7,505
"گیلان","لنگرود","کومله",7,158,0,0,63,221,2,223
"گیلان","لنگرود","کومله",8,393,1,3,149,546,10,556
"گیلان","لنگرود","کومله",9,446,3,3,115,567,3,570
"گیلان","لنگرود","کومله",10,248,1,0,65,314,5,319
"گیلان","لنگرود","کومله",11,638,2,1,64,705,0,705
"گیلان","لنگرود","کومله",12,571,3,0,61,635,9,644
"گیلان","لنگرود","کومله",13,183,2,1,75,261,4,265
"گیلان","لنگرود","کومله",14,251,0,0,19,270,2,272
"گیلان","لنگرود","کومله",15,397,4,0,34,435,3,438
"گیلان","لنگرود","کومله",16,749,4,3,144,900,2,902
"گیلان","لنگرود","کومله",17,543,2,3,77,625,4,629
"گیلان","لنگرود","کومله",18,408,0,1,36,445,0,445
"گیلان","لنگرود","کومله",19,246,1,0,23,270,3,273
"گیلان","لنگرود","کومله",20,568,11,2,100,681,6,687
"گیلان","لنگرود","کومله",21,157,1,0,15,173,0,173
"گیلان","لنگرود","اطاقور",1,370,3,3,48,424,4,428
"گیلان","لنگرود","اطاقور",2,401,4,3,100,508,4,512
"گیلان","لنگرود","اطاقور",3,296,7,1,85,389,1,390
"گیلان","لنگرود","اطاقور",4,186,1,0,38,225,0,225
"گیلان","لنگرود","اطاقور",5,363,0,0,84,447,5,452
"گیلان","لنگرود","اطاقور",6,182,2,0,85,269,0,269
"گیلان","لنگرود","اطاقور",7,301,1,0,14,316,2,318
"گیلان","لنگرود","اطاقور",8,344,5,0,61,410,4,414
"گیلان","لنگرود","اطاقور",9,147,1,0,43,191,2,193
"گیلان","لنگرود","اطاقور",10,204,2,0,36,242,0,242
"گیلان","لنگرود","اطاقور",11,667,6,1,65,739,2,741
"گیلان","لنگرود","اطاقور",12,349,3,1,56,409,4,413
"گیلان","لنگرود","اطاقور",13,338,1,1,77,417,0,417
"گیلان","لنگرود","اطاقور",14,295,5,0,32,332,2,334
"گیلان","لنگرود","اطاقور",15,210,1,0,24,235,3,238
"گیلان","لنگرود","اطاقور",16,158,0,0,32,190,0,190
"گیلان","لنگرود","اطاقور",17,239,0,0,22,261,3,264
"گیلان","لنگرود","اطاقور",18,129,3,0,6,138,2,140
"گیلان","لنگرود","اطاقور",19,152,1,0,12,165,1,166
"گیلان","لنگرود","اطاقور",20,176,1,0,11,188,0,188
"گیلان","لنگرود","اطاقور",21,125,0,0,8,133,0,133
"گیلان","لنگرود","اطاقور",22,146,0,0,10,156,0,156
"گیلان","لنگرود","اطاقور",23,279,0,0,13,292,0,292
"گیلان","لنگرود","اطاقور",24,133,1,0,10,144,0,144
"گیلان","لنگرود","اطاقور",25,189,6,0,22,217,0,217
"گیلان","لنگرود","اطاقور",26,283,0,0,28,311,1,312
"گیلان","لنگرود","اطاقور",27,237,0,0,29,266,4,270
"گیلان","لنگرود","اطاقور",28,126,1,0,5,132,0,132
"گیلان","لنگرود","اطاقور",29,182,0,0,24,206,2,208
"گیلان","لنگرود","اطاقور",30,366,0,1,22,389,1,390
"گیلان","لنگرود","اطاقور",31,226,1,0,23,250,1,251
"گیلان","لنگرود","اطاقور",32,228,3,1,95,327,5,332
"گیلان","لنگرود","اطاقور",33,49,0,0,4,53,0,53
"گیلان","لنگرود","اطاقور",34,132,1,0,9,142,2,144
"گیلان","لنگرود","اطاقور",35,191,3,0,33,227,0,227
"گیلان","لنگرود","اطاقور",36,137,2,1,28,168,0,168
"گیلان","لنگرود","اطاقور",37,191,0,0,20,211,0,211
"گیلان","لنگرود","اطاقور",38,183,0,0,14,197,1,198
"گیلان","لنگرود","اطاقور",39,190,0,1,15,206,1,207
"گیلان","ماسال","مرکزی",1,258,1,0,110,369,8,377
"گیلان","ماسال","مرکزی",2,500,6,6,351,863,10,873
"گیلان","ماسال","مرکزی",3,622,15,8,404,1049,11,1060
"گیلان","ماسال","مرکزی",4,155,3,1,120,279,7,286
"گیلان","ماسال","مرکزی",5,478,5,5,230,718,5,723
"گیلان","ماسال","مرکزی",6,191,3,1,92,287,2,289
"گیلان","ماسال","مرکزی",7,759,12,3,275,1049,3,1052
"گیلان","ماسال","مرکزی",8,463,1,7,183,654,11,665
"گیلان","ماسال","مرکزی",9,356,5,2,175,538,4,542
"گیلان","ماسال","مرکزی",10,362,1,2,158,523,7,530
"گیلان","ماسال","مرکزی",11,300,5,6,100,411,3,414
"گیلان","ماسال","مرکزی",12,254,4,1,157,416,4,420
"گیلان","ماسال","مرکزی",13,167,1,0,21,189,2,191
"گیلان","ماسال","مرکزی",14,244,3,1,123,371,4,375
"گیلان","ماسال","مرکزی",15,195,0,0,52,247,1,248
"گیلان","ماسال","مرکزی",16,449,7,5,106,567,3,570
"گیلان","ماسال","مرکزی",17,219,0,1,128,348,1,349
"گیلان","ماسال","مرکزی",18,149,0,0,21,170,2,172
"گیلان","ماسال","مرکزی",19,117,0,0,4,121,1,122
"گیلان","ماسال","مرکزی",20,130,3,0,26,159,1,160
"گیلان","ماسال","مرکزی",21,367,1,1,77,446,2,448
"گیلان","ماسال","مرکزی",22,270,1,0,20,291,5,296
"گیلان","ماسال","مرکزی",23,218,6,0,85,309,3,312
"گیلان","ماسال","مرکزی",24,545,3,2,84,634,4,638
"گیلان","ماسال","مرکزی",25,321,1,0,50,372,3,375
"گیلان","ماسال","مرکزی",26,281,4,1,73,359,2,361
"گیلان","ماسال","مرکزی",27,134,0,1,6,141,0,141
"گیلان","ماسال","مرکزی",28,261,2,0,40,303,1,304
"گیلان","ماسال","مرکزی",29,79,0,0,7,86,0,86
"گیلان","ماسال","مرکزی",30,371,3,0,43,417,2,419
"گیلان","ماسال","مرکزی",31,383,5,1,130,519,0,519
"گیلان","ماسال","مرکزی",32,149,3,0,87,239,0,239
"گیلان","ماسال","مرکزی",33,139,1,0,78,218,0,218
"گیلان","ماسال","مرکزی",34,170,0,0,39,209,0,209
"گیلان","ماسال","مرکزی",35,334,2,0,90,426,2,428
"گیلان","ماسال","مرکزی",36,311,1,0,58,370,0,370
"گیلان","ماسال","مرکزی",37,369,0,0,48,417,1,418
"گیلان","ماسال","مرکزی",38,343,0,0,32,375,0,375
"گیلان","ماسال","مرکزی",39,131,0,1,9,141,2,143
"گیلان","ماسال","مرکزی",40,296,0,0,39,335,0,335
"گیلان","ماسال","مرکزی",41,474,4,0,42,520,0,520
"گیلان","ماسال","مرکزی",42,282,0,1,38,321,1,322
"گیلان","ماسال","مرکزی",43,154,0,0,40,194,1,195
"گیلان","ماسال","مرکزی",44,206,0,0,75,281,1,282
"گیلان","ماسال","مرکزی",45,300,1,0,32,333,0,333
"گیلان","ماسال","مرکزی",46,98,1,1,29,129,0,129
"گیلان","ماسال","مرکزی",47,142,3,1,61,207,0,207
"گیلان","ماسال","شاندرمن",1,295,2,1,65,363,9,372
"گیلان","ماسال","شاندرمن",2,260,7,1,73,341,5,346
"گیلان","ماسال","شاندرمن",3,510,7,2,157,676,8,684
"گیلان","ماسال","شاندرمن",4,433,3,0,51,487,2,489
"گیلان","ماسال","شاندرمن",5,356,2,2,93,453,1,454
"گیلان","ماسال","شاندرمن",6,143,2,0,63,208,6,214
"گیلان","ماسال","شاندرمن",7,271,1,1,111,384,4,388
"گیلان","ماسال","شاندرمن",8,354,3,0,127,484,9,493
"گیلان","ماسال","شاندرمن",9,126,0,4,24,154,1,155
"گیلان","ماسال","شاندرمن",10,605,2,0,57,664,2,666
"گیلان","ماسال","شاندرمن",11,188,1,0,38,227,0,227
"گیلان","ماسال","شاندرمن",12,349,1,2,95,447,0,447
"گیلان","ماسال","شاندرمن",13,165,0,0,30,195,0,195
"گیلان","ماسال","شاندرمن",14,315,3,0,14,332,0,332
"گیلان","ماسال","شاندرمن",15,539,2,3,54,598,4,602
"گیلان","ماسال","شاندرمن",16,162,1,0,22,185,0,185
"گیلان","ماسال","شاندرمن",17,208,0,0,23,231,4,235
"گیلان","ماسال","شاندرمن",18,284,1,0,21,306,2,308
"گیلان","ماسال","شاندرمن",19,231,0,1,82,314,0,314
"گیلان","ماسال","شاندرمن",20,125,0,1,16,142,1,143
"گیلان","ماسال","شاندرمن",21,336,1,0,33,370,0,370
"گیلان","ماسال","شاندرمن",22,389,0,0,43,432,1,433
"گیلان","ماسال","شاندرمن",23,651,3,2,109,765,2,767
"گیلان","ماسال","شاندرمن",24,449,1,3,74,527,0,527
"گیلان","ماسال","شاندرمن",25,523,4,0,84,611,1,612
"گیلان","ماسال","شاندرمن",26,372,2,0,69,443,0,443
"گیلان","ماسال","شاندرمن",27,171,6,0,52,229,1,230
"گیلان","ماسال","شاندرمن",28,332,1,0,18,351,2,353
"گیلان","ماسال","شاندرمن",29,353,1,0,5,359,1,360
"گیلان","ماسال","شاندرمن",30,166,1,0,18,185,0,185
"گیلان","ماسال","شاندرمن",31,207,0,0,94,301,0,301
"گیلان","ماسال","شاندرمن",32,319,0,0,15,334,1,335
"گیلان","ماسال","شاندرمن",33,194,1,0,7,202,0,202
"گیلان","ماسال","شاندرمن",34,255,3,0,51,309,1,310
"گیلان","ماسال","شاندرمن",35,277,2,0,31,310,0,310
"گیلان","ماسال","شاندرمن",36,314,4,0,64,382,0,382
"گیلان","ماسال","شاندرمن",37,368,2,0,36,406,2,408
"گیلان","ماسال","شاندرمن",38,89,0,0,11,100,0,100
"گیلان","ماسال","شاندرمن",39,161,0,0,3,164,0,164
"گیلان","ماسال","شاندرمن",40,219,0,0,9,228,0,228
"گیلان","ماسال","شاندرمن",41,360,0,0,5,365,0,365
